userid,age,dob_day,dob_year,dob_month,gender,tenure,friend_count,friendships_initiated,likes,likes_received,mobile_likes,mobile_likes_received,www_likes,www_likes_received
1496723,23,7,1990,3,male,184,1,0,94,0,0,0,94,0
1524162,37,3,1976,9,female,26,1,0,94,26,0,0,94,26
1653316,20,23,1993,6,female,347,1,1,102,5,78,3,24,2
2022368,59,3,1954,12,male,1092,1,1,113,1,1,0,112,1
1999300,23,26,1990,2,male,144,1,1,111,231,25,84,86,147
1709107,29,23,1984,12,male,5,1,1,110,11,110,10,0,1
1210718,22,3,1991,11,male,609,1,1,115,1,115,1,0,0
1796379,55,28,1958,4,male,550,1,1,123,135,0,2,123,133
1547753,55,12,1958,3,male,1416,1,1,121,112,45,62,76,50
1072822,24,9,1989,7,male,204,1,1,120,0,113,0,7,0
1997333,19,10,1994,9,male,377,1,1,127,1,127,0,0,1
1353461,48,23,1965,5,female,698,1,1,125,3,125,3,0,0
1384697,46,20,1967,3,male,226,1,0,132,34,0,3,132,31
2018658,56,11,1957,6,male,66,1,1,133,20,130,20,3,0
2048043,31,30,1982,3,female,55,1,1,137,89,62,69,75,20
1215822,17,13,1996,1,male,81,1,0,148,8,148,6,0,2
1805707,25,7,1988,6,female,192,1,1,165,7,165,5,0,2
2040144,22,5,1991,11,male,143,1,1,166,41,166,21,0,20
2181561,24,21,1989,2,female,410,1,1,194,16,1,4,193,12
1680121,54,3,1959,3,female,10,1,1,198,3,198,1,0,2
1402285,18,31,1995,12,male,205,1,1,210,45,5,6,205,39
1454461,19,9,1994,3,female,37,1,1,238,67,8,6,230,61
1228363,18,9,1995,9,female,15,1,0,237,114,237,108,0,6
1306240,23,1,1990,1,female,128,1,0,271,450,271,160,0,290
1072058,16,5,1997,12,male,26,1,1,323,3,42,0,281,3
1727513,43,15,1970,3,female,197,1,0,349,175,349,137,0,38
1537101,26,15,1987,10,female,76,1,1,389,28,389,27,0,1
2127908,13,23,2000,6,male,110,1,1,404,1,0,0,404,1
1058141,24,24,1989,10,male,316,1,1,422,458,422,397,0,61
1886839,25,15,1988,11,male,68,1,0,494,462,494,99,0,363
2168447,27,30,1986,1,female,32,1,0,532,55,500,42,32,13
1859150,58,18,1955,8,male,192,1,0,600,0,600,0,0,0
1765913,44,7,1969,10,female,35,1,1,677,340,142,266,535,74
2159954,106,15,1907,11,male,1031,1,1,1244,47,1237,31,7,16
1644207,19,12,1994,1,female,188,1,1,1427,25,1426,5,1,20
2164475,33,28,1980,3,male,71,1,0,1580,1326,0,679,1580,647
1006266,16,12,1997,7,female,213,1,1,5937,320,5704,122,233,198
1334321,16,28,1997,10,female,276,4,2,93,40,92,7,1,33
1828914,25,1,1988,1,male,31,4,4,92,12,92,10,0,2
1509361,29,3,1984,11,female,573,4,1,92,14,92,2,0,12
1829884,58,1,1955,12,female,204,4,4,100,0,100,0,0,0
1628051,16,22,1997,9,male,173,4,4,112,0,0,0,112,0
1923110,19,10,1994,9,female,5,4,4,112,36,61,25,51,11
1803278,25,1,1988,1,male,148,4,4,111,0,111,0,0,0
1479994,21,1,1992,5,female,245,4,2,121,32,115,32,6,0
1562544,18,1,1995,5,female,208,4,4,130,0,26,0,104,0
1899160,107,1,1906,1,male,949,4,2,133,85,0,3,133,82
1803711,53,25,1960,6,female,798,4,4,152,42,0,7,152,35
2017971,26,8,1987,5,male,368,4,3,190,127,190,51,0,76
1890435,18,1,1995,1,female,169,4,3,211,23,9,23,202,0
1926309,26,1,1987,1,female,667,4,3,238,101,55,57,183,44
1700345,30,19,1983,12,male,47,4,3,236,36,236,5,0,31
1119253,42,2,1971,9,female,275,4,2,251,8,251,7,0,1
1687632,15,23,1998,6,male,187,4,4,289,6,0,0,289,6
1409117,54,29,1959,4,male,58,4,4,521,11,495,6,26,5
1610121,33,21,1980,6,male,546,4,2,1150,31,294,29,856,2
1525441,20,13,1993,9,female,779,4,2,3338,16,3272,8,66,8
1686127,23,10,1990,5,male,200,6,5,15,6,15,5,0,1
1093632,26,20,1987,7,female,66,6,3,15,16,15,7,0,9
1819354,70,12,1943,7,female,272,7,5,16,11,0,5,16,6
1999015,59,11,1954,11,female,4,7,6,16,34,0,20,16,14
1556310,13,3,2000,10,female,165,7,4,16,24,9,12,7,12
2183296,25,10,1988,1,male,134,7,5,16,2,16,2,0,0
2003662,26,25,1987,4,male,454,7,5,16,0,16,0,0,0
1821792,42,25,1971,2,female,476,6,5,16,1,16,0,0,1
1110937,23,3,1990,6,female,271,6,2,16,4,16,3,0,1
1197264,46,14,1967,10,male,451,7,3,16,4,16,4,0,0
1004400,24,9,1989,1,male,178,6,4,17,0,0,0,17,0
1199919,25,1,1988,1,female,242,6,4,17,0,0,0,17,0
1622276,51,31,1962,7,female,301,7,2,17,4,0,1,17,3
2047914,39,31,1974,10,female,313,6,6,17,29,9,5,8,24
2135851,22,17,1991,7,female,140,6,3,17,0,17,0,0,0
1827217,23,7,1990,2,male,148,6,5,17,6,17,3,0,3
1237067,24,1,1989,7,female,341,6,5,17,4,17,4,0,0
2113528,43,29,1970,8,female,141,6,4,17,30,17,30,0,0
1781812,26,19,1987,3,male,596,6,3,18,0,0,0,18,0
1628673,20,18,1993,11,male,309,6,6,18,0,13,0,5,0
1688280,25,20,1988,8,female,260,7,4,18,6,18,4,0,2
2150976,39,20,1974,9,female,788,7,5,18,10,18,10,0,0
1744529,66,14,1947,11,male,395,7,5,19,0,0,0,19,0
2017052,100,4,1913,4,female,217,7,6,19,17,2,9,17,8
2093393,47,17,1966,8,male,950,6,5,19,2,19,2,0,0
1410643,20,5,1993,3,male,68,7,7,19,17,19,16,0,1
1662114,93,1,1920,1,female,58,7,7,20,5,0,0,20,5
1317296,28,19,1985,12,male,36,7,3,20,0,19,0,1,0
1989986,26,30,1987,3,female,463,7,6,20,0,20,0,0,0
1037040,76,17,1937,4,male,98,6,6,20,1,20,0,0,1
1465648,31,5,1982,5,male,15,6,5,20,5,20,5,0,0
1084898,61,21,1952,9,male,366,7,6,21,12,0,1,21,11
1415116,25,1,1988,1,male,42,6,6,21,0,21,0,0,0
1978472,22,5,1991,5,female,90,6,6,21,9,21,6,0,3
1402317,24,27,1989,8,male,647,7,3,21,14,21,6,0,8
1497037,20,9,1993,9,male,1169,7,3,22,34,0,1,22,33
1065500,30,7,1983,6,female,367,6,5,22,1,22,0,0,1
1569537,37,1,1976,1,female,763,7,4,22,3,22,3,0,0
1237241,39,20,1974,6,male,81,6,5,22,0,22,0,0,0
1858552,19,30,1994,11,female,282,7,5,22,4,22,4,0,0
1299941,53,23,1960,8,male,701,7,2,22,5,22,5,0,0
1486758,30,17,1983,9,male,11,7,7,23,10,23,9,0,1
1283302,45,30,1968,10,male,28,6,4,23,5,23,5,0,0
2044148,15,6,1998,7,female,1,6,6,24,3,0,0,24,3
2019839,28,7,1985,9,female,203,7,6,24,5,0,1,24,4
1973269,24,21,1989,8,male,156,7,4,24,21,0,8,24,13
1358905,21,28,1992,8,female,316,7,7,24,16,17,14,7,2
1554351,23,1,1990,1,female,327,7,2,24,7,21,4,3,3
1115632,28,18,1985,6,male,554,6,4,24,4,24,4,0,0
2031347,65,13,1948,6,female,603,7,4,25,1,7,0,18,1
1264112,24,25,1989,3,male,340,7,3,25,2,25,2,0,0
1645653,28,1,1985,1,male,72,7,6,25,25,25,9,0,16
2165912,42,14,1971,5,male,398,7,7,26,6,0,1,26,5
1892288,27,2,1986,9,male,426,6,5,26,3,26,3,0,0
1793967,21,24,1992,7,male,295,7,7,26,9,26,7,0,2
1602498,29,14,1984,7,male,191,6,6,27,0,3,0,24,0
2110790,21,4,1992,12,male,12,6,6,27,2,27,2,0,0
1025552,23,20,1990,10,female,26,6,4,27,2,27,1,0,1
1989426,108,1,1905,1,female,17,6,5,28,7,0,0,28,7
1813910,40,6,1973,10,male,220,7,5,28,11,14,0,14,11
1582963,48,6,1965,1,male,49,6,5,28,0,28,0,0,0
1349195,20,20,1993,8,female,34,6,5,28,13,28,12,0,1
1281397,25,1,1988,1,male,38,7,5,28,9,28,9,0,0
1105464,33,21,1980,7,male,73,7,5,28,47,28,44,0,3
1821314,50,12,1963,9,female,96,6,6,29,4,0,0,29,4
1398660,55,10,1958,9,male,415,7,4,29,2,0,1,29,1
1542493,36,3,1977,1,female,49,7,6,29,12,16,9,13,3
1397743,18,2,1995,2,male,7,6,6,29,0,29,0,0,0
1259980,25,15,1988,3,female,173,7,6,29,4,29,1,0,3
1294990,50,27,1963,11,female,650,6,4,29,11,29,8,0,3
1983056,35,20,1978,5,male,435,6,3,31,8,17,5,14,3
2012206,40,17,1973,7,male,733,6,3,31,12,19,8,12,4
1516279,26,12,1987,1,female,252,7,6,30,39,29,7,1,32
1999756,50,20,1963,3,female,4,7,7,30,1,30,1,0,0
2018973,21,16,1992,5,male,256,7,6,30,12,30,1,0,11
1366522,29,1,1984,1,male,9,6,6,31,53,31,51,0,2
1693038,25,25,1988,1,female,66,6,4,32,0,32,0,0,0
2011913,30,1,1983,6,male,8,6,6,32,2,32,1,0,1
2112854,59,25,1954,5,female,726,7,3,33,29,0,0,33,29
2190605,63,10,1950,1,male,312,6,4,33,0,28,0,5,0
1044283,44,2,1969,3,male,134,7,5,33,3,33,3,0,0
1745277,66,18,1947,8,male,261,7,6,33,4,33,4,0,0
1406801,43,8,1970,10,female,92,7,4,33,17,33,13,0,4
1459084,103,20,1910,1,male,1170,7,7,34,5,11,4,23,1
1822269,17,4,1996,1,male,60,6,3,34,8,12,1,22,7
1569003,21,25,1992,7,female,21,6,6,34,12,27,3,7,9
1917755,25,26,1988,4,female,155,7,7,34,8,34,6,0,2
1874020,47,10,1966,1,male,217,6,6,36,3,0,2,36,1
2151918,53,4,1960,2,female,59,6,5,35,0,35,0,0,0
1022131,60,16,1953,9,male,224,7,6,36,3,36,0,0,3
1905426,77,6,1936,9,female,588,7,4,35,0,35,0,0,0
1990935,25,1,1988,4,female,134,6,4,35,8,35,8,0,0
1158782,51,26,1962,7,female,74,6,2,36,10,36,4,0,6
1521146,52,27,1961,2,female,188,6,2,37,32,0,0,37,32
1212001,29,2,1984,7,female,163,6,6,38,0,0,0,38,0
1649918,37,9,1976,7,male,545,7,5,38,10,0,6,38,4
2088034,67,20,1946,6,female,73,6,0,39,17,0,0,39,17
1611493,17,5,1996,5,female,9,6,3,38,34,38,34,0,0
1687066,27,14,1986,9,female,588,7,4,40,2,0,0,40,2
1282621,36,7,1977,6,male,555,6,2,40,25,4,20,36,5
1580594,19,4,1994,2,male,13,7,4,42,12,33,8,9,4
2033030,36,18,1977,10,male,321,7,4,44,1,16,1,28,0
1778396,25,1,1988,1,female,265,7,6,46,42,44,36,2,6
2144464,31,16,1982,6,male,100,7,6,47,1,47,0,0,1
1886607,43,19,1970,4,female,479,6,3,47,13,47,13,0,0
2131568,28,3,1985,5,male,37,7,6,48,0,24,0,24,0
2177374,19,6,1994,3,male,323,6,6,48,16,46,16,2,0
1236874,20,18,1993,11,female,709,6,6,48,14,48,14,0,0
2096515,14,15,1999,10,male,28,7,4,51,1,14,0,37,1
1265041,43,20,1970,8,male,28,7,6,51,24,46,21,5,3
2168857,59,7,1954,3,female,178,6,5,53,7,13,0,40,7
2164428,21,29,1992,6,male,29,7,7,53,3,53,2,0,1
1588470,41,15,1972,10,male,663,6,4,55,7,0,0,55,7
1273597,50,10,1963,2,male,26,7,7,55,29,55,28,0,1
1712914,65,20,1948,5,male,336,7,5,56,0,0,0,56,0
1003157,108,10,1905,12,female,95,6,4,56,58,0,0,56,58
2082129,25,1,1988,1,female,252,7,7,56,0,29,0,27,0
1116477,38,13,1975,6,male,500,6,4,57,3,50,3,7,0
2020621,29,1,1984,3,male,9,6,4,57,275,44,267,13,8
1697139,24,25,1989,1,female,51,7,5,56,150,56,83,0,67
1351884,19,4,1994,9,male,55,7,6,60,1,60,1,0,0
1766991,38,1,1975,1,male,64,6,5,61,27,60,1,1,26
1378601,27,5,1986,5,female,104,7,6,61,41,61,19,0,22
1794731,71,25,1942,4,male,26,7,7,64,0,0,0,64,0
1659682,63,26,1950,5,male,1366,7,6,64,14,0,13,64,1
1510232,23,20,1990,9,female,44,6,5,64,14,64,14,0,0
1713824,34,16,1979,3,male,30,6,5,64,14,64,12,0,2
1044266,29,12,1984,5,male,122,6,5,68,8,29,2,39,6
1010297,31,3,1982,3,male,569,7,2,67,0,67,0,0,0
1325603,34,21,1979,8,male,440,7,6,68,7,68,4,0,3
1045530,20,23,1993,9,male,240,6,2,69,3,4,3,65,0
1940580,23,14,1990,3,male,395,7,3,69,1,1,0,68,1
1418914,27,18,1986,11,male,98,6,5,71,1,0,1,71,0
1159151,21,14,1992,8,male,322,7,3,73,3,0,0,73,3
1324795,23,25,1990,6,male,325,6,2,72,7,2,0,70,7
1837341,16,11,1997,11,female,494,6,3,73,0,58,0,15,0
1729395,23,25,1990,11,female,27,7,4,73,19,73,8,0,11
1751499,44,3,1969,12,female,51,7,0,76,7,32,7,44,0
1085458,40,7,1973,10,male,19,7,6,80,10,0,1,80,9
1159206,37,1,1976,1,male,638,6,5,78,16,74,16,4,0
1135362,25,1,1988,1,female,27,7,5,82,8,82,8,0,0
1390843,28,26,1985,12,male,119,6,4,83,24,83,17,0,7
1877534,68,25,1945,6,female,275,7,4,85,33,0,19,85,14
1003472,52,17,1961,7,male,124,6,2,85,40,66,22,19,18
1696629,39,15,1974,8,male,863,6,4,85,55,84,25,1,30
1534077,34,13,1979,6,female,283,7,6,87,62,87,16,0,46
1046212,34,1,1979,1,male,94,6,3,90,26,86,26,4,0
1583244,19,22,1994,1,male,398,6,5,94,2,0,0,94,2
1512476,20,17,1993,4,female,105,7,1,102,0,0,0,102,0
1007853,33,31,1980,8,female,128,6,6,104,5,0,2,104,3
2143055,32,2,1981,8,male,267,7,3,106,1,0,0,106,1
1341531,18,9,1995,2,female,148,7,3,105,65,93,30,12,35
1493426,27,10,1986,4,male,153,7,4,108,33,108,11,0,22
1563036,40,19,1973,1,male,129,6,4,115,8,0,1,115,7
1392098,72,31,1941,5,female,35,7,6,117,15,0,8,117,7
1788330,22,22,1991,9,female,5,7,4,114,14,36,6,78,8
2187820,68,17,1945,2,male,621,6,4,120,42,0,11,120,31
1002142,32,18,1981,7,female,687,7,6,134,29,134,6,0,23
1592207,28,1,1985,4,male,236,7,4,138,11,10,0,128,11
1447357,59,1,1954,1,female,137,7,4,138,38,0,1,138,37
1898707,45,20,1968,12,male,523,7,2,153,1,0,1,153,0
1992164,24,21,1989,10,male,344,7,1,154,206,154,140,0,66
1139519,33,13,1980,10,female,227,6,3,163,10,163,8,0,2
2151343,46,3,1967,12,male,148,6,4,163,33,163,2,0,31
1266915,54,6,1959,1,male,332,6,5,177,24,177,5,0,19
1069957,47,26,1966,12,female,82,6,1,175,167,175,142,0,25
1172340,33,1,1980,1,male,36,6,6,190,43,110,18,80,25
1112998,49,5,1964,6,female,257,6,5,199,3,0,3,199,0
1058069,62,29,1951,7,female,449,7,6,197,115,0,8,197,107
1562679,31,10,1982,10,male,403,7,4,199,7,199,5,0,2
1473343,43,5,1970,6,male,284,7,2,191,24,191,24,0,0
1240028,32,1,1981,1,female,284,7,4,201,2,176,2,25,0
1834364,36,3,1977,9,female,971,6,3,208,4,208,4,0,0
1687825,21,28,1992,1,male,140,7,6,212,146,1,40,211,106
1285260,59,11,1954,11,male,71,6,4,213,5,202,1,11,4
2160030,25,10,1988,11,male,413,6,6,239,1,0,1,239,0
1464516,14,3,1999,7,female,93,6,5,236,27,116,8,120,19
2077310,27,6,1986,6,female,55,7,4,242,33,232,27,10,6
2062139,26,18,1987,11,male,589,6,6,239,36,239,25,0,11
1249466,33,1,1980,1,male,507,7,4,240,12,240,1,0,11
2110060,45,27,1968,2,female,805,6,1,258,273,158,154,100,119
1297567,30,1,1983,9,male,1007,7,6,272,53,270,48,2,5
2101570,65,17,1948,5,male,310,7,5,284,50,284,32,0,18
1009333,32,25,1981,3,female,187,7,7,345,84,345,70,0,14
1806872,21,3,1992,6,male,195,6,5,350,248,285,129,65,119
2181036,20,6,1993,3,female,18,6,6,389,0,389,0,0,0
1631166,29,15,1984,7,female,566,7,4,422,6,0,1,422,5
1997899,26,1,1987,11,female,254,6,4,423,790,0,205,423,585
1439905,52,10,1961,10,female,373,6,3,449,227,201,48,248,179
1971042,26,6,1987,9,female,256,6,4,582,7,582,0,0,7
2111088,44,28,1969,9,male,267,6,5,787,85,0,20,787,65
1456982,18,1,1995,2,female,40,7,5,874,802,862,503,12,299
1806132,19,3,1994,8,female,848,6,4,1190,19,1190,4,0,15
1635648,19,27,1994,1,female,380,6,3,1318,33,1313,16,5,17
1818817,39,1,1974,6,female,282,7,4,1601,12,1601,10,0,2
1291948,25,1,1988,1,female,296,6,4,4474,44,110,14,4364,30
1784377,32,4,1981,10,male,8,8,7,71,48,67,42,4,6
1405030,20,26,1993,6,male,208,8,4,72,89,31,53,41,36
1365982,33,15,1980,4,male,320,8,7,75,16,0,9,75,7
1026563,40,21,1973,11,male,362,8,6,77,30,58,10,19,20
2095222,24,10,1989,1,male,107,8,6,77,18,77,10,0,8
2101059,35,1,1978,6,male,647,8,6,78,1,0,1,78,0
2156469,34,16,1979,8,female,23,8,6,83,32,80,16,3,16
1072943,37,27,1976,7,female,180,8,5,82,29,82,21,0,8
1232637,40,17,1973,1,female,226,8,6,87,20,0,0,87,20
1962687,25,1,1988,1,male,24,8,8,91,14,91,4,0,10
2033974,33,11,1980,9,female,94,8,7,91,6,91,6,0,0
1550410,19,28,1994,7,female,234,8,5,96,275,0,31,96,244
1904694,20,19,1993,4,female,210,8,6,97,28,97,26,0,2
1870440,48,14,1965,8,female,520,8,3,100,2,0,0,100,2
1964827,68,9,1945,12,male,751,8,5,101,17,0,0,101,17
1235162,81,29,1932,3,female,35,8,7,102,1,102,0,0,1
1418261,15,31,1998,1,female,33,8,3,108,37,108,36,0,1
1555593,35,25,1978,12,male,59,8,7,114,14,114,10,0,4
1319653,94,19,1919,5,male,336,8,6,131,12,0,10,131,2
1002736,43,10,1970,11,female,527,8,2,134,67,130,47,4,20
1855551,30,29,1983,6,male,514,8,4,137,5,0,5,137,0
1112163,15,18,1998,10,female,263,8,2,148,39,91,29,57,10
1300616,18,19,1995,8,female,167,8,2,146,40,146,38,0,2
1656738,36,19,1977,12,female,402,8,5,157,16,0,0,157,16
1974010,59,28,1954,4,female,306,8,4,152,38,0,0,152,38
1706143,51,16,1962,8,female,45,8,6,165,168,52,129,113,39
1266209,34,17,1979,5,male,504,8,7,166,4,149,2,17,2
1740781,17,18,1996,11,female,252,8,5,168,14,168,9,0,5
2005864,83,14,1930,4,female,534,8,8,172,0,172,0,0,0
1659747,23,20,1990,4,female,309,8,5,194,266,50,26,144,240
2123626,16,30,1997,9,female,364,8,8,216,11,215,3,1,8
1227734,41,6,1972,1,male,282,8,6,226,156,226,154,0,2
1546418,22,18,1991,2,female,369,8,4,238,50,0,4,238,46
1671093,32,31,1981,3,female,181,8,1,355,50,0,3,355,47
1807748,23,3,1990,8,female,433,8,7,469,0,469,0,0,0
2071367,19,6,1994,2,female,345,8,7,677,417,0,11,677,406
1093789,27,3,1986,11,female,423,8,4,718,251,683,151,35,100
1227106,28,12,1985,12,female,573,8,5,779,26,779,17,0,9
1478074,18,22,1995,4,female,71,8,7,799,1162,456,373,343,789
1473263,100,18,1913,12,female,529,8,4,913,7,913,6,0,1
1189437,37,24,1976,11,female,196,8,7,1235,2,1235,2,0,0
1300612,22,1,1991,5,male,260,8,7,1324,16,647,0,677,16
1285858,34,27,1979,2,female,49,8,7,7601,161,7601,106,0,55
1410037,61,5,1952,12,female,11,10,9,11,11,0,1,11,10
2154883,61,18,1952,6,male,1403,10,6,11,15,0,3,11,12
2124204,14,19,1999,1,female,173,9,0,11,0,11,0,0,0
1196791,19,1,1994,1,male,72,10,8,11,0,11,0,0,0
1280222,34,6,1979,2,male,532,9,9,11,0,11,0,0,0
1385076,36,18,1977,2,male,506,10,3,11,3,11,0,0,3
1600742,43,1,1970,1,male,132,10,8,11,2,11,1,0,1
1668365,23,15,1990,5,female,18,9,3,11,8,11,7,0,1
1344486,30,13,1983,2,male,532,9,6,11,16,11,14,0,2
1376160,32,4,1981,1,female,337,9,6,11,10,11,2,0,8
1349512,37,14,1976,5,male,353,9,3,11,10,11,8,0,2
1854623,39,12,1974,11,male,244,10,6,11,15,11,12,0,3
1803162,50,6,1963,12,female,574,9,5,11,9,11,8,0,1
1162324,43,9,1970,4,female,300,9,8,11,37,11,33,0,4
1197186,76,27,1937,4,female,652,9,6,12,2,1,0,11,2
1216361,28,1,1985,1,male,146,10,9,12,0,4,0,8,0
1712483,14,1,1999,1,male,95,10,9,12,3,3,0,9,3
2188412,24,8,1989,6,female,441,9,7,12,8,6,5,6,3
1796923,44,19,1969,7,male,858,10,5,12,109,6,93,6,16
1140536,35,10,1978,5,female,260,9,4,12,1,12,1,0,0
1933970,22,10,1991,1,male,140,10,6,12,6,12,6,0,0
1950450,37,15,1976,2,female,1272,10,7,12,6,12,6,0,0
2169750,21,9,1992,12,female,26,9,7,12,10,12,5,0,5
1668643,23,27,1990,5,male,24,10,8,12,8,12,8,0,0
1955692,32,21,1981,7,male,116,9,9,13,0,0,0,13,0
1164332,59,18,1954,10,male,235,9,7,13,0,0,0,13,0
1529529,23,19,1990,10,male,98,10,7,13,5,0,4,13,1
1178698,37,8,1976,9,male,38,10,10,13,0,3,0,10,0
2091948,43,25,1970,12,female,85,9,4,13,42,12,25,1,17
1579285,60,25,1953,4,female,431,10,6,13,1,13,1,0,0
1989118,54,10,1959,11,female,146,10,6,13,7,13,7,0,0
1928698,78,25,1935,5,female,1015,9,8,14,1,0,0,14,1
1615011,87,12,1926,9,female,285,9,9,14,2,0,1,14,1
2109546,33,10,1980,6,male,331,10,4,14,3,0,1,14,2
1375826,20,27,1993,9,male,463,9,3,14,2,10,1,4,1
1101583,66,7,1947,3,male,1561,9,4,14,4,9,2,5,2
2062511,54,1,1959,1,female,1356,9,4,14,24,10,20,4,4
1010966,59,25,1954,5,male,889,10,7,14,5,11,5,3,0
2060532,28,22,1985,6,female,126,10,3,14,1,14,1,0,0
1784134,32,1,1981,8,male,319,10,10,14,0,14,0,0,0
1980123,19,21,1994,1,male,239,10,5,14,7,14,7,0,0
1368744,32,1,1981,1,male,202,9,9,14,3,14,3,0,0
2066018,33,24,1980,6,female,77,9,7,14,3,14,3,0,0
1091910,36,10,1977,6,male,370,10,6,14,5,14,4,0,1
1974761,43,16,1970,6,male,185,10,7,14,3,14,0,0,3
1574077,49,9,1964,11,male,304,10,7,14,7,14,6,0,1
1071099,66,4,1947,11,male,73,10,6,14,10,14,10,0,0
1583347,30,9,1983,5,male,138,9,3,14,21,14,20,0,1
1437582,41,26,1972,10,male,490,10,4,14,56,14,33,0,23
1150744,14,17,1999,10,male,52,9,8,15,2,0,0,15,2
1121790,43,14,1970,2,female,699,9,5,15,3,0,0,15,3
2111632,58,26,1955,6,male,97,10,5,15,24,9,16,6,8
1412499,40,5,1973,8,male,1006,10,0,15,2,11,2,4,0
1064870,57,5,1956,2,female,83,9,2,15,0,13,0,2,0
2173597,28,16,1985,4,female,26,10,9,15,6,14,1,1,5
1124186,25,5,1988,4,male,60,9,8,15,0,15,0,0,0
1923943,49,5,1964,12,male,64,10,10,15,1,15,1,0,0
1399496,49,5,1964,3,female,214,10,6,15,0,15,0,0,0
1379885,38,10,1975,9,female,180,9,7,15,8,15,4,0,4
1794575,48,25,1965,6,female,569,9,4,15,8,15,8,0,0
1867677,33,1,1980,1,male,30,10,10,15,65,15,16,0,49
2169359,34,1,1979,1,female,142,9,6,16,10,0,4,16,6
1028227,44,25,1969,5,male,162,10,7,16,22,8,10,8,12
1184326,18,30,1995,6,male,141,9,6,16,31,14,22,2,9
1533682,36,14,1977,3,female,259,9,3,16,1,16,1,0,0
1200814,100,1,1913,1,male,27,10,9,16,1,16,1,0,0
1704799,15,10,1998,3,female,122,9,3,16,5,16,4,0,1
1772518,19,28,1994,3,male,39,10,5,16,9,16,6,0,3
1990257,29,20,1984,2,male,237,9,6,16,5,16,3,0,2
1279183,47,1,1966,12,female,1842,9,4,16,4,16,2,0,2
1135497,26,17,1987,12,male,117,10,8,16,66,16,58,0,8
2067805,19,7,1994,1,male,228,9,2,17,1,0,1,17,0
1112056,33,10,1980,8,male,320,9,9,17,0,0,0,17,0
1935686,59,6,1954,7,male,44,10,8,17,8,0,5,17,3
1389813,69,19,1944,12,female,436,10,7,17,7,0,4,17,3
2058575,49,21,1964,5,male,538,9,8,17,11,0,1,17,10
1890277,17,4,1996,2,male,805,10,7,17,0,16,0,1,0
1653425,20,1,1993,1,female,14,10,10,17,4,17,4,0,0
1867219,25,4,1988,12,male,96,10,6,17,6,17,2,0,4
2129357,55,6,1958,12,male,607,9,1,17,5,17,4,0,1
1567298,28,12,1985,1,male,292,9,5,17,12,17,7,0,5
1492008,23,7,1990,5,male,320,10,9,17,64,17,10,0,54
1909174,38,1,1975,12,male,1242,9,2,18,0,0,0,18,0
1712350,17,10,1996,2,female,98,9,6,18,7,0,1,18,6
1776661,23,10,1990,9,female,209,10,6,18,0,18,0,0,0
1828130,45,8,1968,8,male,119,9,5,18,1,18,1,0,0
1866527,51,8,1962,7,female,474,9,1,18,0,18,0,0,0
1830240,29,8,1984,7,female,187,9,5,18,7,18,6,0,1
1536618,31,24,1982,5,female,51,10,7,18,17,18,2,0,15
1606919,52,12,1961,3,female,26,10,7,18,36,18,24,0,12
1270233,53,22,1960,4,male,563,9,7,19,1,1,0,18,1
1727210,56,20,1957,5,male,825,9,3,19,2,0,1,19,1
1423144,68,19,1945,1,female,339,10,9,19,1,0,0,19,1
1257024,20,30,1993,4,male,370,10,9,19,7,0,0,19,7
1306968,19,7,1994,5,male,192,10,3,20,6,0,1,20,5
1682806,20,3,1993,10,female,648,9,9,20,1,20,1,0,0
1867532,24,10,1989,12,male,132,9,4,20,9,20,9,0,0
1558392,55,24,1958,2,female,141,9,4,20,10,20,9,0,1
1151335,27,25,1986,11,male,267,9,3,21,10,17,5,4,5
1359111,30,5,1983,6,female,231,10,5,21,0,21,0,0,0
1284236,16,24,1997,3,female,21,9,6,22,1,0,0,22,1
1923203,26,24,1987,9,female,209,10,6,22,3,0,1,22,2
2121572,50,28,1963,5,female,50,9,4,22,12,0,1,22,11
1764912,25,1,1988,4,female,328,9,5,22,0,6,0,16,0
1592617,39,9,1974,1,female,749,10,7,22,18,20,14,2,4
1317126,29,7,1984,4,male,183,10,9,22,1,22,1,0,0
1802470,38,9,1975,10,male,76,10,7,22,3,22,3,0,0
1698147,17,15,1996,1,male,111,10,7,22,8,22,8,0,0
1581295,28,13,1985,7,male,668,10,8,22,24,22,23,0,1
1597613,38,21,1975,2,female,276,9,8,22,21,22,16,0,5
2163548,19,13,1994,9,male,110,10,9,23,3,23,3,0,0
1022361,25,1,1988,1,male,18,9,9,23,0,23,0,0,0
1863201,18,7,1995,5,male,305,9,8,23,5,23,4,0,1
2099958,21,4,1992,3,female,163,10,6,23,8,23,8,0,0
1319834,30,26,1983,3,female,124,9,4,23,12,23,2,0,10
1746357,31,31,1982,5,female,161,9,2,23,10,23,10,0,0
1013044,62,4,1951,10,male,1356,10,1,24,6,0,0,24,6
2086707,68,9,1945,7,male,63,10,9,24,41,0,18,24,23
1327965,46,23,1967,3,female,703,10,7,24,39,5,27,19,12
1726269,28,1,1985,1,male,306,9,4,24,0,22,0,2,0
1902817,32,23,1981,2,male,453,10,5,24,26,22,24,2,2
1304658,65,1,1948,4,female,558,9,6,24,5,24,3,0,2
1886624,27,21,1986,5,male,334,9,9,25,0,0,0,25,0
1408505,32,12,1981,12,male,238,10,9,25,2,0,0,25,2
1773894,42,28,1971,8,male,79,10,5,25,1,0,0,25,1
1830814,45,1,1968,1,male,389,9,4,26,15,0,13,26,2
1898135,67,13,1946,11,female,1574,9,5,26,6,0,1,26,5
1262467,38,2,1975,6,male,350,9,6,26,13,26,9,0,4
1096149,57,10,1956,9,female,840,10,7,26,18,26,16,0,2
2109348,26,17,1987,2,male,696,10,8,27,1,0,1,27,0
1510827,25,1,1988,1,male,290,9,8,27,4,15,3,12,1
1298501,50,11,1963,11,female,629,9,3,28,2,3,2,25,0
1975144,34,17,1979,6,male,755,10,10,28,16,0,0,28,16
1961841,36,25,1977,5,female,100,10,10,28,5,0,0,28,5
1604356,33,12,1980,11,female,423,10,1,28,6,28,4,0,2
1169630,32,17,1981,11,male,352,10,9,29,8,29,8,0,0
2174594,39,21,1974,3,female,603,9,7,29,9,29,9,0,0
1827576,45,16,1968,8,male,300,9,5,31,2,0,1,31,1
2131863,44,23,1969,4,male,402,10,4,30,7,0,6,30,1
1221331,20,25,1993,8,male,238,9,7,31,19,29,4,2,15
1580011,19,11,1994,2,male,124,9,7,31,11,31,2,0,9
2129303,46,14,1967,3,male,646,9,6,32,9,0,1,32,8
1812768,23,23,1990,12,female,614,9,7,32,4,32,4,0,0
1711375,36,6,1977,5,female,191,10,8,32,10,32,10,0,0
1189094,39,20,1974,11,male,462,9,5,32,17,32,13,0,4
1137841,65,24,1948,5,female,11,9,2,33,5,0,3,33,2
1624495,23,26,1990,5,male,422,9,6,33,44,0,2,33,42
1078561,46,14,1967,1,female,148,10,9,33,0,33,0,0,0
1782874,27,1,1986,1,male,110,10,6,34,1,0,1,34,0
2061187,22,1,1991,6,female,165,9,3,34,11,30,7,4,4
1606974,21,13,1992,7,male,112,10,6,34,14,34,7,0,7
1603390,26,23,1987,12,male,77,10,8,34,21,34,17,0,4
2125844,28,29,1985,11,male,10,10,3,34,58,34,50,0,8
1476444,19,5,1994,5,female,276,10,2,36,2,5,0,31,2
1585433,28,16,1985,2,female,894,9,6,36,7,32,3,4,4
2174969,29,1,1984,1,male,220,9,7,36,2,36,0,0,2
1363040,53,1,1960,1,male,158,10,9,35,3,35,3,0,0
1411533,43,12,1970,9,female,603,9,6,35,31,35,26,0,5
1801181,108,1,1905,1,male,1000,10,10,35,22,35,13,0,9
1265986,23,29,1990,4,male,67,10,10,37,1,0,0,37,1
1172159,30,20,1983,9,male,484,10,5,37,11,31,9,6,2
1311708,14,19,1999,7,male,14,9,8,37,26,37,11,0,15
1289160,23,18,1990,3,female,222,9,2,37,31,37,11,0,20
1389341,22,14,1991,12,male,352,10,7,38,2,0,2,38,0
1603485,40,8,1973,8,female,81,9,9,39,6,39,5,0,1
1920034,18,4,1995,11,male,292,9,6,39,7,39,7,0,0
2012568,52,20,1961,2,female,26,9,7,38,7,38,7,0,0
2186130,62,10,1951,5,male,607,10,5,39,14,39,13,0,1
1835959,25,6,1988,7,female,88,10,8,40,16,40,14,0,2
2169349,28,9,1985,9,male,190,10,5,42,85,0,5,42,80
1538368,24,1,1989,1,female,233,10,6,42,6,33,4,9,2
2152434,67,9,1946,11,male,1123,9,7,41,5,41,3,0,2
1023735,18,19,1995,5,male,24,9,5,42,7,42,7,0,0
2124795,23,1,1990,1,male,10,10,10,43,1,0,0,43,1
1622258,42,4,1971,12,male,49,9,5,44,17,0,5,44,12
1578979,33,25,1980,10,female,254,10,2,44,2,44,2,0,0
1619126,49,9,1964,10,female,951,9,5,44,1,44,0,0,1
1825469,34,8,1979,6,male,354,10,9,44,11,44,10,0,1
1727557,39,11,1974,2,female,325,10,8,43,46,43,21,0,25
1360436,98,2,1915,1,male,654,10,7,45,1,32,1,13,0
1855755,37,17,1976,9,female,462,9,5,45,13,45,10,0,3
1983525,29,9,1984,2,female,475,9,7,46,2,0,0,46,2
1584637,42,14,1971,2,female,154,10,6,46,0,9,0,37,0
1216142,64,16,1949,12,male,572,10,3,46,32,0,19,46,13
1129205,29,5,1984,10,male,183,9,9,48,3,48,3,0,0
1957816,31,4,1982,6,male,83,9,7,48,0,48,0,0,0
1234050,41,16,1972,9,male,241,10,4,48,0,48,0,0,0
1877782,62,17,1951,8,male,383,9,5,48,0,48,0,0,0
2018796,64,23,1949,8,female,67,10,5,49,5,49,2,0,3
1208424,27,19,1986,4,female,296,10,8,50,5,50,3,0,2
1909411,25,23,1988,11,female,367,9,8,53,1,51,1,2,0
2064098,16,5,1997,7,male,269,9,7,54,2,0,0,54,2
1027030,23,24,1990,12,female,4,9,7,54,12,0,4,54,8
1103533,73,10,1940,2,male,257,9,9,54,6,54,4,0,2
2045777,23,21,1990,5,female,49,9,5,54,16,54,10,0,6
2133262,38,10,1975,11,male,28,10,10,55,13,55,13,0,0
1344600,21,6,1992,10,female,233,10,8,56,35,1,6,55,29
2190225,19,4,1994,8,male,100,10,7,56,54,40,17,16,37
1627913,33,1,1980,5,female,727,10,2,56,5,56,5,0,0
1140554,62,8,1951,8,female,56,10,5,57,4,57,4,0,0
1062850,37,18,1976,1,female,272,9,9,57,24,57,19,0,5
1612986,33,1,1980,8,male,260,9,7,56,43,56,22,0,21
1429563,27,1,1986,2,female,305,10,5,59,147,0,0,59,147
1698598,30,15,1983,12,female,276,10,10,60,0,59,0,1,0
1108604,27,29,1986,7,female,41,9,8,63,31,60,16,3,15
1445797,27,18,1986,1,male,381,9,7,63,1,63,1,0,0
2171575,45,7,1968,7,female,705,9,2,61,6,61,6,0,0
1186721,16,1,1997,1,female,301,9,5,63,19,63,7,0,12
1452632,22,15,1991,4,female,613,9,7,64,4,0,4,64,0
2131902,50,1,1963,4,female,589,10,6,65,8,0,1,65,7
1526508,63,4,1950,12,female,68,10,7,64,33,0,16,64,17
2120348,31,26,1982,6,male,189,10,10,64,9,30,8,34,1
1126570,25,10,1988,11,male,26,9,4,64,61,50,51,14,10
1231959,32,3,1981,2,male,15,10,10,64,152,53,108,11,44
1884429,21,2,1992,7,female,8,10,9,64,27,64,27,0,0
1850266,23,5,1990,8,male,126,10,8,67,36,0,0,67,36
1533805,39,18,1974,10,male,423,10,7,69,0,1,0,68,0
1393332,27,24,1986,6,female,496,9,8,71,19,0,7,71,12
1191441,47,23,1966,3,female,59,9,8,73,15,0,10,73,5
1740808,69,5,1944,10,female,813,10,7,73,38,0,9,73,29
1343494,20,20,1993,4,male,29,10,10,72,2,72,2,0,0
2156910,26,9,1987,10,female,100,10,4,77,110,77,41,0,69
1598800,35,14,1978,8,male,819,10,7,75,288,75,273,0,15
1238557,68,13,1945,10,male,1373,10,1,79,12,0,7,79,5
1176268,18,23,1995,2,female,105,10,10,79,30,79,26,0,4
2161813,63,20,1950,3,female,329,10,5,84,103,1,60,83,43
2083014,30,9,1983,3,male,706,9,7,83,6,74,6,9,0
1835041,40,6,1973,5,female,413,9,4,84,11,84,4,0,7
1635385,51,13,1962,9,female,544,10,6,83,4,83,3,0,1
1545965,75,24,1938,5,female,430,9,7,84,23,84,6,0,17
1935291,20,25,1993,7,male,54,10,10,85,1,0,0,85,1
1099551,46,2,1967,3,male,257,10,5,85,4,85,4,0,0
1595476,42,19,1971,3,female,286,9,8,91,46,0,3,91,43
1549258,44,9,1969,5,female,250,10,7,98,23,86,21,12,2
1383208,22,31,1991,12,male,435,10,3,96,81,84,78,12,3
1311203,22,27,1991,7,female,198,10,9,104,44,62,30,42,14
1352577,33,14,1980,1,female,101,10,6,102,179,52,96,50,83
1282840,22,11,1991,10,male,23,9,5,103,101,102,36,1,65
1787564,33,16,1980,6,female,240,10,4,100,61,99,24,1,37
1998968,25,1,1988,1,male,74,10,9,102,5,102,4,0,1
2174591,34,29,1979,7,male,430,10,9,105,26,105,9,0,17
1924647,21,1,1992,1,male,66,9,8,111,17,85,16,26,1
1573333,41,11,1972,6,male,57,9,8,111,26,111,16,0,10
1925709,22,12,1991,7,female,108,9,8,117,54,0,38,117,16
1655808,16,10,1997,10,female,73,9,2,119,118,83,84,36,34
1440893,18,1,1995,4,female,195,10,10,122,43,122,38,0,5
1242127,51,11,1962,10,female,9,10,10,129,52,0,41,129,11
2192653,20,15,1993,10,male,9,10,10,134,9,121,7,13,2
1823173,44,16,1969,9,female,418,9,8,132,45,116,7,16,38
1819227,44,4,1969,2,male,353,9,7,131,1,130,1,1,0
1148823,53,26,1960,9,female,294,9,4,141,77,134,32,7,45
1837031,38,11,1975,6,male,11,10,9,140,40,140,31,0,9
1037433,26,27,1987,4,female,326,10,7,146,45,120,25,26,20
1478138,16,8,1997,10,male,46,9,9,157,23,98,2,59,21
1028040,37,26,1976,1,male,475,10,8,157,16,157,14,0,2
1972001,25,19,1988,7,female,247,10,6,162,66,161,23,1,43
1952125,15,3,1998,3,male,245,10,4,164,8,164,5,0,3
1442226,18,16,1995,4,female,109,9,5,163,13,163,13,0,0
2104811,27,23,1986,4,female,156,10,8,165,24,140,20,25,4
2031753,18,25,1995,9,female,24,10,4,170,163,170,23,0,140
1417938,24,3,1989,3,male,175,9,4,180,139,180,62,0,77
1074425,25,22,1988,9,female,354,9,8,189,2,189,2,0,0
1670448,23,12,1990,3,female,374,9,6,207,32,190,20,17,12
1588425,27,29,1986,8,female,27,10,10,209,12,207,11,2,1
1138557,28,1,1985,12,female,147,10,8,211,12,211,1,0,11
1452776,46,14,1967,8,female,190,9,7,210,38,210,35,0,3
1799128,21,17,1992,3,male,382,10,7,233,55,0,21,233,34
1012388,25,1,1988,1,female,8,10,1,242,35,242,29,0,6
1420331,53,27,1960,2,female,30,10,7,264,13,192,0,72,13
1992951,24,2,1989,4,male,744,10,5,303,2,0,0,303,2
1513043,21,21,1992,10,female,76,10,8,294,33,294,16,0,17
2035702,16,10,1997,10,male,127,10,4,319,0,0,0,319,0
1533840,20,13,1993,8,female,494,10,3,325,0,9,0,316,0
2192356,38,15,1975,6,male,148,9,8,336,15,0,13,336,2
1707165,64,23,1949,9,male,341,9,8,358,61,0,19,358,42
1382322,19,28,1994,3,female,99,10,5,368,78,225,48,143,30
1330408,32,7,1981,8,female,155,9,4,363,168,235,33,128,135
1714149,49,23,1964,7,female,512,10,8,361,1,361,1,0,0
2093336,41,30,1972,7,female,441,10,4,384,43,0,22,384,21
1245442,15,28,1998,7,female,114,10,7,372,58,79,36,293,22
2056135,31,4,1982,4,male,562,10,2,485,10,485,4,0,6
1445452,22,2,1991,6,female,209,10,5,488,318,488,210,0,108
1965549,36,19,1977,12,male,78,9,7,602,4,602,3,0,1
1331870,14,25,1999,10,female,102,10,8,610,102,608,89,2,13
1818700,57,29,1956,1,female,295,10,8,784,235,0,4,784,231
1623622,42,24,1971,6,male,85,9,9,751,0,745,0,6,0
2090686,37,1,1976,9,female,162,9,8,1016,18,1016,13,0,5
1053631,33,1,1980,1,male,384,9,2,1204,66,1156,60,48,6
1845774,22,1,1991,7,female,143,10,7,1635,81,0,15,1635,66
2169231,25,1,1988,1,male,179,9,5,1763,1,1763,1,0,0
1101901,40,15,1973,6,female,81,10,2,2058,23,1903,16,155,7
1834037,70,20,1943,4,male,578,9,9,2972,98,0,25,2972,73
1681258,66,1,1947,8,female,510,11,11,16,7,0,0,16,7
1037662,32,4,1981,10,female,105,11,7,16,21,0,0,16,21
1564187,68,10,1945,9,male,8,11,9,16,17,0,9,16,8
1603822,20,3,1993,12,female,520,11,3,16,0,8,0,8,0
1730447,52,19,1961,12,female,271,11,10,16,0,6,0,10,0
1889129,25,2,1988,10,female,215,11,10,16,0,16,0,0,0
1211622,80,8,1933,2,male,3,11,10,16,62,16,57,0,5
1634823,31,11,1982,3,male,111,11,7,17,2,0,0,17,2
1809503,56,17,1957,1,male,916,11,3,17,7,0,1,17,6
1085073,70,22,1943,11,female,1450,11,5,17,4,0,2,17,2
1347419,13,20,2000,8,male,34,11,11,17,13,0,0,17,13
1749424,19,28,1994,1,male,4,11,11,17,1,7,0,10,1
1446585,26,21,1987,7,male,250,11,9,17,0,17,0,0,0
1583149,37,14,1976,1,female,105,11,6,17,2,17,1,0,1
1402505,35,2,1978,3,male,745,11,9,18,5,0,0,18,5
1795899,18,3,1995,9,male,366,11,6,18,15,0,9,18,6
2000049,23,1,1990,1,female,260,11,6,18,1,13,0,5,1
1420353,23,1,1990,1,male,29,11,10,18,5,18,5,0,0
1562870,75,21,1938,9,male,1499,11,3,19,0,0,0,19,0
2136494,17,1,1996,2,female,444,11,9,19,4,14,0,5,4
1980487,37,23,1976,7,male,286,11,3,19,8,19,6,0,2
1210046,43,11,1970,3,male,504,11,6,20,0,14,0,6,0
1951646,61,3,1952,8,male,416,11,5,20,2,4,2,16,0
1082959,65,14,1948,10,male,728,11,7,21,8,0,1,21,7
1725609,22,2,1991,1,male,85,11,6,21,2,15,2,6,0
1992202,41,11,1972,2,male,297,11,10,21,1,21,1,0,0
1651957,41,9,1972,6,female,604,11,3,21,2,21,2,0,0
2108262,57,10,1956,6,female,294,11,5,21,1,21,1,0,0
1653719,33,21,1980,1,female,590,11,7,21,7,21,1,0,6
1895783,38,18,1975,4,male,258,11,6,21,6,21,5,0,1
1728811,75,26,1938,1,female,649,11,5,22,3,17,0,5,3
1321224,23,20,1990,7,male,45,11,10,22,11,22,9,0,2
2020778,45,23,1968,5,female,297,11,10,23,12,23,9,0,3
1926919,43,2,1970,2,female,184,11,6,24,0,0,0,24,0
1232985,68,14,1945,2,male,321,11,9,24,3,0,2,24,1
1311059,65,24,1948,10,male,1416,11,7,24,9,0,6,24,3
1680658,27,18,1986,12,male,42,11,9,24,9,24,7,0,2
1086327,25,12,1988,2,female,143,11,8,25,2,25,2,0,0
1649725,33,1,1980,1,male,69,11,10,25,0,25,0,0,0
1803970,51,8,1962,10,male,132,11,6,25,0,25,0,0,0
1507551,61,2,1952,12,female,239,11,7,25,4,25,2,0,2
1124183,28,15,1985,8,male,19,11,7,25,12,25,10,0,2
1385508,58,19,1955,3,female,936,11,6,25,8,25,5,0,3
2036543,41,11,1972,2,male,289,11,11,26,3,24,2,2,1
1258913,29,21,1984,6,male,391,11,7,26,18,23,18,3,0
1319254,20,14,1993,11,male,18,11,11,26,13,26,13,0,0
1304162,21,19,1992,8,male,325,11,4,26,22,26,22,0,0
1249717,42,11,1971,12,male,257,11,11,27,18,9,13,18,5
1951705,46,2,1967,7,female,188,11,6,28,14,28,9,0,5
1015153,38,10,1975,10,female,632,11,6,29,2,29,1,0,1
1133663,48,12,1965,3,male,747,11,10,29,20,29,16,0,4
1781374,23,3,1990,3,male,283,11,11,30,13,3,1,27,12
2148601,45,30,1968,7,female,422,11,3,31,10,20,3,11,7
2163532,15,31,1998,8,female,192,11,10,30,1,29,0,1,1
1425618,24,5,1989,6,male,84,11,5,31,8,31,5,0,3
1758152,31,4,1982,10,female,127,11,8,30,12,30,6,0,6
1787551,25,1,1988,1,male,75,11,10,32,6,32,5,0,1
1856704,33,30,1980,4,male,132,11,9,33,12,0,12,33,0
1029424,51,22,1962,7,male,656,11,7,33,19,0,8,33,11
1333053,58,4,1955,12,female,417,11,5,33,7,14,2,19,5
2018950,28,8,1985,3,male,45,11,11,33,2,31,1,2,1
2184203,14,29,1999,3,male,14,11,11,35,1,0,0,35,1
1681393,27,5,1986,10,male,362,11,6,35,3,0,0,35,3
1743475,58,19,1955,5,female,824,11,9,36,5,36,3,0,2
1987131,35,17,1978,10,male,2046,11,4,36,24,36,19,0,5
2049893,62,16,1951,6,female,565,11,7,38,23,31,10,7,13
1693924,59,9,1954,10,male,249,11,9,38,3,38,3,0,0
2172095,19,1,1994,1,male,57,11,11,40,1,40,0,0,1
1245055,33,19,1980,4,female,313,11,9,40,0,40,0,0,0
1194892,31,28,1982,2,female,256,11,11,42,5,13,2,29,3
2188052,37,25,1976,9,male,466,11,7,43,0,43,0,0,0
1382785,73,1,1940,12,male,11,11,9,45,17,45,14,0,3
1652185,32,1,1981,3,male,126,11,10,47,0,44,0,3,0
2035435,34,30,1979,7,male,402,11,8,46,4,46,3,0,1
1386192,23,2,1990,4,male,340,11,9,48,1,44,0,4,1
1188283,21,18,1992,4,male,48,11,11,49,2,49,2,0,0
1142218,62,22,1951,7,male,43,11,10,53,12,53,2,0,10
1599850,68,7,1945,12,female,49,11,5,55,5,0,4,55,1
1517951,50,16,1963,7,female,321,11,3,54,6,47,3,7,3
1723596,76,27,1937,2,male,1663,11,6,58,29,9,5,49,24
1150804,32,25,1981,8,female,113,11,7,56,76,26,26,30,50
2178899,18,24,1995,4,male,82,11,6,56,10,45,9,11,1
1065259,32,14,1981,4,male,602,11,8,56,234,55,181,1,53
1355938,36,19,1977,11,female,257,11,10,59,17,59,17,0,0
1820061,24,9,1989,10,male,264,11,5,63,0,0,0,63,0
1104101,48,9,1965,1,male,275,11,4,64,123,64,50,0,73
1810111,46,4,1967,3,female,251,11,10,66,33,0,5,66,28
2021136,19,7,1994,1,female,148,11,7,67,72,5,71,62,1
2064330,30,8,1983,1,male,47,11,7,67,75,67,17,0,58
1173331,57,29,1956,12,female,909,11,7,69,36,0,1,69,35
1509398,41,29,1972,7,female,438,11,6,71,3,71,3,0,0
1934433,44,23,1969,11,male,337,11,5,70,7,70,6,0,1
1577109,17,27,1996,11,male,97,11,8,73,21,73,20,0,1
1190194,35,24,1978,7,female,850,11,6,73,53,73,53,0,0
1075903,45,12,1968,10,female,110,11,6,84,73,84,29,0,44
1023894,29,21,1984,8,female,391,11,3,85,20,85,17,0,3
1370489,52,13,1961,4,female,176,11,6,86,47,86,32,0,15
1370685,18,26,1995,4,female,305,11,6,88,19,0,5,88,14
2098711,31,4,1982,4,male,454,11,7,99,40,20,9,79,31
1197705,33,9,1980,11,female,110,11,6,98,57,98,57,0,0
1982965,43,25,1970,12,male,361,11,9,102,127,0,5,102,122
1934334,20,16,1993,2,male,238,11,11,100,3,100,3,0,0
1530508,21,12,1992,5,female,89,11,7,107,29,99,23,8,6
1814476,59,17,1954,6,female,227,11,10,108,30,108,27,0,3
2174836,25,1,1988,1,male,69,11,6,119,66,119,24,0,42
2125268,61,7,1952,2,female,143,11,6,123,32,123,23,0,9
2039428,56,30,1957,4,female,153,11,4,130,65,130,37,0,28
1555238,18,31,1995,12,male,206,11,1,133,0,93,0,40,0
2162272,36,27,1977,1,female,406,11,8,137,6,137,2,0,4
1595429,30,23,1983,7,female,239,11,8,138,29,138,12,0,17
1812046,33,17,1980,6,female,794,11,8,139,130,139,41,0,89
1071636,25,22,1988,11,male,204,11,7,149,10,0,0,149,10
1635398,19,4,1994,5,female,189,11,5,171,44,64,28,107,16
1444690,34,3,1979,1,female,244,11,6,197,183,197,140,0,43
2029474,28,8,1985,6,male,37,11,9,206,33,0,0,206,33
1251734,32,17,1981,3,male,392,11,5,245,129,0,28,245,101
1639749,59,14,1954,6,female,697,11,4,251,6,179,1,72,5
1889341,25,17,1988,1,female,64,11,7,261,101,261,26,0,75
1959901,30,29,1983,4,female,901,11,5,287,0,263,0,24,0
1383898,57,15,1956,2,male,141,11,8,303,191,0,48,303,143
2000723,23,3,1990,12,female,198,11,2,321,180,0,8,321,172
1841950,38,1,1975,5,female,41,11,10,340,99,0,25,340,74
1141905,33,1,1980,1,female,210,11,8,382,53,382,34,0,19
1353105,14,21,1999,12,female,54,11,5,506,1,290,0,216,1
1060546,62,25,1951,2,female,402,11,10,585,342,585,98,0,244
1434611,35,10,1978,1,male,236,11,10,1480,4,1463,1,17,3
1882163,16,10,1997,12,male,17,12,11,2,3,2,1,0,2
2121894,22,8,1991,3,female,1032,12,7,2,8,2,0,0,8
1420680,23,1,1990,1,female,211,12,6,2,3,2,3,0,0
2071539,24,29,1989,8,male,33,12,9,2,5,2,5,0,0
1423870,32,18,1981,9,female,228,12,7,2,16,2,15,0,1
1454695,38,10,1975,1,male,1789,12,12,3,0,0,0,3,0
1676605,49,27,1964,8,male,1464,12,8,3,0,0,0,3,0
1470142,36,10,1977,10,male,226,12,11,3,1,0,1,3,0
1753206,28,28,1985,1,male,269,12,9,3,2,0,2,3,0
1241452,37,26,1976,10,male,501,12,11,3,3,0,0,3,3
1611426,61,4,1952,1,female,1041,12,7,3,4,0,4,3,0
1591739,64,19,1949,4,male,970,12,9,3,4,0,2,3,2
1916665,64,28,1949,5,female,428,12,11,3,2,0,0,3,2
2001842,77,13,1936,12,female,5,12,11,3,2,0,2,3,0
1542539,57,7,1956,11,female,67,12,8,3,6,0,0,3,6
1898363,19,22,1994,4,male,452,12,5,3,0,3,0,0,0
1852941,19,1,1994,8,male,95,12,7,3,0,3,0,0,0
1228270,25,21,1988,2,male,239,12,6,3,0,3,0,0,0
1181461,25,19,1988,3,male,211,12,4,3,0,3,0,0,0
1986362,25,7,1988,6,male,130,12,9,3,0,3,0,0,0
1512283,29,7,1984,7,male,205,12,9,3,0,3,0,0,0
1353363,43,19,1970,12,male,303,12,11,3,0,3,0,0,0
1300973,46,5,1967,8,female,160,12,10,3,0,3,0,0,0
2167159,66,2,1947,6,male,178,12,12,3,0,3,0,0,0
1115978,68,17,1945,8,male,124,12,12,3,0,3,0,0,0
2183542,29,12,1984,12,male,28,12,6,3,1,3,1,0,0
1967818,34,1,1979,1,male,325,12,1,3,1,3,1,0,0
2031767,57,14,1956,12,female,1728,12,9,3,1,3,1,0,0
1651706,28,8,1985,8,male,372,12,10,3,2,3,1,0,1
2177156,39,29,1974,10,male,483,12,4,3,2,3,2,0,0
1365801,41,24,1972,10,female,539,12,3,3,3,3,2,0,1
2112522,18,18,1995,8,female,79,12,10,3,28,3,22,0,6
1226425,37,2,1976,7,female,48,12,5,3,60,3,56,0,4
1278673,28,5,1985,5,male,355,12,10,4,0,0,0,4,0
2185745,53,18,1960,7,female,52,12,11,4,0,0,0,4,0
1692080,21,1,1992,1,female,299,12,8,4,1,0,0,4,1
1296586,60,31,1953,10,female,336,12,5,4,5,0,4,4,1
1789771,56,22,1957,10,male,639,12,6,4,6,0,4,4,2
1183269,33,25,1980,10,male,587,12,6,4,0,2,0,2,0
1167233,66,3,1947,7,male,319,12,9,4,0,1,0,3,0
2084772,23,1,1990,1,male,445,12,5,4,1,1,1,3,0
1499988,59,13,1954,10,female,537,12,6,4,28,2,25,2,3
1499412,17,6,1996,6,male,322,12,11,4,0,4,0,0,0
1799644,17,7,1996,7,male,114,12,9,4,0,4,0,0,0
1421129,18,20,1995,8,female,74,12,10,4,0,4,0,0,0
1913320,24,1,1989,1,male,67,12,8,4,0,4,0,0,0
1757859,25,1,1988,1,male,116,12,6,4,0,4,0,0,0
1602383,67,22,1946,9,female,254,12,1,4,0,4,0,0,0
1951265,24,23,1989,2,male,30,12,5,4,1,4,1,0,0
1664027,30,2,1983,6,male,32,12,8,4,4,4,1,0,3
1202821,32,28,1981,12,male,553,12,11,4,3,4,3,0,0
1287331,36,7,1977,7,male,61,12,10,4,5,4,4,0,1
1543789,47,12,1966,12,female,187,12,3,4,5,4,5,0,0
1741511,49,18,1964,5,male,427,12,6,5,0,0,0,5,0
1701530,53,8,1960,6,male,153,12,8,5,15,0,3,5,12
1697992,63,4,1950,7,male,789,12,10,5,8,0,1,5,7
1549007,68,23,1945,5,female,605,12,6,5,9,0,0,5,9
1070592,19,20,1994,4,male,67,12,7,5,0,1,0,4,0
1928957,16,16,1997,7,male,114,12,8,5,1,3,0,2,1
2080190,18,10,1995,6,male,16,12,8,5,2,1,0,4,2
1118204,19,26,1994,8,male,456,12,1,5,0,5,0,0,0
2046702,25,13,1988,2,male,190,12,10,5,0,5,0,0,0
1314192,24,12,1989,6,male,35,12,9,5,3,5,0,0,3
1487186,25,12,1988,10,male,78,12,7,5,1,5,1,0,0
1268318,65,3,1948,12,female,1272,12,6,5,1,5,1,0,0
2116640,18,13,1995,6,female,40,12,3,5,4,5,2,0,2
1588404,57,19,1956,5,male,170,12,11,5,4,5,4,0,0
1250847,67,22,1946,5,female,713,12,10,5,6,5,5,0,1
2018190,25,14,1988,12,male,316,12,7,6,0,0,0,6,0
1397854,50,1,1963,6,female,673,12,10,6,4,0,4,6,0
1695357,75,10,1938,12,female,386,12,9,6,6,0,2,6,4
1887780,108,1,1905,1,male,1131,12,7,6,4,0,2,6,2
1457152,61,18,1952,3,female,172,12,7,6,1,5,1,1,0
1831204,23,14,1990,8,male,157,12,11,6,0,6,0,0,0
1005588,25,1,1988,1,male,40,12,10,6,0,6,0,0,0
1361572,21,10,1992,11,male,93,12,8,6,1,6,0,0,1
1783261,23,1,1990,1,male,827,12,6,6,1,6,1,0,0
2188847,25,1,1988,1,male,229,12,10,6,2,6,2,0,0
1156605,41,13,1972,1,male,263,12,10,6,2,6,2,0,0
2035503,29,9,1984,6,female,856,12,10,6,16,6,1,0,15
1955433,37,20,1976,4,male,77,12,10,6,22,6,2,0,20
1021649,39,27,1974,12,male,394,12,1,6,15,6,14,0,1
1582570,45,31,1968,5,male,293,12,9,6,11,6,11,0,0
2070538,23,14,1990,4,male,420,12,12,7,0,0,0,7,0
1939483,54,28,1959,10,female,106,12,6,7,2,1,1,6,1
1662453,66,22,1947,4,male,1365,12,6,7,7,0,6,7,1
1364820,19,1,1994,11,male,48,12,9,7,11,0,0,7,11
1522943,23,5,1990,1,male,142,12,8,7,59,0,16,7,43
2001746,17,4,1996,7,male,586,12,9,7,0,3,0,4,0
1414151,51,23,1962,5,male,381,12,4,7,0,7,0,0,0
1022930,58,15,1955,5,female,525,12,3,7,0,7,0,0,0
1545865,21,30,1992,6,male,80,12,10,7,2,7,2,0,0
1451324,37,19,1976,4,male,59,12,6,7,2,7,2,0,0
1098944,66,30,1947,1,female,41,12,10,7,3,7,3,0,0
1428787,37,10,1976,9,male,139,12,10,8,1,0,0,8,1
1547261,23,10,1990,5,female,209,12,9,8,7,0,3,8,4
1070259,32,25,1981,5,female,138,12,12,8,5,0,1,8,4
2130198,49,15,1964,12,male,268,12,8,8,5,0,4,8,1
1463884,44,15,1969,10,male,418,12,5,8,0,6,0,2,0
2028084,48,22,1965,5,male,19,12,11,8,1,6,1,2,0
1237649,20,9,1993,1,male,260,12,10,8,1,8,0,0,1
1454468,36,19,1977,8,male,23,12,12,8,1,8,1,0,0
1242888,42,18,1971,1,male,76,12,12,8,0,8,0,0,0
1543547,67,1,1946,6,male,28,12,9,8,7,8,4,0,3
1809181,38,16,1975,5,male,865,12,11,8,12,8,10,0,2
2166415,40,11,1973,10,male,87,12,11,8,35,8,33,0,2
2101422,23,5,1990,6,male,214,12,12,9,110,0,37,9,73
2131638,57,12,1956,4,female,119,12,10,9,90,0,46,9,44
1050849,31,15,1982,4,male,296,12,5,9,0,9,0,0,0
1448265,34,19,1979,9,male,264,12,11,9,0,9,0,0,0
2044809,59,14,1954,4,male,194,12,10,9,0,9,0,0,0
1524735,22,15,1991,2,male,124,12,12,9,7,9,5,0,2
1296247,28,14,1985,4,male,133,12,12,9,9,9,8,0,1
1188196,56,17,1957,4,male,90,12,9,9,8,9,3,0,5
1019426,41,29,1972,10,female,215,12,11,9,16,9,10,0,6
1603892,26,25,1987,9,male,340,12,6,10,6,0,3,10,3
1704951,60,4,1953,1,male,653,12,3,10,2,0,1,10,1
1013725,68,4,1945,2,female,226,12,10,10,3,0,0,10,3
1434144,22,27,1991,1,female,93,12,2,10,15,0,3,10,12
1333771,61,14,1952,8,male,121,12,10,10,22,0,7,10,15
2094402,34,11,1979,2,female,506,12,5,10,12,7,7,3,5
1141326,58,25,1955,4,male,516,12,12,10,7,2,0,8,7
1078735,17,1,1996,4,female,94,12,11,10,0,10,0,0,0
1207979,22,22,1991,3,male,436,12,11,10,1,10,1,0,0
1389218,27,6,1986,12,male,162,12,12,10,2,10,0,0,2
2006588,25,1,1988,2,male,213,12,8,10,9,10,9,0,0
1543797,21,19,1992,12,female,295,12,7,11,1,0,0,11,1
2074432,17,4,1996,11,male,685,12,3,11,4,0,3,11,1
2027005,25,9,1988,7,male,243,12,5,11,3,0,2,11,1
1103804,54,21,1959,2,male,214,12,8,11,6,0,2,11,4
1255066,51,12,1962,7,male,15,12,9,11,16,0,5,11,11
1054977,27,15,1986,7,male,39,12,7,11,1,11,1,0,0
1487308,43,1,1970,1,male,159,12,12,11,4,11,4,0,0
2126795,34,2,1979,10,female,466,12,3,11,19,11,17,0,2
1071039,107,11,1906,1,female,138,12,2,12,0,0,0,12,0
2046402,73,1,1940,1,male,97,12,10,12,7,0,2,12,5
1140049,21,20,1992,6,male,1183,12,5,12,8,0,0,12,8
1493375,68,13,1945,7,female,750,12,11,12,0,10,0,2,0
1735549,24,17,1989,4,female,29,12,6,12,13,12,13,0,0
1758797,31,30,1982,10,female,590,12,3,12,10,12,8,0,2
1573616,55,30,1958,5,male,473,12,5,12,16,12,0,0,16
1995690,25,14,1988,11,male,28,12,12,13,8,13,7,0,1
1233968,58,9,1955,3,female,193,12,12,14,10,0,5,14,5
1187958,52,11,1961,2,female,579,12,8,14,4,13,4,1,0
1344491,58,28,1955,2,female,122,12,3,14,0,14,0,0,0
2094113,25,10,1988,5,male,10,12,11,14,7,14,7,0,0
2003086,52,27,1961,8,female,232,12,11,14,3,14,3,0,0
1560153,37,4,1976,12,male,438,12,4,14,11,14,11,0,0
2050609,61,5,1952,2,male,612,12,5,14,12,14,9,0,3
1578428,51,4,1962,12,female,55,12,10,15,0,0,0,15,0
1393965,14,1,1999,1,male,49,12,12,15,0,15,0,0,0
2089544,19,20,1994,1,female,27,12,6,15,2,15,2,0,0
1628726,27,6,1986,6,female,378,12,9,15,1,15,1,0,0
2158711,26,15,1987,10,male,368,12,8,15,3,15,2,0,1
1038308,15,26,1998,11,male,142,12,11,16,1,0,0,16,1
2002281,50,8,1963,10,female,315,12,10,16,0,2,0,14,0
1369724,30,22,1983,2,male,214,12,11,16,17,0,1,16,16
1212302,56,26,1957,7,female,799,12,5,16,27,0,5,16,22
1053791,23,2,1990,10,male,552,12,10,16,1,9,1,7,0
1664552,60,20,1953,10,female,717,12,9,16,1,15,1,1,0
1160462,38,26,1975,1,female,39,12,7,16,8,16,5,0,3
1068031,23,12,1990,9,female,413,12,6,17,1,15,1,2,0
1648573,48,24,1965,2,male,141,12,9,17,27,15,24,2,3
2099009,24,23,1989,3,male,7,12,11,17,51,17,49,0,2
2048632,33,11,1980,4,male,835,12,12,18,0,0,0,18,0
2109304,26,1,1987,1,female,67,12,11,18,4,18,4,0,0
2037684,38,2,1975,7,male,338,12,9,18,4,18,4,0,0
1862729,43,27,1970,2,female,803,12,8,18,11,18,2,0,9
1292111,54,25,1959,7,male,138,12,2,18,32,18,7,0,25
1412626,17,27,1996,11,male,204,12,10,19,3,0,0,19,3
2016975,60,6,1953,7,female,269,12,10,19,0,19,0,0,0
2172230,24,1,1989,9,male,174,12,8,19,20,19,12,0,8
1777457,46,25,1967,5,male,337,12,9,19,12,19,12,0,0
1429312,21,1,1992,1,male,31,12,12,20,0,20,0,0,0
1768632,21,25,1992,5,male,194,12,9,20,0,20,0,0,0
1969414,48,22,1965,11,male,159,12,8,20,15,20,11,0,4
1039327,59,30,1954,5,female,280,12,8,21,16,0,0,21,16
2145298,63,7,1950,1,female,661,12,6,21,18,0,4,21,14
1584279,18,18,1995,1,female,209,12,7,21,1,21,1,0,0
1678155,57,25,1956,8,female,273,12,6,21,20,21,15,0,5
1425588,60,30,1953,9,female,1714,12,11,22,35,0,18,22,17
2002447,23,26,1990,6,male,749,12,9,22,0,21,0,1,0
1491835,51,30,1962,7,female,710,12,6,22,11,18,3,4,8
1012293,21,5,1992,7,female,90,12,4,22,2,22,2,0,0
1810325,44,9,1969,10,female,515,12,8,22,23,22,21,0,2
2093871,48,28,1965,6,male,298,12,7,23,12,0,1,23,11
1979816,27,26,1986,4,female,274,12,10,23,34,12,11,11,23
1633500,28,10,1985,10,female,210,12,2,23,34,23,21,0,13
1835733,37,12,1976,11,female,47,12,6,24,36,20,19,4,17
2031030,25,15,1988,6,female,174,12,9,24,7,24,7,0,0
1170865,19,4,1994,1,male,1201,12,7,25,16,19,5,6,11
2013570,58,10,1955,10,female,107,12,7,25,14,25,5,0,9
1011816,26,27,1987,2,female,41,12,10,25,17,25,17,0,0
1126558,44,18,1969,11,male,181,12,11,25,20,25,15,0,5
2149540,36,19,1977,11,female,568,12,8,26,11,13,10,13,1
1160433,41,21,1972,10,female,303,12,4,26,15,26,13,0,2
1275615,14,28,1999,1,male,335,12,2,27,1,27,1,0,0
1705241,49,24,1964,10,male,45,12,9,27,16,27,10,0,6
2158352,29,18,1984,5,male,47,12,5,29,16,29,7,0,9
2028366,44,21,1969,10,female,444,12,3,30,11,30,10,0,1
1577997,66,13,1947,8,female,650,12,5,32,0,0,0,32,0
1915408,60,1,1953,1,male,393,12,12,33,108,0,16,33,92
1146761,38,25,1975,12,male,207,12,12,34,3,34,3,0,0
1591246,27,20,1986,10,male,54,12,11,34,7,34,3,0,4
2061250,40,23,1973,6,female,464,12,8,34,43,34,29,0,14
1990064,26,1,1987,1,female,4,12,11,35,3,11,1,24,2
2187021,23,27,1990,11,male,333,12,6,35,12,23,10,12,2
1613926,76,11,1937,12,female,48,12,9,36,37,36,10,0,27
1722573,36,7,1977,8,female,173,12,8,36,83,36,73,0,10
2058154,18,19,1995,11,male,253,12,6,38,3,0,0,38,3
1369648,25,1,1988,1,male,59,12,9,38,1,38,1,0,0
1236182,18,9,1995,2,male,43,12,10,38,25,38,13,0,12
1139931,59,28,1954,9,female,198,12,9,40,0,0,0,40,0
1172445,70,28,1943,2,female,71,12,6,42,51,0,1,42,50
1958120,25,1,1988,1,male,250,12,10,41,2,41,2,0,0
1023000,28,28,1985,2,male,54,12,12,41,4,41,4,0,0
1026065,30,4,1983,4,female,690,12,10,42,0,42,0,0,0
2024270,42,18,1971,8,female,569,12,9,44,2,42,0,2,2
1800788,92,28,1921,6,female,1491,12,11,45,6,29,0,16,6
1906674,45,21,1968,3,male,470,12,7,47,29,0,0,47,29
1306840,58,19,1955,3,male,143,12,11,48,13,0,2,48,11
1030138,71,7,1942,10,male,1059,12,6,49,15,0,5,49,10
1417990,45,12,1968,1,male,227,12,5,49,14,12,6,37,8
2107003,64,7,1949,3,female,305,12,6,49,7,49,7,0,0
1284317,24,9,1989,2,male,47,12,4,50,20,0,6,50,14
2144529,18,5,1995,7,male,381,12,5,53,6,53,1,0,5
1201226,37,26,1976,9,male,143,12,8,53,5,53,3,0,2
1469465,57,17,1956,4,female,496,12,7,54,11,10,2,44,9
1944784,28,5,1985,7,male,333,12,10,55,12,46,12,9,0
1754270,19,15,1994,6,female,82,12,11,55,59,55,43,0,16
1305969,18,14,1995,9,female,18,12,11,58,22,53,1,5,21
1033385,41,14,1972,7,female,265,12,9,59,7,59,5,0,2
1059360,73,8,1940,5,male,946,12,2,62,15,0,11,62,4
1890059,108,1,1905,1,male,94,12,9,64,5,0,0,64,5
1461377,74,26,1939,11,female,657,12,8,66,10,0,10,66,0
1785318,19,19,1994,1,male,261,12,9,68,13,0,1,68,12
2189728,19,19,1994,8,male,302,12,12,67,9,21,2,46,7
1727345,46,17,1967,7,female,257,12,2,68,10,47,10,21,0
1370199,53,8,1960,4,male,248,12,9,66,0,66,0,0,0
1959289,28,15,1985,10,female,635,12,11,70,63,70,45,0,18
1630841,54,20,1959,9,male,428,12,4,75,4,0,0,75,4
1638061,61,10,1952,4,female,108,12,7,77,31,0,6,77,25
1138252,67,18,1946,9,female,152,12,10,75,24,5,1,70,23
1953308,18,26,1995,10,male,192,12,8,83,8,79,5,4,3
1140127,14,27,1999,10,male,201,12,11,81,17,81,17,0,0
1183369,44,15,1969,2,male,667,12,10,85,25,71,16,14,9
1427356,58,15,1955,10,female,174,12,8,87,7,87,6,0,1
1957116,26,16,1987,11,female,421,12,5,87,25,87,25,0,0
2100792,28,1,1985,1,female,236,12,7,104,62,102,19,2,43
1721269,17,1,1996,3,female,274,12,8,100,1,100,0,0,1
1559891,16,5,1997,1,female,134,12,8,109,104,108,41,1,63
1783525,48,2,1965,5,female,247,12,10,116,39,0,19,116,20
1910689,21,1,1992,1,male,50,12,8,122,0,122,0,0,0
2175277,23,1,1990,7,female,387,12,9,129,134,20,67,109,67
1964069,24,18,1989,3,male,469,12,8,138,262,55,170,83,92
1915800,39,3,1974,2,female,316,12,9,142,253,142,188,0,65
2006149,56,11,1957,10,female,1498,12,10,150,77,20,27,130,50
2109118,30,18,1983,4,male,602,12,12,148,16,144,12,4,4
1471085,25,17,1988,9,male,336,12,4,165,1,165,1,0,0
1419212,60,13,1953,11,male,1465,12,7,174,3,168,1,6,2
1624531,16,9,1997,7,female,123,12,10,183,120,178,98,5,22
1565856,27,1,1986,1,male,78,12,8,229,106,103,33,126,73
1353136,44,22,1969,9,female,522,12,7,225,79,214,60,11,19
1657708,33,20,1980,4,male,168,12,10,227,5,227,3,0,2
1376940,30,28,1983,11,female,255,12,5,245,42,16,9,229,33
1226662,34,25,1979,1,female,310,12,8,237,5,237,3,0,2
2117619,38,25,1975,9,male,20,12,11,255,48,171,6,84,42
1406624,27,8,1986,2,male,145,12,7,327,14,327,4,0,10
1095117,63,22,1950,8,female,1590,12,8,350,6,0,1,350,5
2128112,49,21,1964,7,female,158,12,9,410,8,0,0,410,8
2067101,31,24,1982,10,male,19,12,9,415,61,415,53,0,8
1009607,23,12,1990,9,female,36,12,12,453,22,453,13,0,9
1136312,29,26,1984,10,female,267,12,8,638,7,638,4,0,3
1260138,17,21,1996,7,female,152,12,6,706,129,156,51,550,78
1714008,25,1,1988,1,male,39,12,10,710,111,710,77,0,34
1081206,55,26,1958,1,male,223,12,4,699,0,699,0,0,0
2053914,65,4,1948,5,female,391,12,7,826,90,0,9,826,81
1721659,49,1,1964,2,male,257,12,7,1195,87,1195,73,0,14
1050488,54,5,1959,6,female,340,12,5,1473,72,0,3,1473,69
1480674,16,23,1997,6,female,271,12,8,1359,820,1307,536,52,284
1585231,14,21,1999,11,male,73,14,11,0,0,0,0,0,0
1585999,13,1,2000,1,male,293,13,9,0,0,0,0,0,0
1129482,13,11,2000,6,female,203,14,13,0,0,0,0,0,0
2177576,14,22,1999,2,female,51,13,6,0,0,0,0,0,0
2081346,14,1,1999,2,female,37,13,5,0,0,0,0,0,0
1133086,14,1,1999,3,female,296,13,11,0,0,0,0,0,0
1896574,14,15,1999,4,male,368,14,8,0,0,0,0,0,0
1609571,14,2,1999,5,male,405,13,11,0,0,0,0,0,0
1683299,14,11,1999,5,female,157,14,3,0,10,0,6,0,4
1284843,14,15,1999,6,female,191,13,7,0,2,0,2,0,0
1020125,14,17,1999,7,male,59,13,12,0,0,0,0,0,0
1040909,14,8,1999,8,female,216,13,9,0,0,0,0,0,0
1746915,14,12,1999,8,male,36,14,2,0,0,0,0,0,0
1241084,14,1,1999,8,male,95,14,12,0,0,0,0,0,0
1773753,14,20,1999,9,male,271,13,8,0,0,0,0,0,0
1171416,14,16,1999,9,male,78,14,7,0,5,0,2,0,3
1062427,14,10,1999,10,female,299,13,8,0,0,0,0,0,0
1514912,14,5,1999,10,female,44,14,10,0,2,0,2,0,0
1655191,16,7,1997,11,male,100,13,9,0,0,0,0,0,0
1574838,15,2,1998,1,male,459,13,8,0,3,0,0,0,3
1711656,15,8,1998,1,male,118,13,13,0,2,0,1,0,1
1651607,25,4,1988,9,female,644,13,9,1,2,1,1,0,1
1381849,27,10,1986,2,male,172,14,8,1,6,1,6,0,0
1514374,28,28,1985,2,male,98,14,11,1,2,1,1,0,1
1663344,29,3,1984,5,male,17,14,13,1,5,1,5,0,0
1204145,29,2,1984,8,male,222,13,10,1,2,1,2,0,0
1046138,31,18,1982,7,male,232,13,12,1,3,1,2,0,1
1674410,33,4,1980,8,male,23,13,10,1,8,1,4,0,4
1978988,38,18,1975,8,male,502,14,5,1,2,1,2,0,0
1373972,38,12,1975,10,male,595,13,2,1,3,1,1,0,2
1105530,44,6,1969,7,male,853,13,13,1,3,1,3,0,0
1712673,47,10,1966,3,female,793,13,7,1,7,1,7,0,0
1456235,47,8,1966,9,male,217,13,11,1,6,1,3,0,3
1511171,48,13,1965,7,female,170,13,7,1,2,1,2,0,0
2186257,49,12,1964,7,female,343,14,6,1,6,1,5,0,1
1244334,53,11,1960,7,male,518,14,6,1,4,1,0,0,4
1139761,56,6,1957,2,female,206,13,7,1,39,1,36,0,3
1385000,56,3,1957,6,female,91,13,12,1,9,1,4,0,5
1401449,57,10,1956,3,female,1091,14,8,1,6,1,3,0,3
1557825,57,1,1956,6,female,544,14,7,1,2,1,1,0,1
1306883,58,8,1955,8,female,957,14,6,1,3,1,1,0,2
2078741,60,4,1953,4,female,1192,13,6,1,4,1,4,0,0
2151592,64,2,1949,12,male,212,13,10,1,2,1,1,0,1
1751726,63,1,1950,8,male,740,14,3,1,8,1,7,0,1
1106569,66,10,1947,9,female,1956,14,3,1,3,1,3,0,0
1592906,68,22,1945,1,female,88,14,12,1,7,1,5,0,2
1891351,78,17,1935,2,female,153,14,8,1,4,1,4,0,0
1976596,13,22,2000,1,female,200,13,12,2,0,0,0,2,0
2151229,20,2,1993,6,male,45,13,6,2,0,0,0,2,0
1066791,20,22,1993,7,male,270,14,6,2,0,0,0,2,0
2075204,24,13,1989,5,male,356,14,6,2,0,0,0,2,0
1121609,28,15,1985,1,male,411,13,6,2,0,0,0,2,0
1704911,36,13,1977,5,female,258,13,11,2,0,0,0,2,0
1301474,48,13,1965,10,male,130,14,14,2,0,0,0,2,0
1320085,51,1,1962,6,female,87,13,13,2,0,0,0,2,0
1650299,52,27,1961,1,male,15,14,9,2,0,0,0,2,0
1427879,55,19,1958,3,female,751,14,8,2,0,0,0,2,0
1095393,61,1,1952,7,female,141,14,1,2,0,0,0,2,0
1473064,61,15,1952,8,female,237,13,11,2,0,0,0,2,0
1976948,67,3,1946,2,male,1020,13,8,2,0,0,0,2,0
2096924,72,27,1941,8,female,749,13,12,2,0,0,0,2,0
2041706,103,24,1910,8,male,52,14,13,2,0,0,0,2,0
1124944,18,19,1995,12,male,43,13,10,2,1,0,1,2,0
1586503,23,25,1990,1,male,663,13,10,2,1,0,0,2,1
1932706,27,28,1986,8,male,145,13,12,2,1,0,0,2,1
1703653,37,1,1976,1,male,322,13,11,2,1,0,0,2,1
2137490,48,4,1965,4,male,167,14,9,2,1,0,1,2,0
1786130,53,19,1960,2,female,614,13,8,2,1,0,1,2,0
1299567,74,4,1939,9,female,422,14,7,2,1,0,1,2,0
1041392,75,5,1938,1,male,299,14,9,2,1,0,0,2,1
1486403,36,20,1977,10,female,271,13,9,2,2,0,2,2,0
2139043,66,1,1947,11,male,978,13,9,2,2,0,1,2,1
2093545,70,7,1943,6,female,272,14,12,2,2,0,0,2,2
1699329,26,3,1987,3,male,227,13,11,2,34,0,32,2,2
2095058,34,2,1979,3,female,338,13,11,2,4,0,3,2,1
2058663,35,15,1978,4,female,697,13,11,2,23,0,11,2,12
1382883,53,7,1960,12,male,54,14,13,2,6,0,1,2,5
1936866,52,5,1961,10,male,302,13,11,2,4,0,2,2,2
1837744,66,19,1947,10,female,866,14,4,2,5,0,1,2,4
1095504,70,12,1943,9,female,533,14,9,2,4,0,0,2,4
1934050,58,16,1955,4,female,1930,13,6,2,1,1,1,1,0
1275802,72,30,1941,3,female,1494,13,9,2,1,1,1,1,0
1189872,41,16,1972,7,male,30,13,6,2,10,1,4,1,6
1252265,43,1,1970,3,female,223,13,10,2,25,1,17,1,8
1184410,52,25,1961,5,female,973,14,12,2,8,1,8,1,0
1196992,14,20,1999,3,male,134,13,11,2,0,2,0,0,0
1703626,16,12,1997,1,male,82,13,6,2,0,2,0,0,0
1501288,17,11,1996,7,female,248,14,13,2,0,2,0,0,0
1818856,20,7,1993,2,male,503,13,10,2,0,2,0,0,0
1818181,20,15,1993,9,female,39,13,13,2,0,2,0,0,0
1306131,21,3,1992,1,female,434,14,12,2,0,2,0,0,0
1818086,21,1,1992,2,male,283,13,9,2,0,2,0,0,0
1708979,23,1,1990,1,male,8,14,7,2,0,2,0,0,0
1300943,23,25,1990,8,female,113,14,11,2,0,2,0,0,0
1005522,23,10,1990,10,male,339,14,5,2,0,2,0,0,0
1199102,25,29,1988,12,male,790,13,7,2,0,2,0,0,0
1985033,25,8,1988,12,female,346,13,5,2,0,2,0,0,0
2092751,26,15,1987,9,male,719,13,11,2,0,2,0,0,0
1868687,27,5,1986,1,female,555,14,4,2,0,2,0,0,0
1541262,32,8,1981,1,male,390,14,11,2,0,2,0,0,0
1700096,32,10,1981,6,female,180,14,13,2,0,2,0,0,0
1183418,36,3,1977,5,male,174,14,14,2,0,2,0,0,0
1087803,43,7,1970,4,male,197,14,12,2,0,2,0,0,0
2161203,49,6,1964,4,female,116,13,9,2,0,2,0,0,0
1096866,50,9,1963,9,male,957,13,3,2,0,2,0,0,0
1626428,51,20,1962,1,male,54,13,13,2,0,2,0,0,0
1407395,51,1,1962,8,female,591,14,2,2,0,2,0,0,0
1548479,52,9,1961,6,male,85,14,11,2,0,2,0,0,0
1234076,52,11,1961,8,male,175,13,11,2,0,2,0,0,0
1794092,55,10,1958,11,male,307,14,11,2,0,2,0,0,0
1577823,55,17,1958,6,male,620,13,6,2,0,2,0,0,0
1429647,59,30,1954,7,female,185,13,8,2,0,2,0,0,0
1186874,108,9,1905,6,male,279,13,11,2,0,2,0,0,0
1581188,15,14,1998,8,male,10,14,9,2,1,2,1,0,0
1866754,17,27,1996,6,female,11,14,12,2,1,2,1,0,0
1005623,19,14,1994,4,male,370,13,9,2,1,2,1,0,0
1522030,19,24,1994,6,male,95,14,11,2,1,2,1,0,0
1632828,19,10,1994,6,male,4,14,14,2,1,2,1,0,0
1725225,21,3,1992,1,male,18,14,13,2,1,2,1,0,0
1106878,23,28,1990,11,male,308,14,13,2,1,2,1,0,0
1060228,23,26,1990,6,female,783,14,9,2,1,2,0,0,1
1904473,23,2,1990,6,female,139,14,11,2,1,2,1,0,0
1125081,26,5,1987,4,male,277,14,10,2,1,2,1,0,0
1090882,28,13,1985,11,male,238,14,7,2,1,2,1,0,0
1424806,46,2,1967,2,male,488,14,9,2,1,2,1,0,0
1834492,57,17,1956,2,female,70,14,12,2,1,2,0,0,1
1192441,57,11,1956,6,female,303,13,6,2,1,2,1,0,0
1100626,14,6,1999,10,male,217,13,13,2,2,2,2,0,0
1878879,22,21,1991,10,male,12,13,10,2,2,2,1,0,1
1035176,29,14,1984,2,male,170,14,11,2,2,2,0,0,2
1613804,41,6,1972,10,female,133,14,12,2,2,2,2,0,0
1048929,70,1,1943,11,female,125,13,8,2,2,2,2,0,0
1051027,15,14,1998,6,male,24,14,7,2,5,2,5,0,0
1551897,22,10,1991,6,male,755,13,9,2,8,2,4,0,4
1422248,26,5,1987,11,female,41,13,10,2,13,2,13,0,0
1498439,28,18,1985,6,male,77,14,11,2,8,2,2,0,6
1973467,28,9,1985,10,male,384,14,7,2,5,2,0,0,5
1918455,29,10,1984,4,male,422,13,8,2,3,2,0,0,3
1529880,32,2,1981,3,male,39,14,8,2,6,2,6,0,0
1156339,33,7,1980,1,male,415,14,9,2,15,2,3,0,12
1544950,34,20,1979,9,male,138,14,12,2,4,2,4,0,0
2004521,36,18,1977,2,female,32,14,7,2,6,2,2,0,4
1104538,38,5,1975,5,male,544,13,5,2,7,2,4,0,3
1430696,40,15,1973,3,male,906,13,7,2,6,2,6,0,0
1898865,44,12,1969,4,male,41,13,5,2,7,2,7,0,0
1376224,48,16,1965,10,male,427,14,6,2,3,2,3,0,0
1530389,49,20,1964,2,male,827,14,4,2,3,2,3,0,0
1463097,53,11,1960,1,male,49,14,14,2,7,2,2,0,5
1715992,58,8,1955,9,female,32,13,5,2,3,2,3,0,0
1450237,63,11,1950,11,female,48,13,12,2,4,2,2,0,2
2105255,17,2,1996,2,male,405,13,13,3,0,0,0,3,0
1286100,28,21,1985,3,male,1439,13,10,3,0,0,0,3,0
1320390,33,8,1980,4,male,352,14,2,3,0,0,0,3,0
1201240,79,4,1934,3,female,806,13,4,3,0,0,0,3,0
2120728,52,22,1961,2,female,230,14,12,3,1,0,0,3,1
2077702,65,6,1948,6,male,51,13,11,3,1,0,0,3,1
1431611,37,5,1976,3,male,1365,14,11,3,4,0,1,3,3
1003125,20,8,1993,7,male,44,14,13,3,9,0,1,3,8
1865714,23,1,1990,1,male,403,14,12,3,8,0,0,3,8
1156793,24,9,1989,7,male,37,13,13,3,5,0,1,3,4
1769150,62,27,1951,1,male,199,14,10,3,9,0,5,3,4
2150286,64,19,1949,3,female,95,14,5,3,5,0,0,3,5
1267352,68,7,1945,6,female,1005,14,5,3,5,0,3,3,2
1738061,108,1,1905,1,male,41,13,0,3,113,0,4,3,109
1181846,25,1,1988,1,male,440,14,9,3,0,1,0,2,0
1677812,46,1,1967,8,male,279,14,13,3,0,1,0,2,0
1541562,15,8,1998,6,female,123,14,5,3,1,1,1,2,0
1014603,39,4,1974,10,male,39,14,8,3,4,1,2,2,2
1884046,33,26,1980,1,female,131,13,9,3,116,2,73,1,43
1515812,14,28,1999,2,male,68,13,6,3,0,3,0,0,0
1425587,18,3,1995,1,male,854,14,13,3,0,3,0,0,0
1684680,20,9,1993,6,male,19,14,14,3,0,3,0,0,0
2032364,22,5,1991,5,male,14,14,9,3,0,3,0,0,0
2060273,24,12,1989,10,male,635,14,10,3,0,3,0,0,0
1639654,27,31,1986,12,female,99,13,10,3,0,3,0,0,0
1168644,26,25,1987,9,male,214,14,5,3,0,3,0,0,0
1120096,27,20,1986,6,male,212,14,13,3,0,3,0,0,0
2138778,28,23,1985,6,male,2,14,14,3,0,3,0,0,0
1372248,32,2,1981,2,male,446,14,13,3,0,3,0,0,0
1580007,39,5,1974,10,female,520,13,4,3,0,3,0,0,0
2189898,58,13,1955,11,female,744,14,11,3,0,3,0,0,0
1374364,57,1,1956,1,male,508,14,11,3,0,3,0,0,0
1168705,65,28,1948,1,male,1595,14,6,3,0,3,0,0,0
1154826,20,1,1993,1,male,24,13,13,3,1,3,1,0,0
1360153,20,18,1993,7,male,120,13,9,3,1,3,1,0,0
1847791,24,1,1989,1,male,169,14,13,3,1,3,1,0,0
1753714,32,27,1981,3,male,302,13,5,3,1,3,1,0,0
2047043,44,9,1969,9,female,331,13,9,3,1,3,1,0,0
1129505,65,28,1948,1,female,272,13,10,3,1,3,1,0,0
1133257,19,30,1994,8,female,46,13,11,3,3,3,3,0,0
1246949,21,30,1992,7,female,23,13,8,3,4,3,3,0,1
1090949,23,1,1990,1,male,146,13,6,3,2,3,2,0,0
1281637,25,1,1988,1,male,48,13,11,3,3,3,1,0,2
1558568,28,4,1985,2,male,628,13,11,3,4,3,4,0,0
1584148,32,28,1981,10,female,473,13,5,3,2,3,2,0,0
2027279,33,1,1980,1,male,163,13,11,3,2,3,2,0,0
1523682,33,20,1980,7,male,36,13,11,3,2,3,2,0,0
1625823,37,9,1976,6,female,670,14,7,3,2,3,1,0,1
1530796,43,10,1970,9,male,323,13,7,3,3,3,3,0,0
1277534,19,8,1994,8,male,202,14,12,3,6,3,1,0,5
2054011,25,9,1988,12,male,58,14,7,3,8,3,2,0,6
2030589,27,10,1986,2,female,607,13,13,3,5,3,5,0,0
1613268,28,25,1985,4,male,12,13,12,3,5,3,5,0,0
1355641,28,17,1985,7,female,157,13,13,3,5,3,1,0,4
1355278,38,10,1975,3,male,396,14,10,3,8,3,8,0,0
1408243,38,15,1975,3,female,191,14,7,3,38,3,33,0,5
1657519,57,24,1956,1,female,180,13,8,4,0,0,0,4,0
1588952,59,17,1954,4,male,1090,14,8,4,0,0,0,4,0
1768425,94,26,1919,2,female,2,14,13,4,0,0,0,4,0
1159528,24,17,1989,1,male,197,14,11,4,1,0,0,4,1
1713298,28,2,1985,9,female,165,13,10,4,1,0,0,4,1
1905523,33,1,1980,1,male,480,13,9,4,2,0,2,4,0
1660462,38,1,1975,1,male,23,14,13,4,1,0,0,4,1
2027138,54,11,1959,4,female,207,13,4,4,1,0,0,4,1
1204337,74,29,1939,11,female,1593,13,4,4,2,0,0,4,2
1733451,14,6,1999,1,female,392,14,13,4,6,0,6,4,0
1317549,30,21,1983,4,male,178,14,5,4,15,0,7,4,8
1033492,33,2,1980,11,male,235,13,6,4,18,0,8,4,10
1732205,35,24,1978,6,male,733,13,5,4,14,0,4,4,10
1309681,71,20,1942,6,male,82,13,10,4,10,0,3,4,7
2148258,101,7,1912,6,female,512,13,9,4,23,0,9,4,14
1180064,63,25,1950,3,female,274,13,5,4,0,2,0,2,0
1743708,14,17,1999,2,male,30,13,7,4,1,2,0,2,1
1990150,24,7,1989,11,male,94,14,13,4,1,2,0,2,1
1989629,28,23,1985,10,male,65,14,8,4,2,2,2,2,0
2059280,29,21,1984,2,female,459,13,12,4,2,2,1,2,1
1991597,32,14,1981,3,male,26,13,9,4,4,2,0,2,4
1875527,32,26,1981,11,male,186,13,6,4,34,2,28,2,6
1142115,64,2,1949,11,male,47,14,8,4,0,3,0,1,0
1504536,21,27,1992,12,male,112,13,8,4,2,3,2,1,0
1504295,62,28,1951,4,male,1441,13,4,4,1,3,0,1,1
1687167,17,7,1996,2,male,308,14,10,4,0,4,0,0,0
2010140,18,11,1995,2,male,307,13,12,4,0,4,0,0,0
1485435,23,10,1990,2,female,177,13,8,4,0,4,0,0,0
1948952,25,8,1988,10,male,18,13,13,4,0,4,0,0,0
1792539,27,22,1986,12,male,63,14,8,4,0,4,0,0,0
1607822,26,28,1987,10,male,687,13,12,4,0,4,0,0,0
1513526,28,5,1985,12,female,112,14,6,4,0,4,0,0,0
1155421,36,26,1977,6,male,15,14,14,4,0,4,0,0,0
2018616,43,14,1970,10,male,788,13,3,4,0,4,0,0,0
1787723,52,8,1961,9,female,635,14,12,4,0,4,0,0,0
1705833,64,15,1949,7,female,678,14,11,4,0,4,0,0,0
1042105,20,5,1993,1,male,734,14,10,4,1,4,1,0,0
1361766,24,13,1989,11,male,19,14,14,4,1,4,1,0,0
1175441,29,2,1984,11,male,27,13,11,4,2,4,2,0,0
1594878,35,20,1978,7,female,333,13,9,4,1,4,1,0,0
1977074,36,28,1977,10,male,22,13,11,4,2,4,0,0,2
1858951,47,23,1966,7,male,418,14,4,4,1,4,1,0,0
1187583,85,1,1928,2,female,186,13,9,4,2,4,1,0,1
1951394,17,1,1996,1,male,26,13,7,4,3,4,3,0,0
1314776,25,23,1988,10,female,391,13,7,4,3,4,3,0,0
1213938,33,2,1980,2,male,467,14,9,4,4,4,4,0,0
1179937,47,26,1966,10,male,640,13,2,4,3,4,2,0,1
1453664,50,1,1963,4,male,17,13,7,4,5,4,5,0,0
1838240,26,28,1987,5,male,448,14,10,4,9,4,4,0,5
1208380,30,24,1983,12,female,28,14,12,4,6,4,3,0,3
1097149,38,27,1975,10,male,171,14,10,4,6,4,6,0,0
1428191,50,6,1963,10,male,1300,14,4,4,7,4,2,0,5
1013705,70,2,1943,3,male,974,13,9,4,17,4,2,0,15
1581835,70,15,1943,6,male,139,14,12,4,6,4,5,0,1
1624395,14,21,1999,7,male,76,14,11,5,0,0,0,5,0
1154797,31,10,1982,4,male,1171,14,14,5,0,0,0,5,0
1973941,22,23,1991,8,female,806,13,9,5,2,0,0,5,2
1204216,23,17,1990,5,male,159,14,10,5,1,0,1,5,0
1986439,30,15,1983,9,female,263,14,11,5,1,0,0,5,1
1694388,39,18,1974,3,male,500,14,1,5,1,0,0,5,1
1344165,48,1,1965,3,male,1518,13,10,5,1,0,1,5,0
1264307,71,19,1942,6,male,1551,13,2,5,1,0,0,5,1
1099761,76,18,1937,3,male,617,13,7,5,3,0,0,5,3
1626984,16,24,1997,4,male,32,13,10,5,7,0,0,5,7
1536719,20,12,1993,2,male,16,14,13,5,5,0,0,5,5
1277894,62,26,1951,9,female,11,13,8,5,5,0,3,5,2
1268335,77,20,1936,2,female,17,14,10,5,4,0,0,5,4
1008628,25,11,1988,2,male,138,14,6,5,8,0,1,5,7
1066674,46,12,1967,12,male,328,14,12,5,11,0,9,5,2
1782769,25,4,1988,2,male,125,13,13,5,0,1,0,4,0
1092159,32,12,1981,6,male,463,14,8,5,0,3,0,2,0
2147862,46,10,1967,10,male,1042,13,6,5,0,4,0,1,0
1086414,51,31,1962,8,female,186,13,9,5,1,4,1,1,0
2152209,16,16,1997,10,male,25,13,8,5,0,5,0,0,0
1358532,21,10,1992,10,male,334,13,6,5,0,5,0,0,0
1865166,26,3,1987,12,female,676,13,7,5,0,5,0,0,0
1888812,30,1,1983,1,male,380,13,12,5,0,5,0,0,0
1952068,31,15,1982,4,female,15,13,5,5,0,5,0,0,0
1432469,33,1,1980,12,male,282,13,12,5,0,5,0,0,0
1492357,59,17,1954,12,female,316,13,10,5,0,5,0,0,0
1381603,23,18,1990,8,male,23,13,12,5,1,5,1,0,0
1058901,25,8,1988,8,female,413,14,14,5,2,5,2,0,0
1312113,31,8,1982,8,male,202,14,9,5,1,5,1,0,0
1239771,34,3,1979,1,male,551,13,6,5,1,5,1,0,0
1555797,38,16,1975,1,male,20,13,13,5,2,5,2,0,0
1012823,39,22,1974,3,male,102,14,13,5,2,5,2,0,0
2052604,44,24,1969,1,male,310,14,10,5,1,5,1,0,0
1292554,51,20,1962,6,male,1225,14,4,5,1,5,1,0,0
1227448,71,14,1942,7,male,157,13,4,5,2,5,0,0,2
1981040,22,3,1991,5,male,55,14,4,5,7,5,1,0,6
1858594,26,5,1987,2,female,212,14,5,5,7,5,7,0,0
1415469,28,2,1985,1,male,398,14,13,5,8,5,6,0,2
1641947,16,1,1997,1,male,943,13,11,6,0,0,0,6,0
2003455,31,27,1982,8,male,200,13,13,6,0,0,0,6,0
1540299,39,6,1974,11,female,157,14,9,6,0,0,0,6,0
2023556,61,27,1952,3,female,633,13,10,6,0,0,0,6,0
1621970,60,31,1953,3,male,983,14,11,6,3,0,1,6,2
1927234,20,12,1993,8,male,17,14,14,6,0,4,0,2,0
2065711,19,28,1994,5,female,320,13,2,6,0,6,0,0,0
1960855,20,9,1993,3,male,207,14,6,6,0,6,0,0,0
1825687,24,12,1989,8,male,258,13,13,6,0,6,0,0,0
1858970,25,1,1988,1,male,215,14,11,6,0,6,0,0,0
1057331,27,10,1986,4,male,143,14,12,6,0,6,0,0,0
2055763,35,16,1978,9,female,415,14,8,6,0,6,0,0,0
2171618,39,27,1974,8,female,437,13,4,6,0,6,0,0,0
1256730,62,23,1951,2,male,514,13,13,6,0,6,0,0,0
1892804,51,1,1962,11,male,684,13,11,6,2,6,2,0,0
1847061,15,5,1998,7,male,10,14,14,6,8,6,2,0,6
1330632,25,6,1988,5,male,435,14,11,6,5,6,4,0,1
1768850,32,12,1981,12,male,164,14,14,6,5,6,5,0,0
1143845,49,22,1964,1,male,384,13,9,6,8,6,7,0,1
2055053,17,1,1996,5,male,31,14,11,6,9,6,8,0,1
2139848,26,4,1987,4,female,448,14,5,6,16,6,16,0,0
1562945,33,1,1980,1,male,10,14,12,6,19,6,15,0,4
1880277,22,3,1991,8,male,769,14,11,7,0,0,0,7,0
1184382,26,8,1987,8,male,53,14,12,7,0,0,0,7,0
1393727,36,10,1977,12,male,397,13,12,7,0,0,0,7,0
1635499,25,15,1988,6,male,178,13,11,7,2,0,0,7,2
1261914,30,17,1983,9,female,263,13,7,7,3,0,3,7,0
1347769,43,1,1970,1,female,961,13,7,7,6,0,6,7,0
1577130,52,22,1961,11,female,59,14,13,7,8,0,1,7,7
1507251,102,30,1911,3,male,407,13,13,7,7,0,7,7,0
1420616,30,30,1983,8,female,387,13,11,7,11,0,7,7,4
1720966,23,1,1990,1,female,273,13,12,7,0,2,0,5,0
1197626,48,6,1965,3,female,13,13,13,7,4,5,2,2,2
1292033,53,2,1960,11,female,706,13,8,7,7,3,5,4,2
1653536,19,22,1994,6,male,26,14,12,7,0,7,0,0,0
1975275,23,1,1990,1,female,119,14,14,7,1,7,1,0,0
1791149,28,28,1985,11,female,445,14,2,7,0,7,0,0,0
1318095,30,20,1983,4,male,642,13,4,7,1,7,0,0,1
1269796,36,7,1977,4,female,418,13,10,7,0,7,0,0,0
1834685,42,13,1971,4,male,1673,14,6,7,1,7,0,0,1
1579341,47,25,1966,8,female,376,13,10,7,1,7,0,0,1
1813679,55,25,1958,12,male,448,14,13,7,0,7,0,0,0
1901179,74,24,1939,12,male,196,14,10,7,1,7,1,0,0
1924459,18,6,1995,6,male,382,13,8,7,2,7,2,0,0
1254974,22,5,1991,1,male,43,13,13,7,2,7,2,0,0
1500747,23,28,1990,7,female,17,14,2,7,9,7,8,0,1
2139068,48,13,1965,11,female,265,14,6,7,6,7,3,0,3
1902319,36,7,1977,7,male,659,14,10,7,25,7,15,0,10
1656734,83,1,1930,1,male,23,14,10,7,24,7,17,0,7
1233050,15,13,1998,1,male,49,14,13,8,0,1,0,7,0
1554918,73,29,1940,4,male,604,13,10,8,1,0,0,8,1
2147843,62,29,1951,11,male,39,14,7,8,97,0,25,8,72
1578737,49,2,1964,7,female,303,13,10,8,8,4,6,4,2
2127989,22,18,1991,7,male,183,14,12,8,2,7,2,1,0
1197050,28,18,1985,2,male,145,13,12,8,4,6,2,2,2
2076163,20,11,1993,5,female,536,14,11,8,1,8,1,0,0
2157568,34,13,1979,2,female,259,13,9,8,1,8,0,0,1
1714880,58,22,1955,11,male,1385,14,10,8,0,8,0,0,0
1291257,20,9,1993,1,male,636,13,9,8,2,8,2,0,0
1046951,29,2,1984,10,female,285,13,4,8,2,8,2,0,0
1814860,43,1,1970,1,male,158,13,12,8,2,8,2,0,0
1884495,56,14,1957,5,female,1779,13,7,8,2,8,2,0,0
1248463,14,27,1999,8,male,4,13,13,8,10,8,8,0,2
1729753,40,30,1973,1,female,290,13,8,8,10,8,10,0,0
1075438,51,6,1962,4,male,59,14,13,8,5,8,3,0,2
2146244,52,5,1961,2,female,369,14,12,8,9,8,8,0,1
1879651,37,2,1976,3,female,287,14,11,8,26,8,24,0,2
1546841,52,20,1961,3,male,37,13,2,8,77,8,34,0,43
1765592,74,6,1939,2,female,1748,13,1,9,1,0,1,9,0
1813746,17,4,1996,10,male,191,14,10,9,4,1,4,8,0
1859260,40,15,1973,1,male,215,13,10,9,3,0,2,9,1
1496565,108,12,1905,6,female,214,13,10,9,3,0,0,9,3
1802934,21,15,1992,4,male,429,14,6,9,4,4,2,5,2
1171881,55,7,1958,3,female,312,13,11,9,2,2,1,7,1
1661948,28,20,1985,1,female,280,13,10,9,9,2,0,7,9
1406458,49,7,1964,4,male,348,13,5,9,63,5,30,4,33
1044539,68,20,1945,2,male,845,13,9,9,1,8,1,1,0
1163542,21,1,1992,1,male,63,14,11,9,0,9,0,0,0
1382828,28,12,1985,12,male,205,14,12,9,0,9,0,0,0
1516061,48,18,1965,4,female,81,13,12,9,0,9,0,0,0
1404576,50,16,1963,10,male,946,13,7,9,0,9,0,0,0
1959184,58,2,1955,12,female,617,14,7,9,1,9,0,0,1
1722590,61,23,1952,10,male,26,14,11,9,1,9,0,0,1
1684878,87,7,1926,8,male,163,13,11,9,0,9,0,0,0
2111537,22,3,1991,12,female,277,14,12,9,4,9,4,0,0
1510424,28,16,1985,10,female,487,13,9,9,5,9,3,0,2
1051061,46,22,1967,10,female,335,14,7,9,8,9,5,0,3
1184494,53,31,1960,1,male,30,13,9,9,13,9,4,0,9
1407732,72,18,1941,1,female,21,14,13,10,0,0,0,10,0
1351321,28,3,1985,3,male,435,13,6,10,16,1,7,9,9
1357885,52,18,1961,6,female,1259,14,7,10,25,0,7,10,18
1619041,23,11,1990,10,male,1695,14,12,10,0,6,0,4,0
1726551,23,2,1990,3,female,167,13,11,10,1,9,0,1,1
1551773,53,12,1960,2,male,197,13,8,10,1,9,1,1,0
1214817,57,21,1956,5,male,191,13,11,10,6,8,5,2,1
1099563,59,30,1954,8,female,530,14,8,10,6,9,5,1,1
1315218,24,15,1989,2,female,115,14,11,10,22,9,17,1,5
1431293,18,3,1995,7,female,851,13,12,10,0,10,0,0,0
1334987,19,21,1994,6,male,304,14,9,10,1,10,1,0,0
1094027,21,30,1992,9,female,275,13,2,10,0,10,0,0,0
1517184,29,18,1984,2,male,284,13,10,10,0,10,0,0,0
1532525,34,23,1979,7,male,662,14,9,10,0,10,0,0,0
1754873,50,21,1963,9,female,579,13,5,10,0,10,0,0,0
1073030,37,10,1976,8,female,551,14,6,10,5,10,4,0,1
1387293,46,27,1967,11,male,75,13,10,10,5,10,3,0,2
1060155,28,29,1985,8,female,13,14,13,10,7,10,5,0,2
1793751,34,5,1979,12,male,37,13,9,10,10,10,10,0,0
1652453,35,7,1978,1,female,804,14,11,10,8,10,1,0,7
1575197,28,7,1985,3,male,394,14,13,11,0,0,0,11,0
1450744,67,21,1946,12,female,985,13,6,11,3,0,1,11,2
1562474,68,26,1945,6,female,794,13,11,11,2,0,2,11,0
2008573,14,9,1999,7,male,18,13,7,11,16,0,0,11,16
1098085,37,2,1976,2,male,1337,13,12,11,6,9,3,2,3
1868525,14,2,1999,2,male,170,14,13,11,0,11,0,0,0
1762495,31,15,1982,5,male,393,13,9,11,1,11,1,0,0
1778350,58,21,1955,5,male,88,14,5,11,0,11,0,0,0
1453540,38,19,1975,4,female,338,13,9,11,2,11,0,0,2
1004361,51,12,1962,9,female,154,13,13,11,2,11,2,0,0
2052478,60,3,1953,3,female,444,14,11,11,2,11,1,0,1
1466143,25,31,1988,3,female,431,13,8,11,8,11,5,0,3
1910567,60,14,1953,6,female,159,14,11,11,20,11,9,0,11
2079796,18,10,1995,5,male,80,14,13,12,0,0,0,12,0
1821868,23,22,1990,12,male,93,14,12,12,2,0,1,12,1
1582671,23,27,1990,10,male,466,13,7,12,6,0,4,12,2
1862864,35,10,1978,3,male,107,14,8,12,4,0,0,12,4
1412072,54,9,1959,1,male,53,14,8,12,1,6,1,6,0
1944083,17,1,1996,1,female,8,13,11,12,6,10,5,2,1
1254542,14,1,1999,1,male,13,13,12,12,0,12,0,0,0
1602118,26,7,1987,1,male,68,14,13,12,0,12,0,0,0
1156845,46,20,1967,12,female,376,13,10,12,0,12,0,0,0
1711851,59,24,1954,4,female,214,14,13,12,1,12,1,0,0
1047058,25,3,1988,3,female,243,14,9,12,2,12,1,0,1
1725697,28,5,1985,5,male,307,13,5,12,4,12,3,0,1
1252005,49,8,1964,8,male,741,13,8,12,7,12,4,0,3
1258748,61,9,1952,4,male,1080,13,9,12,3,12,1,0,2
1082618,61,22,1952,10,male,70,13,12,12,3,12,3,0,0
1873389,67,7,1946,7,male,1363,13,7,12,2,12,0,0,2
1714254,53,29,1960,10,male,588,13,6,12,12,12,12,0,0
1453224,19,14,1994,12,female,295,14,13,12,19,12,19,0,0
1137256,35,1,1978,2,male,33,13,7,12,28,12,27,0,1
1159691,14,27,1999,4,male,48,13,9,13,1,0,1,13,0
1445130,16,22,1997,12,male,395,13,13,13,0,0,0,13,0
1765281,24,23,1989,10,female,182,13,6,13,2,0,0,13,2
1415500,31,7,1982,7,female,366,13,13,13,2,1,0,12,2
1916562,42,21,1971,9,male,114,13,11,13,0,0,0,13,0
2187474,63,17,1950,6,female,1067,14,11,13,10,0,3,13,7
1288482,22,5,1991,9,male,343,14,11,13,15,5,14,8,1
1196243,73,6,1940,1,female,1022,13,5,13,10,3,5,10,5
2024889,47,14,1966,9,male,781,14,9,13,0,13,0,0,0
1324817,61,5,1952,6,female,929,14,11,13,1,13,0,0,1
1489689,69,8,1944,10,female,405,14,8,13,6,13,5,0,1
1566173,100,1,1913,1,female,38,13,12,13,5,13,1,0,4
2166941,40,25,1973,6,male,143,14,5,13,10,13,8,0,2
1192747,24,23,1989,3,male,231,14,10,13,25,13,24,0,1
1612503,29,4,1984,5,male,1082,13,5,14,0,0,0,14,0
1620918,74,4,1939,3,female,574,13,7,14,2,0,0,14,2
1397719,14,16,1999,8,male,155,13,11,14,3,0,0,14,3
1534011,23,1,1990,1,male,494,13,5,14,4,0,2,14,2
1424966,60,20,1953,7,female,1162,14,8,14,3,0,0,14,3
1917536,70,2,1943,4,female,2164,13,7,14,3,0,0,14,3
1887776,27,1,1986,1,male,438,14,12,14,49,1,19,13,30
1610174,20,6,1993,7,male,245,14,14,14,2,14,2,0,0
1240135,43,18,1970,5,female,501,14,10,14,0,14,0,0,0
1314820,43,10,1970,10,male,386,14,5,14,27,14,12,0,15
1026975,50,5,1963,9,female,98,13,8,14,25,14,24,0,1
1711603,78,9,1935,6,male,1146,14,11,15,0,0,0,15,0
1555368,25,1,1988,2,female,139,13,13,15,5,0,3,15,2
1316011,28,9,1985,3,male,153,13,2,15,12,14,12,1,0
1525426,29,27,1984,11,male,529,14,13,15,2,15,2,0,0
1572784,53,9,1960,5,female,91,14,3,15,0,15,0,0,0
1297887,61,12,1952,9,male,1777,13,6,15,2,15,2,0,0
1470859,20,7,1993,9,male,185,14,10,15,6,15,5,0,1
1634878,43,5,1970,7,male,45,13,12,15,4,15,4,0,0
1294573,54,11,1959,11,male,405,13,7,15,8,15,8,0,0
1971649,38,1,1975,3,female,56,14,10,15,13,15,6,0,7
1389119,27,1,1986,3,male,219,13,12,15,23,15,22,0,1
1260372,37,24,1976,11,male,548,13,12,15,26,15,15,0,11
1877754,16,15,1997,2,male,92,14,13,16,13,0,0,16,13
1290656,48,18,1965,3,female,12,14,6,16,11,2,5,14,6
1626185,16,16,1997,4,female,331,14,3,16,0,16,0,0,0
1039338,25,1,1988,1,male,178,13,11,16,0,16,0,0,0
1816170,25,1,1988,6,male,248,13,12,16,0,16,0,0,0
1076573,25,12,1988,9,female,289,14,11,16,0,16,0,0,0
1879140,26,1,1987,1,male,13,13,8,16,9,16,9,0,0
2084974,33,15,1980,9,male,12,13,12,16,8,16,6,0,2
1028842,25,1,1988,10,male,100,14,11,16,23,16,5,0,18
1890087,31,2,1982,3,female,10,13,1,16,14,16,13,0,1
1113009,59,6,1954,9,male,399,13,8,16,16,16,16,0,0
1305457,27,25,1986,1,male,341,13,11,17,1,0,1,17,0
1586845,65,21,1948,3,female,169,14,6,17,2,0,0,17,2
1274392,27,27,1986,5,male,295,14,10,17,4,0,2,17,2
1785774,37,1,1976,4,male,504,13,4,17,19,1,12,16,7
1066892,76,25,1937,12,female,278,13,5,17,12,0,5,17,7
1451165,20,19,1993,12,male,16,14,5,17,6,9,0,8,6
1584798,22,25,1991,6,female,369,14,7,17,9,9,3,8,6
1332654,23,8,1990,10,male,103,13,12,17,0,17,0,0,0
1325575,34,24,1979,9,male,522,13,7,17,2,17,2,0,0
1446698,43,23,1970,2,male,454,14,8,17,0,17,0,0,0
1380647,23,1,1990,4,male,101,13,11,17,12,17,6,0,6
1750821,83,18,1930,9,female,309,13,9,18,0,0,0,18,0
1796829,50,11,1963,1,female,15,14,9,18,17,17,12,1,5
1963801,33,5,1980,12,male,134,13,12,18,1,18,1,0,0
1060256,42,11,1971,2,male,358,14,8,18,1,18,0,0,1
1518321,61,19,1952,7,female,395,14,10,18,0,18,0,0,0
1533452,66,14,1947,10,male,25,14,12,18,1,18,1,0,0
1674636,19,30,1994,11,female,386,14,12,18,4,18,3,0,1
1431950,51,14,1962,11,female,668,13,8,18,16,18,14,0,2
1362337,61,29,1952,9,female,1445,13,4,18,25,18,24,0,1
1441413,32,24,1981,3,male,520,13,11,19,2,13,2,6,0
2102183,32,27,1981,10,male,539,14,6,19,3,19,3,0,0
1769766,33,13,1980,8,male,118,13,7,19,0,19,0,0,0
1720203,35,21,1978,3,male,225,13,10,19,3,19,3,0,0
1773136,38,27,1975,12,male,624,13,8,19,3,19,2,0,1
1272732,21,8,1992,3,male,63,13,8,19,4,19,4,0,0
1203500,23,25,1990,12,male,68,14,14,19,7,19,7,0,0
1738696,56,30,1957,8,female,409,14,7,19,11,19,6,0,5
1319190,24,1,1989,9,female,203,14,10,20,13,0,3,20,10
1252175,69,14,1944,7,female,442,13,2,20,1,16,1,4,0
1094773,15,15,1998,5,female,493,14,10,20,0,20,0,0,0
1820578,27,2,1986,10,female,193,14,6,20,0,20,0,0,0
2143019,67,23,1946,2,female,1228,13,5,20,4,20,4,0,0
2162150,66,5,1947,8,male,21,14,12,21,5,18,5,3,0
1540939,30,28,1983,3,female,150,14,9,21,33,20,25,1,8
1896271,33,18,1980,8,male,217,14,9,21,1,21,1,0,0
1125176,52,17,1961,12,male,368,13,9,21,0,21,0,0,0
1774928,55,3,1958,12,female,320,13,5,21,0,21,0,0,0
1738346,22,3,1991,6,female,431,13,5,21,12,21,9,0,3
1759556,48,21,1965,5,female,427,14,9,21,25,21,24,0,1
1521859,72,14,1941,2,male,1002,13,6,22,1,0,1,22,0
1196787,61,1,1952,1,female,342,14,11,22,11,0,11,22,0
1644902,61,1,1952,5,female,117,14,10,22,9,1,4,21,5
1095871,61,15,1952,5,female,1483,14,4,22,11,5,9,17,2
1014764,20,3,1993,7,male,536,13,12,22,2,19,2,3,0
1235584,41,1,1972,1,male,553,14,6,22,1,21,1,1,0
1401724,17,5,1996,4,male,289,13,6,22,1,22,1,0,0
2165047,65,20,1948,11,male,561,14,10,22,12,22,10,0,2
1087511,62,25,1951,5,female,334,13,11,22,25,22,22,0,3
1483035,67,24,1946,6,female,552,14,7,23,3,0,3,23,0
2065355,25,23,1988,6,female,504,13,8,23,2,17,2,6,0
1893862,60,17,1953,3,male,1025,14,7,23,12,18,11,5,1
1715901,23,4,1990,12,female,47,13,10,23,7,23,7,0,0
1533406,23,10,1990,6,female,225,13,11,23,4,23,3,0,1
1165663,46,31,1967,10,female,163,14,11,23,11,23,9,0,2
1154357,52,21,1961,3,male,275,13,5,23,5,23,4,0,1
1582078,57,14,1956,5,female,252,13,7,23,14,23,14,0,0
1262130,21,3,1992,2,male,928,13,13,24,3,6,1,18,2
1043647,43,4,1970,7,female,122,14,9,24,2,24,2,0,0
1649025,29,12,1984,10,female,575,14,11,24,6,24,4,0,2
1299892,50,27,1963,11,female,691,14,5,24,43,24,41,0,2
1282172,63,14,1950,7,female,29,14,11,24,73,24,56,0,17
1110322,43,9,1970,4,female,691,13,7,25,7,0,1,25,6
1563150,49,18,1964,1,female,505,13,10,25,11,0,1,25,10
1359379,70,22,1943,2,male,1611,14,8,25,9,0,2,25,7
1109735,37,17,1976,3,male,23,14,11,25,20,23,9,2,11
1717562,59,14,1954,1,male,297,13,8,25,1,25,1,0,0
1910100,25,3,1988,10,male,28,14,14,25,6,25,6,0,0
2036559,28,2,1985,12,male,265,14,13,25,5,25,5,0,0
1211995,85,25,1928,12,male,909,14,8,26,0,0,0,26,0
1676083,101,10,1912,8,male,400,13,8,26,21,1,10,25,11
1146903,18,10,1995,9,male,72,14,7,26,0,13,0,13,0
1089072,28,14,1985,10,male,21,14,12,26,3,6,3,20,0
2143696,54,7,1959,4,female,607,13,8,26,6,11,2,15,4
1784846,46,20,1967,7,male,678,13,1,26,47,11,33,15,14
1658898,23,31,1990,8,male,28,13,9,26,17,20,14,6,3
2048470,27,11,1986,11,male,318,13,10,26,0,26,0,0,0
1426936,24,20,1989,7,male,10,14,10,26,16,26,16,0,0
1500494,48,7,1965,1,female,401,13,9,26,26,26,11,0,15
1887223,50,28,1963,10,female,453,14,10,26,42,26,38,0,4
1576312,20,17,1993,4,male,756,14,6,27,0,0,0,27,0
1373421,62,10,1951,8,female,469,14,12,27,4,0,0,27,4
1201511,56,12,1957,9,female,40,13,11,27,118,0,21,27,97
1278447,55,15,1958,9,female,510,13,7,27,2,12,1,15,1
1560091,55,1,1958,3,male,346,13,9,27,4,25,3,2,1
1262449,18,1,1995,4,female,187,13,11,27,4,27,4,0,0
1592684,40,1,1973,7,male,533,13,13,27,2,27,1,0,1
1304725,19,20,1994,7,female,220,14,8,27,36,27,28,0,8
1994132,44,7,1969,9,female,274,14,10,27,23,27,22,0,1
1518686,63,27,1950,6,female,457,13,11,27,17,27,16,0,1
1854214,22,10,1991,9,female,512,14,7,28,24,1,0,27,24
1171638,69,9,1944,6,female,1209,13,2,28,21,28,12,0,9
1241370,32,25,1981,10,male,563,13,7,29,13,3,7,26,6
1823775,13,8,2000,7,male,47,13,13,29,6,29,4,0,2
1469472,43,14,1970,2,male,162,14,10,29,6,29,3,0,3
1320002,46,17,1967,6,male,668,14,9,29,7,29,7,0,0
1166915,55,25,1958,5,female,1301,13,1,29,12,29,12,0,0
1814661,60,24,1953,10,male,1193,14,11,31,44,0,8,31,36
1895012,70,14,1943,12,female,312,13,13,30,4,30,4,0,0
1176343,25,1,1988,1,male,54,14,13,31,17,31,11,0,6
1732730,41,22,1972,11,female,459,14,7,31,19,31,12,0,7
2016707,44,20,1969,10,female,577,14,8,30,20,30,12,0,8
1426914,75,25,1938,8,female,796,14,10,31,23,31,16,0,7
1130010,25,2,1988,1,female,89,13,6,30,79,30,60,0,19
1605602,59,1,1954,11,female,673,13,11,32,21,0,0,32,21
1367516,70,22,1943,3,female,173,13,13,32,68,23,49,9,19
1324942,35,20,1978,5,male,355,14,13,32,0,32,0,0,0
1276194,31,9,1982,3,male,36,13,13,32,16,32,13,0,3
1888148,33,19,1980,5,female,128,13,9,33,2,0,1,33,1
1820727,71,1,1942,4,female,1545,14,5,33,1,0,0,33,1
1366810,18,20,1995,7,female,92,13,4,33,32,12,1,21,31
1120499,22,22,1991,6,female,299,14,10,33,10,33,3,0,7
1931906,24,8,1989,8,male,11,14,13,33,7,33,7,0,0
1037094,25,22,1988,9,male,126,13,10,33,6,33,4,0,2
1534120,25,1,1988,1,female,43,14,12,33,30,33,12,0,18
2192970,32,1,1981,10,female,25,13,12,33,30,33,6,0,24
1853092,23,1,1990,1,female,245,14,10,34,2,0,2,34,0
2062704,42,27,1971,9,male,428,13,7,34,0,0,0,34,0
1339781,55,16,1958,7,male,924,13,8,34,19,0,2,34,17
1030480,55,31,1958,8,female,163,13,7,35,7,0,1,35,6
1981169,68,2,1945,7,female,1920,13,6,35,47,0,20,35,27
1510251,16,19,1997,6,male,739,13,10,36,2,26,0,10,2
2155856,39,20,1974,5,female,99,13,13,35,35,20,12,15,23
1469368,47,1,1966,11,female,89,14,4,36,18,36,14,0,4
1085720,22,10,1991,5,female,506,13,3,36,29,36,11,0,18
1765178,37,6,1976,3,female,383,14,7,36,28,36,12,0,16
1989726,52,2,1961,1,male,227,13,8,36,23,36,22,0,1
1953179,58,27,1955,4,male,289,14,6,37,34,0,5,37,29
1682854,63,28,1950,9,male,1080,14,13,37,4,37,4,0,0
1605718,75,16,1938,8,male,801,13,7,39,10,0,5,39,5
1584000,33,18,1980,1,female,198,14,10,38,20,22,7,16,13
1366984,42,31,1971,10,male,376,13,4,39,18,39,18,0,0
1271686,55,24,1958,8,female,868,13,11,39,20,39,7,0,13
1208046,89,24,1924,2,female,1493,13,9,38,12,38,9,0,3
1215196,76,27,1937,10,female,227,14,12,40,4,0,0,40,4
1587143,20,11,1993,7,male,268,13,8,40,24,39,15,1,9
1343756,23,10,1990,2,male,584,14,12,40,1,40,1,0,0
1879557,39,18,1974,10,male,765,14,10,41,3,0,3,41,0
1737997,18,24,1995,2,male,278,14,7,41,20,0,18,41,2
1238710,26,30,1987,11,male,72,13,6,41,18,1,14,40,4
1973047,22,5,1991,12,female,229,14,10,41,38,22,9,19,29
1980006,26,7,1987,6,female,111,14,9,42,1,42,1,0,0
1326442,26,20,1987,6,male,7,14,14,42,4,42,4,0,0
1051040,30,17,1983,11,female,443,13,9,41,1,41,1,0,0
1628058,36,25,1977,7,female,538,13,5,42,18,42,16,0,2
1339152,49,18,1964,10,female,249,14,11,42,37,42,36,0,1
1498909,17,10,1996,12,female,443,14,10,44,30,44,26,0,4
2184113,25,11,1988,4,female,512,14,10,43,101,43,73,0,28
1951968,52,17,1961,12,female,8,14,13,45,15,0,1,45,14
1721351,41,12,1972,5,female,70,13,12,45,5,45,3,0,2
1526477,23,28,1990,2,male,397,14,9,46,39,40,23,6,16
1158243,42,29,1971,9,female,377,13,9,46,5,46,5,0,0
1669424,46,3,1967,3,male,608,13,1,47,26,47,16,0,10
1871223,40,3,1973,7,male,701,14,7,48,17,20,9,28,8
1373901,19,14,1994,2,female,391,13,7,49,5,49,4,0,1
1406954,42,6,1971,11,male,473,14,7,48,0,48,0,0,0
1981108,50,28,1963,10,male,165,14,3,48,0,48,0,0,0
2103101,24,25,1989,12,male,185,13,10,49,22,49,21,0,1
2173135,30,21,1983,4,female,254,14,11,48,33,48,27,0,6
1497726,41,6,1972,3,female,4,13,13,48,37,48,18,0,19
1081940,36,20,1977,6,female,572,14,12,51,23,0,10,51,13
2096255,40,10,1973,7,male,319,14,12,50,12,3,3,47,9
1299446,103,1,1910,1,male,1525,13,8,50,6,49,6,1,0
2048649,38,26,1975,8,female,33,14,12,51,17,48,16,3,1
1921383,31,25,1982,10,male,34,13,5,50,50,50,48,0,2
1739041,31,8,1982,12,male,200,13,8,52,2,0,2,52,0
1285836,17,2,1996,2,female,397,13,11,52,71,15,42,37,29
1129077,59,22,1954,7,female,130,13,10,53,5,53,5,0,0
1646887,50,31,1963,12,female,283,13,7,55,1,0,1,55,0
2113177,53,6,1960,9,male,262,13,7,55,8,0,4,55,4
1927158,70,19,1943,3,female,1502,14,11,54,6,7,0,47,6
1279174,17,30,1996,11,female,357,13,12,55,42,52,20,3,22
1435777,42,15,1971,7,female,381,13,12,54,1,54,0,0,1
2075661,60,14,1953,7,male,560,14,9,57,0,0,0,57,0
1398860,63,31,1950,8,male,144,14,11,56,4,0,4,56,0
1913526,56,7,1957,9,female,207,14,7,56,14,0,3,56,11
1315134,60,1,1953,4,male,898,13,9,56,10,0,4,56,6
1998673,71,23,1942,6,male,266,13,6,57,51,0,0,57,51
1069811,60,26,1953,4,male,206,13,11,57,5,57,3,0,2
1076204,40,19,1973,9,male,84,13,10,57,22,57,22,0,0
1813671,42,5,1971,11,female,109,13,13,56,76,56,28,0,48
1195996,56,26,1957,4,female,18,14,12,57,84,57,69,0,15
1256809,56,24,1957,1,male,190,13,12,60,31,0,3,60,28
2137272,32,21,1981,1,male,326,14,8,60,6,47,3,13,3
1042478,22,27,1991,8,female,397,14,7,61,96,26,60,35,36
1417881,30,29,1983,1,male,23,14,12,63,10,54,8,9,2
1474188,47,18,1966,9,male,176,13,10,63,16,63,12,0,4
1482671,23,8,1990,5,male,34,14,14,64,8,0,1,64,7
1331531,60,28,1953,4,female,1100,13,9,64,27,0,12,64,15
1348166,69,1,1944,10,female,538,14,11,67,6,0,4,67,2
1236272,24,9,1989,3,female,726,14,6,68,30,0,15,68,15
1904908,19,3,1994,5,male,361,14,9,66,1,25,1,41,0
1722986,26,18,1987,10,male,119,14,13,67,1,61,0,6,1
1746895,100,20,1913,3,female,169,13,11,66,1,66,1,0,0
1109883,58,20,1955,5,male,12,13,9,71,32,0,11,71,21
1281484,30,25,1983,8,female,246,14,9,71,8,40,7,31,1
1995837,58,17,1955,5,female,208,14,9,71,0,71,0,0,0
1389353,47,26,1966,9,male,1012,14,5,74,1,1,1,73,0
1930971,69,8,1944,11,male,1048,13,10,74,28,4,9,70,19
1332357,37,18,1976,3,male,538,14,12,72,24,24,4,48,20
2067462,29,3,1984,8,male,69,14,13,74,1,74,1,0,0
1156600,23,4,1990,7,female,1022,14,9,74,19,74,13,0,6
2091575,25,6,1988,12,female,182,13,5,72,29,72,29,0,0
2069926,37,27,1976,8,male,125,13,13,73,26,73,26,0,0
1523587,55,26,1958,10,female,1717,14,5,72,35,72,28,0,7
1028913,52,11,1961,12,female,1419,14,7,76,123,0,2,76,121
1760517,44,18,1969,10,male,346,14,10,77,16,77,16,0,0
1704182,25,17,1988,4,female,418,13,8,79,81,2,20,77,61
1158584,16,4,1997,9,female,81,13,12,80,97,80,65,0,32
1275674,74,20,1939,12,female,746,14,7,82,48,0,17,82,31
2037263,55,30,1958,9,male,368,13,9,84,60,30,46,54,14
2030932,40,25,1973,11,male,135,13,9,81,41,81,32,0,9
2055940,31,20,1982,10,female,420,14,9,84,65,84,11,0,54
1799877,54,27,1959,8,male,655,14,6,85,175,0,75,85,100
1122135,52,22,1961,3,female,440,14,10,85,25,18,22,67,3
1565694,71,16,1942,6,male,391,14,3,85,26,22,13,63,13
1620588,66,12,1947,1,female,115,13,8,86,12,86,5,0,7
1061674,24,18,1989,10,female,66,13,5,86,18,86,11,0,7
1283268,38,10,1975,11,female,237,13,10,89,2,0,1,89,1
1914074,24,11,1989,7,female,204,13,11,88,242,88,144,0,98
1834085,16,19,1997,6,male,227,14,5,93,5,1,4,92,1
1875773,103,1,1910,1,male,806,13,6,98,5,18,4,80,1
1348138,62,16,1951,4,female,914,13,6,96,39,0,26,96,13
1653421,25,28,1988,4,female,461,14,10,98,50,94,48,4,2
1020358,46,8,1967,2,female,415,14,13,96,56,86,31,10,25
1695634,20,23,1993,4,female,63,13,5,98,2,98,0,0,2
1443903,46,19,1967,1,female,305,14,12,97,5,97,4,0,1
1660845,59,29,1954,8,female,343,14,11,96,4,96,4,0,0
1510551,20,15,1993,9,male,9,13,9,98,23,98,23,0,0
1916920,45,17,1968,10,female,78,13,10,97,19,97,18,0,1
1203041,31,4,1982,5,female,88,14,9,99,604,99,543,0,61
1838872,49,28,1964,10,male,318,14,2,100,52,97,33,3,19
2063564,56,20,1957,5,male,1037,13,9,101,38,80,27,21,11
1461806,34,19,1979,1,male,136,14,6,101,18,101,17,0,1
1530673,36,19,1977,2,male,532,13,7,106,15,93,11,13,4
1285981,59,25,1954,7,female,1708,13,7,105,11,105,10,0,1
1024727,14,24,1999,12,male,150,14,7,114,3,44,0,70,3
1446471,47,16,1966,6,male,206,14,11,116,45,116,39,0,6
1828862,43,20,1970,3,female,108,14,8,124,3,124,3,0,0
2019196,38,24,1975,10,male,174,14,2,122,26,122,10,0,16
1539152,51,20,1962,8,male,148,14,10,126,0,0,0,126,0
1044466,60,15,1953,11,female,753,13,7,128,8,0,6,128,2
1900035,70,7,1943,7,male,92,14,8,129,12,0,9,129,3
1482640,25,20,1988,11,female,167,14,11,127,73,49,51,78,22
1672878,19,8,1994,6,female,250,13,2,125,78,39,55,86,23
2125387,36,23,1977,1,male,1476,14,10,126,23,122,3,4,20
1130103,62,21,1951,3,male,420,14,8,136,42,0,35,136,7
1718692,22,14,1991,10,male,189,13,1,135,22,129,17,6,5
1704587,17,12,1996,11,female,435,13,7,140,15,23,2,117,13
1661843,18,22,1995,2,male,321,14,8,148,28,1,8,147,20
1937808,28,14,1985,10,female,280,14,6,149,135,0,2,149,133
1942393,40,24,1973,11,female,187,13,9,146,48,146,39,0,9
1730006,27,27,1986,1,male,158,14,9,156,32,44,11,112,21
2118835,23,2,1990,2,male,42,13,12,157,11,157,10,0,1
2028979,33,3,1980,11,female,508,13,7,162,18,0,2,162,16
1768467,35,21,1978,10,male,39,13,12,158,17,157,6,1,11
1975372,55,28,1958,10,female,50,13,7,163,88,163,74,0,14
1242850,66,27,1947,3,female,75,13,7,170,61,0,50,170,11
1106337,46,9,1967,12,female,22,13,11,166,137,117,32,49,105
1295645,18,4,1995,5,male,311,14,14,181,8,59,0,122,8
1779042,52,30,1961,6,male,60,14,9,186,56,114,45,72,11
1230511,18,22,1995,8,female,91,14,12,187,110,178,43,9,67
1077493,17,8,1996,5,male,309,13,10,196,57,181,35,15,22
1366451,21,13,1992,6,male,66,13,13,221,245,66,136,155,109
2142650,29,1,1984,1,female,182,13,11,220,1,220,1,0,0
1469376,58,18,1955,3,male,197,13,10,225,0,0,0,225,0
1553748,53,5,1960,3,female,310,14,7,228,8,118,2,110,6
1223480,19,13,1994,5,female,698,13,11,231,143,228,44,3,99
1710625,28,12,1985,12,female,204,13,12,229,21,229,17,0,4
2118228,26,16,1987,3,female,602,14,11,225,75,225,75,0,0
1648142,44,17,1969,8,female,271,14,13,251,26,251,14,0,12
1202421,24,19,1989,8,female,117,14,8,269,61,38,12,231,49
1422103,57,22,1956,12,female,96,14,11,284,11,0,6,284,5
1654984,21,19,1992,11,female,225,14,11,288,117,55,11,233,106
1480096,28,11,1985,5,female,54,14,13,320,150,148,65,172,85
1596982,21,17,1992,8,male,405,14,11,320,51,296,32,24,19
1092269,33,3,1980,4,female,286,13,11,316,8,316,3,0,5
2153812,53,4,1960,3,male,118,13,12,323,24,323,16,0,8
1127722,68,26,1945,10,female,318,14,10,342,36,2,3,340,33
1986492,39,15,1974,2,female,528,14,7,351,308,178,204,173,104
1064215,21,1,1992,1,female,231,14,8,374,0,374,0,0,0
1666588,19,10,1994,3,male,336,14,12,434,113,434,99,0,14
1037189,23,6,1990,2,female,126,13,9,438,143,438,44,0,99
1272380,13,2,2000,2,male,208,14,11,474,10,35,9,439,1
1005487,58,19,1955,12,male,323,13,11,462,8,0,3,462,5
1124346,68,11,1945,9,male,130,14,4,565,7,552,5,13,2
1030910,35,28,1978,4,male,42,14,8,609,10,609,4,0,6
2129046,20,30,1993,9,female,269,13,4,589,551,589,274,0,277
2032923,71,15,1942,9,female,964,13,9,679,13,0,8,679,5
1033330,20,20,1993,5,female,116,14,6,754,440,753,372,1,68
1948781,26,3,1987,6,male,271,14,5,893,683,889,406,4,277
1361952,42,29,1971,9,female,160,14,2,1352,130,514,68,838,62
1455216,25,9,1988,7,female,336,14,6,1372,26,1372,23,0,3
1031045,42,18,1971,3,male,253,14,13,1392,107,1392,43,0,64
2075157,26,12,1987,7,female,109,14,6,1914,2669,1914,1225,0,1444
1076343,23,3,1990,2,male,1100,14,8,3743,123,2673,48,1070,75
1524985,24,20,1989,10,male,216,15,9,3,3,3,2,0,1
1146663,25,1,1988,1,male,27,15,10,3,2,3,2,0,0
1094069,27,11,1986,2,male,452,15,5,3,2,3,2,0,0
2096990,37,29,1976,5,male,152,15,12,3,2,3,2,0,0
2055931,59,9,1954,2,female,411,15,8,3,3,3,3,0,0
1982087,60,28,1953,5,male,302,15,13,3,2,3,2,0,0
2047657,30,25,1983,12,male,397,15,8,3,10,3,10,0,0
1846037,33,20,1980,4,male,246,15,4,3,18,3,8,0,10
2069326,41,7,1972,2,male,565,15,5,3,27,3,15,0,12
1532340,57,21,1956,5,male,132,15,6,3,8,3,8,0,0
1705398,68,11,1945,12,male,188,15,9,3,5,3,3,0,2
1030028,17,24,1996,6,female,403,15,11,4,0,0,0,4,0
1730906,51,6,1962,2,male,1059,15,4,4,0,0,0,4,0
1974330,56,19,1957,12,male,1036,15,3,4,0,0,0,4,0
1265864,30,28,1983,6,female,564,15,7,4,1,0,1,4,0
1561954,34,18,1979,11,male,358,15,13,4,1,0,1,4,0
1988846,45,18,1968,12,male,411,15,6,4,2,0,1,4,1
1359676,85,9,1928,2,female,743,15,12,4,1,0,0,4,1
1574616,72,19,1941,12,female,924,15,13,4,3,0,0,4,3
1526474,15,8,1998,1,male,648,15,11,4,0,1,0,3,0
1188520,45,7,1968,3,male,1518,15,8,4,3,1,2,3,1
1512783,45,9,1968,10,female,2029,15,13,4,3,2,1,2,2
1810841,20,8,1993,1,male,25,15,8,4,0,4,0,0,0
1607276,24,12,1989,4,male,5,15,15,4,0,4,0,0,0
2128455,34,15,1979,5,male,91,15,9,4,0,4,0,0,0
1165014,41,4,1972,12,male,308,15,10,4,0,4,0,0,0
2056880,51,28,1962,9,male,493,15,7,4,0,4,0,0,0
1244009,61,4,1952,6,male,360,15,8,4,0,4,0,0,0
1460908,14,21,1999,11,male,300,15,13,4,2,4,0,0,2
1498303,15,8,1998,12,male,153,15,12,4,2,4,1,0,1
1630511,19,1,1994,8,male,395,15,8,4,2,4,2,0,0
1006632,20,14,1993,5,male,28,15,12,4,1,4,1,0,0
1328052,28,2,1985,9,male,86,15,14,4,1,4,0,0,1
1894118,52,2,1961,4,male,656,15,4,4,1,4,0,0,1
1070182,58,25,1955,8,male,1438,15,8,4,2,4,2,0,0
1585395,18,11,1995,4,male,37,15,7,4,3,4,3,0,0
1624704,29,4,1984,2,male,55,15,13,4,3,4,3,0,0
2189574,31,22,1982,9,female,172,15,10,4,3,4,3,0,0
2150967,46,14,1967,4,female,658,15,5,4,3,4,3,0,0
1815904,57,27,1956,11,male,188,15,8,4,3,4,3,0,0
1171785,24,4,1989,4,female,18,15,15,4,10,4,8,0,2
1461813,33,3,1980,7,female,471,15,4,4,8,4,6,0,2
1042517,19,19,1994,10,male,197,15,11,5,1,0,1,5,0
2020346,22,30,1991,9,male,378,15,10,5,1,0,0,5,1
1345176,37,1,1976,5,female,229,15,12,5,13,0,0,5,13
1795947,30,3,1983,5,female,65,15,13,5,3,4,2,1,1
1544498,64,6,1949,5,male,20,15,9,5,4,4,4,1,0
2092023,14,1,1999,1,female,99,15,10,5,0,5,0,0,0
1263951,21,10,1992,3,male,43,15,13,5,0,5,0,0,0
1398816,15,28,1998,4,male,336,15,8,5,2,5,0,0,2
1331194,51,12,1962,4,male,188,15,12,5,3,5,3,0,0
2100381,62,30,1951,6,male,173,15,2,5,1,5,1,0,0
1256759,25,1,1988,1,male,264,15,11,5,5,5,5,0,0
1876211,15,24,1998,1,female,12,15,14,5,23,5,23,0,0
1352690,25,5,1988,6,male,39,15,11,5,8,5,7,0,1
1487844,42,20,1971,5,female,238,15,4,5,26,5,5,0,21
1475655,33,12,1980,9,male,550,15,15,6,3,0,1,6,2
1274794,51,6,1962,6,female,487,15,5,6,2,0,0,6,2
1779189,67,12,1946,4,female,204,15,12,6,3,0,2,6,1
1321296,53,12,1960,4,female,169,15,15,6,4,0,0,6,4
1344119,90,3,1923,2,female,811,15,6,6,14,0,1,6,13
1585740,52,20,1961,9,female,776,15,2,6,6,2,3,4,3
1602490,51,4,1962,10,male,4,15,13,6,0,6,0,0,0
2010734,32,29,1981,3,male,7,15,14,6,3,6,3,0,0
1349612,33,25,1980,10,male,62,15,12,6,1,6,0,0,1
2147056,47,4,1966,2,male,431,15,4,6,2,6,2,0,0
2092047,100,9,1913,11,female,242,15,13,6,3,6,3,0,0
1432158,21,2,1992,8,female,412,15,5,6,4,6,3,0,1
1422697,40,13,1973,4,male,223,15,3,6,4,6,4,0,0
1649434,54,10,1959,2,male,289,15,8,6,6,6,6,0,0
1630015,24,17,1989,11,male,1436,15,9,6,10,6,9,0,1
1466897,79,29,1934,12,male,20,15,14,6,11,6,5,0,6
1616431,24,1,1989,1,female,125,15,6,7,0,3,0,4,0
1098095,55,3,1958,10,male,399,15,11,7,0,5,0,2,0
1400052,58,13,1955,2,male,99,15,11,7,0,5,0,2,0
1209819,61,4,1952,1,female,613,15,9,7,1,5,1,2,0
1256164,18,27,1995,2,male,149,15,8,7,0,7,0,0,0
2165434,25,3,1988,9,male,159,15,15,7,1,7,1,0,0
1525350,27,2,1986,2,female,742,15,11,7,0,7,0,0,0
1749658,15,10,1998,5,male,145,15,12,7,4,7,4,0,0
2159202,49,19,1964,11,male,220,15,13,7,2,7,2,0,0
1273630,70,4,1943,8,male,1182,15,10,7,3,7,0,0,3
1162759,34,26,1979,2,female,126,15,7,7,5,7,3,0,2
1613116,19,1,1994,1,female,236,15,10,7,17,7,14,0,3
1966506,42,20,1971,1,female,834,15,8,8,0,0,0,8,0
1199335,83,1,1930,2,male,405,15,4,8,1,0,0,8,1
1636561,63,5,1950,12,male,492,15,11,8,3,0,1,8,2
1611015,55,26,1958,10,male,99,15,9,8,5,0,5,8,0
1625935,57,1,1956,6,male,624,15,10,8,7,0,1,8,6
1052705,54,14,1959,1,female,1073,15,6,8,2,6,1,2,1
1462704,21,8,1992,11,female,88,15,13,8,0,8,0,0,0
1829132,55,10,1958,3,female,349,15,5,8,1,8,1,0,0
1099614,18,1,1995,1,male,31,15,10,8,6,8,5,0,1
2020053,59,11,1954,5,female,209,15,9,8,21,8,8,0,13
1816010,61,22,1952,4,male,1700,15,14,9,1,0,1,9,0
2112756,27,10,1986,6,male,592,15,6,9,4,2,4,7,0
2180626,31,1,1982,1,male,345,15,9,9,0,9,0,0,0
1309391,50,14,1963,6,female,107,15,15,9,1,9,1,0,0
1195116,23,2,1990,3,male,101,15,14,9,2,9,2,0,0
1655737,23,20,1990,8,male,428,15,11,9,4,9,4,0,0
1540073,39,1,1974,1,male,383,15,12,9,3,9,3,0,0
1289343,100,6,1913,4,female,788,15,9,9,14,9,10,0,4
1892713,44,12,1969,5,female,283,15,10,10,3,10,2,0,1
1106500,45,24,1968,5,male,349,15,14,10,5,10,2,0,3
1468074,51,12,1962,2,female,56,15,10,10,4,10,4,0,0
2053749,61,24,1952,6,female,136,15,14,10,2,10,1,0,1
1419321,67,7,1946,5,male,20,15,14,10,9,10,8,0,1
1582261,20,6,1993,9,female,22,15,6,10,16,10,15,0,1
1497874,35,17,1978,1,male,209,15,15,11,0,0,0,11,0
2029460,22,21,1991,2,female,281,15,6,11,5,0,1,11,4
1446835,62,9,1951,10,female,1606,15,4,11,7,0,2,11,5
1844653,23,22,1990,5,male,21,15,13,11,1,11,1,0,0
1807946,39,1,1974,1,female,381,15,13,11,1,11,1,0,0
1448571,54,24,1959,7,female,202,15,11,11,0,11,0,0,0
1699869,76,16,1937,1,male,146,15,12,11,1,11,1,0,0
2074021,18,1,1995,1,male,45,15,15,11,5,11,4,0,1
1926675,20,8,1993,10,male,67,15,2,11,10,11,6,0,4
1475054,36,24,1977,4,male,116,15,13,12,0,0,0,12,0
1514551,26,1,1987,1,male,210,15,14,12,7,9,3,3,4
1527979,27,12,1986,11,male,528,15,10,12,1,12,1,0,0
1842952,36,21,1977,10,male,603,15,5,12,1,12,1,0,0
2031109,29,18,1984,5,male,258,15,11,12,9,12,5,0,4
1823285,45,5,1968,12,male,190,15,11,12,9,12,9,0,0
1836593,43,20,1970,1,female,573,15,11,13,9,1,1,12,8
1846890,40,12,1973,3,male,879,15,13,13,2,13,2,0,0
2030369,42,1,1971,3,female,244,15,11,13,2,13,1,0,1
1223652,15,20,1998,11,male,56,15,11,13,8,13,3,0,5
1311349,34,3,1979,8,female,66,15,13,13,8,13,6,0,2
2108659,59,27,1954,6,female,102,15,11,13,14,13,11,0,3
1817153,60,9,1953,3,female,73,15,10,13,22,13,11,0,11
2047347,73,9,1940,10,female,344,15,15,14,9,0,4,14,5
2138458,20,10,1993,4,female,617,15,10,14,0,14,0,0,0
1058850,47,30,1966,7,male,563,15,13,14,2,14,1,0,1
1496632,13,1,2000,1,male,265,15,9,14,9,14,4,0,5
1535528,25,12,1988,12,female,5,15,15,14,20,14,19,0,1
1474619,19,1,1994,6,female,261,15,4,14,75,14,29,0,46
1261004,32,17,1981,7,male,261,15,9,14,70,14,69,0,1
1348393,47,24,1966,3,female,63,15,9,14,21,14,15,0,6
1788158,50,18,1963,10,male,985,15,5,14,36,14,5,0,31
1923643,51,22,1962,12,male,317,15,11,15,11,3,8,12,3
1818563,35,27,1978,5,male,35,15,10,15,5,15,5,0,0
1405861,43,21,1970,7,male,47,15,14,15,3,15,3,0,0
1462702,17,18,1996,8,female,214,15,10,16,0,0,0,16,0
1309104,61,25,1952,3,female,462,15,6,16,22,0,14,16,8
1409625,25,7,1988,6,male,381,15,15,16,0,16,0,0,0
1062965,68,31,1945,8,female,86,15,12,16,2,16,0,0,2
1158441,63,1,1950,12,male,342,15,14,16,4,16,4,0,0
1346371,69,3,1944,3,female,1381,15,4,17,2,0,1,17,1
1791626,18,14,1995,11,male,511,15,7,17,2,17,2,0,0
1472440,27,23,1986,11,male,302,15,9,17,0,17,0,0,0
1910703,27,11,1986,9,female,106,15,5,17,40,17,11,0,29
1513016,20,29,1993,11,male,116,15,10,18,1,18,1,0,0
1444951,33,29,1980,9,male,408,15,8,18,4,18,4,0,0
1583716,44,1,1969,3,male,426,15,9,18,10,18,10,0,0
1243670,24,23,1989,3,female,459,15,8,18,11,18,7,0,4
2124207,42,31,1971,7,female,383,15,3,19,0,2,0,17,0
1244863,43,18,1970,5,male,174,15,10,19,5,18,4,1,1
1337871,30,1,1983,5,female,25,15,12,19,37,19,35,0,2
1387402,22,16,1991,6,male,517,15,9,20,26,4,3,16,23
1241934,15,22,1998,9,male,40,15,12,20,14,20,14,0,0
2103744,39,12,1974,11,male,394,15,13,20,14,20,6,0,8
1949347,71,3,1942,5,female,1470,15,9,21,3,0,2,21,1
1017250,50,21,1963,2,male,114,15,10,21,1,17,0,4,1
2156718,39,24,1974,9,female,282,15,7,22,3,0,1,22,2
1108702,67,28,1946,4,female,851,15,1,22,1,0,1,22,0
2187500,35,28,1978,11,female,621,15,9,22,6,0,0,22,6
1354409,50,20,1963,2,female,211,15,10,22,5,1,3,21,2
1964601,45,11,1968,4,male,301,15,15,22,8,22,3,0,5
1155057,25,21,1988,9,female,15,15,7,22,20,22,20,0,0
1937634,40,25,1973,12,female,197,15,8,22,23,22,19,0,4
2066659,22,4,1991,4,female,493,15,12,23,26,0,13,23,13
1784047,24,26,1989,1,male,252,15,10,23,24,13,4,10,20
1231409,62,18,1951,7,male,263,15,11,23,1,23,0,0,1
2074462,26,1,1987,1,male,417,15,8,24,1,0,0,24,1
1220163,24,31,1989,1,female,16,15,12,24,22,16,2,8,20
2112741,39,20,1974,5,male,476,15,5,25,0,22,0,3,0
1458021,22,5,1991,2,male,366,15,13,25,0,25,0,0,0
1967270,30,15,1983,8,male,404,15,13,26,3,0,2,26,1
1375998,19,24,1994,5,male,46,15,9,26,11,26,11,0,0
1069706,40,13,1973,6,female,596,15,8,26,29,26,11,0,18
1914364,61,1,1952,11,female,96,15,8,27,8,3,3,24,5
1769809,18,10,1995,9,female,41,15,9,27,3,27,3,0,0
1430802,23,20,1990,4,female,523,15,10,27,1,27,0,0,1
1737519,18,28,1995,9,male,18,15,12,28,8,28,6,0,2
1031093,29,1,1984,1,male,278,15,7,28,6,28,5,0,1
1800046,28,1,1985,1,male,506,15,8,29,0,2,0,27,0
1721084,28,18,1985,9,male,389,15,6,29,43,27,23,2,20
2038634,33,29,1980,6,female,777,15,11,29,3,29,3,0,0
1853274,42,13,1971,10,male,317,15,9,29,19,29,16,0,3
1046574,33,7,1980,3,male,9,15,12,31,15,25,13,6,2
1940798,52,12,1961,5,female,514,15,7,31,6,31,1,0,5
1950769,27,15,1986,4,male,71,15,15,31,47,31,45,0,2
1721885,42,8,1971,4,female,523,15,8,32,4,27,3,5,1
1275782,20,16,1993,10,female,209,15,13,32,24,30,7,2,17
1042257,34,16,1979,5,female,80,15,14,32,5,32,0,0,5
1899569,37,20,1976,6,male,1912,15,10,32,4,32,4,0,0
1433316,35,4,1978,5,male,1346,15,10,36,4,7,4,29,0
1881500,15,14,1998,1,male,357,15,9,36,6,0,0,36,6
1050640,43,13,1970,4,male,306,15,10,36,8,0,2,36,6
2141654,38,8,1975,3,male,1478,15,4,37,9,33,4,4,5
1544315,20,2,1993,9,female,249,15,13,37,33,37,18,0,15
1422305,82,21,1931,5,male,142,15,10,38,0,0,0,38,0
1071719,22,16,1991,5,male,108,15,3,39,22,0,4,39,18
1586615,33,13,1980,5,male,392,15,15,39,5,39,3,0,2
1394771,25,13,1988,1,female,196,15,7,39,16,39,10,0,6
2023269,46,12,1967,7,female,241,15,11,38,48,38,36,0,12
1913439,36,25,1977,12,male,619,15,11,40,11,5,9,35,2
2145253,74,7,1939,5,male,867,15,11,40,27,0,10,40,17
1889837,44,23,1969,4,female,130,15,10,40,9,40,2,0,7
2026878,22,8,1991,12,female,84,15,10,42,29,28,11,14,18
1218562,15,7,1998,10,female,49,15,10,42,1,42,1,0,0
1608552,28,16,1985,8,male,14,15,14,41,0,41,0,0,0
1644220,19,1,1994,1,male,31,15,7,42,18,42,12,0,6
1276639,29,1,1984,1,male,403,15,8,44,21,0,8,44,13
1752319,53,27,1960,7,male,280,15,10,43,19,0,17,43,2
1636674,51,20,1962,3,female,193,15,8,43,28,0,3,43,25
1396028,27,6,1986,4,male,30,15,10,43,3,42,3,1,0
1184242,27,15,1986,5,female,78,15,9,44,3,44,3,0,0
2102999,76,17,1937,1,female,285,15,8,44,4,44,1,0,3
1483208,35,19,1978,12,male,145,15,4,43,15,43,15,0,0
1457358,41,3,1972,12,male,103,15,13,44,32,44,31,0,1
1856030,22,18,1991,8,female,178,15,13,45,13,45,9,0,4
1966594,18,20,1995,12,female,231,15,4,51,8,51,8,0,0
1520625,27,4,1986,12,male,69,15,10,53,16,2,0,51,16
2119082,44,24,1969,2,male,124,15,14,53,0,53,0,0,0
1660829,36,17,1977,10,male,52,15,13,55,28,39,26,16,2
1416271,30,1,1983,10,female,71,15,12,54,38,54,10,0,28
2111825,18,18,1995,7,male,12,15,12,56,0,54,0,2,0
1100956,31,14,1982,7,male,21,15,14,58,1,58,1,0,0
1468065,22,20,1991,3,male,42,15,11,56,16,56,7,0,9
1973247,47,14,1966,9,male,56,15,10,57,10,57,10,0,0
1753789,19,1,1994,2,male,51,15,12,62,77,42,56,20,21
1543215,23,11,1990,7,female,492,15,6,63,27,58,16,5,11
1941752,30,24,1983,3,female,37,15,11,65,71,65,64,0,7
1224258,54,3,1959,1,female,111,15,10,65,49,65,33,0,16
1056906,37,23,1976,2,female,410,15,2,68,28,68,23,0,5
1522121,24,6,1989,11,female,188,15,9,73,69,72,40,1,29
1297241,55,13,1958,5,male,244,15,11,77,0,0,0,77,0
1305774,33,19,1980,10,male,350,15,12,77,62,0,0,77,62
1210405,21,2,1992,12,female,1091,15,8,76,25,19,4,57,21
1601590,28,20,1985,6,male,65,15,10,75,4,75,4,0,0
1288518,50,16,1963,2,female,127,15,15,75,11,75,6,0,5
1495956,45,11,1968,12,male,482,15,12,79,67,3,26,76,41
1807429,68,6,1945,6,female,377,15,9,79,109,0,5,79,104
1214617,38,14,1975,8,female,327,15,9,80,17,80,15,0,2
1338304,61,9,1952,2,female,616,15,6,84,41,0,10,84,31
1364308,55,1,1958,1,female,814,15,12,95,8,0,1,95,7
1219107,27,9,1986,9,female,100,15,11,93,15,85,11,8,4
1242969,38,10,1975,1,female,380,15,7,95,70,83,38,12,32
1936081,29,1,1984,1,male,15,15,13,97,3,97,2,0,1
1007250,19,3,1994,6,female,6,15,12,100,2,0,1,100,1
2006697,30,18,1983,4,male,430,15,13,102,4,0,0,102,4
2167748,59,23,1954,3,male,1014,15,3,102,6,0,4,102,2
2039434,18,21,1995,2,female,233,15,11,104,6,68,4,36,2
1772916,61,27,1952,1,female,369,15,10,100,25,100,22,0,3
1334019,16,17,1997,6,male,67,15,12,106,42,6,14,100,28
1284546,33,8,1980,6,male,370,15,15,109,28,109,28,0,0
1196846,46,12,1967,4,male,595,15,9,112,16,89,12,23,4
1589417,53,1,1960,1,male,110,15,8,110,41,110,32,0,9
2121048,41,13,1972,2,female,531,15,12,120,18,120,17,0,1
1260628,47,27,1966,5,male,60,15,13,122,183,122,79,0,104
1217009,34,12,1979,5,female,23,15,15,130,71,0,44,130,27
1260276,24,2,1989,7,female,589,15,10,134,61,134,53,0,8
1294635,80,28,1933,9,female,532,15,8,150,5,0,1,150,4
1188861,54,31,1959,8,female,98,15,2,145,12,145,6,0,6
1306691,50,16,1963,9,female,1357,15,9,144,184,144,27,0,157
1967408,43,1,1970,10,female,553,15,11,154,24,3,16,151,8
1727676,54,28,1959,5,female,1156,15,6,151,25,0,4,151,21
2119300,41,16,1972,8,male,55,15,11,152,108,152,105,0,3
1786558,50,16,1963,11,female,9,15,14,176,69,176,66,0,3
2014430,33,21,1980,5,female,153,15,14,175,163,175,152,0,11
1146226,32,15,1981,3,female,361,15,10,199,90,104,33,95,57
1545133,23,15,1990,3,female,312,15,12,203,7,203,3,0,4
1930132,51,16,1962,12,male,708,15,15,241,2,241,0,0,2
2084689,104,25,1909,10,male,1621,15,10,255,9,139,5,116,4
2067095,58,11,1955,4,female,47,15,15,250,2,250,2,0,0
1620039,25,21,1988,12,female,257,15,10,283,12,283,11,0,1
1471395,31,8,1982,2,male,172,15,14,319,0,319,0,0,0
1160981,37,9,1976,2,female,365,15,5,311,143,311,112,0,31
1238261,34,29,1979,6,female,57,15,6,675,79,674,36,1,43
1009555,41,15,1972,11,male,604,15,13,879,380,879,380,0,0
1483880,26,1,1987,1,male,165,15,6,1867,9,1867,8,0,1
2053177,37,5,1976,4,female,441,15,8,3044,225,3043,155,1,70
1154122,16,13,1997,10,female,345,16,9,1,2,1,1,0,1
1900106,20,17,1993,8,male,78,17,11,1,4,1,2,0,2
2079351,22,12,1991,12,female,140,16,15,1,3,1,3,0,0
1466714,23,14,1990,2,male,173,17,11,1,6,1,2,0,4
2121718,25,1,1988,1,female,26,17,16,1,6,1,3,0,3
2029387,25,29,1988,2,male,112,16,6,1,3,1,2,0,1
1288504,25,9,1988,10,male,14,17,17,1,8,1,3,0,5
2075408,26,1,1987,1,female,151,17,17,1,2,1,1,0,1
2090108,26,19,1987,3,male,373,17,13,1,7,1,3,0,4
1095521,26,6,1987,7,male,67,17,11,1,4,1,2,0,2
2005852,28,20,1985,12,male,185,16,9,1,4,1,4,0,0
1125642,28,1,1985,3,male,322,17,15,1,10,1,7,0,3
1654069,28,12,1985,6,male,170,17,16,1,4,1,3,0,1
1072891,30,24,1983,11,female,4,16,12,1,7,1,3,0,4
1344210,30,9,1983,1,male,1901,17,6,1,2,1,1,0,1
1500856,39,10,1974,12,female,642,17,4,1,4,1,2,0,2
2053494,39,16,1974,2,male,436,16,12,1,9,1,9,0,0
1667862,41,3,1972,6,male,419,17,7,1,2,1,2,0,0
1538791,42,5,1971,10,male,18,17,10,1,3,1,0,0,3
1701444,44,8,1969,12,male,73,16,14,1,3,1,2,0,1
2101778,44,6,1969,7,female,762,17,8,1,4,1,3,0,1
1408281,44,27,1969,9,male,728,17,10,1,5,1,2,0,3
1782283,53,20,1960,5,male,976,17,10,1,2,1,2,0,0
1199021,53,22,1960,9,female,41,17,17,1,3,1,2,0,1
1957873,56,2,1957,10,female,537,16,8,1,2,1,1,0,1
1839823,63,11,1950,10,male,232,17,15,1,8,1,3,0,5
2110262,74,5,1939,5,male,684,16,13,1,4,1,4,0,0
2088815,14,28,1999,5,male,293,16,12,2,0,0,0,2,0
1105337,15,13,1998,5,male,254,16,8,2,0,0,0,2,0
2146922,22,7,1991,5,male,62,17,15,2,0,0,0,2,0
1945299,26,16,1987,12,male,284,17,10,2,0,0,0,2,0
1072603,29,10,1984,2,male,466,17,11,2,0,0,0,2,0
1463527,54,6,1959,4,female,283,16,14,2,0,0,0,2,0
1572840,24,1,1989,1,male,245,17,15,2,1,0,0,2,1
2059974,27,7,1986,2,male,448,16,10,2,1,0,0,2,1
1293596,30,18,1983,8,male,544,16,9,2,1,0,0,2,1
1229257,54,18,1959,11,male,81,16,13,2,1,0,0,2,1
1482353,65,27,1948,6,male,535,16,9,2,1,0,0,2,1
1261075,100,12,1913,10,male,1811,16,8,2,1,0,1,2,0
2185283,19,14,1994,3,male,605,16,7,2,2,0,1,2,1
1600806,46,13,1967,10,male,421,17,12,2,2,0,0,2,2
1406184,53,25,1960,11,male,496,16,12,2,2,0,0,2,2
1974927,57,4,1956,5,male,976,17,4,2,2,0,1,2,1
2034827,67,15,1946,8,NA,2416,16,5,2,2,0,0,2,2
1057421,13,1,2000,1,male,105,16,16,2,3,0,2,2,1
1310205,15,3,1998,4,male,26,16,16,2,3,0,2,2,1
1466284,23,23,1990,1,male,377,17,16,2,3,0,0,2,3
1796567,47,12,1966,6,male,509,17,12,2,3,0,3,2,0
1831174,48,25,1965,2,female,382,16,5,2,3,0,0,2,3
1466236,48,26,1965,4,male,183,16,14,2,3,0,1,2,2
1691142,50,31,1963,5,female,1279,17,8,2,3,0,3,2,0
2140396,56,27,1957,11,female,384,16,7,2,10,0,2,2,8
1720687,55,7,1958,4,male,374,17,4,2,5,0,5,2,0
1551099,55,5,1958,9,male,1017,16,4,2,6,0,2,2,4
1254663,56,24,1957,7,male,1926,17,4,2,3,0,0,2,3
1646184,60,15,1953,7,male,983,16,13,2,12,0,3,2,9
1557219,69,14,1944,8,male,912,16,10,2,3,0,2,2,1
1145709,81,21,1932,10,male,1673,17,10,2,4,0,4,2,0
1532504,86,17,1927,5,female,1046,16,13,2,18,0,16,2,2
1999249,22,8,1991,2,male,392,17,10,2,0,1,0,1,0
1513708,51,22,1962,8,male,436,17,16,2,0,1,0,1,0
2050125,59,24,1954,2,female,1313,16,6,2,0,1,0,1,0
1699157,32,14,1981,9,male,1540,16,14,2,3,1,2,1,1
1763665,39,15,1974,5,female,184,16,3,2,10,1,10,1,0
1331003,55,3,1958,10,male,1096,16,7,2,7,1,7,1,0
1023463,59,4,1954,8,male,635,17,1,2,17,1,7,1,10
1686811,67,4,1946,10,male,1434,16,8,2,16,1,4,1,12
1853078,14,18,1999,5,male,227,16,14,2,0,2,0,0,0
1054860,17,17,1996,6,male,119,16,4,2,0,2,0,0,0
2077566,18,31,1995,10,female,259,16,6,2,0,2,0,0,0
1499428,19,24,1994,6,female,267,16,9,2,0,2,0,0,0
1149982,23,2,1990,2,male,575,17,8,2,0,2,0,0,0
1819514,23,1,1990,7,female,362,17,8,2,0,2,0,0,0
1883570,25,25,1988,5,female,848,16,14,2,0,2,0,0,0
1689205,25,1,1988,10,male,218,16,15,2,0,2,0,0,0
1965814,28,5,1985,5,male,186,16,14,2,0,2,0,0,0
1187816,29,27,1984,3,male,398,16,10,2,0,2,0,0,0
1145317,29,7,1984,9,male,240,16,3,2,0,2,0,0,0
1489367,32,19,1981,6,male,1359,16,6,2,0,2,0,0,0
1502978,33,30,1980,6,male,1173,17,15,2,0,2,0,0,0
2060133,33,28,1980,10,male,91,17,4,2,0,2,0,0,0
1688670,40,28,1973,5,female,292,17,9,2,0,2,0,0,0
1979939,43,14,1970,1,male,932,17,11,2,0,2,0,0,0
2141993,45,30,1968,8,male,150,16,11,2,0,2,0,0,0
1348443,52,22,1961,6,female,420,17,11,2,0,2,0,0,0
1183854,53,28,1960,10,male,997,16,5,2,0,2,0,0,0
1063398,64,11,1949,2,male,1668,17,4,2,0,2,0,0,0
1367547,67,15,1946,6,female,486,16,10,2,0,2,0,0,0
1396671,71,25,1942,12,male,499,16,12,2,0,2,0,0,0
1010113,74,1,1939,1,female,42,16,14,2,0,2,0,0,0
1647400,14,29,1999,7,female,266,17,14,2,1,2,0,0,1
1364216,15,20,1998,6,female,285,16,1,2,1,2,0,0,1
1040285,18,12,1995,10,male,417,16,11,2,1,2,1,0,0
2151612,19,15,1994,8,male,20,16,9,2,1,2,1,0,0
1623468,21,25,1992,4,male,54,17,15,2,1,2,1,0,0
2099144,21,28,1992,10,female,197,17,13,2,1,2,1,0,0
1301926,27,19,1986,11,female,165,17,1,2,1,2,1,0,0
1751302,28,24,1985,7,male,64,16,16,2,1,2,1,0,0
1095998,31,10,1982,1,male,1428,16,9,2,1,2,0,0,1
1153779,31,29,1982,10,male,61,17,16,2,1,2,0,0,1
1741988,33,11,1980,11,male,219,16,11,2,1,2,1,0,0
1583642,32,4,1981,6,male,346,16,11,2,1,2,1,0,0
1715592,33,4,1980,9,male,674,16,4,2,1,2,1,0,0
1843845,36,12,1977,4,male,427,17,15,2,1,2,0,0,1
1358729,39,22,1974,8,male,61,17,12,2,1,2,1,0,0
2044875,45,23,1968,10,female,546,16,7,2,1,2,1,0,0
1796741,56,2,1957,10,male,421,17,12,2,1,2,0,0,1
1701081,65,23,1948,5,male,339,16,13,2,1,2,1,0,0
1899459,28,16,1985,7,female,446,16,7,2,2,2,2,0,0
1426254,40,12,1973,4,female,38,16,13,2,2,2,0,0,2
1928231,17,8,1996,8,male,251,17,13,2,49,2,11,0,38
1966146,25,1,1988,1,male,231,16,10,2,4,2,3,0,1
2183251,27,9,1986,12,male,151,17,3,2,10,2,10,0,0
1314218,28,8,1985,5,male,30,16,8,2,3,2,3,0,0
1117112,32,9,1981,12,male,258,17,10,2,9,2,9,0,0
2067439,31,8,1982,4,male,111,17,9,2,6,2,3,0,3
2178259,31,21,1982,6,male,215,17,10,2,30,2,23,0,7
1413514,35,28,1978,6,female,483,16,6,2,3,2,1,0,2
2170121,37,15,1976,10,male,31,16,12,2,14,2,10,0,4
2063946,39,21,1974,12,male,97,16,10,2,6,2,5,0,1
1548733,40,1,1973,11,female,152,16,11,2,13,2,13,0,0
1798260,43,10,1970,6,female,1603,16,6,2,14,2,8,0,6
1225046,50,5,1963,4,male,689,16,3,2,22,2,13,0,9
2113379,52,1,1961,10,male,1036,16,9,2,16,2,12,0,4
1867314,53,5,1960,1,male,1418,16,5,2,5,2,0,0,5
1294462,60,30,1953,6,female,1000,17,9,2,20,2,18,0,2
1734042,62,28,1951,3,female,1331,17,7,2,4,2,2,0,2
1688784,78,28,1935,8,male,430,17,13,2,21,2,14,0,7
1412964,14,1,1999,7,male,154,16,12,3,0,0,0,3,0
1748149,20,17,1993,9,male,257,16,14,3,0,0,0,3,0
1526533,40,12,1973,9,male,624,17,15,3,0,0,0,3,0
1206447,60,1,1953,11,female,1082,16,6,3,0,0,0,3,0
1766115,46,17,1967,4,female,297,17,4,3,1,0,0,3,1
1757447,49,1,1964,9,female,572,16,10,3,1,0,0,3,1
1587294,33,3,1980,3,male,584,16,13,3,2,0,1,3,1
1086008,36,22,1977,2,male,637,17,8,3,3,0,0,3,3
1723143,57,8,1956,11,female,851,16,4,3,2,0,2,3,0
1563335,60,18,1953,12,male,14,16,14,3,2,0,2,3,0
1541729,59,13,1954,8,male,39,16,13,3,3,0,0,3,3
1490914,73,8,1940,2,female,1139,16,8,3,2,0,1,3,1
1764936,52,9,1961,7,female,244,16,10,3,15,0,8,3,7
1635076,66,26,1947,5,male,988,17,7,3,7,0,2,3,5
1643951,69,20,1944,8,male,247,16,11,3,11,0,9,3,2
1036742,16,10,1997,6,female,262,16,7,3,0,1,0,2,0
2110557,59,18,1954,8,male,322,17,12,3,1,2,1,1,0
2018102,16,29,1997,1,female,984,16,3,3,0,3,0,0,0
1816626,18,14,1995,11,female,466,16,12,3,0,3,0,0,0
1443429,17,30,1996,6,male,322,16,13,3,0,3,0,0,0
1619606,17,20,1996,10,female,222,17,6,3,0,3,0,0,0
2010697,18,22,1995,6,male,69,17,16,3,0,3,0,0,0
2036042,18,13,1995,8,male,408,17,11,3,0,3,0,0,0
1421259,20,10,1993,1,male,96,17,13,3,0,3,0,0,0
1346859,21,2,1992,6,male,162,17,15,3,0,3,0,0,0
1500829,47,5,1966,3,male,293,17,6,3,0,3,0,0,0
1397219,48,1,1965,6,female,214,16,14,3,0,3,0,0,0
2123359,51,16,1962,11,female,470,16,7,3,0,3,0,0,0
1110409,50,25,1963,3,male,285,16,7,3,0,3,0,0,0
1047746,57,13,1956,3,male,449,16,10,3,0,3,0,0,0
1669202,64,29,1949,4,male,100,17,5,3,0,3,0,0,0
1760730,108,30,1905,3,female,269,16,8,3,0,3,0,0,0
2000969,23,1,1990,1,male,28,17,16,3,1,3,1,0,0
1135566,25,15,1988,1,female,44,16,15,3,1,3,1,0,0
1662647,33,29,1980,12,female,138,16,11,3,1,3,0,0,1
1662829,33,9,1980,4,male,1053,17,9,3,1,3,1,0,0
1926652,38,3,1975,11,male,45,17,16,3,1,3,1,0,0
1018774,43,25,1970,11,male,184,17,3,3,1,3,1,0,0
1278254,20,1,1993,4,male,157,17,16,3,4,3,4,0,0
1012099,20,17,1993,10,female,453,17,6,3,4,3,3,0,1
1924462,25,13,1988,1,male,88,17,17,3,2,3,2,0,0
1124349,28,4,1985,1,male,101,17,13,3,3,3,1,0,2
1421060,37,18,1976,3,male,295,17,6,3,3,3,3,0,0
1682615,57,23,1956,9,male,992,17,12,3,2,3,1,0,1
1967035,13,29,2000,1,female,6,17,17,3,12,3,8,0,4
1504823,25,1,1988,1,male,140,17,16,3,17,3,9,0,8
1573073,26,1,1987,1,female,36,16,14,3,17,3,17,0,0
1538938,27,26,1986,9,male,49,17,13,3,12,3,8,0,4
1355143,30,10,1983,7,female,76,16,15,3,5,3,5,0,0
1240145,31,14,1982,5,female,20,16,9,3,5,3,3,0,2
1019502,43,22,1970,10,female,150,16,15,3,5,3,5,0,0
1753197,57,10,1956,5,female,19,16,10,3,22,3,10,0,12
1145506,62,18,1951,9,female,26,16,11,3,10,3,8,0,2
1126869,69,2,1944,9,male,25,17,15,3,86,3,32,0,54
1251693,98,21,1915,9,female,19,17,15,3,7,3,7,0,0
2123730,32,18,1981,3,male,532,17,17,4,0,0,0,4,0
1834533,36,4,1977,2,male,341,17,9,4,2,0,2,4,0
1698633,61,7,1952,11,female,407,16,11,4,1,0,1,4,0
1077794,61,15,1952,7,female,1060,16,7,4,2,0,2,4,0
1887846,68,8,1945,1,female,496,17,6,4,1,0,0,4,1
2184587,107,10,1906,10,male,874,17,8,4,1,0,0,4,1
1332661,78,16,1935,7,female,1175,16,11,4,5,0,0,4,5
1455580,46,3,1967,9,female,354,17,16,4,11,0,2,4,9
2003170,58,19,1955,5,female,166,16,13,4,7,0,3,4,4
1125031,59,25,1954,5,female,1089,17,3,4,22,0,11,4,11
1994245,71,27,1942,3,female,921,17,12,4,6,0,4,4,2
1667116,60,24,1953,6,female,879,16,5,4,0,1,0,3,0
1156253,63,12,1950,9,male,1810,16,7,4,1,1,0,3,1
1575536,25,28,1988,9,male,558,16,9,4,13,1,9,3,4
2168203,51,19,1962,4,male,255,16,14,4,3,3,3,1,0
1567055,31,10,1982,12,female,576,16,11,4,0,4,0,0,0
1697888,31,17,1982,3,male,637,17,8,4,0,4,0,0,0
1296423,31,24,1982,3,male,110,17,5,4,0,4,0,0,0
2023422,103,10,1910,12,male,558,16,9,4,0,4,0,0,0
2111398,15,4,1998,12,male,107,16,10,4,2,4,1,0,1
1378089,25,3,1988,1,male,295,16,11,4,1,4,1,0,0
1653679,25,1,1988,1,male,5,16,14,4,2,4,2,0,0
2046528,27,8,1986,4,male,141,17,13,4,1,4,0,0,1
1327517,28,26,1985,8,female,1025,16,3,4,1,4,0,0,1
1844279,29,2,1984,2,female,460,17,6,4,1,4,0,0,1
1769649,36,16,1977,1,male,91,16,15,4,1,4,1,0,0
1733524,42,17,1971,6,male,133,16,13,4,2,4,2,0,0
2161572,47,2,1966,7,female,320,17,13,4,1,4,1,0,0
2011952,52,1,1961,12,male,268,17,14,4,1,4,1,0,0
2129521,18,31,1995,1,male,215,17,6,4,4,4,3,0,1
1107195,21,28,1992,12,female,83,16,15,4,3,4,2,0,1
1455848,21,12,1992,12,male,15,17,12,4,3,4,1,0,2
1691622,23,12,1990,1,female,266,17,6,4,3,4,0,0,3
1683768,23,1,1990,1,male,369,16,11,4,4,4,4,0,0
1499015,26,1,1987,1,male,317,17,12,4,4,4,4,0,0
1052593,31,31,1982,8,male,36,17,16,4,3,4,3,0,0
1154945,50,16,1963,7,female,62,17,10,4,5,4,1,0,4
1806816,51,18,1962,7,male,638,16,12,4,4,4,4,0,0
1809537,67,23,1946,10,male,537,17,5,4,4,4,2,0,2
1346043,18,14,1995,8,male,89,16,14,4,7,4,5,0,2
1331658,21,31,1992,3,male,237,17,16,4,12,4,11,0,1
1006728,26,25,1987,1,female,22,17,13,4,6,4,3,0,3
1955338,29,17,1984,7,female,50,17,11,4,8,4,7,0,1
1064934,24,10,1989,4,male,18,17,5,5,0,0,0,5,0
1595619,15,11,1998,7,female,157,17,12,5,1,0,0,5,1
1439848,22,28,1991,3,female,54,17,9,5,3,0,3,5,0
1426701,25,11,1988,11,male,15,17,13,5,1,0,0,5,1
1698489,47,1,1966,7,male,144,16,10,5,5,0,4,5,1
1523247,57,22,1956,6,male,697,17,5,5,4,0,0,5,4
1387826,67,22,1946,10,male,115,17,6,5,4,0,0,5,4
2029654,60,9,1953,8,female,1273,17,7,5,9,0,5,5,4
1609651,63,6,1950,1,female,1131,17,5,5,13,0,5,5,8
1166084,72,11,1941,10,female,508,16,12,5,9,0,2,5,7
1912641,28,25,1985,12,male,432,17,7,5,1,3,0,2,1
1873274,36,11,1977,9,male,17,17,12,5,4,3,3,2,1
1881610,23,1,1990,1,male,476,16,8,5,1,4,0,1,1
1151686,15,19,1998,6,male,17,16,8,5,0,5,0,0,0
1672645,18,1,1995,12,male,46,16,13,5,0,5,0,0,0
1169917,20,11,1993,7,male,171,16,12,5,0,5,0,0,0
2019809,33,6,1980,3,male,308,16,14,5,0,5,0,0,0
1453795,37,24,1976,12,male,545,16,5,5,0,5,0,0,0
1779949,51,15,1962,2,male,739,17,9,5,0,5,0,0,0
1539090,14,22,1999,8,male,3,17,15,5,1,5,1,0,0
2134587,16,11,1997,9,male,445,17,12,5,3,5,3,0,0
1154465,17,1,1996,1,male,14,16,10,5,2,5,1,0,1
1903881,18,18,1995,5,male,102,17,16,5,1,5,1,0,0
1093883,18,26,1995,9,male,337,16,16,5,2,5,2,0,0
1666439,34,22,1979,8,male,584,16,14,5,3,5,0,0,3
2068306,38,16,1975,10,female,155,17,8,5,1,5,0,0,1
2182949,62,24,1951,7,male,415,17,15,5,3,5,2,0,1
1663408,76,2,1937,5,female,245,16,9,5,4,5,2,0,2
1956244,14,19,1999,5,female,23,16,6,5,8,5,6,0,2
1401367,35,29,1978,4,male,39,17,12,5,14,5,13,0,1
2107794,51,11,1962,11,female,340,16,9,5,47,5,13,0,34
1886599,55,19,1958,6,female,1932,17,5,5,24,5,22,0,2
1701885,61,4,1952,1,female,246,16,11,5,26,5,14,0,12
1342771,16,17,1997,8,female,589,17,12,6,0,0,0,6,0
2131619,15,2,1998,2,male,11,17,10,6,3,0,0,6,3
1436716,21,4,1992,6,male,119,17,14,6,3,0,0,6,3
2193371,37,23,1976,3,female,376,16,5,6,3,0,0,6,3
1529540,47,30,1966,8,female,333,16,14,6,1,0,0,6,1
1629186,81,9,1932,4,female,5,17,9,6,10,1,8,5,2
1253344,23,17,1990,11,female,56,16,10,6,10,4,4,2,6
1674377,60,30,1953,10,female,41,16,12,6,9,4,2,2,7
1909850,19,14,1994,10,male,677,17,4,6,31,5,3,1,28
1276327,25,6,1988,6,female,563,17,15,6,10,5,6,1,4
2119813,21,23,1992,1,male,69,17,14,6,0,6,0,0,0
1785860,25,5,1988,11,female,603,16,11,6,0,6,0,0,0
1537928,26,8,1987,10,male,447,16,11,6,0,6,0,0,0
1584634,32,21,1981,2,male,126,16,8,6,0,6,0,0,0
1497118,15,1,1998,1,male,56,16,10,6,2,6,2,0,0
1856698,22,15,1991,1,male,590,17,10,6,1,6,0,0,1
2035429,23,1,1990,1,male,37,16,13,6,1,6,1,0,0
2110895,39,23,1974,9,male,307,17,8,6,1,6,1,0,0
1070331,18,9,1995,4,female,291,16,10,6,6,6,4,0,2
1457829,25,1,1988,1,male,132,17,16,6,4,6,4,0,0
2093165,25,10,1988,3,male,688,17,13,6,7,6,7,0,0
1211543,56,6,1957,4,male,816,16,12,6,4,6,1,0,3
1416888,26,27,1987,11,male,68,16,3,6,17,6,16,0,1
1638940,33,29,1980,10,male,333,17,10,6,26,6,12,0,14
2034313,39,21,1974,6,female,166,16,14,6,12,6,11,0,1
2095366,61,6,1952,6,female,144,17,9,6,58,6,55,0,3
1113118,17,11,1996,1,male,121,17,10,7,1,0,1,7,0
1314747,22,12,1991,8,male,643,17,14,7,0,0,0,7,0
1016844,26,20,1987,6,male,122,16,9,7,0,0,0,7,0
1783916,33,19,1980,8,male,646,17,11,7,0,0,0,7,0
1528713,53,5,1960,6,female,467,16,12,7,0,0,0,7,0
1366689,108,22,1905,9,female,1042,17,6,7,1,0,1,7,0
1356857,50,19,1963,12,male,199,16,8,7,4,1,1,6,3
1981371,66,23,1947,6,male,1377,17,7,7,10,0,4,7,6
1347856,50,20,1963,6,female,396,16,8,7,12,0,2,7,10
2110833,24,6,1989,6,male,120,16,13,7,2,5,2,2,0
1628071,34,3,1979,9,male,105,16,14,7,7,5,5,2,2
1059179,24,28,1989,1,female,169,16,10,7,40,4,10,3,30
1544134,18,30,1995,1,female,193,17,13,7,1,6,1,1,0
1155113,38,15,1975,7,male,1028,17,8,7,2,6,1,1,1
1487371,25,1,1988,9,male,73,17,16,7,1,7,1,0,0
1889453,27,11,1986,1,male,58,16,16,7,1,7,1,0,0
1832218,28,10,1985,9,male,30,17,11,7,0,7,0,0,0
1610384,32,4,1981,5,female,100,16,15,7,0,7,0,0,0
1328851,38,5,1975,4,male,296,17,11,7,1,7,1,0,0
1242050,44,24,1969,2,male,450,17,6,7,0,7,0,0,0
1225237,47,4,1966,5,female,464,16,7,7,0,7,0,0,0
2150107,53,28,1960,2,male,1256,16,11,7,0,7,0,0,0
1379380,58,3,1955,4,male,1707,17,8,7,0,7,0,0,0
1666786,59,17,1954,8,male,625,17,8,7,0,7,0,0,0
2035737,103,3,1910,12,male,722,16,2,7,0,7,0,0,0
1970659,24,19,1989,2,female,486,17,13,7,2,7,2,0,0
1962482,14,20,1999,4,male,136,17,11,7,81,7,15,0,66
1138883,20,22,1993,3,male,148,16,11,7,19,7,5,0,14
1521924,24,26,1989,10,female,570,17,12,7,12,7,12,0,0
1308727,25,1,1988,6,male,12,17,17,7,25,7,11,0,14
1091980,36,2,1977,7,female,120,16,14,8,1,0,0,8,1
2141573,56,8,1957,10,female,80,17,13,8,0,0,0,8,0
1324525,21,8,1992,1,male,801,16,9,8,3,0,3,8,0
1307227,70,1,1943,1,female,1112,16,6,8,2,0,1,8,1
1467999,69,24,1944,1,male,683,17,10,8,5,0,0,8,5
2189525,55,7,1958,11,male,1246,17,12,8,17,0,13,8,4
1675941,66,12,1947,1,female,35,17,11,8,13,1,2,7,11
1725129,22,31,1991,12,female,309,17,8,8,5,2,3,6,2
1779935,17,7,1996,3,male,120,16,9,8,25,5,24,3,1
1946328,30,26,1983,4,male,624,16,9,8,2,7,1,1,1
1106378,49,19,1964,2,male,696,16,12,8,0,8,0,0,0
1739212,61,3,1952,8,female,1685,17,9,8,1,8,1,0,0
1749446,72,20,1941,10,female,1753,16,4,8,0,8,0,0,0
1030061,60,22,1953,3,female,222,17,9,8,4,8,4,0,0
1306288,20,8,1993,12,female,420,16,15,8,8,8,6,0,2
1424169,70,28,1943,3,female,1078,17,9,8,7,8,6,0,1
1482424,38,14,1975,2,female,623,16,2,8,30,8,27,0,3
1772792,39,8,1974,7,male,257,16,11,8,15,8,14,0,1
1792990,51,18,1962,5,female,290,17,6,8,34,8,31,0,3
2125176,65,18,1948,8,male,636,17,9,8,16,8,15,0,1
1922280,42,1,1971,2,female,598,16,12,9,0,0,0,9,0
1007011,63,16,1950,9,female,572,17,12,9,1,0,1,9,0
1640689,39,30,1974,1,female,143,17,14,9,5,0,1,9,4
2029575,23,24,1990,6,male,248,16,9,9,25,0,7,9,18
1992437,58,29,1955,6,female,24,16,10,9,20,0,18,9,2
1624892,26,4,1987,11,male,111,16,10,9,10,8,3,1,7
1084291,34,3,1979,6,female,648,17,11,9,40,8,20,1,20
1153629,38,16,1975,1,female,443,16,11,9,0,9,0,0,0
1842815,43,24,1970,10,male,188,16,5,9,1,9,1,0,0
1775978,14,13,1999,11,female,182,17,11,9,3,9,0,0,3
1666437,19,16,1994,5,female,311,16,7,9,2,9,1,0,1
1638861,49,4,1964,12,male,399,17,9,9,4,9,4,0,0
1873121,62,4,1951,3,male,898,17,9,9,3,9,2,0,1
1269845,71,8,1942,9,female,898,17,4,9,4,9,3,0,1
1704415,108,13,1905,7,female,249,17,13,9,2,9,2,0,0
1742903,26,20,1987,2,female,131,16,14,9,7,9,2,0,5
2066588,30,25,1983,12,male,65,17,8,9,60,9,4,0,56
1005512,56,18,1957,11,female,140,16,14,9,35,9,5,0,30
1832608,58,19,1955,11,female,383,17,13,10,0,1,0,9,0
1208796,58,18,1955,9,female,413,16,11,10,0,0,0,10,0
1097441,77,12,1936,9,male,672,16,6,10,5,0,4,10,1
1314115,66,16,1947,2,female,519,17,10,10,8,0,2,10,6
1420003,73,30,1940,7,male,1294,17,6,10,12,0,9,10,3
1705355,35,3,1978,1,male,1255,17,6,10,29,0,10,10,19
1539636,28,1,1985,1,male,45,16,13,10,4,3,0,7,4
1737236,39,3,1974,3,male,218,17,12,10,2,2,1,8,1
1503308,22,22,1991,6,female,236,16,10,10,10,5,5,5,5
1933077,48,24,1965,10,female,955,17,7,10,13,4,2,6,11
1902001,23,20,1990,10,female,41,16,15,10,0,10,0,0,0
1373184,28,13,1985,4,male,155,16,11,10,1,10,1,0,0
1798826,34,1,1979,1,female,467,16,13,10,0,10,0,0,0
1879264,21,13,1992,5,male,206,16,10,10,3,10,1,0,2
1043797,30,1,1983,1,male,445,16,12,10,5,10,5,0,0
1423564,69,21,1944,7,female,482,16,7,10,5,10,4,0,1
1273646,19,30,1994,8,male,13,17,16,10,7,10,6,0,1
1397149,33,19,1980,9,male,181,17,11,10,11,10,11,0,0
1829982,73,25,1940,10,male,68,16,15,10,8,10,8,0,0
1497813,38,12,1975,11,female,7,17,13,10,110,10,67,0,43
1540919,28,9,1985,8,male,264,16,13,11,0,0,0,11,0
1198304,74,22,1939,1,male,179,17,11,11,16,0,10,11,6
1615377,72,12,1941,8,female,116,16,12,11,54,0,1,11,53
1740947,58,4,1955,5,female,730,16,6,11,0,5,0,6,0
1733332,18,25,1995,10,female,114,17,13,11,0,11,0,0,0
1114383,20,20,1993,10,male,32,16,15,11,1,11,1,0,0
2054896,53,19,1960,12,female,454,17,12,11,0,11,0,0,0
1006996,63,9,1950,3,female,422,17,11,11,1,11,1,0,0
1859236,26,16,1987,3,male,341,16,10,11,2,11,0,0,2
1969144,41,16,1972,6,female,551,17,6,11,6,11,6,0,0
1291439,18,5,1995,10,female,415,17,8,11,13,11,5,0,8
2002298,105,18,1908,11,male,1090,16,8,11,12,11,10,0,2
1775816,45,3,1968,5,female,614,16,12,11,22,11,22,0,0
1507390,36,20,1977,8,male,258,16,11,12,0,0,0,12,0
1279218,71,7,1942,7,male,617,17,8,12,0,0,0,12,0
1935258,60,3,1953,11,male,913,16,11,12,2,0,0,12,2
1855446,83,18,1930,7,female,834,16,3,12,5,0,1,12,4
2189093,64,7,1949,1,female,122,17,7,12,10,2,4,10,6
1213304,72,16,1941,5,female,255,16,11,12,59,0,3,12,56
1508082,56,2,1957,4,female,899,16,7,12,5,9,1,3,4
1254353,18,21,1995,8,male,72,16,13,12,0,12,0,0,0
1189177,23,27,1990,6,female,265,16,12,12,0,12,0,0,0
1228655,32,5,1981,8,male,230,16,12,12,5,12,3,0,2
1436246,36,17,1977,6,female,425,17,15,12,2,12,0,0,2
2012269,44,21,1969,12,female,412,16,4,12,2,12,2,0,0
1149802,69,13,1944,3,female,74,17,12,12,6,12,6,0,0
1100695,76,18,1937,6,female,1218,16,7,12,2,12,2,0,0
1647699,25,1,1988,1,female,112,16,10,12,17,12,15,0,2
1452292,39,31,1974,1,male,210,17,15,12,8,12,8,0,0
2034822,45,13,1968,3,male,16,17,11,12,19,12,10,0,9
1178771,15,21,1998,8,female,11,16,14,13,1,0,1,13,0
1841792,24,9,1989,9,female,284,16,7,13,0,0,0,13,0
1747699,70,20,1943,1,male,1088,16,9,13,0,0,0,13,0
1219290,19,18,1994,6,male,105,17,17,13,4,0,1,13,3
1963420,45,25,1968,7,male,837,16,9,13,3,0,3,13,0
1739474,55,4,1958,7,male,58,16,14,13,5,0,1,13,4
1343963,21,17,1992,4,female,536,16,9,13,10,11,6,2,4
1963791,40,15,1973,1,male,539,17,12,13,36,11,36,2,0
1621986,23,5,1990,2,male,190,16,14,13,2,13,2,0,0
1599881,73,3,1940,3,female,614,17,10,13,0,13,0,0,0
1552652,24,1,1989,12,male,141,17,11,13,4,13,4,0,0
1528294,38,6,1975,6,male,283,17,13,13,5,13,5,0,0
1059424,42,25,1971,9,female,93,17,11,13,3,13,3,0,0
1259987,62,13,1951,10,female,322,16,13,13,3,13,3,0,0
1141829,31,22,1982,12,male,134,17,17,13,9,13,5,0,4
1134461,46,29,1967,9,male,195,17,13,13,10,13,10,0,0
1255218,56,30,1957,8,female,146,16,10,13,8,13,3,0,5
1472274,66,27,1947,12,female,1868,17,9,14,2,0,0,14,2
1977291,66,10,1947,6,male,62,16,13,14,2,0,1,14,1
1779567,67,24,1946,7,male,1,16,15,14,1,0,0,14,1
1947513,20,24,1993,7,female,405,17,13,14,4,0,2,14,2
1484681,23,8,1990,9,male,408,16,13,14,3,0,1,14,2
1286171,49,14,1964,5,female,931,17,8,14,4,0,0,14,4
1827148,72,24,1941,12,male,1952,17,2,14,5,0,3,14,2
1087617,50,24,1963,3,female,239,16,9,14,15,0,8,14,7
1598163,61,2,1952,10,male,110,16,10,14,9,0,1,14,8
1602073,57,4,1956,7,female,101,16,10,14,41,0,6,14,35
2069316,52,1,1961,12,male,823,17,12,14,7,6,5,8,2
1599714,22,26,1991,12,male,94,16,16,14,0,14,0,0,0
1726315,13,16,2000,5,male,18,17,11,14,12,14,9,0,3
1221599,59,1,1954,2,male,272,16,5,14,18,14,13,0,5
1725433,73,1,1940,4,male,1627,16,7,14,50,14,48,0,2
1233049,58,22,1955,5,male,233,16,15,15,1,0,0,15,1
1707534,80,26,1933,5,male,295,16,10,15,8,0,2,15,6
1461543,48,16,1965,8,female,642,17,14,15,3,10,3,5,0
1298733,108,6,1905,10,male,317,17,4,15,13,13,3,2,10
2031688,45,7,1968,7,female,252,17,13,15,0,15,0,0,0
1656810,18,7,1995,7,male,16,17,10,15,4,15,4,0,0
1860162,64,24,1949,5,male,198,16,16,15,8,15,0,0,8
1770079,61,12,1952,12,female,1335,16,9,15,15,15,10,0,5
1911626,65,25,1948,10,male,310,17,15,15,16,15,9,0,7
1486853,16,13,1997,1,male,333,16,5,16,0,1,0,15,0
1941396,76,17,1937,10,female,729,16,9,16,8,0,3,16,5
1298586,26,25,1987,1,female,693,17,5,16,10,0,2,16,8
2022941,48,30,1965,3,male,469,16,13,16,0,8,0,8,0
1167450,54,10,1959,11,female,435,17,6,16,11,9,5,7,6
1142047,14,9,1999,2,male,27,17,15,16,1,16,0,0,1
1674676,25,19,1988,5,male,244,16,11,16,0,16,0,0,0
1865595,26,1,1987,1,male,289,16,15,16,2,16,1,0,1
1377023,56,30,1957,4,female,1330,17,11,16,2,16,1,0,1
1443817,79,10,1934,10,female,64,17,11,16,0,16,0,0,0
1819812,25,15,1988,4,male,31,16,12,16,6,16,6,0,0
1327310,35,8,1978,3,female,246,16,6,16,21,16,12,0,9
2183826,53,3,1960,6,female,266,17,10,16,16,16,14,0,2
2090538,71,2,1942,9,female,922,17,11,17,2,0,1,17,1
1678998,34,29,1979,4,female,638,17,10,17,6,0,0,17,6
1038516,72,4,1941,4,male,1686,17,5,17,8,1,7,16,1
1917884,73,7,1940,5,female,12,16,11,17,4,9,4,8,0
1196629,25,4,1988,12,female,278,16,10,17,8,17,8,0,0
1493228,36,3,1977,2,male,88,17,8,17,3,17,3,0,0
1133957,45,3,1968,2,female,595,17,8,17,3,17,3,0,0
2119510,66,14,1947,8,male,6,17,16,17,5,17,5,0,0
2083169,56,11,1957,5,NA,1968,16,6,18,3,1,2,17,1
2062685,47,29,1966,11,male,361,17,10,18,0,18,0,0,0
1271354,27,21,1986,11,male,23,16,15,18,8,18,8,0,0
1676063,45,29,1968,5,male,39,16,15,18,4,18,4,0,0
1217813,35,19,1978,10,female,744,16,13,18,24,18,15,0,9
2130566,60,12,1953,5,female,417,16,16,19,3,0,0,19,3
1250368,39,1,1974,3,female,648,17,5,19,12,14,5,5,7
1483765,15,24,1998,3,male,22,16,8,19,3,19,3,0,0
1360076,51,21,1962,7,female,61,17,15,19,1,19,0,0,1
1006691,23,3,1990,3,male,636,16,12,19,10,19,10,0,0
1397803,26,2,1987,2,male,173,16,11,19,8,19,8,0,0
2141406,38,29,1975,12,male,239,16,11,19,29,19,26,0,3
2087688,77,4,1936,4,female,1562,16,2,20,0,0,0,20,0
1132212,22,10,1991,5,female,219,17,8,20,0,8,0,12,0
2037340,52,3,1961,6,male,620,17,7,20,20,4,10,16,10
1370304,25,19,1988,6,male,351,17,11,20,1,20,1,0,0
1087706,25,15,1988,11,female,60,17,13,20,19,20,12,0,7
1911070,23,3,1990,7,male,301,16,7,21,1,21,1,0,0
2099433,45,31,1968,5,male,497,17,7,21,1,21,1,0,0
2102384,81,27,1932,3,male,1832,16,10,22,8,0,7,22,1
1784709,39,6,1974,6,male,302,16,10,22,30,1,0,21,30
1140398,52,22,1961,6,female,54,16,11,22,24,0,0,22,24
1775890,20,19,1993,10,male,85,16,5,22,16,22,15,0,1
1122078,18,11,1995,12,male,252,16,12,23,1,0,0,23,1
1653774,30,19,1983,2,male,204,17,7,23,3,2,0,21,3
1725892,67,8,1946,12,female,509,16,8,23,8,0,7,23,1
1164961,19,24,1994,5,male,105,17,11,23,10,23,10,0,0
1444058,25,22,1988,8,male,174,16,13,23,7,23,7,0,0
1074697,30,19,1983,7,female,327,16,13,23,18,23,18,0,0
1397048,34,25,1979,4,female,85,17,10,24,0,16,0,8,0
1452198,16,14,1997,9,male,13,16,14,24,15,10,6,14,9
1629628,32,15,1981,10,male,200,16,12,24,0,24,0,0,0
1302969,38,26,1975,1,male,207,16,7,24,7,24,4,0,3
1846992,25,20,1988,3,male,278,17,11,24,17,24,17,0,0
1418606,14,5,1999,3,male,330,17,11,25,1,0,0,25,1
1106401,23,20,1990,3,female,296,17,11,25,5,4,0,21,5
1997967,72,9,1941,9,female,60,17,17,25,9,0,4,25,5
1877304,59,15,1954,9,female,858,17,14,25,9,12,7,13,2
1998342,42,11,1971,2,male,285,17,13,25,0,25,0,0,0
1803038,23,1,1990,10,female,400,16,6,26,3,0,2,26,1
1163008,44,3,1969,7,female,763,16,8,26,1,0,0,26,1
1124165,64,24,1949,12,female,101,16,12,26,1,0,0,26,1
1099165,53,11,1960,5,male,240,16,5,26,16,0,6,26,10
1000957,40,3,1973,3,male,22,17,9,26,31,9,21,17,10
1403037,18,26,1995,5,male,6,17,17,26,2,26,2,0,0
1263523,22,13,1991,8,male,9,17,13,26,3,26,1,0,2
1064618,34,15,1979,4,female,98,16,9,26,8,26,6,0,2
1194528,54,1,1959,1,female,488,16,11,26,11,26,8,0,3
1362632,16,4,1997,8,male,297,16,14,27,4,0,3,27,1
1699746,56,26,1957,1,female,373,16,14,27,2,0,0,27,2
2118497,78,18,1935,4,female,1199,16,14,27,0,0,0,27,0
1324362,47,26,1966,3,male,1503,17,11,27,4,23,4,4,0
1421938,23,2,1990,1,male,24,17,12,27,28,27,16,0,12
1729619,63,5,1950,10,female,462,16,12,27,17,27,15,0,2
1223046,21,5,1992,7,female,174,16,8,28,3,3,1,25,2
1139293,14,1,1999,1,male,473,16,12,28,16,25,8,3,8
1745146,31,29,1982,1,male,130,16,12,28,4,28,2,0,2
1486495,21,8,1992,4,male,216,16,13,28,7,28,3,0,4
2159871,27,21,1986,8,male,29,16,16,28,9,28,3,0,6
2155253,50,1,1963,6,female,177,16,14,28,11,28,10,0,1
1568726,103,10,1910,1,male,812,16,7,29,2,0,0,29,2
1456854,31,1,1982,1,female,475,16,11,29,25,13,0,16,25
1370511,20,2,1993,8,male,281,17,10,29,3,29,3,0,0
1889360,66,9,1947,6,female,281,17,14,29,1,29,1,0,0
1191051,54,6,1959,2,female,826,17,9,29,9,29,7,0,2
1748721,25,1,1988,1,female,270,16,13,29,21,29,11,0,10
1517407,29,12,1984,9,female,592,16,9,31,0,0,0,31,0
1356959,62,3,1951,4,male,1468,16,4,30,2,0,0,30,2
2071987,65,30,1948,8,male,163,17,12,30,20,0,3,30,17
2157500,22,1,1991,1,male,128,16,14,31,1,30,0,1,1
2182038,56,24,1957,8,female,378,16,13,30,12,30,12,0,0
1344601,21,15,1992,1,male,419,17,7,31,19,31,19,0,0
1068845,33,7,1980,12,male,34,16,12,30,24,30,19,0,5
1001584,14,28,1999,5,male,495,16,13,32,5,30,3,2,2
1256606,39,27,1974,5,female,553,16,11,32,2,32,0,0,2
1290703,50,1,1963,4,male,797,16,7,32,0,32,0,0,0
2168475,19,13,1994,7,female,278,16,8,32,8,32,6,0,2
1056695,21,17,1992,3,male,386,16,11,32,15,32,10,0,5
1228159,25,28,1988,1,female,154,17,8,32,6,32,6,0,0
1438794,37,6,1976,12,male,103,16,9,32,20,32,18,0,2
1155878,25,1,1988,1,male,40,16,14,33,2,33,0,0,2
1850616,22,21,1991,3,male,16,17,14,33,13,33,13,0,0
1653371,23,14,1990,2,male,160,17,11,34,0,0,0,34,0
1141676,55,4,1958,5,female,102,16,10,34,1,10,0,24,1
1293733,26,1,1987,1,male,454,17,13,34,0,34,0,0,0
1812781,34,25,1979,11,male,180,16,12,34,14,34,13,0,1
1558387,51,17,1962,6,female,431,16,8,34,18,34,8,0,10
1732248,58,16,1955,9,male,2268,17,6,34,13,34,4,0,9
1307567,19,27,1994,8,female,382,17,13,35,15,0,6,35,9
1402080,65,10,1948,10,female,726,16,4,35,17,0,2,35,15
1700397,69,25,1944,11,male,1450,16,9,35,10,24,6,11,4
1261279,47,21,1966,11,female,152,17,11,36,13,36,13,0,0
1935343,16,30,1997,12,female,4,17,5,36,53,36,47,0,6
2125410,25,16,1988,1,male,240,17,14,35,130,35,95,0,35
1644318,28,6,1985,9,male,580,17,10,37,0,0,0,37,0
1055793,16,7,1997,5,male,59,17,7,37,0,37,0,0,0
1711390,55,3,1958,7,male,18,16,12,37,62,37,58,0,4
1283613,52,26,1961,1,female,428,16,13,38,1,17,1,21,0
1214402,21,20,1992,9,male,563,16,15,39,9,10,4,29,5
2045893,26,27,1987,9,male,108,16,8,39,0,39,0,0,0
1990876,28,29,1985,9,female,217,16,10,38,31,38,30,0,1
1874797,21,14,1992,10,female,138,16,6,40,24,40,19,0,5
1898342,30,26,1983,11,female,581,17,8,40,118,40,85,0,33
1418017,28,1,1985,1,male,402,17,14,41,3,0,2,41,1
1354865,49,21,1964,3,male,279,17,15,41,6,0,0,41,6
1156601,55,23,1958,9,female,140,17,12,42,0,0,0,42,0
1775013,15,8,1998,7,female,192,16,9,42,19,27,6,15,13
1004987,17,31,1996,10,male,36,17,11,42,6,42,5,0,1
1661116,24,29,1989,8,male,154,17,15,42,28,42,20,0,8
1960751,33,12,1980,4,male,462,16,11,43,0,0,0,43,0
1869601,51,29,1962,12,female,843,17,13,44,16,0,0,44,16
1845469,48,5,1965,5,female,79,17,16,43,3,36,2,7,1
1403454,33,1,1980,1,male,35,16,11,44,0,44,0,0,0
1317717,40,4,1973,8,male,297,17,10,43,6,43,5,0,1
1973301,59,1,1954,1,female,564,17,14,44,7,44,5,0,2
1810172,60,21,1953,1,female,236,17,10,43,0,43,0,0,0
1312181,55,30,1958,4,female,498,17,9,44,23,44,17,0,6
1301200,34,7,1979,4,female,70,16,6,44,68,44,49,0,19
1592417,22,15,1991,4,female,25,16,12,46,11,42,11,4,0
1641080,23,10,1990,4,female,306,16,7,47,9,47,5,0,4
1354704,43,17,1970,4,female,73,17,17,46,74,46,63,0,11
1149232,34,20,1979,3,female,158,16,8,49,8,49,8,0,0
1094638,30,7,1983,12,male,420,17,10,48,12,48,7,0,5
2182653,47,4,1966,10,female,356,17,13,49,17,49,16,0,1
1923666,21,3,1992,3,male,373,17,14,50,1,0,1,50,0
1724680,53,7,1960,5,female,368,16,14,51,5,0,1,51,4
1391957,63,22,1950,10,female,473,16,12,50,2,0,0,50,2
1612120,18,17,1995,3,male,142,16,7,50,0,50,0,0,0
1018629,23,6,1990,10,male,60,16,16,51,2,51,1,0,1
1961892,53,26,1960,7,male,1202,16,12,51,5,51,1,0,4
1477468,33,8,1980,5,male,256,16,16,50,21,50,16,0,5
1786983,58,4,1955,10,female,723,17,12,50,11,50,6,0,5
1229684,14,10,1999,8,female,138,17,15,51,39,51,29,0,10
2121713,50,15,1963,4,female,406,17,10,52,11,0,3,52,8
1334641,37,29,1976,8,female,255,17,6,53,6,18,1,35,5
1408648,50,1,1963,1,male,186,17,9,53,1,53,1,0,0
1736308,27,18,1986,1,female,117,17,12,53,57,53,36,0,21
1343074,104,16,1909,9,female,1439,16,14,55,2,55,2,0,0
1472411,50,21,1963,10,male,303,16,8,55,11,55,11,0,0
1602246,20,1,1993,1,female,530,16,6,57,65,0,1,57,64
1932824,18,24,1995,2,male,101,16,8,58,7,57,6,1,1
1102221,64,1,1949,7,male,13,16,14,56,0,43,0,13,0
1126545,55,1,1958,9,male,627,17,10,56,5,56,4,0,1
2126420,29,2,1984,1,male,447,16,0,56,14,56,12,0,2
1884582,20,18,1993,7,male,110,16,11,56,60,56,55,0,5
1361100,21,5,1992,8,female,302,16,3,58,401,58,288,0,113
1898671,23,13,1990,3,female,237,17,16,59,52,9,25,50,27
2025605,26,18,1987,8,female,278,17,8,59,7,30,4,29,3
1213439,41,7,1972,1,male,587,16,9,60,8,60,7,0,1
1536511,60,29,1953,3,female,403,17,12,60,56,60,41,0,15
1601671,55,26,1958,2,female,62,17,12,62,6,32,3,30,3
1698176,21,12,1992,5,female,10,17,2,61,642,55,440,6,202
2009271,79,29,1934,5,female,367,17,6,62,0,62,0,0,0
1326030,105,1,1908,8,NA,2160,16,7,65,22,37,16,28,6
1207792,24,12,1989,12,female,148,17,4,65,2,65,2,0,0
1069400,41,11,1972,7,male,368,16,9,64,14,64,9,0,5
1512134,18,26,1995,2,male,265,16,12,67,6,4,2,63,4
1231307,41,11,1972,3,female,501,17,11,67,2,16,0,51,2
1933920,54,2,1959,12,female,764,16,7,67,208,44,135,23,73
1558151,32,19,1981,10,male,18,17,13,66,8,65,4,1,4
1637581,25,17,1988,7,male,151,16,15,66,0,66,0,0,0
1036467,39,8,1974,11,female,496,16,8,67,33,67,30,0,3
2061142,41,1,1972,1,female,99,17,11,67,21,67,19,0,2
1069723,55,29,1958,10,female,57,16,9,69,8,1,5,68,3
1095380,43,1,1970,8,female,499,17,11,70,29,0,4,70,25
1686076,43,10,1970,9,male,1217,16,10,69,74,58,57,11,17
1106742,23,9,1990,1,female,260,17,11,71,19,71,13,0,6
1357371,24,19,1989,8,female,301,17,5,71,27,71,24,0,3
1941697,79,7,1934,8,female,924,17,8,69,20,69,5,0,15
1629082,59,3,1954,9,female,36,16,13,71,56,71,55,0,1
2079190,47,12,1966,3,male,742,17,9,72,10,2,0,70,10
1316711,81,8,1932,8,female,866,17,10,74,15,0,5,74,10
1375931,40,18,1973,9,female,421,16,15,73,2,45,2,28,0
1701824,28,11,1985,1,female,218,17,5,74,12,72,8,2,4
1253468,39,22,1974,7,female,815,16,7,73,3,72,3,1,0
2005204,58,25,1955,5,female,84,17,10,74,26,71,17,3,9
1514499,25,10,1988,12,female,305,17,13,72,0,72,0,0,0
1104422,20,17,1993,7,male,106,16,11,76,9,74,7,2,2
1546441,14,23,1999,10,female,88,17,11,78,40,0,2,78,38
1558847,26,28,1987,10,female,594,16,14,80,52,2,17,78,35
1810344,53,20,1960,5,male,256,17,9,79,8,78,4,1,4
1219068,53,26,1960,11,female,639,17,14,80,49,76,44,4,5
1656726,43,26,1970,2,male,670,16,5,79,5,79,3,0,2
1574037,35,14,1978,10,female,259,16,12,78,45,78,38,0,7
1947141,41,11,1972,5,female,468,17,13,83,48,81,47,2,1
1959154,13,9,2000,6,female,47,17,14,83,8,83,8,0,0
1843281,26,8,1987,11,male,364,16,13,83,7,83,7,0,0
1527765,18,16,1995,2,male,409,17,13,84,20,84,17,0,3
1888447,73,15,1940,5,male,163,17,4,87,12,0,2,87,10
1718025,17,12,1996,6,female,309,16,10,86,23,12,0,74,23
1137588,68,29,1945,7,male,91,16,11,87,20,87,2,0,18
1103425,38,5,1975,4,male,311,17,13,87,94,87,82,0,12
1556991,45,1,1968,8,male,23,16,13,89,61,6,36,83,25
1692711,26,10,1987,5,male,24,17,13,89,8,85,8,4,0
1316080,22,6,1991,5,male,5,17,16,91,1,91,1,0,0
1320026,25,2,1988,1,male,198,17,13,91,46,91,18,0,28
1509184,35,28,1978,6,female,137,16,16,88,77,88,50,0,27
1907609,65,3,1948,11,female,473,16,12,88,64,88,52,0,12
1939316,23,1,1990,11,female,556,16,5,92,65,1,6,91,59
1012644,60,27,1953,3,female,268,17,14,92,23,21,10,71,13
1873399,19,17,1994,11,female,190,16,10,92,133,74,35,18,98
1528059,26,19,1987,1,female,387,17,11,92,12,92,12,0,0
2172204,41,1,1972,11,female,631,16,12,94,7,94,7,0,0
1336103,52,15,1961,7,male,967,16,9,93,9,93,5,0,4
1326456,35,16,1978,10,male,140,16,15,99,10,0,1,99,9
1395274,59,24,1954,4,female,81,17,10,98,23,0,17,98,6
1742415,40,5,1973,4,male,122,16,13,99,13,60,12,39,1
1857574,26,9,1987,8,female,119,17,13,98,48,90,19,8,29
1268095,16,16,1997,11,male,47,17,16,97,21,97,13,0,8
1435445,37,10,1976,4,male,303,16,13,103,34,0,15,103,19
1721212,26,10,1987,9,male,203,17,16,102,56,37,30,65,26
1133200,22,4,1991,7,female,341,17,10,101,69,90,18,11,51
2141687,30,7,1983,12,female,179,17,16,104,167,81,84,23,83
1073026,21,9,1992,12,male,467,16,15,101,1,101,1,0,0
1543572,26,3,1987,4,female,324,16,13,100,11,100,11,0,0
1412911,21,17,1992,12,female,164,16,9,103,68,103,25,0,43
1590996,18,4,1995,2,female,431,16,9,107,45,1,3,106,42
1149302,23,25,1990,11,female,245,16,12,105,22,105,21,0,1
1570922,42,29,1971,10,male,226,17,9,106,40,106,24,0,16
2048990,72,29,1941,12,female,835,17,10,111,57,0,37,111,20
1024288,45,31,1968,3,male,274,16,14,113,1,105,0,8,1
1545875,60,11,1953,6,male,1894,17,6,114,97,43,74,71,23
1128362,14,10,1999,2,male,517,16,13,115,37,99,36,16,1
1019642,39,9,1974,6,male,472,17,6,119,65,104,46,15,19
1125225,27,15,1986,10,female,585,17,10,115,7,115,7,0,0
1381566,63,19,1950,1,female,129,17,17,116,1,116,1,0,0
1091105,56,14,1957,9,female,403,16,7,120,5,0,1,120,4
2029513,26,9,1987,9,female,550,16,11,122,6,30,3,92,3
1550283,44,12,1969,2,male,377,17,9,121,119,121,74,0,45
1351035,42,1,1971,1,male,55,17,15,129,7,0,1,129,6
1566569,36,15,1977,1,female,307,16,13,126,93,68,62,58,31
1383484,27,28,1986,10,female,701,17,13,127,39,107,19,20,20
1956311,31,2,1982,5,male,444,16,14,127,18,127,12,0,6
1666279,102,1,1911,1,male,220,16,10,129,6,129,5,0,1
1283845,18,1,1995,1,male,42,17,10,126,43,126,40,0,3
1926684,44,2,1969,12,female,229,17,5,127,829,127,598,0,231
1132829,33,5,1980,5,female,466,16,11,131,417,0,79,131,338
1868555,25,11,1988,10,female,248,17,14,135,5,115,3,20,2
2163401,40,22,1973,2,female,474,17,15,134,21,134,16,0,5
1233889,103,31,1910,12,male,230,17,15,134,11,134,11,0,0
1807567,46,7,1967,2,female,412,17,11,141,70,0,14,141,56
1803906,60,1,1953,10,female,384,17,9,137,55,0,30,137,25
1240482,53,1,1960,5,female,264,17,12,143,43,141,22,2,21
1438229,24,7,1989,11,female,171,17,12,148,118,130,73,18,45
1580972,29,5,1984,2,male,100,17,12,145,117,133,59,12,58
2185260,32,24,1981,9,female,855,17,8,148,577,143,364,5,213
2031467,44,30,1969,9,female,260,16,10,149,61,149,47,0,14
1756162,48,23,1965,10,female,258,16,7,145,60,145,47,0,13
1064820,57,22,1956,3,male,89,17,12,157,3,37,1,120,2
1031979,15,16,1998,6,male,50,17,13,154,114,151,22,3,92
1580876,18,21,1995,6,male,66,17,12,153,52,153,33,0,19
1324526,21,16,1992,5,female,776,17,9,163,12,158,8,5,4
1534093,29,20,1984,1,female,752,17,15,161,5,161,2,0,3
1311198,37,14,1976,6,female,183,16,5,168,12,79,5,89,7
1274705,31,19,1982,2,male,200,16,15,168,0,168,0,0,0
1378647,33,13,1980,8,female,343,17,9,171,7,171,4,0,3
1345568,43,11,1970,11,male,186,16,12,185,7,185,3,0,4
1766379,38,22,1975,1,female,320,17,12,194,101,193,67,1,34
1559096,44,16,1969,7,female,396,17,9,202,136,0,27,202,109
1408793,36,2,1977,6,female,285,17,14,210,79,201,48,9,31
1595549,23,2,1990,1,male,18,16,12,204,7,204,4,0,3
1448292,15,21,1998,11,female,345,17,9,208,82,208,59,0,23
1921402,33,10,1980,12,male,174,16,12,203,60,203,46,0,14
1078670,56,8,1957,2,male,164,17,14,217,34,0,10,217,24
1777612,34,8,1979,5,female,199,17,8,218,177,85,118,133,59
1001484,23,20,1990,1,male,37,17,11,215,0,215,0,0,0
1025578,28,1,1985,3,female,398,16,14,216,65,216,57,0,8
1453516,52,10,1961,2,female,39,17,13,245,66,0,16,245,50
1352284,13,2,2000,4,female,214,17,9,241,11,160,4,81,7
1061072,19,13,1994,3,female,113,17,17,241,1052,240,346,1,706
1096517,28,6,1985,11,female,36,16,15,284,54,277,54,7,0
1196680,30,15,1983,3,male,90,17,13,285,55,285,55,0,0
1798899,61,8,1952,7,female,801,17,7,294,908,0,113,294,795
1860124,27,11,1986,7,female,56,16,15,304,196,243,162,61,34
1635401,35,24,1978,4,male,214,16,13,308,101,308,95,0,6
1995141,22,12,1991,2,female,379,17,13,315,98,208,56,107,42
1987533,33,3,1980,10,male,1285,16,8,310,48,310,17,0,31
1711361,74,17,1939,12,female,222,17,10,330,51,0,12,330,39
1059710,58,22,1955,10,male,493,16,16,343,304,0,13,343,291
1007742,23,4,1990,3,female,188,16,10,344,200,222,45,122,155
1345709,18,1,1995,8,male,76,16,10,353,322,36,46,317,276
1552939,42,2,1971,1,female,255,16,6,373,181,0,17,373,164
1437453,46,20,1967,11,female,134,16,15,372,99,371,17,1,82
1806957,35,1,1978,1,female,231,16,8,375,30,375,24,0,6
1223391,20,29,1993,5,male,229,16,14,413,246,210,91,203,155
1116440,43,27,1970,3,male,459,17,14,416,44,416,30,0,14
2117888,15,23,1998,12,male,104,16,14,434,50,280,7,154,43
1004142,100,26,1913,10,female,1619,17,11,463,100,413,51,50,49
1306197,33,11,1980,4,female,303,17,3,494,179,454,53,40,126
1254794,18,11,1995,8,female,67,17,12,549,6,549,4,0,2
1670383,28,9,1985,11,male,60,16,16,568,11,313,0,255,11
2031106,66,7,1947,8,male,541,16,10,637,78,0,19,637,59
1440505,24,25,1989,11,male,922,16,15,673,272,609,212,64,60
1814997,25,8,1988,8,male,188,17,16,849,281,848,114,1,167
2159317,51,7,1962,1,male,219,16,12,827,29,827,15,0,14
1866178,19,15,1994,7,male,606,17,10,954,65,165,55,789,10
1019726,15,1,1998,3,female,95,16,11,917,382,916,163,1,219
1108430,54,1,1959,8,male,56,17,12,1094,68,1094,41,0,27
1459224,23,21,1990,6,female,829,17,13,1284,51,1284,33,0,18
1503484,41,25,1972,11,male,516,16,7,1418,324,1389,159,29,165
1659410,49,3,1964,8,female,368,17,15,1791,378,142,40,1649,338
1056608,66,30,1947,9,female,172,16,15,7940,773,7940,340,0,433
1382053,25,29,1988,2,female,283,18,6,10,6,10,2,0,4
1122991,53,29,1960,3,male,231,18,16,11,1,0,0,11,1
1589576,37,15,1976,7,male,522,18,11,11,4,0,3,11,1
1623315,77,13,1936,7,female,622,18,16,11,4,3,0,8,4
1654030,26,7,1987,5,male,411,18,6,11,1,11,0,0,1
1964285,61,3,1952,12,male,671,18,9,11,0,11,0,0,0
1405664,43,22,1970,9,male,799,18,12,11,4,11,4,0,0
1066979,50,25,1963,5,male,473,18,11,11,2,11,1,0,1
1665097,20,3,1993,3,male,76,18,12,11,16,11,12,0,4
1947625,27,5,1986,2,male,306,18,16,11,8,11,4,0,4
1261562,47,26,1966,6,female,964,18,16,12,3,1,1,11,2
1907784,45,4,1968,5,male,1510,18,11,12,11,0,1,12,10
1285956,17,18,1996,1,male,277,18,17,12,33,0,10,12,23
2166164,51,10,1962,9,female,235,18,13,12,21,0,2,12,19
1172947,53,19,1960,6,female,769,18,11,12,1,11,1,1,0
2155289,33,8,1980,4,female,27,18,11,12,33,10,21,2,12
1504947,52,27,1961,7,female,161,18,14,12,0,12,0,0,0
1061611,48,1,1965,1,male,245,18,12,12,6,12,6,0,0
2018693,31,14,1982,2,male,276,18,14,13,7,0,0,13,7
2147246,73,26,1940,9,male,992,18,7,13,12,0,1,13,11
1894972,43,1,1970,1,male,46,18,16,13,8,9,5,4,3
1653867,43,4,1970,7,male,60,18,17,13,10,7,3,6,7
1694631,27,10,1986,9,female,435,18,10,13,1,13,1,0,0
2070732,23,12,1990,4,female,462,18,5,13,17,13,17,0,0
1307422,40,30,1973,9,male,247,18,14,13,14,13,10,0,4
1648098,18,6,1995,3,female,244,18,5,14,2,0,0,14,2
2109396,38,5,1975,5,female,9,18,16,14,6,10,4,4,2
1891598,53,24,1960,4,male,408,18,12,14,8,9,0,5,8
1919290,43,7,1970,10,male,520,18,13,14,0,14,0,0,0
2184493,50,24,1963,7,male,228,18,8,15,0,0,0,15,0
1538784,65,10,1948,2,female,2035,18,8,15,5,0,2,15,3
1678679,58,4,1955,1,male,808,18,13,15,29,0,0,15,29
1983014,50,7,1963,9,female,762,18,3,15,37,8,20,7,17
1899119,30,27,1983,2,male,220,18,9,15,0,13,0,2,0
1767542,23,7,1990,2,male,78,18,16,15,12,15,7,0,5
1121994,63,3,1950,8,male,1178,18,4,16,3,0,1,16,2
1266834,50,24,1963,4,female,363,18,15,16,49,0,39,16,10
1170574,23,1,1990,1,male,193,18,17,16,17,16,17,0,0
1864361,21,13,1992,8,female,339,18,8,17,13,0,4,17,9
2036835,92,25,1921,12,female,1531,18,15,17,19,2,16,15,3
2165799,26,25,1987,6,male,594,18,12,17,2,17,2,0,0
1903130,24,12,1989,3,male,56,18,17,17,13,17,12,0,1
2109029,36,14,1977,12,male,136,18,1,17,11,17,11,0,0
1676271,31,1,1982,1,male,317,18,11,18,0,2,0,16,0
1835302,32,5,1981,12,female,228,18,13,18,1,18,1,0,0
1591495,31,31,1982,12,male,83,18,11,18,3,18,3,0,0
1389980,45,19,1968,9,female,120,18,12,18,3,18,3,0,0
1305537,30,16,1983,2,female,740,18,6,18,18,18,12,0,6
1400761,30,9,1983,7,male,65,18,16,18,18,18,3,0,15
1734014,44,4,1969,12,female,526,18,10,18,24,18,23,0,1
1462655,32,1,1981,5,female,322,18,12,19,2,0,0,19,2
1919265,60,11,1953,11,female,842,18,17,19,0,1,0,18,0
1297179,108,22,1905,5,female,973,18,16,19,3,0,3,19,0
2017432,52,24,1961,7,female,103,18,16,19,8,0,2,19,6
1548557,28,2,1985,2,male,10,18,16,19,44,18,35,1,9
1800067,13,8,2000,7,female,41,18,8,19,2,19,2,0,0
2076944,45,9,1968,9,male,276,18,6,19,0,19,0,0,0
1966176,49,21,1964,2,female,989,18,13,19,3,19,3,0,0
1975362,56,12,1957,4,male,664,18,16,19,9,19,8,0,1
2175723,18,12,1995,9,female,108,18,10,19,61,19,41,0,20
1246671,27,1,1986,1,female,672,18,11,19,29,19,22,0,7
1067683,27,14,1986,3,male,176,18,15,20,2,0,0,20,2
1034281,47,20,1966,10,male,392,18,6,20,80,0,8,20,72
1754582,25,10,1988,10,male,569,18,17,20,10,16,9,4,1
2011417,25,1,1988,12,male,659,18,16,20,3,20,1,0,2
1530905,32,24,1981,4,female,433,18,11,20,10,20,10,0,0
1881066,32,11,1981,4,female,231,18,9,20,8,20,6,0,2
1370712,47,1,1966,1,male,240,18,9,20,26,20,13,0,13
1913482,56,6,1957,10,male,107,18,16,20,79,20,28,0,51
2183728,22,14,1991,1,female,247,18,13,21,11,0,7,21,4
1484766,61,26,1952,10,male,177,18,10,21,14,0,3,21,11
1111638,36,29,1977,7,female,16,18,10,21,6,6,4,15,2
2039309,100,1,1913,1,male,29,18,16,21,6,12,2,9,4
1797510,34,1,1979,1,female,385,18,11,21,4,21,4,0,0
1725110,51,24,1962,5,male,315,18,13,21,12,21,8,0,4
1692556,33,18,1980,10,male,991,18,6,22,0,22,0,0,0
1198586,44,2,1969,2,male,195,18,7,22,12,22,3,0,9
1026898,108,14,1905,9,male,8,18,18,22,5,22,5,0,0
1165927,36,23,1977,4,male,340,18,17,23,2,0,0,23,2
2030025,49,8,1964,11,female,633,18,4,23,12,23,7,0,5
1579293,61,27,1952,7,female,1104,18,9,24,2,3,0,21,2
1550805,47,18,1966,10,male,451,18,12,24,14,4,4,20,10
1991242,24,13,1989,2,male,446,18,10,24,4,24,4,0,0
1379947,22,17,1991,8,male,167,18,16,25,3,25,2,0,1
1120010,32,1,1981,1,male,220,18,17,25,3,25,2,0,1
1520288,38,1,1975,1,male,487,18,10,25,0,25,0,0,0
1709872,36,19,1977,4,female,257,18,7,26,9,1,0,25,9
1271145,50,16,1963,6,female,590,18,9,26,0,26,0,0,0
2024442,63,25,1950,4,male,278,18,15,27,41,2,5,25,36
1569054,37,10,1976,12,male,1323,18,13,27,130,24,31,3,99
1648259,24,4,1989,1,male,28,18,17,27,3,27,3,0,0
1456890,28,17,1985,4,female,307,18,16,28,11,3,1,25,10
2104554,36,10,1977,5,female,434,18,9,28,40,28,40,0,0
1399340,44,20,1969,5,male,71,18,16,29,1,0,1,29,0
1816630,20,7,1993,3,female,456,18,8,29,1,20,0,9,1
2142912,39,18,1974,8,female,462,18,7,29,9,29,7,0,2
2082198,61,16,1952,8,female,414,18,13,29,10,29,8,0,2
1985241,34,16,1979,5,male,601,18,5,30,0,30,0,0,0
1199085,34,4,1979,10,female,211,18,8,31,10,31,5,0,5
1247714,33,13,1980,4,female,1825,18,12,31,24,31,20,0,4
1359590,31,5,1982,8,male,73,18,12,32,26,29,16,3,10
1932143,17,1,1996,1,female,732,18,12,32,0,32,0,0,0
1472127,41,24,1972,4,female,363,18,4,32,0,32,0,0,0
1233680,75,13,1938,5,female,102,18,13,33,13,32,4,1,9
1991449,13,20,2000,6,male,55,18,13,33,0,33,0,0,0
1122190,74,29,1939,3,female,2125,18,12,33,1,33,1,0,0
2037416,54,27,1959,4,female,38,18,11,33,18,33,16,0,2
1393870,26,1,1987,1,male,59,18,15,33,104,33,55,0,49
2062411,19,28,1994,6,male,346,18,18,34,9,34,6,0,3
2193268,26,18,1987,2,male,565,18,16,36,0,0,0,36,0
1528025,23,8,1990,1,female,275,18,6,35,25,0,9,35,16
1965438,46,16,1967,5,female,149,18,9,36,1,29,1,7,0
1897057,27,4,1986,12,male,546,18,18,35,17,33,10,2,7
1769398,43,29,1970,4,male,792,18,18,35,3,35,3,0,0
1271072,65,29,1948,5,female,716,18,8,36,6,36,2,0,4
1118423,29,2,1984,1,female,143,18,5,36,71,36,44,0,27
2053108,41,1,1972,4,male,24,18,14,39,3,39,2,0,1
1756401,47,10,1966,7,female,391,18,7,38,21,38,18,0,3
1714273,69,6,1944,12,male,1287,18,8,39,10,39,10,0,0
1667407,49,1,1964,4,male,574,18,12,40,0,40,0,0,0
1407560,79,7,1934,11,female,328,18,11,40,8,40,5,0,3
1072072,30,22,1983,4,female,421,18,8,42,11,0,0,42,11
2102836,56,1,1957,1,male,48,18,16,42,17,0,15,42,2
1932842,29,28,1984,11,male,51,18,17,43,14,43,9,0,5
1570374,20,3,1993,3,male,125,18,16,47,3,0,1,47,2
1817666,35,4,1978,1,male,205,18,13,47,0,1,0,46,0
2095143,14,24,1999,7,female,387,18,12,47,4,46,0,1,4
1360813,31,16,1982,2,female,247,18,11,46,2,40,1,6,1
1239585,48,29,1965,7,male,17,18,15,46,26,45,19,1,7
1063743,25,11,1988,7,female,65,18,13,47,17,47,7,0,10
1786023,37,16,1976,4,male,440,18,8,46,21,46,20,0,1
2152733,33,1,1980,1,female,340,18,13,48,1,48,1,0,0
1467363,28,27,1985,12,female,155,18,16,49,56,49,46,0,10
1040300,57,21,1956,1,female,5,18,16,50,40,33,19,17,21
1707521,23,17,1990,8,female,453,18,11,50,1,49,0,1,1
1397499,48,16,1965,2,male,146,18,16,51,3,51,3,0,0
1466316,77,5,1936,8,female,960,18,8,50,7,50,5,0,2
1480874,46,14,1967,5,female,35,18,15,51,101,51,84,0,17
1568182,19,18,1994,10,female,408,18,4,52,87,0,6,52,81
1110318,54,20,1959,10,female,1338,18,13,53,3,53,2,0,1
2108259,25,1,1988,1,female,265,18,16,53,21,53,21,0,0
1178814,18,7,1995,7,male,153,18,9,54,5,54,2,0,3
1275871,23,19,1990,7,female,13,18,14,55,3,55,3,0,0
1746220,28,14,1985,8,male,455,18,16,54,5,54,3,0,2
2158489,65,27,1948,4,female,97,18,11,55,9,55,5,0,4
2172896,80,7,1933,4,female,85,18,14,56,94,0,12,56,82
1291450,25,25,1988,11,female,901,18,15,57,79,54,27,3,52
1463824,33,1,1980,2,female,201,18,4,58,2,58,1,0,1
1970934,56,8,1957,5,male,249,18,15,58,9,58,9,0,0
1200050,19,25,1994,9,female,3,18,18,58,12,58,11,0,1
1118121,29,26,1984,10,male,191,18,15,60,2,60,2,0,0
1945933,77,12,1936,3,female,314,18,5,59,1,59,0,0,1
2054100,41,11,1972,7,male,69,18,13,60,43,60,32,0,11
1944909,53,19,1960,7,female,337,18,16,62,27,48,23,14,4
1949138,50,16,1963,7,female,162,18,14,61,31,61,20,0,11
1302645,68,18,1945,12,male,46,18,11,66,16,0,1,66,15
1379405,40,16,1973,9,female,315,18,5,66,27,64,14,2,13
1806635,34,20,1979,4,female,42,18,7,71,17,71,5,0,12
1952536,55,24,1958,1,female,470,18,3,69,14,69,7,0,7
1026831,47,15,1966,4,male,530,18,7,71,56,71,33,0,23
1946986,17,17,1996,11,female,10,18,14,74,9,74,5,0,4
2053736,34,16,1979,9,female,237,18,7,72,87,72,81,0,6
1060136,26,15,1987,8,male,474,18,17,75,20,0,10,75,10
2161378,68,19,1945,3,female,334,18,16,77,23,2,10,75,13
1420094,56,9,1957,4,female,873,18,13,80,98,80,91,0,7
1690700,66,23,1947,9,female,362,18,12,81,7,0,1,81,6
2097579,25,1,1988,10,female,205,18,10,83,41,82,21,1,20
1440869,32,15,1981,7,female,76,18,8,81,1,81,1,0,0
1278474,61,1,1952,10,female,2,18,17,82,33,82,19,0,14
1729244,20,23,1993,2,male,84,18,16,88,32,13,10,75,22
2034141,65,1,1948,6,female,1539,18,10,94,12,3,0,91,12
1638969,34,6,1979,12,male,607,18,12,92,8,92,8,0,0
1280252,46,28,1967,5,female,402,18,10,99,149,4,20,95,129
1240053,20,10,1993,3,male,317,18,9,102,9,0,1,102,8
1365956,64,1,1949,10,female,685,18,7,104,50,0,0,104,50
2177855,68,9,1945,5,male,893,18,15,100,194,0,16,100,178
1118259,42,20,1971,8,female,280,18,12,102,85,85,75,17,10
1056858,59,4,1954,1,female,23,18,8,104,30,104,20,0,10
2131101,65,26,1948,9,male,1451,18,11,101,67,101,66,0,1
1030323,30,10,1983,3,female,181,18,14,107,1465,107,1279,0,186
1306290,23,25,1990,10,male,81,18,14,111,15,111,13,0,2
1854575,22,1,1991,3,male,486,18,12,111,23,111,19,0,4
1314229,60,19,1953,7,female,170,18,17,119,4,0,0,119,4
1075973,40,13,1973,12,male,367,18,17,124,79,101,75,23,4
1019892,60,26,1953,4,female,986,18,13,121,19,121,15,0,4
2068291,21,20,1992,3,male,174,18,16,130,3,0,3,130,0
1294568,57,18,1956,3,male,461,18,9,130,39,109,19,21,20
2137872,30,15,1983,1,male,82,18,8,131,2,131,2,0,0
1100932,48,13,1965,3,female,138,18,6,135,79,135,59,0,20
2060656,42,27,1971,10,female,174,18,14,137,37,137,37,0,0
2032430,73,29,1940,2,male,1276,18,12,145,70,82,54,63,16
1915448,54,6,1959,5,female,343,18,16,146,23,132,14,14,9
1492697,42,2,1971,10,male,287,18,5,149,85,148,83,1,2
1420736,25,1,1988,1,male,36,18,17,147,24,147,16,0,8
1519432,30,16,1983,9,male,409,18,9,144,11,144,10,0,1
1028027,34,27,1979,8,female,286,18,14,152,36,86,1,66,35
1757710,21,22,1992,1,female,397,18,8,163,1,0,0,163,1
2037603,55,28,1958,5,male,77,18,11,159,12,0,8,159,4
1144920,43,10,1970,3,female,389,18,8,200,97,0,42,200,55
1037984,35,28,1978,7,female,27,18,14,197,202,133,95,64,107
1297340,32,11,1981,12,female,390,18,16,200,1,162,1,38,0
1483167,58,2,1955,8,female,1178,18,12,195,27,195,20,0,7
2107078,61,25,1952,2,female,432,18,6,209,31,0,0,209,31
2073496,52,10,1961,3,female,95,18,5,229,15,0,5,229,10
1530700,28,12,1985,1,male,366,18,16,227,2,172,2,55,0
1353167,45,1,1968,9,female,360,18,7,229,38,229,27,0,11
1458280,31,8,1982,7,male,107,18,13,235,75,212,66,23,9
1003870,22,1,1991,1,female,412,18,13,239,48,239,45,0,3
2109337,48,5,1965,1,female,119,18,12,234,145,234,131,0,14
1197517,44,3,1969,8,female,353,18,13,247,85,219,58,28,27
1564266,26,25,1987,9,female,564,18,15,255,93,255,59,0,34
1964057,20,19,1993,1,female,64,18,17,265,224,107,62,158,162
1752465,19,1,1994,1,female,238,18,16,285,0,285,0,0,0
1330914,33,1,1980,1,male,4,18,17,360,22,360,19,0,3
1538456,50,15,1963,1,female,21,18,16,434,265,434,253,0,12
1744709,33,21,1980,3,female,300,18,16,484,108,479,15,5,93
1644898,25,12,1988,7,female,590,18,13,705,1007,636,757,69,250
1009456,73,1,1940,1,female,257,18,7,873,49,873,30,0,19
1170091,26,1,1987,1,female,213,18,11,2061,3547,1,1458,2060,2089
1231545,35,31,1978,12,female,90,19,11,4,3,4,1,0,2
1114200,47,18,1966,12,male,822,20,11,4,3,4,1,0,2
1876980,58,12,1955,7,female,475,20,18,4,4,4,2,0,2
1398004,21,1,1992,1,male,25,20,18,4,7,4,4,0,3
2049540,24,30,1989,1,male,149,19,16,4,8,4,3,0,5
2054593,25,21,1988,4,female,376,19,8,4,7,4,7,0,0
1636937,32,27,1981,2,female,117,20,11,4,6,4,3,0,3
1876965,40,20,1973,4,female,221,19,9,4,18,4,15,0,3
2044854,51,7,1962,5,male,842,20,12,4,140,4,88,0,52
1435393,91,23,1922,4,female,437,19,10,4,8,4,3,0,5
1694641,44,29,1969,8,female,375,20,10,5,0,0,0,5,0
2040343,79,11,1934,5,female,144,19,9,5,3,0,0,5,3
1129391,74,8,1939,10,female,92,19,14,5,5,0,2,5,3
2113242,14,9,1999,4,male,19,20,19,5,51,0,12,5,39
1635357,43,17,1970,7,female,310,20,7,5,9,0,1,5,8
1627038,62,10,1951,2,male,371,19,15,5,12,0,2,5,10
1522831,21,1,1992,1,male,1,19,19,5,2,2,0,3,2
1872377,40,13,1973,9,male,194,20,19,5,1,2,1,3,0
1562335,54,16,1959,4,female,419,19,13,5,3,1,0,4,3
2097529,60,20,1953,5,male,802,19,9,5,5,2,4,3,1
1487115,69,15,1944,1,female,68,20,16,5,5,3,5,2,0
1865217,33,9,1980,1,female,97,20,15,5,59,3,59,2,0
1925250,46,21,1967,9,female,229,19,15,5,8,4,6,1,2
1609565,53,22,1960,3,male,620,20,13,5,13,4,7,1,6
1818401,16,17,1997,9,male,299,20,14,5,0,5,0,0,0
2044145,25,23,1988,8,male,196,19,13,5,0,5,0,0,0
2020887,28,7,1985,11,male,250,20,1,5,0,5,0,0,0
2065479,27,1,1986,1,male,989,19,17,5,0,5,0,0,0
1022555,30,16,1983,1,male,560,20,2,5,0,5,0,0,0
2154358,46,23,1967,5,female,271,20,16,5,0,5,0,0,0
1267214,51,2,1962,7,male,677,19,5,5,0,5,0,0,0
2119454,56,13,1957,4,male,707,20,11,5,0,5,0,0,0
1323540,67,16,1946,9,female,684,20,13,5,0,5,0,0,0
1957223,74,28,1939,8,male,1564,19,10,5,0,5,0,0,0
1899823,15,19,1998,11,male,47,20,16,5,1,5,1,0,0
1222818,19,1,1994,1,male,113,20,19,5,1,5,1,0,0
1117405,23,8,1990,11,male,236,19,15,5,1,5,1,0,0
1965324,23,10,1990,10,female,467,19,10,5,3,5,3,0,0
1576176,31,24,1982,9,male,274,19,7,5,1,5,1,0,0
1108461,36,13,1977,8,male,20,19,12,5,1,5,1,0,0
1133068,40,27,1973,10,male,596,19,14,5,2,5,2,0,0
1003247,47,21,1966,7,male,1714,20,9,5,3,5,0,0,3
1976379,52,2,1961,12,female,440,19,15,5,2,5,0,0,2
1305239,68,9,1945,3,female,1070,20,10,5,2,5,2,0,0
1873788,69,18,1944,10,male,471,19,12,5,2,5,1,0,1
1416349,21,28,1992,10,male,156,20,16,5,5,5,3,0,2
1720653,27,13,1986,7,female,645,20,10,5,5,5,1,0,4
1631716,40,21,1973,9,male,306,20,14,5,5,5,3,0,2
2108435,45,5,1968,9,female,411,20,13,5,6,5,4,0,2
2054376,50,23,1963,10,male,311,20,10,5,4,5,2,0,2
1942466,64,20,1949,10,male,404,20,8,5,4,5,2,0,2
1532733,17,5,1996,7,male,111,20,2,5,15,5,5,0,10
1361268,18,23,1995,4,female,48,20,13,5,15,5,10,0,5
2110436,27,5,1986,8,male,30,20,12,5,8,5,3,0,5
1476050,30,24,1983,3,male,340,20,8,5,9,5,9,0,0
1890273,49,2,1964,12,male,302,19,15,5,16,5,16,0,0
2159287,54,17,1959,11,female,400,20,13,5,20,5,17,0,3
1870316,22,10,1991,1,male,111,19,8,6,2,0,1,6,1
1923043,52,12,1961,6,male,389,19,3,6,2,0,0,6,2
1316485,53,12,1960,7,female,533,20,14,6,2,0,1,6,1
1253485,55,28,1958,2,male,275,19,17,6,1,0,0,6,1
1486878,14,21,1999,8,female,248,19,13,6,11,0,1,6,10
1953470,30,17,1983,6,female,656,20,9,6,41,0,25,6,16
1264644,33,1,1980,1,female,378,19,10,6,21,1,10,5,11
1209272,73,3,1940,3,male,462,20,15,6,9,0,0,6,9
2097999,73,9,1940,2,female,1346,20,12,6,2,4,2,2,0
1095981,74,20,1939,9,female,1416,20,8,6,16,4,12,2,4
1788388,51,6,1962,9,female,899,20,9,6,10,5,9,1,1
1624393,16,16,1997,4,male,36,19,16,6,0,6,0,0,0
1655092,17,1,1996,1,male,56,20,19,6,0,6,0,0,0
1714174,24,25,1989,6,male,147,19,8,6,0,6,0,0,0
1872676,33,19,1980,9,male,283,19,12,6,0,6,0,0,0
2124078,108,5,1905,1,female,577,19,9,6,0,6,0,0,0
1076662,22,3,1991,4,male,472,20,5,6,1,6,1,0,0
1360024,23,13,1990,6,male,145,19,13,6,3,6,2,0,1
1866145,25,5,1988,1,male,150,19,13,6,3,6,3,0,0
1903908,33,23,1980,4,male,1558,19,9,6,2,6,2,0,0
1135118,49,15,1964,11,male,261,20,15,6,2,6,2,0,0
1098403,52,24,1961,4,male,365,20,17,6,2,6,1,0,1
1007615,60,24,1953,5,female,66,19,2,6,3,6,3,0,0
1519518,23,1,1990,1,male,52,19,18,6,4,6,2,0,2
1867948,26,23,1987,7,female,288,19,16,6,5,6,4,0,1
1089655,33,4,1980,12,female,498,19,5,6,7,6,5,0,2
1319714,34,10,1979,12,female,231,20,12,6,7,6,5,0,2
2024836,44,5,1969,8,male,581,20,10,6,4,6,4,0,0
1626113,70,23,1943,6,female,355,20,16,6,8,6,3,0,5
1474475,14,24,1999,11,female,106,20,15,6,11,6,1,0,10
1473407,16,20,1997,9,male,179,20,13,6,19,6,18,0,1
1939698,33,1,1980,1,male,32,19,16,6,18,6,14,0,4
1653890,55,14,1958,10,male,137,20,4,6,17,6,11,0,6
1517016,22,18,1991,8,male,677,20,18,7,0,0,0,7,0
2057544,23,9,1990,7,male,93,19,12,7,0,0,0,7,0
2038696,49,6,1964,2,female,546,19,16,7,0,1,0,6,0
1899699,62,24,1951,7,female,1713,20,12,7,0,0,0,7,0
1570246,41,14,1972,12,male,520,19,12,7,4,0,3,7,1
1330929,49,20,1964,8,female,405,19,14,7,3,0,3,7,0
1403558,70,1,1943,7,female,313,20,14,7,3,0,3,7,0
1022685,23,20,1990,10,male,410,19,7,7,4,3,1,4,3
1738780,41,4,1972,8,male,316,20,14,7,8,5,4,2,4
2053760,25,27,1988,4,female,9,19,15,7,45,5,43,2,2
2140231,53,31,1960,12,male,116,20,16,7,11,5,4,2,7
1897980,46,14,1967,6,female,183,19,13,7,0,6,0,1,0
1025496,93,10,1920,5,female,1329,19,5,7,4,6,1,1,3
1433767,22,17,1991,11,male,182,20,9,7,0,7,0,0,0
1979491,22,5,1991,7,male,873,19,7,7,1,7,1,0,0
1555285,27,16,1986,11,male,58,19,19,7,1,7,0,0,1
1684823,38,27,1975,11,female,78,20,6,7,0,7,0,0,0
1316318,42,5,1971,10,male,106,19,17,7,0,7,0,0,0
1925857,62,25,1951,11,male,369,19,13,7,0,7,0,0,0
1834702,16,21,1997,12,male,96,19,15,7,4,7,0,0,4
1321844,26,18,1987,3,male,81,19,13,7,3,7,1,0,2
1420743,26,12,1987,10,male,483,19,17,7,3,7,3,0,0
1474250,29,13,1984,11,female,152,20,17,7,4,7,4,0,0
1939375,25,1,1988,10,male,62,19,14,7,7,7,2,0,5
1743449,29,4,1984,1,male,121,19,19,7,5,7,5,0,0
1807972,41,18,1972,12,female,64,19,9,7,6,7,4,0,2
1133468,50,1,1963,1,male,7,19,16,7,5,7,4,0,1
2102893,106,14,1907,4,male,1007,19,8,7,6,7,3,0,3
1788222,19,19,1994,1,male,394,20,11,7,15,7,7,0,8
1821508,21,21,1992,3,male,14,19,11,7,21,7,17,0,4
1899521,24,17,1989,8,female,517,20,8,7,16,7,15,0,1
1707467,55,4,1958,12,female,168,19,10,7,14,7,11,0,3
2119827,58,15,1955,10,female,516,19,14,7,37,7,29,0,8
1875681,15,19,1998,2,male,713,19,18,8,1,0,0,8,1
1487364,15,25,1998,8,male,74,19,14,8,1,0,0,8,1
1778343,19,11,1994,11,female,385,19,14,8,0,0,0,8,0
1708528,58,21,1955,3,female,285,20,12,8,0,0,0,8,0
1272234,69,7,1944,11,male,221,20,9,8,4,0,3,8,1
1384058,19,10,1994,1,female,187,20,4,8,36,5,19,3,17
1452418,29,3,1984,10,male,701,19,6,8,29,3,24,5,5
1272063,17,17,1996,6,male,288,19,10,8,14,7,4,1,10
2060013,25,21,1988,9,male,45,19,17,8,0,8,0,0,0
1951866,26,21,1987,3,male,459,20,18,8,1,8,1,0,0
1155813,33,4,1980,4,male,303,19,10,8,1,8,1,0,0
1629207,43,14,1970,7,male,91,19,18,8,0,8,0,0,0
2127226,55,15,1958,1,female,617,20,13,8,0,8,0,0,0
1004694,66,2,1947,5,female,2335,19,2,8,0,8,0,0,0
1189368,71,23,1942,7,female,209,20,16,8,1,8,1,0,0
1468163,23,27,1990,8,male,7,19,18,8,2,8,2,0,0
1000103,65,20,1948,2,female,595,20,7,8,4,8,2,0,2
1523726,35,19,1978,12,male,295,20,14,8,7,8,7,0,0
1933777,47,1,1966,8,male,1185,20,17,8,11,8,7,0,4
1254413,69,3,1944,7,male,671,20,15,8,5,8,4,0,1
1965828,49,25,1964,4,female,90,19,14,8,13,8,8,0,5
2003708,51,23,1962,2,male,838,19,11,8,15,8,11,0,4
1017269,70,8,1943,12,female,818,20,10,8,60,8,34,0,26
1971735,14,7,1999,1,male,453,19,19,9,0,0,0,9,0
2154889,22,28,1991,11,male,389,20,5,9,0,0,0,9,0
2105572,23,2,1990,2,female,291,19,1,9,0,0,0,9,0
1503965,65,28,1948,4,male,91,20,15,9,0,0,0,9,0
1538236,74,10,1939,4,female,840,19,15,9,1,0,1,9,0
2129290,27,7,1986,12,male,302,20,13,9,2,0,1,9,1
1138292,26,3,1987,3,male,408,20,20,9,4,0,2,9,2
1169351,75,7,1938,7,female,1576,20,12,9,4,0,0,9,4
1236394,20,5,1993,3,male,314,19,15,9,10,0,1,9,9
1938592,32,8,1981,10,male,259,19,19,9,9,0,6,9,3
1622292,22,15,1991,11,male,48,19,11,9,1,3,0,6,1
1622699,67,25,1946,2,female,310,20,15,9,3,6,0,3,3
1114505,71,9,1942,9,female,1696,19,7,9,2,4,1,5,1
1285953,21,2,1992,2,female,112,20,13,9,4,8,2,1,2
1732436,39,17,1974,6,female,573,20,13,9,3,8,2,1,1
1021334,20,1,1993,1,female,32,20,17,9,49,7,8,2,41
1042700,25,6,1988,5,male,664,19,16,9,0,9,0,0,0
1653567,37,21,1976,1,male,1206,20,6,9,0,9,0,0,0
1711907,67,4,1946,2,male,2030,20,10,9,1,9,1,0,0
2043292,71,5,1942,11,female,343,20,8,9,1,9,0,0,1
1543461,74,23,1939,3,male,869,20,10,9,1,9,1,0,0
1375222,16,8,1997,10,male,325,19,10,9,3,9,3,0,0
2030490,21,19,1992,11,female,477,20,14,9,4,9,1,0,3
1789480,23,5,1990,5,male,195,19,10,9,4,9,4,0,0
2092149,24,18,1989,3,male,58,19,14,9,4,9,4,0,0
2000265,20,4,1993,7,female,330,19,8,9,13,9,7,0,6
2182981,103,23,1910,10,female,99,20,8,9,9,9,9,0,0
1509827,23,1,1990,1,female,453,20,18,9,15,9,15,0,0
1426414,36,27,1977,10,male,66,20,9,9,20,9,10,0,10
1607406,59,23,1954,11,male,192,19,3,9,17,9,5,0,12
2181548,21,20,1992,3,male,36,20,16,10,5,0,1,10,4
1530897,43,13,1970,11,female,158,20,16,10,19,0,10,10,9
1524907,28,1,1985,1,male,402,19,17,10,0,5,0,5,0
1349391,22,18,1991,8,male,18,20,14,10,12,9,8,1,4
1317614,31,6,1982,6,female,109,20,14,10,0,10,0,0,0
1718350,35,10,1978,1,male,267,20,13,10,1,10,0,0,1
1649998,49,1,1964,12,male,153,19,15,10,0,10,0,0,0
1996542,29,8,1984,4,male,177,19,12,10,6,10,3,0,3
2152554,38,13,1975,2,female,164,19,14,10,4,10,2,0,2
1171542,46,22,1967,11,female,60,20,7,10,5,10,5,0,0
1418367,60,21,1953,12,male,62,19,16,10,2,10,2,0,0
1816576,22,11,1991,4,female,441,20,7,10,9,10,9,0,0
1008880,28,4,1985,5,female,154,20,14,10,13,10,12,0,1
1651000,55,5,1958,7,female,358,19,12,10,8,10,6,0,2
1368781,68,17,1945,8,male,112,20,18,10,16,10,15,0,1
1540321,19,20,1994,6,male,67,19,16,11,1,2,0,9,1
1577931,29,5,1984,6,male,284,20,19,11,1,0,0,11,1
1081576,31,7,1982,7,female,355,19,12,11,4,0,1,11,3
2176431,52,1,1961,7,male,116,19,15,11,3,0,1,11,2
1524828,21,8,1992,8,female,105,19,14,11,8,0,0,11,8
1768131,51,6,1962,2,female,588,20,14,11,9,0,9,11,0
1861377,53,17,1960,5,female,751,20,17,11,9,0,3,11,6
1795227,54,5,1959,12,female,425,19,11,11,20,0,9,11,11
2056053,63,3,1950,6,female,1576,19,9,11,35,0,19,11,16
1707564,93,16,1920,4,female,1547,20,12,11,5,3,0,8,5
1129357,21,23,1992,1,male,213,19,9,11,8,6,1,5,7
1464192,14,26,1999,1,female,226,20,15,11,6,9,3,2,3
1132288,46,11,1967,11,male,642,20,12,11,0,11,0,0,0
1462503,75,18,1938,12,male,1432,19,10,11,0,11,0,0,0
1459870,16,9,1997,3,male,88,20,16,11,2,11,2,0,0
1776236,28,17,1985,5,male,242,20,11,11,3,11,0,0,3
1125773,41,20,1972,3,male,213,20,13,11,6,11,5,0,1
1352651,54,1,1959,10,female,126,19,13,11,2,11,2,0,0
1838871,24,3,1989,3,female,109,20,9,11,11,11,4,0,7
2111102,26,2,1987,2,male,334,20,15,11,8,11,8,0,0
2118402,27,13,1986,3,female,228,19,13,11,10,11,10,0,0
2118958,34,10,1979,12,male,500,20,7,11,8,11,2,0,6
1762795,38,6,1975,6,male,26,20,8,11,22,11,9,0,13
1422896,65,1,1948,7,female,669,19,9,12,1,0,0,12,1
1800732,43,12,1970,12,female,490,19,18,12,3,0,1,12,2
1570630,28,3,1985,11,female,457,19,5,12,1,11,1,1,0
1673274,15,23,1998,5,male,1,20,20,12,5,10,5,2,0
1800491,17,30,1996,6,male,19,20,15,12,4,11,3,1,1
1618697,55,1,1958,5,male,285,20,8,12,4,10,3,2,1
1695767,18,5,1995,12,male,368,20,12,12,0,12,0,0,0
1226772,25,25,1988,1,female,52,19,12,12,1,12,1,0,0
1116169,36,28,1977,9,female,421,19,13,12,0,12,0,0,0
1788856,37,13,1976,6,male,174,20,15,12,0,12,0,0,0
1914701,46,8,1967,3,male,360,19,13,12,0,12,0,0,0
2021634,52,12,1961,5,female,519,20,12,12,1,12,1,0,0
1375246,21,10,1992,6,male,406,20,15,12,3,12,0,0,3
1162085,28,2,1985,9,female,102,20,16,12,5,12,5,0,0
1023329,42,1,1971,5,female,548,19,6,12,3,12,3,0,0
2103738,99,26,1914,9,female,1345,20,12,12,6,12,5,0,1
1994437,33,2,1980,2,male,740,19,16,12,9,12,1,0,8
1982966,25,12,1988,11,female,31,20,10,12,54,12,54,0,0
1677621,41,27,1972,10,male,243,20,6,12,37,12,28,0,9
1676939,66,19,1947,5,male,233,20,18,12,25,12,15,0,10
1258409,36,19,1977,10,male,408,19,14,13,0,0,0,13,0
1956983,52,28,1961,1,male,430,19,8,13,15,0,4,13,11
1326622,68,26,1945,2,male,258,20,18,13,15,0,10,13,5
1163372,38,5,1975,5,male,744,19,18,13,1,3,1,10,0
1941095,62,8,1951,9,male,1607,20,9,13,4,7,0,6,4
2114485,21,9,1992,12,male,88,19,17,13,0,13,0,0,0
1791230,24,18,1989,3,male,65,20,19,13,1,13,1,0,0
1469411,31,1,1982,6,male,57,19,17,13,1,13,0,0,1
1001567,33,13,1980,11,female,445,20,16,13,0,13,0,0,0
1203780,64,2,1949,1,female,1175,20,12,13,0,13,0,0,0
1665554,23,1,1990,1,male,20,19,17,13,4,13,4,0,0
1036616,31,22,1982,11,male,274,19,14,13,7,13,2,0,5
2146696,36,3,1977,10,male,72,19,15,13,7,13,3,0,4
1476957,25,1,1988,1,male,106,19,19,13,14,13,12,0,2
1415420,26,1,1987,1,male,403,20,15,13,10,13,10,0,0
1797980,48,22,1965,10,female,87,19,16,13,16,13,7,0,9
1421678,19,15,1994,9,male,225,20,11,14,2,0,0,14,2
1427610,37,19,1976,7,female,480,19,13,14,0,0,0,14,0
1333074,113,3,1900,8,female,1311,20,7,14,1,0,0,14,1
1463813,55,22,1958,3,female,777,19,12,14,3,0,3,14,0
2128167,58,26,1955,8,male,1077,19,10,14,3,0,3,14,0
1539325,25,3,1988,2,male,478,20,9,14,26,0,5,14,21
1189247,34,13,1979,10,male,284,19,13,14,51,0,9,14,42
1358240,63,23,1950,7,male,180,19,7,14,15,10,13,4,2
1262789,24,23,1989,3,female,488,20,13,14,30,13,28,1,2
1467200,31,5,1982,1,male,146,20,15,14,0,14,0,0,0
1485868,36,3,1977,3,female,365,20,18,14,2,14,2,0,0
1409824,26,13,1987,9,female,100,20,10,14,8,14,8,0,0
1315548,69,23,1944,6,female,746,19,9,15,1,0,0,15,1
1982667,62,20,1951,10,female,1171,20,6,15,7,10,3,5,4
1074520,18,2,1995,10,male,267,19,14,15,0,15,0,0,0
1661590,33,25,1980,1,male,365,19,16,15,0,15,0,0,0
1331774,34,11,1979,3,male,270,20,7,15,0,15,0,0,0
2081131,14,29,1999,9,male,38,20,7,15,9,15,0,0,9
1219197,36,11,1977,2,female,216,20,8,15,9,15,8,0,1
1955881,57,10,1956,9,female,1208,20,12,15,4,15,4,0,0
1065730,24,4,1989,3,male,154,19,14,15,12,15,11,0,1
2154708,30,6,1983,12,male,18,20,5,15,34,15,4,0,30
1808305,59,16,1954,4,male,384,19,6,16,2,0,1,16,1
1827447,19,1,1994,5,female,360,19,12,16,4,0,1,16,3
1890096,26,12,1987,6,male,393,19,17,16,37,0,16,16,21
1794781,56,6,1957,3,male,19,19,11,16,52,1,29,15,23
1138682,36,26,1977,10,male,1009,19,15,16,5,10,5,6,0
1283665,24,12,1989,3,male,22,19,18,16,0,16,0,0,0
2000657,40,22,1973,10,female,19,20,16,16,25,16,22,0,3
1243647,67,24,1946,11,female,87,20,20,16,37,16,24,0,13
1332498,14,14,1999,9,female,82,20,10,17,0,0,0,17,0
1604230,53,13,1960,8,female,20,20,15,17,0,0,0,17,0
2050464,64,30,1949,5,female,1171,20,10,17,1,1,0,16,1
2165487,42,8,1971,7,male,504,19,3,17,19,2,15,15,4
1139210,22,17,1991,10,female,529,19,13,17,46,0,4,17,42
1328611,33,31,1980,10,male,347,19,7,17,5,12,5,5,0
1938378,20,1,1993,1,male,49,19,18,17,0,17,0,0,0
1591170,43,23,1970,9,male,187,20,19,17,0,17,0,0,0
2098371,23,3,1990,3,male,69,20,19,17,5,17,4,0,1
2029557,53,4,1960,4,male,10,19,18,17,9,17,5,0,4
1376080,54,25,1959,12,female,50,20,13,17,45,17,27,0,18
1156871,58,2,1955,2,NA,1822,19,10,17,32,17,28,0,4
1707946,52,19,1961,7,female,124,20,12,18,24,0,14,18,10
1485249,23,3,1990,9,female,25,19,12,18,43,16,28,2,15
1443568,31,25,1982,9,male,162,19,11,18,0,18,0,0,0
1669165,42,1,1971,1,female,545,19,7,18,4,18,2,0,2
1584134,46,3,1967,4,male,103,19,15,18,10,18,9,0,1
1514922,26,1,1987,7,male,69,19,18,18,25,18,24,0,1
1282572,41,15,1972,5,female,450,20,15,18,22,18,17,0,5
1032186,52,31,1961,12,male,321,19,15,18,12,18,12,0,0
1606385,25,25,1988,3,female,51,20,14,18,38,18,35,0,3
1348583,30,4,1983,6,male,19,19,9,18,35,18,35,0,0
1355750,29,8,1984,2,male,364,19,12,19,1,14,1,5,0
1907648,71,19,1942,4,male,1543,19,6,19,1,14,0,5,1
1638995,46,4,1967,7,female,902,20,15,19,2,19,1,0,1
1138823,54,6,1959,1,male,78,19,17,19,1,19,1,0,0
1159120,28,7,1985,6,female,304,19,9,19,6,19,4,0,2
1176602,55,22,1958,7,male,647,20,12,19,5,19,1,0,4
1879402,57,2,1956,11,male,1402,20,12,19,11,19,10,0,1
1652846,40,14,1973,8,male,242,19,14,20,5,19,4,1,1
1061290,20,30,1993,5,female,133,19,14,20,52,20,30,0,22
1558440,28,16,1985,5,male,13,19,15,21,5,0,3,21,2
1187142,48,22,1965,3,female,94,20,8,21,35,0,19,21,16
1179081,67,30,1946,11,female,64,19,15,21,2,21,1,0,1
1077274,27,2,1986,5,male,30,20,10,21,9,21,9,0,0
1939866,31,26,1982,10,female,605,20,6,21,7,21,7,0,0
1957453,14,27,1999,10,male,316,20,9,22,1,0,1,22,0
2179604,73,28,1940,1,female,1173,20,8,22,0,0,0,22,0
1207121,14,22,1999,4,female,303,19,12,22,6,2,0,20,6
1032377,55,24,1958,8,female,601,19,18,22,5,0,5,22,0
2122162,108,1,1905,1,female,1850,19,7,22,4,0,2,22,2
1024133,22,5,1991,3,male,16,20,17,22,27,15,18,7,9
1064788,57,24,1956,6,male,141,20,17,22,21,6,2,16,19
1643615,35,28,1978,1,female,346,20,18,22,30,17,18,5,12
2047974,70,10,1943,1,female,467,19,17,22,20,21,13,1,7
1119045,23,9,1990,12,NA,186,19,12,22,0,22,0,0,0
1034805,24,23,1989,11,male,343,19,13,22,9,22,9,0,0
1975350,29,20,1984,8,female,226,20,4,22,26,22,20,0,6
1779078,31,2,1982,7,male,670,19,11,22,18,22,17,0,1
1335283,33,15,1980,6,female,384,19,9,22,23,22,23,0,0
1717845,36,26,1977,10,female,25,19,19,22,15,22,9,0,6
1714629,31,13,1982,10,male,230,20,20,22,37,22,18,0,19
2157988,33,10,1980,6,female,672,19,12,22,33,22,32,0,1
1278494,28,10,1985,5,female,559,19,8,23,2,13,1,10,1
1392331,24,14,1989,2,female,23,20,15,23,48,11,5,12,43
1653088,42,19,1971,1,male,179,19,14,23,0,22,0,1,0
1173973,39,19,1974,3,female,728,20,11,23,1,23,1,0,0
1975917,43,1,1970,1,female,164,19,14,24,0,0,0,24,0
1155660,22,14,1991,7,male,450,20,15,24,5,4,3,20,2
1640153,59,5,1954,11,female,731,20,10,24,7,0,2,24,5
2130916,49,8,1964,8,female,230,20,11,24,28,0,9,24,19
2048533,15,3,1998,2,male,133,20,16,24,0,15,0,9,0
1538418,26,1,1987,1,male,923,19,10,24,6,16,2,8,4
1664705,65,21,1948,9,male,1821,20,4,24,19,15,8,9,11
1038932,28,11,1985,5,male,635,20,18,24,42,9,19,15,23
1013542,40,25,1973,8,female,327,19,11,24,9,24,9,0,0
1788036,32,7,1981,8,male,647,19,14,24,19,24,14,0,5
1279491,24,16,1989,9,female,444,19,9,25,14,21,11,4,3
2153267,49,29,1964,5,female,294,20,14,25,9,24,7,1,2
1165778,49,1,1964,11,female,408,20,17,25,3,25,2,0,1
1839748,58,12,1955,2,female,1341,19,15,25,1,25,1,0,0
1024390,69,11,1944,10,male,769,20,5,25,7,25,7,0,0
2069630,21,5,1992,7,male,132,19,15,25,23,25,23,0,0
1108189,38,15,1975,2,male,70,19,14,25,97,25,80,0,17
1055499,49,10,1964,6,female,381,20,7,26,1,0,0,26,1
1156757,68,19,1945,10,female,452,20,17,26,2,0,2,26,0
1422185,33,20,1980,8,male,367,20,9,26,16,0,3,26,13
1070193,26,1,1987,1,female,355,20,12,26,2,26,0,0,2
1409376,39,23,1974,2,female,158,19,18,26,4,26,4,0,0
2065229,35,30,1978,1,male,258,19,15,26,11,26,9,0,2
1670683,59,22,1954,3,male,418,20,15,26,6,26,3,0,3
1051447,20,12,1993,8,female,539,19,13,27,21,3,14,24,7
1853698,18,18,1995,10,male,497,20,11,27,2,8,2,19,0
1284175,23,24,1990,10,male,102,19,17,27,21,9,7,18,14
1364632,54,11,1959,11,male,1401,19,4,27,9,26,7,1,2
1053083,18,4,1995,9,male,146,19,13,27,8,27,5,0,3
1865692,56,15,1957,7,female,1021,19,7,27,13,27,9,0,4
1848610,26,1,1987,8,female,522,19,8,27,38,27,29,0,9
1776023,40,1,1973,1,male,2,19,18,27,20,27,15,0,5
1552111,62,10,1951,7,male,1562,19,9,28,37,25,27,3,10
1471888,50,11,1963,7,female,644,19,8,28,4,28,4,0,0
1239699,51,9,1962,10,female,248,19,9,28,1,28,1,0,0
1443076,108,23,1905,4,female,367,19,11,28,8,28,8,0,0
1387275,31,9,1982,9,female,164,19,9,28,24,28,10,0,14
1967356,65,20,1948,2,female,661,20,19,29,16,0,3,29,13
1594432,69,30,1944,8,female,656,20,9,29,13,0,8,29,5
1131820,34,13,1979,10,male,488,19,14,29,2,29,1,0,1
1124459,51,12,1962,2,male,431,20,11,29,1,29,1,0,0
1085025,24,23,1989,9,male,13,19,15,29,5,29,3,0,2
1568956,35,29,1978,9,male,572,19,14,29,15,29,12,0,3
1735409,47,3,1966,6,male,162,20,16,29,15,29,15,0,0
1728351,18,9,1995,4,female,99,20,18,31,2,0,1,31,1
1681983,56,11,1957,7,female,670,20,8,30,9,0,4,30,5
1380750,52,25,1961,8,male,240,20,16,31,28,0,6,31,22
1390119,25,25,1988,3,female,367,20,14,31,29,23,21,8,8
1571613,38,22,1975,1,male,453,19,12,31,2,31,2,0,0
1368966,57,22,1956,11,male,12,19,18,30,2,30,2,0,0
1603351,25,1,1988,1,male,28,19,15,30,6,30,3,0,3
1078439,25,14,1988,5,male,292,20,6,30,10,30,9,0,1
1054342,36,10,1977,6,male,485,19,12,30,15,30,5,0,10
1103387,66,4,1947,9,female,588,19,10,31,6,31,5,0,1
2145454,74,17,1939,3,female,182,20,17,31,16,31,16,0,0
1995633,27,3,1986,4,male,249,19,2,30,22,30,22,0,0
1514975,24,15,1989,3,male,327,20,13,32,18,23,17,9,1
1860210,66,11,1947,5,female,343,20,11,32,0,25,0,7,0
2162975,37,20,1976,4,female,626,19,9,32,37,32,32,0,5
1709243,55,23,1958,4,female,239,19,11,32,20,32,18,0,2
1436933,67,5,1946,5,male,66,19,17,32,40,32,12,0,28
1392080,58,25,1955,1,male,747,19,12,33,10,0,2,33,8
2114768,57,4,1956,5,male,628,19,10,33,75,33,61,0,14
1683575,20,17,1993,11,male,278,19,12,34,0,1,0,33,0
1533984,54,17,1959,3,male,22,20,14,34,1,0,0,34,1
1441035,19,11,1994,2,female,617,19,6,34,0,16,0,18,0
1075688,49,1,1964,1,male,613,19,14,34,16,30,12,4,4
1122778,23,19,1990,1,male,138,20,14,34,1,34,1,0,0
1667108,25,10,1988,5,female,279,20,11,34,6,34,6,0,0
1219792,43,28,1970,12,female,371,20,8,34,13,34,13,0,0
1197567,42,29,1971,3,female,265,19,17,34,17,34,17,0,0
1652163,16,4,1997,1,male,26,19,12,34,34,34,24,0,10
2162629,67,29,1946,11,female,510,20,8,35,77,3,42,32,35
1591621,42,9,1971,9,male,138,20,10,36,3,8,2,28,1
1227948,42,21,1971,6,female,215,19,12,36,2,36,2,0,0
1342363,49,13,1964,11,male,594,20,18,36,0,36,0,0,0
1790767,42,15,1971,4,female,44,19,11,35,9,35,7,0,2
1332867,46,13,1967,1,female,1414,20,9,37,1,11,0,26,1
1010178,23,3,1990,1,male,181,20,18,37,21,16,12,21,9
1265609,18,19,1995,8,male,51,19,9,37,5,32,5,5,0
1995645,39,6,1974,11,female,162,20,12,37,11,37,11,0,0
1332020,24,22,1989,12,female,16,19,18,37,35,37,28,0,7
1771388,20,1,1993,1,male,27,19,15,38,5,0,1,38,4
1732945,20,14,1993,9,male,133,19,18,39,57,11,42,28,15
1479295,34,24,1979,5,female,368,20,11,39,0,39,0,0,0
1130789,20,30,1993,3,male,57,20,13,38,19,38,13,0,6
1540616,36,30,1977,1,female,482,20,8,38,12,38,6,0,6
1587594,53,27,1960,3,male,726,19,9,40,0,0,0,40,0
1513605,61,8,1952,10,male,1061,19,15,40,32,6,30,34,2
1316272,23,1,1990,1,male,147,19,17,40,42,32,32,8,10
1461878,29,2,1984,2,female,221,20,17,40,10,40,2,0,8
1270895,72,10,1941,8,male,170,19,13,40,9,40,4,0,5
2085945,15,23,1998,11,male,61,19,17,41,2,0,1,41,1
1275493,19,14,1994,5,male,309,20,11,42,1,0,0,42,1
1247661,29,10,1984,10,male,190,19,5,42,3,0,0,42,3
1411260,58,23,1955,1,female,80,20,18,41,9,39,6,2,3
1111273,15,1,1998,12,male,52,20,15,41,15,41,12,0,3
1203333,43,19,1970,3,female,302,20,16,42,16,42,12,0,4
1269893,36,29,1977,12,male,148,20,15,41,54,41,47,0,7
1010548,39,21,1974,5,female,466,19,7,42,31,42,28,0,3
1222738,25,10,1988,10,male,333,19,13,43,1,43,1,0,0
1781343,26,26,1987,1,female,348,20,13,44,8,44,8,0,0
1569679,48,27,1965,3,female,182,19,16,44,91,44,57,0,34
2073091,18,9,1995,10,male,368,20,15,45,0,0,0,45,0
1790446,34,11,1979,3,male,331,19,9,45,24,0,6,45,18
1668910,35,7,1978,3,female,62,19,18,45,35,11,6,34,29
1038672,30,10,1983,5,male,37,20,18,47,4,16,0,31,4
2001909,30,21,1983,10,female,1105,19,13,46,91,29,74,17,17
1262734,29,29,1984,3,female,371,19,10,48,1,0,0,48,1
1210470,46,20,1967,9,female,413,19,12,48,18,47,14,1,4
1613921,19,11,1994,2,male,580,20,15,48,35,41,22,7,13
1088569,36,3,1977,8,male,61,20,8,49,74,38,61,11,13
1158893,23,10,1990,11,male,406,19,14,48,64,48,60,0,4
1973406,26,17,1987,12,male,98,20,20,49,70,49,36,0,34
1806663,25,6,1988,1,female,52,20,15,49,37,49,35,0,2
1052176,24,5,1989,6,male,139,20,16,50,2,0,0,50,2
1136500,51,1,1962,9,male,652,19,9,50,0,0,0,50,0
1556467,60,9,1953,10,female,663,19,9,50,13,0,5,50,8
1701078,70,9,1943,11,female,104,19,11,50,25,0,16,50,9
2182958,102,5,1911,2,male,438,19,11,51,4,22,4,29,0
1365082,53,4,1960,10,male,457,19,13,51,68,42,18,9,50
1398053,27,1,1986,1,male,88,20,19,50,5,50,5,0,0
2159246,35,5,1978,10,male,106,19,18,53,14,3,6,50,8
1578513,49,22,1964,7,female,535,20,18,52,35,0,5,52,30
1215900,39,15,1974,11,female,642,20,14,52,55,49,41,3,14
1664240,19,1,1994,1,male,87,20,10,52,0,52,0,0,0
1916090,24,18,1989,11,male,235,20,7,53,0,53,0,0,0
1736654,26,7,1987,5,male,221,20,10,52,2,52,0,0,2
1227867,40,18,1973,12,female,315,20,8,53,36,53,36,0,0
1125496,60,1,1953,1,male,25,19,17,54,13,32,8,22,5
1378249,18,17,1995,4,female,511,20,17,55,0,55,0,0,0
1370884,27,11,1986,9,male,754,19,14,54,17,54,10,0,7
2153261,31,17,1982,4,male,150,19,16,54,9,54,7,0,2
2007421,29,10,1984,4,female,401,19,11,55,44,55,37,0,7
1206579,37,1,1976,1,female,86,20,13,57,33,0,19,57,14
1031292,52,1,1961,8,male,632,20,15,56,11,0,2,56,9
1952781,30,11,1983,12,female,548,20,14,58,24,12,8,46,16
1925215,53,6,1960,3,female,313,20,15,57,16,50,5,7,11
2014400,44,10,1969,1,male,481,20,12,57,62,57,36,0,26
1478246,75,17,1938,5,female,452,19,16,60,1,0,1,60,0
1825935,28,1,1985,2,female,493,20,14,59,8,17,6,42,2
2144910,25,20,1988,2,female,35,20,15,60,30,60,30,0,0
1547135,31,8,1982,6,male,43,19,10,59,29,59,17,0,12
1345808,48,20,1965,1,female,219,20,15,60,13,60,12,0,1
1729645,31,21,1982,1,female,357,20,16,60,49,60,49,0,0
1439555,33,14,1980,3,male,293,20,14,59,58,59,27,0,31
1533167,40,25,1973,4,female,204,19,8,59,40,59,36,0,4
2175702,26,16,1987,2,female,147,19,11,63,60,0,23,63,37
1607572,29,1,1984,1,male,110,19,16,62,23,61,11,1,12
1693692,56,30,1957,12,female,1028,19,12,63,44,57,38,6,6
1632454,28,25,1985,1,male,192,19,13,63,79,63,69,0,10
1299602,43,24,1970,5,female,256,19,5,62,139,62,116,0,23
1913802,27,27,1986,7,female,693,19,15,65,71,0,37,65,34
1984235,22,30,1991,5,female,1185,20,5,65,87,45,45,20,42
1786179,26,21,1987,8,male,29,19,15,64,88,64,62,0,26
1203116,23,8,1990,8,male,447,19,9,68,14,0,0,68,14
1427352,77,16,1936,11,female,893,19,11,66,21,12,16,54,5
1463665,67,11,1946,10,female,1976,20,11,68,40,65,30,3,10
1052153,59,22,1954,1,male,110,19,10,67,121,52,109,15,12
1764522,22,21,1991,10,female,118,19,19,66,2,66,2,0,0
1714305,28,2,1985,2,male,243,19,4,67,1,67,1,0,0
2126481,60,8,1953,3,female,283,20,17,66,17,66,8,0,9
1647770,14,12,1999,4,female,95,19,6,70,63,0,38,70,25
1256447,47,26,1966,10,male,1946,20,13,71,123,30,113,41,10
2051364,36,16,1977,5,female,20,19,15,70,28,70,16,0,12
1251677,43,31,1970,5,male,332,19,14,69,48,69,42,0,6
1668508,19,7,1994,3,female,196,19,13,73,46,3,3,70,43
1918290,35,23,1978,8,female,184,20,15,73,16,72,14,1,2
1522825,56,2,1957,4,male,290,20,12,72,58,57,38,15,20
1686628,66,11,1947,7,female,506,19,12,74,0,74,0,0,0
1388228,43,14,1970,6,male,269,19,14,77,3,0,0,77,3
1180455,43,20,1970,4,female,232,20,14,75,19,8,8,67,11
1821084,66,5,1947,10,female,620,19,9,76,2,67,0,9,2
1217636,103,28,1910,2,female,911,20,17,77,33,70,22,7,11
2107432,108,13,1905,6,female,138,19,17,77,1,77,0,0,1
1640337,64,22,1949,9,male,764,19,13,78,2,78,1,0,1
1703233,50,9,1963,9,female,181,20,7,83,0,83,0,0,0
1015518,26,18,1987,3,male,291,20,16,83,14,83,13,0,1
1884750,30,4,1983,10,female,313,19,9,83,61,83,53,0,8
1926910,54,28,1959,10,female,613,19,15,87,26,67,20,20,6
1387342,66,6,1947,1,female,285,20,18,86,9,86,4,0,5
1041153,66,15,1947,10,female,677,20,15,86,18,86,14,0,4
2078921,37,20,1976,10,female,74,19,11,86,69,86,65,0,4
1244163,18,20,1995,10,male,264,19,13,88,6,79,3,9,3
1170181,25,9,1988,9,female,291,20,17,88,3,88,2,0,1
1571857,18,15,1995,12,female,2,19,15,93,102,0,14,93,88
1740386,21,7,1992,9,female,489,19,6,96,41,13,9,83,32
1004536,108,30,1905,9,female,136,20,15,97,55,9,9,88,46
1129743,59,6,1954,7,female,1811,19,10,96,4,46,3,50,1
1271483,42,1,1971,1,male,216,20,17,97,1,97,1,0,0
1386002,53,13,1960,8,female,257,20,6,98,2,98,1,0,1
1037652,50,31,1963,7,female,540,20,11,99,29,99,11,0,18
1325922,18,21,1995,7,male,235,19,18,102,33,0,4,102,29
1837764,40,5,1973,10,female,432,20,16,101,15,99,11,2,4
1305844,60,6,1953,11,female,300,20,9,103,12,103,11,0,1
1684029,39,27,1974,7,male,373,19,10,109,25,0,7,109,18
1998213,25,1,1988,1,male,31,20,11,108,31,65,11,43,20
1185161,18,20,1995,7,male,309,19,5,106,20,106,2,0,18
1479901,55,1,1958,7,male,21,19,13,111,22,50,12,61,10
2069718,29,7,1984,1,male,165,19,18,112,16,110,16,2,0
2080383,17,17,1996,1,female,476,20,14,112,49,92,46,20,3
1726368,25,1,1988,1,male,270,20,13,113,5,113,4,0,1
1532038,40,27,1973,6,female,509,20,11,110,1,110,1,0,0
1010792,65,12,1948,2,female,223,20,14,113,0,113,0,0,0
1565082,37,27,1976,7,female,41,19,14,112,51,112,7,0,44
2099426,41,6,1972,11,male,499,20,14,113,79,113,77,0,2
1037606,46,7,1967,8,female,483,19,11,114,21,113,17,1,4
1831424,49,19,1964,9,male,226,19,19,117,11,117,6,0,5
1184741,21,4,1992,3,female,78,19,15,114,109,114,65,0,44
1772460,30,23,1983,4,female,482,20,4,117,98,117,40,0,58
1245803,38,26,1975,7,female,641,19,11,117,115,117,83,0,32
1285941,98,29,1915,10,male,1725,19,11,121,111,9,70,112,41
1296447,57,8,1956,8,female,73,20,12,124,31,63,20,61,11
1220262,16,8,1997,1,female,215,19,8,120,99,120,71,0,28
1525363,30,20,1983,10,male,106,20,8,125,58,125,37,0,21
1732035,45,20,1968,11,female,223,19,12,132,29,132,24,0,5
1480635,64,19,1949,1,male,104,19,16,141,25,141,22,0,3
2189184,81,27,1932,9,male,223,20,12,146,2,1,2,145,0
1421806,49,28,1964,4,female,1494,19,13,150,86,105,56,45,30
1045590,19,14,1994,9,female,318,20,19,148,9,136,8,12,1
1469997,20,10,1993,5,male,293,20,12,150,6,150,4,0,2
1157847,51,30,1962,4,male,241,20,15,144,141,144,133,0,8
1031306,53,20,1960,8,female,477,20,8,157,66,0,28,157,38
1350243,22,3,1991,7,female,789,20,16,156,6,107,6,49,0
1952688,18,1,1995,1,female,2,19,14,155,119,36,24,119,95
1178176,59,6,1954,3,female,439,19,17,156,3,142,3,14,0
1697929,17,9,1996,1,female,116,20,7,156,81,154,34,2,47
1508303,16,21,1997,10,female,10,20,16,158,69,36,15,122,54
1806290,18,1,1995,3,male,119,20,16,161,20,158,11,3,9
1112875,18,14,1995,5,male,29,20,15,163,20,163,17,0,3
1569887,48,24,1965,12,female,272,20,6,169,38,0,26,169,12
1801533,56,25,1957,11,female,104,19,15,166,38,0,1,166,37
1261608,38,9,1975,6,female,240,20,17,172,11,169,5,3,6
2041608,56,12,1957,1,female,638,20,9,179,38,0,30,179,8
2095962,21,12,1992,8,male,371,19,16,187,4,0,1,187,3
1280401,25,22,1988,10,female,397,19,8,184,18,183,13,1,5
1063865,42,25,1971,1,female,367,19,10,183,11,183,7,0,4
1105728,55,5,1958,12,male,799,20,4,186,15,186,4,0,11
2066878,56,24,1957,5,male,760,20,5,196,27,118,15,78,12
1801874,33,5,1980,10,male,610,20,6,200,72,200,54,0,18
1588831,52,15,1961,10,female,90,20,16,193,42,193,23,0,19
1285834,56,3,1957,6,female,214,20,5,191,102,191,30,0,72
1891429,67,20,1946,7,female,382,20,7,198,91,198,32,0,59
2181116,50,16,1963,2,female,721,19,9,206,20,0,6,206,14
1585941,67,25,1946,7,female,1334,20,9,206,10,40,6,166,4
2096211,27,10,1986,12,female,435,20,14,210,115,202,41,8,74
1290474,31,1,1982,1,female,115,19,15,205,107,204,63,1,44
1731454,16,24,1997,12,female,284,20,8,211,58,211,17,0,41
2076345,28,14,1985,7,female,680,20,16,216,0,0,0,216,0
1899242,19,13,1994,7,female,125,20,17,220,56,220,30,0,26
2147434,23,11,1990,9,male,338,19,12,229,15,229,8,0,7
1825416,35,2,1978,3,female,436,20,15,222,29,222,29,0,0
1285608,43,11,1970,3,female,452,20,15,229,29,229,26,0,3
1300525,22,14,1991,9,female,514,19,8,242,534,238,70,4,464
1506555,47,10,1966,5,female,394,20,14,239,6,238,3,1,3
1174656,43,20,1970,9,male,478,20,7,243,15,243,12,0,3
1543394,38,14,1975,2,male,510,20,3,263,35,262,30,1,5
1188670,29,26,1984,6,female,123,19,9,262,74,262,53,0,21
2092385,46,1,1967,8,female,97,19,16,272,461,272,381,0,80
1797304,53,3,1960,1,male,57,20,6,282,126,1,86,281,40
1616130,18,17,1995,4,male,185,20,8,292,32,262,11,30,21
1695793,39,16,1974,6,female,105,19,14,300,19,300,15,0,4
1379884,34,29,1979,11,male,154,20,6,294,52,294,52,0,0
1194543,36,1,1977,8,female,342,20,5,309,34,234,27,75,7
1581597,14,2,1999,1,male,92,19,14,323,80,315,78,8,2
1646679,25,1,1988,1,male,31,20,18,309,7,309,7,0,0
1642274,45,20,1968,1,female,554,20,16,319,1,319,1,0,0
2149911,19,1,1994,1,female,366,20,8,340,201,48,21,292,180
1378684,18,17,1995,10,female,433,20,8,333,92,183,66,150,26
1089398,108,19,1905,4,female,141,20,11,336,2,300,0,36,2
1077660,19,25,1994,4,female,457,19,7,353,335,3,181,350,154
1229177,23,2,1990,1,female,145,20,12,351,93,346,29,5,64
1546482,69,8,1944,5,female,1000,20,11,395,201,14,19,381,182
1587920,42,22,1971,11,NA,1059,19,10,402,45,402,13,0,32
2033916,62,29,1951,9,female,161,20,18,442,143,440,116,2,27
1512667,73,3,1940,6,male,1493,19,5,460,77,0,18,460,59
1465007,32,1,1981,1,female,151,19,9,480,427,477,131,3,296
1102392,25,11,1988,11,female,199,19,6,547,138,547,102,0,36
1740527,51,9,1962,8,male,211,20,15,593,15,0,2,593,13
1665269,25,16,1988,8,female,82,19,9,595,20,595,11,0,9
1168913,56,12,1957,10,male,42,19,12,617,155,485,72,132,83
1713917,45,15,1968,10,male,346,20,14,642,0,642,0,0,0
1114196,20,18,1993,8,female,29,20,16,683,209,608,165,75,44
2009038,50,20,1963,8,female,887,19,14,772,11,286,5,486,6
1562940,56,1,1957,1,male,101,20,18,826,104,0,52,826,52
1903427,33,23,1980,5,female,92,19,11,1221,118,1220,53,1,65
1129590,45,15,1968,5,female,193,20,16,1568,416,208,5,1360,411
1261712,58,23,1955,10,male,1319,20,16,1710,125,1710,116,0,9
1471682,41,30,1972,7,female,1548,20,7,2330,512,1896,367,434,145
1675983,49,25,1964,7,female,239,20,10,2384,431,2384,410,0,21
2168149,77,13,1936,1,male,679,21,7,3,3,0,0,3,3
2076813,41,23,1972,4,female,352,21,18,3,21,0,10,3,11
2011869,77,21,1936,5,female,42,21,16,3,31,0,20,3,11
1076760,19,2,1994,10,male,105,21,13,3,0,1,0,2,0
1484045,65,17,1948,6,female,1139,21,15,3,8,2,6,1,2
1357922,21,11,1992,5,male,47,21,10,3,0,3,0,0,0
1656883,23,24,1990,8,male,100,21,21,3,0,3,0,0,0
1338015,26,7,1987,11,female,190,21,11,3,0,3,0,0,0
1052694,26,23,1987,12,male,22,21,6,3,0,3,0,0,0
1795343,25,18,1988,1,female,414,21,18,3,0,3,0,0,0
1223532,25,1,1988,1,male,194,21,9,3,0,3,0,0,0
1195474,26,3,1987,9,male,264,21,18,3,0,3,0,0,0
1506171,46,17,1967,3,male,574,21,12,3,0,3,0,0,0
1140464,66,12,1947,11,female,757,21,8,3,0,3,0,0,0
2113529,18,22,1995,11,male,223,21,17,3,1,3,1,0,0
1348325,25,5,1988,10,male,114,21,10,3,1,3,0,0,1
1591083,22,10,1991,10,male,52,21,9,3,2,3,1,0,1
1094741,35,21,1978,6,male,365,21,16,3,2,3,1,0,1
1259691,60,20,1953,6,female,151,21,18,3,4,3,2,0,2
1644120,65,23,1948,12,female,87,21,9,3,2,3,1,0,1
1385833,69,17,1944,9,female,93,21,14,3,3,3,2,0,1
1947382,20,27,1993,8,female,267,21,13,3,7,3,5,0,2
2144333,30,4,1983,1,male,56,21,6,3,5,3,4,0,1
1246466,33,17,1980,10,male,572,21,16,3,29,3,11,0,18
1398723,52,30,1961,3,female,280,21,18,3,5,3,4,0,1
1516244,55,12,1958,4,male,605,21,15,3,8,3,7,0,1
1903104,61,23,1952,8,female,223,21,13,3,12,3,9,0,3
1638557,23,10,1990,12,female,682,21,18,4,0,0,0,4,0
1899915,14,31,1999,12,male,157,21,17,4,1,0,0,4,1
1673846,18,22,1995,9,male,10,21,16,4,1,0,1,4,0
1150549,20,6,1993,3,female,807,21,14,4,1,0,1,4,0
1649532,77,13,1936,3,female,406,21,11,4,1,0,1,4,0
2031189,76,4,1937,7,male,361,21,13,4,5,0,2,4,3
1755055,43,2,1970,12,male,584,21,13,4,0,2,0,2,0
1362084,49,30,1964,11,male,439,21,21,4,0,3,0,1,0
2042547,54,21,1959,2,female,1568,21,11,4,1,3,0,1,1
2131745,23,12,1990,5,female,153,21,10,4,0,4,0,0,0
1208138,25,1,1988,1,male,21,21,6,4,2,4,2,0,0
1893046,27,4,1986,10,male,303,21,14,4,1,4,0,0,1
1268274,50,26,1963,10,male,223,21,16,4,2,4,2,0,0
1875244,25,16,1988,6,male,256,21,19,4,3,4,3,0,0
2144011,28,25,1985,10,female,395,21,10,4,5,4,4,0,1
1123182,49,3,1964,4,male,1103,21,11,4,4,4,2,0,2
2104238,64,15,1949,6,female,440,21,17,4,3,4,2,0,1
1436854,65,5,1948,3,female,1470,21,13,4,3,4,2,0,1
1413147,18,23,1995,10,female,112,21,14,4,19,4,17,0,2
1162034,23,30,1990,11,male,16,21,12,4,23,4,23,0,0
1861217,23,14,1990,2,male,151,21,9,4,7,4,7,0,0
1734871,24,25,1989,4,male,133,21,19,4,8,4,1,0,7
1304642,27,5,1986,3,female,475,21,14,4,25,4,21,0,4
1525813,29,6,1984,10,male,437,21,16,4,42,4,20,0,22
1364360,32,10,1981,9,male,107,21,8,4,13,4,8,0,5
1241581,38,14,1975,6,male,6,21,20,4,13,4,3,0,10
1697217,54,30,1959,4,female,29,21,17,4,7,4,4,0,3
1574091,18,3,1995,11,male,19,21,16,5,0,0,0,5,0
1848510,26,6,1987,4,male,594,21,9,5,0,0,0,5,0
1191321,75,1,1938,2,female,441,21,19,5,3,0,2,5,1
1221558,62,20,1951,12,female,1373,21,10,5,12,0,5,5,7
1913388,48,1,1965,5,female,549,21,4,5,4,3,3,2,1
1484520,18,21,1995,6,male,224,21,20,5,0,5,0,0,0
2193499,29,4,1984,12,male,263,21,14,5,0,5,0,0,0
1533348,34,26,1979,2,male,501,21,9,5,0,5,0,0,0
1504076,34,2,1979,9,male,537,21,13,5,0,5,0,0,0
1281184,67,5,1946,10,female,1178,21,12,5,0,5,0,0,0
1183170,108,23,1905,4,male,1157,21,15,5,0,5,0,0,0
1999712,20,20,1993,5,male,28,21,18,5,1,5,1,0,0
1774790,20,25,1993,8,male,24,21,19,5,1,5,1,0,0
1836434,22,15,1991,11,female,207,21,12,5,3,5,3,0,0
1596627,26,18,1987,4,male,253,21,4,5,1,5,1,0,0
1080381,28,26,1985,5,male,23,21,21,5,1,5,0,0,1
1187963,64,9,1949,9,male,233,21,18,5,2,5,2,0,0
1250056,38,23,1975,10,male,67,21,19,5,5,5,5,0,0
1721379,29,20,1984,4,male,34,21,12,5,16,5,16,0,0
1693836,20,28,1993,10,male,366,21,15,6,12,0,3,6,9
1085387,43,14,1970,9,male,373,21,3,6,16,4,4,2,12
1428175,13,19,2000,2,male,107,21,14,6,2,5,0,1,2
2063450,23,1,1990,1,male,240,21,20,6,0,6,0,0,0
1686001,44,4,1969,7,male,355,21,16,6,0,6,0,0,0
2086824,25,3,1988,7,female,489,21,1,6,1,6,0,0,1
1530649,33,12,1980,4,male,19,21,20,6,1,6,1,0,0
1766412,18,15,1995,7,male,114,21,17,6,5,6,2,0,3
1189879,45,4,1968,5,male,393,21,9,6,5,6,5,0,0
1888671,68,17,1945,10,male,560,21,9,6,8,6,7,0,1
2037545,20,20,1993,11,male,110,21,9,6,12,6,4,0,8
1671595,19,21,1994,12,male,141,21,10,7,1,0,0,7,1
1816346,18,8,1995,1,male,699,21,13,7,4,0,3,7,1
1433157,19,1,1994,1,male,284,21,6,7,2,0,0,7,2
1559685,53,27,1960,6,male,22,21,18,7,33,2,21,5,12
1916330,19,12,1994,4,female,395,21,12,7,0,7,0,0,0
1162632,25,1,1988,1,male,202,21,8,7,0,7,0,0,0
1079387,31,16,1982,10,female,416,21,15,7,0,7,0,0,0
1885671,37,27,1976,7,male,495,21,12,7,0,7,0,0,0
1182571,51,29,1962,4,male,314,21,13,7,0,7,0,0,0
1588406,24,19,1989,12,male,1029,21,18,7,2,7,1,0,1
1541595,45,25,1968,9,female,268,21,14,7,3,7,3,0,0
1084532,22,15,1991,1,female,174,21,10,7,9,7,8,0,1
1047630,30,4,1983,10,male,392,21,3,7,10,7,9,0,1
1488861,54,4,1959,1,female,490,21,12,7,6,7,6,0,0
1429344,79,6,1934,3,male,826,23,15,15,9,0,7,15,2
1927118,18,7,1995,7,female,299,22,8,15,5,6,0,9,5
1791703,20,13,1993,6,female,285,23,7,15,18,4,18,11,0
1543258,24,18,1989,10,male,569,22,15,15,1,11,1,4,0
1368818,27,7,1986,1,male,96,23,20,15,9,12,7,3,2
1470002,24,23,1989,8,male,52,22,13,15,0,15,0,0,0
1110756,53,3,1960,3,female,280,23,17,15,1,15,0,0,1
1718638,70,30,1943,9,male,99,23,5,15,1,15,1,0,0
1786973,17,1,1996,1,male,110,23,23,15,7,15,7,0,0
2142720,30,27,1983,7,male,64,23,20,15,7,15,7,0,0
1002103,45,5,1968,1,female,127,22,14,15,4,15,3,0,1
1282301,101,12,1912,12,female,33,22,18,15,9,15,9,0,0
1891873,65,29,1948,8,female,363,23,19,15,13,15,9,0,4
1788834,63,20,1950,3,female,39,22,11,16,9,0,0,16,9
1679559,66,7,1947,4,female,600,23,16,16,7,1,1,15,6
1671619,17,8,1996,4,male,278,22,15,16,0,7,0,9,0
1683635,32,14,1981,8,female,709,23,14,16,1,15,1,1,0
1121838,33,4,1980,9,male,17,23,11,16,51,12,17,4,34
1965830,42,26,1971,2,female,452,23,20,16,50,13,43,3,7
1526187,17,16,1996,7,female,602,22,17,16,1,16,1,0,0
2114789,66,9,1947,1,female,488,22,19,16,2,16,0,0,2
1182842,23,2,1990,8,male,274,22,15,16,6,16,5,0,1
1843519,41,30,1972,10,male,266,22,8,16,51,16,34,0,17
1657699,42,23,1971,9,male,212,23,18,17,1,0,0,17,1
1022514,21,21,1992,10,male,27,23,14,17,14,2,11,15,3
1814493,63,30,1950,6,female,697,22,9,17,13,0,5,17,8
1056044,18,4,1995,10,male,468,22,8,17,11,12,1,5,10
1687335,27,2,1986,8,male,847,22,13,17,15,12,8,5,7
1589467,28,1,1985,1,male,745,23,11,17,0,17,0,0,0
1254390,47,5,1966,8,female,153,22,15,17,1,17,1,0,0
1564249,70,13,1943,12,female,205,23,11,17,0,17,0,0,0
1362209,22,1,1991,1,male,243,23,18,17,17,17,8,0,9
1992346,26,12,1987,6,female,302,22,16,17,17,17,6,0,11
2011533,38,16,1975,7,female,303,23,11,17,12,17,5,0,7
1531827,43,20,1970,4,female,111,22,20,17,14,17,11,0,3
1624779,14,13,1999,6,male,32,23,14,17,58,17,33,0,25
1571179,26,13,1987,10,male,474,23,20,18,0,0,0,18,0
1731841,53,10,1960,10,female,635,22,22,18,14,0,1,18,13
1066019,68,17,1945,8,female,593,23,15,18,36,3,26,15,10
1965885,28,3,1985,12,male,1627,23,20,18,1,15,0,3,1
1370591,21,5,1992,2,male,74,23,22,18,1,18,0,0,1
1421884,32,5,1981,7,female,327,23,17,18,1,18,1,0,0
1770022,34,6,1979,6,female,87,23,13,18,0,18,0,0,0
1765813,39,15,1974,8,female,302,22,14,18,1,18,1,0,0
1041792,34,25,1979,11,male,122,22,17,18,4,18,1,0,3
2021818,24,7,1989,8,male,333,23,12,18,17,18,3,0,14
1656096,29,1,1984,5,male,516,22,16,18,33,18,20,0,13
1714144,51,3,1962,3,male,992,22,7,18,30,18,16,0,14
1837378,55,22,1958,12,female,411,22,15,19,13,0,8,19,5
1156919,108,1,1905,1,male,1733,23,12,19,44,0,13,19,31
2103819,24,23,1989,9,male,799,22,14,19,3,10,2,9,1
1392744,29,11,1984,1,male,201,22,11,19,4,18,3,1,1
1124640,38,7,1975,7,female,282,22,19,19,7,18,4,1,3
1204036,20,20,1993,2,female,21,23,4,19,2,19,2,0,0
1522439,31,10,1982,4,male,144,23,23,19,0,19,0,0,0
1694285,33,6,1980,1,female,479,23,10,19,2,19,2,0,0
1933749,44,10,1969,3,female,70,23,16,19,2,19,0,0,2
1197078,64,15,1949,5,female,736,23,16,19,1,19,0,0,1
1825380,60,26,1953,4,male,1571,23,12,19,14,19,10,0,4
1629379,23,18,1990,3,female,244,22,15,19,88,19,27,0,61
1071270,19,1,1994,1,female,125,22,16,20,2,2,0,18,2
1558465,22,20,1991,9,female,139,23,21,20,1,0,1,20,0
1097455,25,1,1988,1,female,269,22,13,20,1,2,0,18,1
2145433,108,1,1905,4,female,1361,23,8,20,26,0,16,20,10
1043481,26,8,1987,8,male,501,22,12,20,6,9,5,11,1
1365572,26,4,1987,5,male,38,22,16,20,3,15,2,5,1
1195235,23,1,1990,1,male,336,23,17,20,0,20,0,0,0
1294115,47,29,1966,8,male,458,22,7,20,3,20,1,0,2
1523444,20,1,1993,7,male,182,22,16,20,4,20,4,0,0
1458907,25,1,1988,1,female,13,23,12,20,9,20,9,0,0
1422632,20,9,1993,8,female,235,22,7,20,39,20,34,0,5
2050631,27,1,1986,2,female,504,22,9,21,3,15,3,6,0
1844051,39,7,1974,4,female,431,23,12,21,18,21,14,0,4
1859749,33,16,1980,10,male,763,22,14,22,4,0,0,22,4
1294359,74,12,1939,6,male,1543,22,6,22,33,0,10,22,23
1609779,19,31,1994,5,male,128,22,5,22,7,10,5,12,2
2057327,21,22,1992,3,male,37,22,16,22,4,12,3,10,1
1322887,48,22,1965,9,male,405,22,15,22,31,16,23,6,8
1461133,16,11,1997,3,male,69,22,19,22,2,22,2,0,0
1090098,27,17,1986,2,female,206,22,10,22,3,22,3,0,0
1563219,35,2,1978,8,male,26,23,19,22,0,22,0,0,0
1577568,50,21,1963,7,female,241,22,19,22,2,22,2,0,0
1196378,51,13,1962,1,male,191,22,15,22,0,22,0,0,0
1474929,20,15,1993,7,male,264,22,22,22,13,22,12,0,1
1734534,25,17,1988,4,female,93,22,17,22,6,22,4,0,2
1474487,34,13,1979,10,male,327,23,17,22,4,22,1,0,3
1931434,67,16,1946,2,female,1180,22,11,22,5,22,5,0,0
1665650,100,31,1913,8,female,18,22,19,22,18,22,17,0,1
1333221,79,23,1934,8,female,1260,22,13,23,1,0,0,23,1
2188023,62,17,1951,3,male,682,22,13,23,13,0,3,23,10
1991720,58,21,1955,1,male,427,22,16,23,24,0,6,23,18
1056042,16,8,1997,2,female,422,22,18,23,0,11,0,12,0
2131731,21,17,1992,7,female,210,23,23,23,6,12,5,11,1
1966018,53,7,1960,8,female,424,22,19,23,8,7,6,16,2
1158051,74,25,1939,4,female,1371,23,4,23,0,20,0,3,0
1464456,22,19,1991,6,male,13,23,20,23,17,23,9,0,8
1970447,38,28,1975,11,male,502,23,13,23,71,23,30,0,41
1880630,74,11,1939,12,male,711,22,21,24,6,0,2,24,4
1200766,22,1,1991,6,female,422,23,14,24,17,0,9,24,8
1385266,21,1,1992,1,male,162,23,17,24,0,6,0,18,0
1134851,64,3,1949,9,female,138,22,18,24,7,8,5,16,2
1748301,28,8,1985,9,male,175,22,17,24,1,24,1,0,0
1085066,69,7,1944,12,male,819,23,13,24,3,24,1,0,2
1555225,42,21,1971,11,male,94,22,13,24,10,24,5,0,5
1018249,22,24,1991,5,male,65,22,19,24,30,24,20,0,10
1294022,45,9,1968,2,male,42,23,15,24,17,24,16,0,1
2154787,45,10,1968,8,male,408,23,21,25,1,0,0,25,1
1378682,25,8,1988,5,female,432,23,14,25,13,25,7,0,6
1081149,30,15,1983,3,male,292,23,21,25,34,25,12,0,22
1298524,46,30,1967,3,male,369,22,7,25,16,25,16,0,0
1672501,76,17,1937,3,male,315,22,12,25,18,25,17,0,1
1546725,33,28,1980,8,female,217,22,17,25,57,25,40,0,17
1947766,44,20,1969,9,male,252,22,18,25,48,25,20,0,28
1217812,54,12,1959,10,male,263,23,12,26,1,0,0,26,1
1419078,26,20,1987,8,female,163,22,16,26,26,0,1,26,25
1621877,73,7,1940,1,female,1209,23,12,26,3,26,2,0,1
1998816,18,23,1995,9,male,5,22,18,26,13,26,13,0,0
1408886,21,1,1992,1,male,237,22,15,26,8,26,8,0,0
2089678,25,10,1988,9,male,242,22,12,26,19,26,5,0,14
1658895,34,6,1979,1,female,291,22,15,26,22,26,15,0,7
1881588,55,24,1958,9,male,561,23,19,26,24,26,23,0,1
1698974,24,22,1989,5,male,245,22,17,27,1,14,0,13,1
2137574,18,19,1995,12,female,282,23,14,27,12,26,4,1,8
2039082,18,13,1995,4,male,442,23,8,27,0,27,0,0,0
2138670,54,17,1959,2,female,457,22,14,27,11,27,4,0,7
1423121,66,15,1947,10,female,69,23,11,27,6,27,6,0,0
1003897,69,13,1944,11,male,502,22,5,27,10,27,9,0,1
1545619,72,8,1941,7,male,116,23,18,27,40,27,14,0,26
1857781,17,9,1996,9,female,126,22,15,27,50,27,43,0,7
1135893,54,7,1959,8,female,1496,23,12,28,2,5,0,23,2
1050603,14,17,1999,5,male,88,23,20,28,6,1,1,27,5
1083787,63,24,1950,12,female,646,22,16,28,13,2,8,26,5
1581239,53,21,1960,3,male,103,23,18,28,39,0,7,28,32
1188947,61,8,1952,5,female,292,23,18,28,8,19,4,9,4
1608091,21,29,1992,7,female,529,23,16,28,3,23,2,5,1
1003843,39,3,1974,4,male,297,22,9,28,11,28,9,0,2
1867577,52,29,1961,4,female,746,23,10,28,25,28,16,0,9
1823087,43,2,1970,2,female,604,23,10,28,47,28,37,0,10
1102868,27,30,1986,3,male,263,22,18,29,0,0,0,29,0
2049137,66,20,1947,8,male,508,22,13,29,1,5,1,24,0
1478459,73,25,1940,2,female,1522,22,16,29,4,10,3,19,1
1484933,25,11,1988,2,male,53,22,12,29,15,20,12,9,3
1732543,46,17,1967,2,female,39,22,13,29,19,28,10,1,9
2035023,35,23,1978,7,female,600,22,14,29,0,29,0,0,0
1702744,26,17,1987,10,female,31,22,16,29,21,29,9,0,12
1725468,49,10,1964,4,male,714,23,11,31,1,0,1,31,0
1653734,63,5,1950,9,male,1580,22,6,31,9,16,6,15,3
2096401,23,4,1990,6,male,61,23,15,31,39,17,30,14,9
1523647,25,1,1988,1,female,208,22,11,30,15,28,9,2,6
1700067,112,11,1901,9,male,1164,22,8,30,31,23,20,7,11
1973874,17,6,1996,10,female,479,23,20,31,0,31,0,0,0
1711700,25,2,1988,3,male,297,23,5,31,5,31,4,0,1
1899905,28,14,1985,10,male,351,23,15,30,0,30,0,0,0
2156160,45,23,1968,10,male,524,22,7,31,1,31,1,0,0
1370013,17,1,1996,1,male,103,23,20,31,11,31,5,0,6
1291659,65,19,1948,10,female,625,22,19,30,13,30,4,0,9
1655230,24,14,1989,4,female,353,22,4,32,12,32,7,0,5
1652054,20,19,1993,9,male,510,22,13,33,2,2,0,31,2
2000436,48,8,1965,3,female,124,22,11,33,0,0,0,33,0
1729877,25,13,1988,9,male,251,23,16,33,38,0,2,33,36
1538915,43,12,1970,11,female,789,23,20,33,10,15,3,18,7
1989046,33,15,1980,6,female,547,22,14,33,27,33,26,0,1
1490806,70,13,1943,7,male,556,22,19,34,6,0,1,34,5
2014864,26,2,1987,2,male,217,22,19,34,4,34,1,0,3
1855176,42,3,1971,11,male,286,23,10,34,20,34,18,0,2
1291613,69,4,1944,4,male,62,22,10,34,9,34,3,0,6
2142557,28,12,1985,12,male,194,22,18,34,33,34,29,0,4
1204745,31,30,1982,11,female,914,22,19,34,32,34,27,0,5
1738623,40,27,1973,2,female,41,22,5,34,22,34,12,0,10
1124355,15,12,1998,7,male,320,23,17,35,2,3,2,32,0
1102743,68,1,1945,12,female,617,23,22,35,49,0,3,35,46
1680773,23,1,1990,11,female,192,23,20,36,3,34,2,2,1
2038640,38,15,1975,8,male,28,22,19,36,3,36,3,0,0
1636638,49,7,1964,7,female,206,22,9,35,6,35,3,0,3
1870539,42,24,1971,11,male,183,22,14,35,45,35,45,0,0
1331989,45,27,1968,8,female,82,22,14,36,38,36,30,0,8
1128340,47,3,1966,10,female,207,22,15,35,27,35,24,0,3
1225748,16,6,1997,6,male,187,22,14,37,4,37,2,0,2
1850026,46,3,1967,10,male,551,23,19,37,18,37,15,0,3
1182305,53,26,1960,8,male,21,22,14,37,10,37,10,0,0
1329537,39,1,1974,1,female,1608,23,18,37,27,37,7,0,20
1088685,27,18,1986,1,female,622,22,17,37,116,37,65,0,51
1679989,38,5,1975,5,male,545,23,15,38,3,0,0,38,3
1033249,66,18,1947,11,male,32,22,19,39,33,0,5,39,28
2080906,25,28,1988,1,female,775,23,13,39,6,17,4,22,2
1647974,21,9,1992,11,male,9,22,20,39,43,17,36,22,7
1521743,40,1,1973,5,male,1136,23,12,38,45,28,26,10,19
1649171,17,10,1996,5,male,216,22,19,38,3,38,1,0,2
2135823,18,27,1995,5,male,401,22,9,38,3,38,2,0,1
1003098,28,23,1985,12,male,253,22,14,39,0,39,0,0,0
1692958,66,2,1947,9,female,511,22,14,38,7,38,6,0,1
2183508,33,6,1980,12,female,349,23,15,38,42,38,40,0,2
1814513,33,23,1980,12,male,99,22,11,40,1,40,0,0,1
1952230,40,26,1973,7,female,342,23,13,40,1,40,1,0,0
1438880,75,13,1938,3,female,1200,23,7,40,3,40,2,0,1
1526818,17,19,1996,1,male,845,22,8,41,4,0,0,41,4
1801999,51,17,1962,4,female,217,22,11,42,13,0,3,42,10
1447297,52,23,1961,5,female,652,23,12,42,2,41,1,1,1
1986729,25,1,1988,1,male,281,23,18,41,8,34,6,7,2
2184827,39,25,1974,10,female,597,23,12,42,0,42,0,0,0
1148805,48,3,1965,7,female,115,22,12,41,13,41,9,0,4
1579819,38,20,1975,9,male,118,23,16,44,3,0,2,44,1
1739436,25,14,1988,11,male,703,22,11,43,4,39,3,4,1
1055519,34,27,1979,9,female,354,23,18,44,28,39,23,5,5
1008891,55,28,1958,11,female,509,22,15,43,17,43,13,0,4
1667511,36,9,1977,6,female,246,22,6,44,32,44,29,0,3
1414487,14,15,1999,2,male,80,23,18,45,47,0,6,45,41
1173886,65,10,1948,8,female,418,22,9,45,62,26,42,19,20
1539603,86,9,1927,12,female,113,22,21,46,7,0,7,46,0
1752275,70,2,1943,10,female,434,23,17,47,11,0,0,47,11
1581443,34,31,1979,7,female,442,22,8,47,3,47,3,0,0
1012018,25,1,1988,1,male,268,23,12,47,24,47,21,0,3
1451391,46,1,1967,1,male,375,23,11,46,98,46,90,0,8
1863377,30,20,1983,8,male,269,23,18,48,41,12,22,36,19
1218803,28,24,1985,12,female,404,23,12,48,0,48,0,0,0
2061528,60,6,1953,4,male,670,22,7,51,0,0,0,51,0
1618422,59,24,1954,9,female,699,23,21,50,5,16,2,34,3
1927588,14,19,1999,5,male,520,22,19,51,8,51,1,0,7
1467644,34,25,1979,7,male,77,22,20,51,8,51,5,0,3
1809861,28,24,1985,1,female,499,22,12,51,22,51,5,0,17
2142241,60,26,1953,12,female,1305,23,10,50,28,50,14,0,14
1877968,52,13,1961,9,male,821,22,11,51,38,51,18,0,20
1577210,31,11,1982,10,female,30,22,20,52,3,47,0,5,3
1724802,36,6,1977,10,female,380,22,14,52,3,52,2,0,1
1456770,17,27,1996,5,female,159,23,5,54,51,10,6,44,45
1115245,21,11,1992,9,female,593,23,12,54,11,38,7,16,4
1595315,43,12,1970,8,female,145,22,14,54,18,11,2,43,16
1736520,39,5,1974,3,male,601,22,11,54,2,54,1,0,1
1685134,42,14,1971,2,female,369,22,11,55,2,55,2,0,0
1406636,56,28,1957,5,male,531,22,20,55,4,55,3,0,1
1138597,42,3,1971,10,female,346,23,14,55,32,55,29,0,3
1347476,103,1,1910,1,female,834,22,14,54,28,54,16,0,12
1654764,23,25,1990,7,female,346,23,20,55,79,55,39,0,40
2156869,26,19,1987,8,male,22,22,20,57,1,0,0,57,1
1927042,18,13,1995,10,male,20,23,15,57,45,20,18,37,27
1285540,54,2,1959,5,male,548,23,18,57,20,50,12,7,8
1843360,47,28,1966,4,male,2166,22,13,57,86,57,80,0,6
1479829,62,23,1951,4,female,820,22,6,62,3,0,1,62,2
1856743,25,4,1988,1,male,266,23,16,63,35,10,9,53,26
1928412,36,6,1977,5,male,510,23,4,61,25,6,16,55,9
1406016,18,23,1995,8,male,587,22,21,61,72,58,15,3,57
1226950,77,1,1936,9,male,9,23,23,65,13,23,10,42,3
1233548,42,12,1971,6,female,494,22,12,65,20,60,6,5,14
1685532,55,10,1958,2,male,658,22,15,64,1,64,1,0,0
2116032,108,22,1905,8,female,1032,23,10,66,2,0,2,66,0
1571070,28,2,1985,2,male,24,22,12,67,49,66,39,1,10
1386170,23,1,1990,3,male,140,22,21,68,6,68,4,0,2
1293756,46,7,1967,3,female,293,22,13,66,5,66,1,0,4
2071066,52,14,1961,9,female,1007,22,8,67,35,67,20,0,15
1877289,26,21,1987,5,female,320,23,15,69,21,64,19,5,2
1348668,33,15,1980,6,male,200,22,14,70,11,70,11,0,0
2097439,17,1,1996,2,male,49,22,11,70,39,70,32,0,7
1737042,49,14,1964,2,female,1301,22,3,71,34,71,26,0,8
1716866,29,8,1984,11,female,22,23,13,74,27,74,23,0,4
1196152,42,20,1971,9,female,105,23,15,74,20,74,14,0,6
1241587,48,6,1965,2,female,656,22,13,72,24,72,13,0,11
1313709,36,27,1977,12,female,958,22,9,74,138,74,133,0,5
1221997,64,25,1949,7,male,431,22,12,76,84,0,12,76,72
1967342,35,17,1978,8,female,402,22,9,75,117,0,1,75,116
1639231,25,1,1988,1,male,247,23,20,76,0,76,0,0,0
1767075,59,4,1954,8,male,335,23,13,76,24,76,16,0,8
1471278,54,23,1959,1,female,74,22,17,78,10,0,8,78,2
1972756,56,10,1957,9,male,857,23,7,79,34,0,0,79,34
1951759,36,29,1977,5,male,212,22,14,79,67,46,53,33,14
2185438,57,1,1956,2,female,319,23,6,84,7,0,1,84,6
2075323,67,28,1946,6,male,751,22,4,82,51,0,11,82,40
2171935,30,10,1983,1,male,297,23,18,81,1,81,1,0,0
1033038,47,23,1966,10,female,18,23,13,84,24,84,10,0,14
1179452,40,15,1973,12,male,467,22,16,83,82,83,39,0,43
1519318,62,21,1951,5,male,234,22,19,87,7,72,3,15,4
1357347,48,17,1965,2,male,306,22,3,85,4,85,4,0,0
1942347,50,13,1963,4,female,107,23,5,87,69,87,61,0,8
1655196,56,2,1957,7,female,523,22,18,88,3,0,0,88,3
2160989,69,12,1944,9,female,469,23,19,91,2,0,0,91,2
1037691,73,8,1940,2,male,535,22,18,88,11,0,0,88,11
2067410,18,7,1995,1,male,47,23,21,91,73,57,16,34,57
2148022,16,15,1997,11,male,303,22,13,91,6,84,5,7,1
1351861,26,1,1987,7,male,307,22,19,88,8,83,5,5,3
2135470,13,24,2000,5,male,76,23,16,89,67,86,23,3,44
1223331,54,12,1959,5,female,506,22,7,89,53,89,41,0,12
2185047,55,27,1958,10,female,383,23,12,90,20,90,9,0,11
1836193,20,19,1993,2,male,340,23,21,94,53,5,7,89,46
1728188,41,1,1972,1,female,92,23,12,94,45,6,15,88,30
1557691,56,2,1957,11,female,1161,22,15,95,35,0,10,95,25
1504049,48,4,1965,8,female,329,23,19,94,183,1,140,93,43
2021504,31,17,1982,10,female,276,22,11,92,125,33,75,59,50
2099355,58,8,1955,12,female,1664,23,12,93,81,86,70,7,11
1830984,21,7,1992,11,female,81,23,17,95,5,95,5,0,0
1592279,41,3,1972,8,male,626,23,11,94,2,94,2,0,0
2130075,49,25,1964,7,male,75,22,10,92,31,92,16,0,15
1192288,42,18,1971,12,male,96,22,17,92,60,92,24,0,36
1065443,47,28,1966,9,female,1911,23,10,99,124,18,50,81,74
1691462,69,1,1944,1,male,287,22,12,96,59,1,5,95,54
1655613,66,16,1947,9,female,1254,23,15,98,12,97,12,1,0
1684470,19,1,1994,1,female,113,22,13,99,50,87,27,12,23
1680821,47,29,1966,4,female,669,22,14,98,5,98,4,0,1
1022587,39,8,1974,6,male,216,23,4,96,71,96,69,0,2
1522643,107,13,1906,2,male,9,22,16,104,32,0,26,104,6
1594025,31,28,1982,8,female,46,22,18,100,57,70,22,30,35
1996178,27,5,1986,2,female,496,22,20,101,25,101,14,0,11
1090168,41,1,1972,1,female,195,22,21,103,22,103,14,0,8
1977557,43,10,1970,7,female,57,23,16,100,28,100,11,0,17
1437743,52,2,1961,10,male,873,23,12,104,30,104,24,0,6
2052620,57,30,1956,10,male,1459,23,5,102,77,102,45,0,32
1932095,20,20,1993,1,female,187,23,15,102,156,102,76,0,80
1929375,27,13,1986,2,male,16,22,12,109,14,74,11,35,3
1244001,35,1,1978,1,male,29,23,15,108,12,108,2,0,10
1400638,29,4,1984,5,female,89,23,13,108,92,108,91,0,1
2120552,38,17,1975,2,female,170,22,20,105,96,105,80,0,16
1152293,28,17,1985,6,female,231,23,12,116,5,0,0,116,5
1653682,50,3,1963,1,male,334,23,10,118,4,0,2,118,2
1339707,77,14,1936,3,female,1858,23,10,115,27,0,9,115,18
1259262,21,3,1992,2,female,405,22,11,119,128,116,62,3,66
1410852,34,3,1979,2,female,284,22,10,118,107,91,65,27,42
2074737,50,1,1963,11,female,72,22,19,115,6,115,3,0,3
1466666,55,12,1958,7,male,281,23,14,119,69,119,52,0,17
2060376,18,1,1995,12,female,138,23,14,118,145,118,51,0,94
1481154,29,7,1984,7,male,444,22,16,120,5,0,2,120,3
1634988,63,29,1950,7,female,249,23,11,122,18,0,3,122,15
1955332,27,3,1986,2,female,684,22,15,122,70,122,61,0,9
1735443,34,9,1979,9,male,291,22,12,123,63,123,46,0,17
1133675,29,1,1984,12,female,693,22,14,121,93,121,88,0,5
1495722,68,20,1945,4,male,534,23,6,129,31,0,9,129,22
1238317,42,12,1971,4,female,364,22,12,130,85,0,2,130,83
1895092,40,2,1973,4,female,468,22,16,128,13,128,9,0,4
1236507,58,1,1955,2,male,107,22,11,128,67,128,45,0,22
1547099,22,13,1991,12,female,137,23,12,129,130,129,108,0,22
1179556,19,10,1994,11,female,34,23,18,131,73,26,33,105,40
1791679,63,21,1950,12,female,603,23,16,137,1,3,1,134,0
1363430,108,7,1905,8,female,1362,22,10,137,129,137,82,0,47
1931892,19,5,1994,8,male,96,23,8,145,4,101,3,44,1
1837916,23,21,1990,5,male,84,23,6,146,133,46,103,100,30
1349159,22,10,1991,1,male,376,22,13,145,122,145,80,0,42
1321308,16,9,1997,5,male,99,23,4,145,309,145,264,0,45
1217495,25,16,1988,5,female,158,23,20,148,240,148,199,0,41
1559755,72,13,1941,5,female,112,23,15,154,62,0,45,154,17
2018580,108,21,1905,3,male,121,22,21,154,45,139,10,15,35
2058770,36,3,1977,5,male,437,23,21,156,65,156,60,0,5
1708358,26,27,1987,4,male,395,23,22,161,2,40,1,121,1
1259630,17,16,1996,4,female,138,23,18,162,69,139,26,23,43
1255114,58,3,1955,6,male,1669,23,19,170,97,0,52,170,45
2149538,66,5,1947,10,male,830,23,12,169,31,1,8,168,23
1905311,27,25,1986,10,male,159,22,11,166,0,166,0,0,0
1937785,38,16,1975,7,female,111,23,20,168,18,168,18,0,0
1120960,59,29,1954,4,female,73,23,22,169,69,169,34,0,35
1940428,47,26,1966,2,female,787,23,5,174,84,123,55,51,29
1984551,28,2,1985,10,female,138,23,19,181,245,172,113,9,132
1679249,26,22,1987,11,female,154,23,11,180,74,180,17,0,57
2174120,35,28,1978,5,female,344,23,9,180,62,180,61,0,1
1543900,66,18,1947,12,male,1089,23,7,185,15,0,11,185,4
1884717,30,15,1983,11,female,376,23,17,183,99,95,54,88,45
2074243,43,20,1970,9,female,261,23,22,188,102,39,60,149,42
2010618,22,8,1991,12,female,461,23,6,182,9,182,5,0,4
1990721,33,15,1980,8,male,51,23,23,186,59,186,58,0,1
2103595,51,9,1962,8,male,27,22,15,193,75,190,54,3,21
1708100,25,1,1988,1,female,89,22,11,196,71,196,60,0,11
1598867,56,24,1957,6,female,125,22,17,193,88,193,71,0,17
1563086,49,26,1964,4,female,425,22,10,209,112,0,7,209,105
1949425,23,20,1990,5,female,224,22,21,209,146,42,16,167,130
2165320,65,4,1948,8,female,1530,23,11,204,62,203,11,1,51
1487314,59,5,1954,5,female,171,23,16,204,9,204,4,0,5
2074087,28,10,1985,7,female,103,23,11,219,73,219,70,0,3
1347120,15,14,1998,4,female,27,23,14,239,202,239,139,0,63
1538408,74,2,1939,4,female,924,22,14,256,4,245,3,11,1
1947493,43,10,1970,3,male,48,23,21,247,1,247,0,0,1
1415959,19,16,1994,5,male,287,23,17,264,64,253,15,11,49
1105659,32,15,1981,9,female,149,22,10,262,62,262,8,0,54
1170114,30,30,1983,10,male,230,22,17,286,18,0,11,286,7
1465199,63,9,1950,8,female,254,22,21,283,20,0,1,283,19
1460300,20,7,1993,1,female,272,23,15,279,180,90,89,189,91
1978500,37,9,1976,3,female,334,22,10,281,22,281,10,0,12
1161080,28,3,1985,3,male,478,22,12,286,48,286,37,0,11
1906290,40,29,1973,9,male,259,22,17,301,215,9,46,292,169
1996496,37,23,1976,5,male,236,22,6,301,28,301,28,0,0
1576388,57,8,1956,4,male,59,23,20,323,6,323,5,0,1
2155222,20,31,1993,8,female,23,23,21,335,91,8,35,327,56
1049405,28,25,1985,12,male,446,23,19,334,273,129,238,205,35
1734858,44,3,1969,6,female,563,23,12,335,61,335,51,0,10
1904149,31,14,1982,10,male,281,23,11,338,281,338,257,0,24
2192017,108,15,1905,10,female,25,22,19,349,53,10,6,339,47
1676810,38,21,1975,1,female,372,22,8,380,57,0,14,380,43
1305756,21,10,1992,8,female,497,22,13,389,130,385,37,4,93
1017983,37,30,1976,12,female,294,22,17,407,204,25,95,382,109
1748037,25,1,1988,1,male,15,23,17,397,42,397,39,0,3
1305815,47,6,1966,6,female,20,23,20,445,190,4,38,441,152
1388611,63,21,1950,4,female,419,22,17,437,240,0,128,437,112
1177978,40,17,1973,9,male,383,22,14,422,169,368,102,54,67
1020556,59,7,1954,12,male,319,22,16,478,118,0,14,478,104
1028092,19,3,1994,4,female,295,23,14,455,324,450,93,5,231
1905516,22,6,1991,6,female,64,22,16,468,27,468,10,0,17
1875103,27,1,1986,1,male,107,23,14,506,48,506,41,0,7
2104080,27,29,1986,7,female,102,23,8,507,204,507,171,0,33
1883564,72,8,1941,12,female,332,22,17,542,59,0,49,542,10
1108564,54,5,1959,6,female,616,22,11,548,2,548,0,0,2
1085580,56,28,1957,5,male,53,22,12,549,60,549,47,0,13
1460389,69,27,1944,3,female,894,22,13,597,27,0,8,597,19
1841600,47,10,1966,1,male,1162,23,8,645,22,330,9,315,13
1980479,17,15,1996,12,female,212,23,16,761,394,182,223,579,171
1912015,35,9,1978,7,female,254,22,22,838,91,838,42,0,49
1231250,39,22,1974,8,female,118,22,18,814,312,814,285,0,27
1142233,52,27,1961,12,male,138,23,16,919,380,0,326,919,54
1015468,28,22,1985,3,female,33,22,17,978,2465,26,679,952,1786
1382745,25,16,1988,11,female,69,23,17,939,135,939,49,0,86
1626410,48,29,1965,6,female,726,22,11,1210,65,170,50,1040,15
1949377,24,24,1989,6,female,567,23,15,1154,183,709,11,445,172
1716016,54,13,1959,12,male,620,23,16,1268,60,864,34,404,26
1190380,65,5,1948,7,female,711,22,8,1842,1010,0,291,1842,719
2172841,32,1,1981,1,male,147,22,10,2179,4,2179,3,0,1
1676874,15,13,1998,9,female,76,23,8,5616,4604,0,655,5616,3949
1675903,20,1,1993,1,male,61,22,5,3853,2935,3751,1067,102,1868
1512058,33,8,1980,5,male,214,23,11,5098,193,5098,178,0,15
1477023,65,5,1948,12,male,1535,24,8,1,0,1,0,0,0
1033088,17,5,1996,12,male,287,24,17,1,1,1,1,0,0
1492575,18,7,1995,12,male,136,24,12,1,1,1,1,0,0
1967701,25,10,1988,6,female,367,24,9,1,1,1,0,0,1
1729207,28,21,1985,4,male,374,24,10,1,1,1,0,0,1
1396705,31,1,1982,7,male,210,24,18,1,1,1,1,0,0
1067238,32,6,1981,10,male,445,24,6,1,1,1,1,0,0
1043466,37,15,1976,3,male,857,24,1,1,1,1,1,0,0
1124244,38,24,1975,6,male,521,24,20,1,1,1,1,0,0
1157189,42,20,1971,6,male,226,24,18,1,1,1,1,0,0
1066823,44,29,1969,9,female,403,24,19,1,1,1,0,0,1
1747001,49,10,1964,4,male,89,24,13,1,1,1,1,0,0
1258534,63,5,1950,1,male,528,24,16,1,1,1,1,0,0
1305662,14,14,1999,11,female,21,24,16,1,2,1,1,0,1
1053318,21,23,1992,7,female,600,24,8,1,14,1,14,0,0
1257527,22,27,1991,8,male,201,24,8,1,8,1,3,0,5
1728036,23,23,1990,2,female,230,24,12,1,6,1,4,0,2
2035613,24,14,1989,7,female,198,24,22,1,6,1,6,0,0
1436420,26,6,1987,4,male,293,24,9,1,2,1,2,0,0
1209857,27,18,1986,9,female,187,24,11,1,2,1,1,0,1
1303453,29,14,1984,2,female,286,24,15,1,10,1,10,0,0
1805967,32,18,1981,6,male,260,24,19,1,24,1,24,0,0
2076874,33,28,1980,9,female,571,24,9,1,8,1,8,0,0
1810395,33,12,1980,10,male,315,24,20,1,4,1,4,0,0
1007205,36,30,1977,7,male,424,24,17,1,2,1,2,0,0
1471726,42,5,1971,8,female,264,24,17,1,10,1,6,0,4
1941853,44,24,1969,2,male,413,24,16,1,2,1,2,0,0
1373036,45,16,1968,1,male,597,24,10,1,2,1,2,0,0
1559810,54,2,1959,10,female,276,24,11,1,8,1,4,0,4
1497988,17,18,1996,9,male,339,24,17,2,0,0,0,2,0
1875459,18,16,1995,1,male,173,24,22,2,0,0,0,2,0
1687178,28,1,1985,10,female,517,24,10,2,2,0,0,2,2
1249210,18,8,1995,6,male,208,24,20,2,4,0,2,2,2
1810603,34,3,1979,6,male,159,24,14,2,4,0,0,2,4
1276009,48,12,1965,10,male,276,24,15,2,5,0,0,2,5
1423902,54,30,1959,3,female,265,24,13,2,14,0,3,2,11
1185374,57,13,1956,5,male,1056,24,17,2,5,0,3,2,2
1636548,62,6,1951,10,female,541,24,20,2,85,0,22,2,63
1268501,64,11,1949,7,female,214,24,8,2,3,0,0,2,3
1633423,69,1,1944,4,male,605,24,16,2,6,0,5,2,1
1861256,73,19,1940,3,male,775,24,9,2,10,0,1,2,9
1512975,61,1,1952,10,female,2280,24,18,2,2,1,1,1,1
1120119,28,1,1985,1,female,136,24,3,2,17,1,15,1,2
1009163,35,10,1978,6,male,876,24,18,2,7,1,4,1,3
1047783,51,19,1962,9,male,552,24,3,2,27,1,19,1,8
2116618,19,22,1994,9,male,420,24,19,2,0,2,0,0,0
1762237,23,20,1990,11,male,698,24,18,2,0,2,0,0,0
1778988,23,12,1990,12,female,288,24,21,2,0,2,0,0,0
1184563,37,12,1976,12,female,123,24,19,2,0,2,0,0,0
1368155,41,28,1972,10,male,290,24,22,2,0,2,0,0,0
1547113,45,8,1968,1,male,507,24,7,2,0,2,0,0,0
1950756,49,16,1964,2,male,599,24,18,2,0,2,0,0,0
1749090,50,22,1963,7,female,900,24,14,2,0,2,0,0,0
2092706,19,6,1994,7,male,107,24,10,2,1,2,1,0,0
1688444,22,25,1991,3,male,633,24,20,2,1,2,1,0,0
1488565,25,1,1988,1,male,196,24,20,2,1,2,1,0,0
1244412,25,12,1988,4,male,737,24,3,2,1,2,1,0,0
1340304,28,1,1985,12,female,1262,24,17,2,1,2,1,0,0
1014673,35,21,1978,10,male,89,24,16,2,1,2,0,0,1
1899379,54,27,1959,11,female,320,24,18,2,1,2,1,0,0
1194521,25,1,1988,1,male,477,24,11,2,2,2,2,0,0
1483162,28,12,1985,5,female,313,24,15,2,2,2,1,0,1
2131973,30,27,1983,7,male,636,24,19,2,2,2,0,0,2
1069436,18,5,1995,5,female,760,24,14,2,18,2,3,0,15
1283711,19,6,1994,4,male,27,24,13,2,10,2,9,0,1
1635657,20,14,1993,5,male,46,24,23,2,4,2,4,0,0
1417871,21,29,1992,7,female,49,24,20,2,25,2,3,0,22
1958854,25,11,1988,11,male,29,24,14,2,20,2,2,0,18
1599648,25,25,1988,10,female,378,24,10,2,19,2,12,0,7
1468280,26,2,1987,2,male,538,24,4,2,14,2,1,0,13
1743106,31,22,1982,9,male,400,24,20,2,3,2,3,0,0
1990039,35,16,1978,3,male,1105,24,15,2,4,2,2,0,2
1895822,44,11,1969,5,female,245,24,10,2,18,2,7,0,11
1302321,49,13,1964,11,male,48,24,19,2,7,2,5,0,2
1983006,50,18,1963,11,male,340,24,9,2,6,2,6,0,0
1493940,67,8,1946,4,male,946,24,17,2,10,2,10,0,0
1762571,13,1,2000,4,male,84,24,16,3,0,0,0,3,0
1631138,19,22,1994,12,male,325,24,16,3,0,0,0,3,0
1583281,102,15,1911,10,male,1799,24,19,3,0,0,0,3,0
2036584,52,23,1961,6,male,724,24,21,3,1,0,1,3,0
1171850,59,31,1954,1,female,977,24,19,3,1,0,0,3,1
1961963,49,10,1964,7,female,666,24,15,3,4,0,1,3,3
1764471,82,15,1931,3,male,1180,24,7,3,2,0,0,3,2
2161910,27,22,1986,4,male,22,24,23,3,9,0,8,3,1
1612577,17,14,1996,2,male,193,24,19,3,0,2,0,1,0
1281331,61,29,1952,2,male,1845,24,6,3,0,1,0,2,0
1260320,69,26,1944,10,female,171,24,22,3,3,1,1,2,2
1458975,66,8,1947,6,female,503,24,9,3,10,2,7,1,3
1694122,16,14,1997,5,male,170,24,6,3,0,3,0,0,0
1363687,24,6,1989,2,male,39,24,24,3,0,3,0,0,0
1698591,25,15,1988,2,male,432,24,18,3,0,3,0,0,0
1730271,25,18,1988,4,male,722,24,11,3,0,3,0,0,0
1276136,29,7,1984,9,female,939,24,12,3,0,3,0,0,0
1733883,13,12,2000,7,male,163,24,19,3,1,3,1,0,0
1097825,14,12,1999,9,female,80,24,15,3,1,3,1,0,0
1944312,15,12,1998,9,male,363,24,19,3,1,3,1,0,0
1332182,21,3,1992,11,male,614,24,20,3,1,3,1,0,0
2004052,21,13,1992,11,male,557,24,15,3,1,3,0,0,1
2190883,25,1,1988,1,male,103,24,18,3,1,3,1,0,0
1576743,37,5,1976,2,female,705,24,15,3,1,3,1,0,0
1520888,57,9,1956,11,male,107,24,19,3,1,3,1,0,0
2031816,21,30,1992,10,male,249,24,19,3,4,3,4,0,0
1295270,71,26,1942,11,male,871,24,12,3,4,3,3,0,1
1800010,19,1,1994,7,male,727,24,18,3,8,3,3,0,5
2047229,26,20,1987,1,male,46,24,8,3,32,3,11,0,21
2155169,27,6,1986,6,male,235,24,19,3,6,3,3,0,3
1902321,29,5,1984,10,male,491,24,3,3,7,3,2,0,5
1040072,33,22,1980,8,female,359,24,17,3,7,3,6,0,1
1434526,33,1,1980,11,female,359,24,16,3,12,3,9,0,3
1704202,37,8,1976,7,male,272,24,12,3,46,3,44,0,2
1999415,56,22,1957,3,female,761,24,9,3,20,3,17,0,3
1387487,63,14,1950,3,male,113,24,18,3,7,3,3,0,4
1428902,51,22,1962,10,male,591,24,14,4,1,0,0,4,1
1275605,69,31,1944,1,male,150,24,20,4,1,0,0,4,1
1622821,22,7,1991,8,female,92,24,14,4,4,0,2,4,2
1496880,31,31,1982,5,female,198,24,12,4,8,0,8,4,0
2025948,54,22,1959,8,male,520,24,5,4,12,0,7,4,5
1654855,50,23,1963,1,male,1660,24,11,4,1,2,1,2,0
1737520,59,2,1954,9,female,771,24,13,4,5,2,3,2,2
1685507,25,1,1988,1,male,98,24,24,4,0,3,0,1,0
1752975,63,19,1950,10,female,45,24,21,4,3,3,3,1,0
2052055,39,28,1974,4,male,533,24,10,4,0,4,0,0,0
2154214,51,27,1962,12,female,145,24,18,4,0,4,0,0,0
1362296,53,20,1960,7,female,1011,24,20,4,0,4,0,0,0
1977007,13,25,2000,8,female,67,24,4,4,1,4,1,0,0
2174127,19,17,1994,9,male,22,24,19,4,1,4,1,0,0
1184634,23,7,1990,11,male,358,24,20,4,1,4,1,0,0
1620207,25,1,1988,1,male,36,24,22,4,2,4,1,0,1
1764031,25,30,1988,8,male,11,24,15,4,2,4,2,0,0
1999686,26,4,1987,1,male,306,24,22,4,2,4,1,0,1
1085110,28,10,1985,10,male,475,24,21,4,2,4,2,0,0
2043425,33,31,1980,1,male,182,24,24,4,1,4,1,0,0
1080691,46,9,1967,6,male,481,24,11,4,1,4,1,0,0
1803144,54,26,1959,2,female,137,24,17,4,1,4,0,0,1
1874429,16,6,1997,1,male,104,24,24,4,5,4,4,0,1
1439658,48,19,1965,5,female,92,24,19,4,3,4,2,0,1
2075293,50,14,1963,10,male,25,24,4,4,4,4,3,0,1
1368076,71,6,1942,4,male,1253,24,18,4,5,4,4,0,1
1547944,16,4,1997,11,female,24,24,16,4,6,4,6,0,0
1306452,36,11,1977,9,male,312,24,21,4,7,4,6,0,1
1806471,37,4,1976,7,female,570,24,5,4,10,4,9,0,1
2129711,82,10,1931,1,female,1192,24,8,5,0,0,0,5,0
2074023,58,25,1955,3,male,575,24,17,5,2,0,1,5,1
1049396,64,20,1949,6,female,606,24,23,5,3,0,0,5,3
1987719,75,18,1938,6,female,719,24,18,5,1,0,0,5,1
1018066,77,14,1936,12,female,159,24,18,5,3,0,0,5,3
1782010,60,14,1953,2,female,85,24,16,5,5,0,1,5,4
1786370,20,27,1993,10,male,48,24,14,5,53,0,10,5,43
1167258,62,3,1951,3,male,1642,24,9,5,16,0,6,5,10
1036601,59,21,1954,11,female,306,24,17,5,0,3,0,2,0
2032131,59,1,1954,7,female,310,24,17,5,3,1,3,4,0
1099936,55,21,1958,6,male,906,24,8,5,14,3,12,2,2
1861999,47,20,1966,2,female,150,24,19,5,10,4,7,1,3
1452190,18,1,1995,1,male,210,24,18,5,0,5,0,0,0
1594857,22,11,1991,9,male,378,24,12,5,0,5,0,0,0
1310999,34,1,1979,3,male,219,24,19,5,0,5,0,0,0
2069174,36,3,1977,1,male,191,24,13,5,0,5,0,0,0
1926642,24,17,1989,3,male,103,24,11,5,1,5,0,0,1
1159065,25,9,1988,10,female,21,24,15,5,3,5,3,0,0
1989244,30,19,1983,7,male,138,24,18,5,2,5,2,0,0
1066894,32,22,1981,6,male,374,24,16,5,2,5,2,0,0
1843696,37,5,1976,10,male,141,24,17,5,1,5,1,0,0
1483907,48,25,1965,4,female,452,24,17,5,11,5,5,0,6
1925837,50,14,1963,8,male,663,24,11,5,12,5,1,0,11
1664248,57,6,1956,9,male,1335,24,11,5,29,5,21,0,8
1676974,59,2,1954,8,female,99,24,18,5,9,5,5,0,4
1588856,67,1,1946,4,male,546,24,18,6,0,0,0,6,0
1535449,24,8,1989,10,male,547,24,11,6,3,0,0,6,3
2117399,38,20,1975,6,male,482,24,11,6,5,0,4,6,1
2044998,78,7,1935,10,female,1118,24,14,6,6,0,4,6,2
1977607,108,1,1905,1,male,2208,24,10,6,8,0,6,6,2
2039092,60,1,1953,1,male,192,24,13,6,14,0,7,6,7
1924233,61,16,1952,9,male,70,24,14,6,15,0,9,6,6
1620374,73,6,1940,11,female,18,24,11,6,33,0,7,6,26
1969060,73,10,1940,9,male,473,24,18,6,28,0,19,6,9
1605283,25,8,1988,9,male,260,24,15,6,1,4,0,2,1
1342132,25,15,1988,10,male,39,24,22,6,7,3,5,3,2
1612399,18,29,1995,10,male,29,24,20,6,17,2,15,4,2
1754125,79,17,1934,10,male,10,24,22,6,9,3,5,3,4
2182287,17,12,1996,7,male,40,24,22,6,3,6,2,0,1
1918315,20,20,1993,8,male,81,24,11,6,2,6,2,0,0
1551096,24,23,1989,1,female,69,24,15,6,2,6,1,0,1
1246520,55,1,1958,10,male,406,24,5,6,1,6,1,0,0
1756514,43,20,1970,3,female,231,24,16,6,4,6,3,0,1
2007554,91,12,1922,9,male,416,24,7,6,5,6,4,0,1
1759601,19,27,1994,1,male,554,24,7,6,14,6,11,0,3
1364938,25,12,1988,1,female,423,24,14,6,18,6,18,0,0
1976464,30,10,1983,4,female,189,24,21,6,10,6,10,0,0
1615407,48,15,1965,3,male,320,24,21,6,14,6,3,0,11
1775674,17,2,1996,8,male,189,24,14,7,0,0,0,7,0
1485496,47,26,1966,7,male,184,24,12,7,0,0,0,7,0
1870495,14,18,1999,4,male,359,24,23,7,3,0,0,7,3
2074858,72,28,1941,3,female,164,24,15,7,4,0,3,7,1
1651284,21,14,1992,2,female,209,24,17,7,31,0,19,7,12
1214259,44,24,1969,5,female,579,24,12,7,12,1,5,6,7
2008534,55,3,1958,11,female,1185,24,20,7,16,0,13,7,3
1841274,23,18,1990,3,female,690,24,19,7,1,6,1,1,0
1930068,60,15,1953,8,female,829,24,4,7,1,6,1,1,0
1397485,63,7,1950,6,male,966,24,13,7,0,6,0,1,0
1350591,22,25,1991,5,male,712,24,9,7,5,6,0,1,5
1934971,25,8,1988,12,male,42,24,18,7,8,6,5,1,3
1679805,49,26,1964,6,male,124,24,22,7,1,7,1,0,0
1642273,47,21,1966,5,female,271,24,5,7,3,7,2,0,1
1324890,21,20,1992,1,male,226,24,18,7,6,7,2,0,4
1146390,31,20,1982,8,male,16,24,23,7,10,7,10,0,0
1418942,56,16,1957,2,male,702,24,11,7,60,7,26,0,34
1885264,71,23,1942,7,female,1099,24,18,7,13,7,11,0,2
1907192,33,25,1980,3,female,251,24,14,8,0,0,0,8,0
1288308,40,4,1973,3,male,13,24,23,8,1,0,0,8,1
1781505,94,25,1919,12,male,543,24,23,8,0,0,0,8,0
1782688,57,10,1956,3,female,319,24,6,8,2,0,1,8,1
1507599,52,1,1961,12,male,226,24,20,8,27,0,4,8,23
1537248,53,31,1960,12,male,137,24,8,8,14,0,8,8,6
1505178,81,21,1932,10,female,521,24,10,8,17,0,5,8,12
1220070,26,14,1987,3,male,190,24,17,8,0,5,0,3,0
1567807,16,6,1997,1,male,13,24,3,8,10,3,1,5,9
1755691,45,16,1968,3,male,164,24,7,8,9,4,5,4,4
1562267,53,1,1960,4,male,43,24,17,8,8,7,5,1,3
1635429,59,25,1954,3,male,1452,24,3,8,11,7,2,1,9
1441477,26,8,1987,1,male,272,24,9,8,1,8,1,0,0
1413016,72,8,1941,10,female,830,24,11,8,0,8,0,0,0
2097967,25,1,1988,1,male,264,24,6,8,2,8,1,0,1
1362695,28,7,1985,3,female,182,24,9,8,3,8,0,0,3
1214711,34,21,1979,2,female,321,24,7,8,2,8,0,0,2
1471822,44,26,1969,6,male,991,24,11,8,5,8,5,0,0
1579446,45,25,1968,7,female,459,24,14,8,28,8,18,0,10
1483494,34,31,1979,1,female,315,24,18,9,4,0,1,9,3
1246603,60,9,1953,8,female,49,24,4,9,23,0,1,9,22
1167639,62,28,1951,6,female,478,24,16,9,4,2,3,7,1
1302865,23,5,1990,6,male,266,24,10,9,13,5,9,4,4
1080377,22,13,1991,9,male,236,24,14,9,11,8,8,1,3
2150088,63,15,1950,6,female,24,24,19,9,0,9,0,0,0
1165447,23,14,1990,4,male,138,24,20,9,2,9,1,0,1
1003603,28,2,1985,1,male,1266,24,18,9,5,9,4,0,1
1623458,31,5,1982,10,male,847,24,21,9,4,9,2,0,2
2055595,39,24,1974,9,female,541,24,11,9,3,9,2,0,1
1654659,57,27,1956,12,female,324,24,12,9,3,9,3,0,0
1152555,43,1,1970,4,female,12,24,24,9,8,9,8,0,0
1639125,30,12,1983,3,female,1432,24,11,9,185,9,20,0,165
2192228,49,20,1964,12,male,32,24,15,10,0,0,0,10,0
1939525,48,14,1965,12,male,417,24,17,10,5,0,3,10,2
1592140,51,9,1962,12,male,29,24,19,10,17,5,6,5,11
1885346,18,25,1995,7,female,240,24,12,10,0,10,0,0,0
1500004,21,17,1992,11,male,43,24,23,10,1,10,0,0,1
2060791,32,26,1981,10,female,431,24,6,10,1,10,1,0,0
2121191,46,6,1967,11,female,94,24,6,10,0,10,0,0,0
1477573,23,1,1990,1,male,95,24,20,10,3,10,3,0,0
1696279,33,1,1980,1,female,388,24,12,10,9,10,1,0,8
1220777,42,22,1971,3,male,621,24,8,10,11,10,10,0,1
1261327,64,7,1949,1,male,1392,24,4,10,7,10,4,0,3
1723706,67,21,1946,9,female,229,24,7,10,11,10,9,0,2
1351051,16,24,1997,8,male,53,24,17,10,22,10,17,0,5
1306993,46,9,1967,8,male,135,24,18,10,27,10,13,0,14
1496933,66,23,1947,6,female,800,24,11,11,4,0,2,11,2
1082123,57,26,1956,1,female,555,24,17,11,20,0,13,11,7
1908716,55,8,1958,1,female,204,24,15,11,16,8,7,3,9
1653559,30,3,1983,12,male,536,24,8,11,6,11,3,0,3
1132175,29,6,1984,9,male,115,24,14,11,2,11,0,0,2
1749666,36,19,1977,6,male,28,24,18,11,7,11,5,0,2
1678401,45,12,1968,9,male,679,24,14,11,10,11,10,0,0
1052467,18,18,1995,5,female,41,24,10,11,36,11,29,0,7
1490827,35,24,1978,7,male,781,24,8,11,17,11,10,0,7
1093860,30,15,1983,1,male,825,24,8,12,0,12,0,0,0
1270635,33,19,1980,7,female,409,24,12,12,0,12,0,0,0
1236048,46,8,1967,6,male,686,24,13,12,0,12,0,0,0
1858101,73,6,1940,12,female,136,24,12,12,0,12,0,0,0
1024516,20,2,1993,7,male,293,24,16,12,6,12,6,0,0
1876597,22,15,1991,2,male,426,24,19,12,3,12,3,0,0
1861667,30,7,1983,9,male,288,24,19,12,2,12,1,0,1
1077426,45,22,1968,12,male,598,24,15,12,4,12,1,0,3
1055206,68,19,1945,8,female,131,24,24,12,2,12,2,0,0
1852472,19,6,1994,7,female,210,24,10,12,20,12,19,0,1
1829433,34,19,1979,10,female,177,24,17,12,56,12,44,0,12
1517720,16,26,1997,9,male,286,24,20,13,0,0,0,13,0
1833337,22,1,1991,2,male,108,24,23,13,0,9,0,4,0
1842108,46,8,1967,12,female,48,24,8,13,49,10,31,3,18
1818353,53,22,1960,11,female,188,24,18,13,10,13,9,0,1
1937058,29,11,1984,10,female,65,24,7,13,24,13,19,0,5
1980405,60,21,1953,2,female,717,24,7,13,48,13,5,0,43
1565435,33,28,1980,8,female,21,24,14,14,0,0,0,14,0
2128681,34,7,1979,3,female,202,24,15,14,0,0,0,14,0
1465934,103,5,1910,12,female,925,24,10,14,16,0,9,14,7
1681292,57,31,1956,5,male,301,24,16,14,0,8,0,6,0
1319244,39,24,1974,2,female,500,24,20,14,9,13,4,1,5
1208363,67,3,1946,4,female,209,24,24,14,0,14,0,0,0
2127342,34,19,1979,4,female,848,24,12,14,34,14,15,0,19
1468027,38,31,1975,10,female,404,24,17,15,17,13,14,2,3
1815265,22,4,1991,5,male,585,24,13,15,11,15,6,0,5
1516839,14,4,1999,10,male,10,24,20,16,1,0,0,16,1
1854701,53,17,1960,6,female,352,24,20,16,0,0,0,16,0
2031190,37,12,1976,8,male,50,24,12,16,21,10,17,6,4
1966752,74,2,1939,4,male,1564,24,13,16,2,15,2,1,0
1654559,67,15,1946,12,female,1937,24,13,16,49,14,25,2,24
1182776,41,14,1972,8,male,49,24,19,16,6,16,5,0,1
2061615,44,4,1969,1,male,301,24,12,17,8,1,6,16,2
1929699,82,9,1931,7,male,544,24,18,17,11,0,7,17,4
1904869,46,14,1967,2,female,313,24,12,17,25,11,1,6,24
1500147,51,16,1962,8,female,257,24,11,17,2,17,2,0,0
1758571,81,1,1932,10,male,1290,24,10,18,0,0,0,18,0
1718219,78,29,1935,8,female,23,24,21,18,12,3,0,15,12
1237132,24,14,1989,2,female,577,24,19,18,2,11,0,7,2
1545754,28,7,1985,10,male,520,24,7,18,14,9,12,9,2
1668064,23,16,1990,4,male,580,24,20,18,0,18,0,0,0
1481334,22,1,1991,1,male,286,24,16,18,10,18,8,0,2
1339899,19,31,1994,5,male,172,24,21,19,0,0,0,19,0
1133601,64,13,1949,10,male,351,24,16,19,5,0,5,19,0
1934734,35,31,1978,8,male,938,24,4,19,5,7,0,12,5
1379018,66,7,1947,7,male,997,24,14,19,32,7,24,12,8
2008701,70,8,1943,10,male,399,24,13,19,22,19,20,0,2
1901453,23,11,1990,7,female,220,24,15,20,1,0,0,20,1
1875197,18,15,1995,3,male,160,24,16,20,24,1,2,19,22
1063381,45,20,1968,2,female,285,24,14,20,0,7,0,13,0
1191063,45,28,1968,2,female,1838,24,14,20,8,12,1,8,7
1334839,25,28,1988,1,male,554,24,9,20,7,16,6,4,1
2136158,76,3,1937,9,male,1535,24,11,20,7,19,6,1,1
1171269,25,25,1988,5,male,271,24,16,20,115,18,70,2,45
1082746,53,19,1960,10,male,599,24,6,22,11,1,4,21,7
1062275,62,16,1951,7,female,325,24,16,22,21,0,1,22,20
1669586,26,1,1987,1,male,128,24,23,22,1,22,1,0,0
1004547,35,1,1978,4,male,139,24,12,22,8,22,4,0,4
1790331,20,6,1993,1,female,37,24,20,22,20,22,19,0,1
1291791,25,11,1988,2,female,295,24,19,22,19,22,17,0,2
1041487,61,10,1952,1,female,675,24,18,23,2,0,2,23,0
1771173,70,27,1943,10,female,1637,24,14,23,0,0,0,23,0
1636254,65,29,1948,2,female,220,24,20,23,13,0,0,23,13
1709949,15,6,1998,6,male,56,24,22,23,3,23,3,0,0
1422043,58,30,1955,3,male,495,24,5,23,1,23,1,0,0
1377157,73,26,1940,10,female,1098,24,16,23,3,23,3,0,0
1942832,51,8,1962,6,female,671,24,12,23,32,23,16,0,16
1011752,61,7,1952,9,female,390,24,14,23,21,23,3,0,18
1368053,54,13,1959,1,female,291,24,20,24,3,24,3,0,0
1153002,71,4,1942,8,female,506,24,12,24,12,24,8,0,4
2182000,32,5,1981,7,female,634,24,15,25,3,23,3,2,0
1234315,40,23,1973,2,female,477,24,18,25,5,25,1,0,4
1155052,47,2,1966,8,male,607,24,14,26,2,0,2,26,0
1211529,58,29,1955,11,female,641,24,10,26,4,26,3,0,1
1327474,58,27,1955,5,female,83,24,11,26,3,26,1,0,2
1782586,44,11,1969,6,female,528,24,11,26,14,26,13,0,1
1835164,46,24,1967,2,male,109,24,14,26,12,26,7,0,5
1571328,65,23,1948,9,female,1628,24,10,26,12,26,9,0,3
1292219,55,12,1958,10,female,21,24,15,27,14,0,0,27,14
1328234,23,24,1990,6,male,140,24,11,27,35,25,30,2,5
1061724,39,18,1974,12,male,532,24,9,28,2,28,2,0,0
1954985,46,1,1967,1,female,869,24,5,28,2,28,2,0,0
1424043,44,14,1969,10,male,69,24,16,28,7,28,6,0,1
1048683,73,13,1940,1,female,670,24,17,28,10,28,4,0,6
1822495,54,22,1959,3,female,253,24,15,29,66,27,48,2,18
1781266,37,12,1976,10,male,379,24,5,29,5,29,4,0,1
1452330,52,21,1961,1,female,924,24,17,29,11,29,10,0,1
1544250,70,25,1943,1,male,429,24,10,31,10,1,3,30,7
1179887,53,15,1960,11,female,159,24,16,31,12,31,2,0,10
1637091,52,11,1961,3,female,227,24,10,31,8,31,7,0,1
2159934,41,16,1972,5,male,303,24,22,32,13,32,12,0,1
1402975,38,23,1975,12,female,313,24,19,32,94,32,89,0,5
1972288,53,11,1960,9,male,584,24,11,33,10,33,8,0,2
1768716,22,18,1991,7,female,82,24,19,34,12,21,11,13,1
1026002,34,25,1979,8,male,121,24,22,34,1,31,0,3,1
2129744,55,4,1958,6,female,180,24,20,34,1,30,1,4,0
1800118,31,15,1982,4,female,542,24,10,34,19,34,2,0,17
2035656,33,5,1980,2,female,173,24,16,34,20,34,18,0,2
1341364,20,10,1993,3,female,270,24,14,36,39,33,36,3,3
1023693,18,2,1995,11,male,113,24,22,35,4,35,1,0,3
2161324,52,10,1961,3,male,570,24,13,37,15,0,3,37,12
1791786,22,20,1991,3,male,22,24,16,37,8,37,5,0,3
1473385,37,19,1976,1,male,141,24,18,37,10,37,5,0,5
1694462,69,24,1944,4,male,52,24,22,39,14,0,6,39,8
1908394,21,15,1992,7,female,273,24,15,38,36,38,28,0,8
1218779,43,21,1970,12,female,105,24,19,38,36,38,10,0,26
1867137,34,18,1979,10,female,153,24,13,39,69,39,63,0,6
1007864,45,14,1968,7,female,903,24,17,40,124,0,36,40,88
1369611,68,14,1945,12,female,51,24,16,40,2,39,2,1,0
2168326,60,24,1953,1,female,61,24,19,40,18,40,2,0,16
1391947,69,7,1944,1,female,1026,24,6,41,10,2,1,39,9
1617598,38,2,1975,8,male,291,24,19,41,12,23,11,18,1
1935799,73,28,1940,9,female,296,24,13,42,5,42,4,0,1
1347011,25,1,1988,1,male,19,24,20,42,18,42,15,0,3
1441352,49,9,1964,6,male,2074,24,10,41,12,41,5,0,7
2148245,25,23,1988,2,female,216,24,12,44,2,43,1,1,1
1678954,43,26,1970,6,female,444,24,22,43,18,34,12,9,6
1410156,29,29,1984,6,male,428,24,20,43,138,36,78,7,60
2189713,37,2,1976,1,female,278,24,7,45,76,45,62,0,14
1156126,33,26,1980,12,male,119,24,23,46,0,0,0,46,0
1749559,26,18,1987,1,male,555,24,19,47,14,34,10,13,4
2062500,31,27,1982,10,male,74,24,13,48,114,40,34,8,80
1647831,21,2,1992,7,female,343,24,16,49,6,49,4,0,2
1634892,34,9,1979,11,male,380,24,16,49,28,49,25,0,3
1726022,61,6,1952,7,male,656,24,16,48,36,48,13,0,23
1853584,53,8,1960,5,female,719,24,14,50,84,0,73,50,11
1735899,57,10,1956,7,female,507,24,14,50,1,19,1,31,0
1073137,70,9,1943,7,female,283,24,16,52,22,3,11,49,11
1435821,46,27,1967,5,male,1144,24,17,52,47,49,36,3,11
1358250,64,13,1949,1,female,528,24,7,54,85,0,1,54,84
1728200,31,27,1982,1,male,301,24,18,55,1,55,1,0,0
1629725,67,2,1946,11,female,736,24,11,55,0,55,0,0,0
1514217,17,14,1996,7,male,631,24,11,58,7,5,4,53,3
1239702,21,13,1992,9,female,421,24,12,56,25,50,13,6,12
1377994,49,25,1964,3,male,134,24,17,58,3,58,3,0,0
2099648,43,24,1970,5,female,904,24,14,57,66,57,66,0,0
1993635,63,8,1950,11,male,802,24,14,56,43,56,9,0,34
1169458,35,13,1978,9,male,146,24,9,56,95,56,84,0,11
1146707,21,9,1992,4,female,181,24,11,61,10,7,1,54,9
2096405,42,26,1971,11,female,421,24,12,61,68,60,28,1,40
1081918,51,24,1962,12,male,219,24,18,61,28,61,25,0,3
1249718,59,3,1954,9,female,1360,24,6,65,13,0,6,65,7
1865038,61,25,1952,2,male,357,24,7,68,4,68,4,0,0
1998938,16,9,1997,8,male,256,24,18,70,25,32,7,38,18
1469574,46,4,1967,12,female,1835,24,10,71,3,69,0,2,3
1128545,31,23,1982,1,female,411,24,21,73,43,73,28,0,15
1267985,60,20,1953,3,female,588,24,12,75,26,32,17,43,9
1989712,46,27,1967,11,female,455,24,15,75,84,68,57,7,27
2005875,42,2,1971,12,male,540,24,16,76,12,76,6,0,6
1259421,73,19,1940,1,female,1573,24,9,79,6,34,6,45,0
1445628,17,17,1996,8,female,99,24,9,80,15,45,13,35,2
1649454,21,29,1992,2,male,335,24,17,78,34,62,14,16,20
1590851,61,26,1952,9,female,649,24,8,83,11,0,4,83,7
1970683,25,1,1988,1,female,165,24,10,82,168,50,100,32,68
1521832,18,10,1995,6,male,223,24,19,84,12,84,6,0,6
2134326,26,18,1987,8,female,257,24,17,85,39,0,16,85,23
1582759,31,8,1982,1,male,81,24,22,87,64,6,25,81,39
1741650,16,3,1997,6,male,27,24,20,86,3,86,3,0,0
1218454,22,14,1991,7,female,189,24,20,91,22,38,12,53,10
2068128,22,24,1991,10,male,460,24,19,91,9,89,9,2,0
1661809,43,22,1970,7,female,563,24,19,91,7,91,5,0,2
1302451,17,22,1996,2,male,94,24,19,91,29,91,26,0,3
2025940,47,17,1966,3,male,424,24,10,96,7,0,1,96,6
1743603,43,18,1970,2,female,427,24,18,100,37,0,18,100,19
1318259,25,18,1988,12,female,51,24,23,103,69,100,61,3,8
1247466,25,14,1988,8,female,192,24,16,102,37,102,25,0,12
1969874,29,1,1984,1,male,34,24,18,103,22,103,19,0,3
1546937,26,30,1987,7,male,830,24,19,108,48,103,43,5,5
1869942,29,19,1984,10,male,77,24,20,106,7,106,7,0,0
1563397,56,26,1957,3,male,877,24,17,109,49,109,27,0,22
1218846,38,25,1975,3,male,595,24,20,105,152,105,152,0,0
1468746,108,1,1905,1,female,9,24,13,111,100,0,22,111,78
1455936,17,5,1996,11,female,103,24,2,112,67,112,27,0,40
1805451,40,17,1973,4,female,311,24,12,110,36,110,11,0,25
1437341,48,24,1965,12,male,332,24,19,112,44,112,29,0,15
1253173,26,19,1987,8,male,567,24,17,114,1,0,0,114,1
1941943,49,7,1964,3,female,12,24,10,118,41,118,30,0,11
1483320,47,29,1966,5,female,151,24,12,121,4,121,3,0,1
1286327,36,7,1977,6,female,354,24,13,122,48,122,15,0,33
1478872,61,22,1952,4,female,308,24,15,125,14,0,4,125,10
1682918,26,11,1987,8,male,424,24,20,127,0,127,0,0,0
1395247,38,9,1975,12,female,172,24,16,127,46,127,30,0,16
1818495,44,27,1969,10,female,346,24,12,136,63,136,59,0,4
1739142,19,22,1994,9,male,257,24,18,143,3,143,0,0,3
1421563,25,1,1988,1,female,155,24,16,139,17,139,2,0,15
2018504,42,20,1971,11,male,529,24,15,143,6,143,6,0,0
1132892,56,4,1957,8,female,645,24,8,143,38,143,37,0,1
1509667,53,12,1960,5,female,394,24,12,145,38,101,19,44,19
2095857,55,2,1958,5,female,461,24,10,145,28,115,18,30,10
1823716,70,13,1943,9,female,50,24,14,144,14,144,14,0,0
1994574,15,5,1998,3,female,655,24,11,153,8,16,6,137,2
1607988,24,23,1989,10,male,538,24,11,151,29,151,28,0,1
1488417,54,21,1959,8,female,875,24,24,160,105,155,75,5,30
1934595,32,23,1981,3,male,148,24,6,179,169,1,138,178,31
2151292,29,1,1984,1,male,56,24,8,180,100,180,85,0,15
1907026,21,14,1992,7,female,317,24,17,191,26,0,3,191,23
1385981,70,16,1943,10,female,676,24,16,199,32,29,30,170,2
1600830,103,16,1910,9,male,433,24,24,204,822,0,177,204,645
1161547,53,12,1960,10,male,380,24,11,213,10,213,3,0,7
1922995,103,31,1910,12,male,523,24,9,223,465,59,377,164,88
1367505,31,14,1982,4,female,219,24,15,237,40,150,38,87,2
1170236,64,19,1949,8,male,1112,24,20,252,22,252,18,0,4
1942927,15,20,1998,9,female,63,24,18,255,97,255,74,0,23
1911553,30,28,1983,12,female,371,24,17,264,77,257,27,7,50
1700775,18,19,1995,10,male,594,24,21,281,42,277,39,4,3
2010923,40,17,1973,12,female,69,24,23,297,1,297,1,0,0
2105263,71,18,1942,5,male,1078,24,19,386,413,0,89,386,324
2149842,19,9,1994,1,male,545,24,18,390,72,383,42,7,30
1189359,63,1,1950,1,male,216,24,23,433,81,0,16,433,65
1512344,62,18,1951,9,female,1807,24,10,469,52,0,9,469,43
1841989,38,19,1975,2,female,52,24,19,484,90,484,83,0,7
2044759,22,25,1991,2,male,515,24,10,688,41,8,14,680,27
1719674,40,1,1973,4,male,381,24,11,845,272,539,205,306,67
1391270,46,4,1967,9,female,107,24,16,849,578,849,480,0,98
2136842,71,10,1942,4,female,355,24,13,911,60,0,39,911,21
1920321,40,5,1973,11,male,592,24,5,982,118,848,100,134,18
1993163,32,1,1981,5,male,15,24,18,1475,74,1474,71,1,3
1741969,33,17,1980,9,female,215,24,17,1590,1242,1590,1127,0,115
2162063,43,1,1970,12,male,143,25,23,1,1,1,1,0,0
2053602,59,4,1954,3,female,230,25,23,1,1,1,1,0,0
1030022,61,12,1952,8,female,147,25,20,1,1,1,1,0,0
1449552,63,3,1950,7,female,1670,25,14,1,1,1,1,0,0
2161131,17,3,1996,4,female,5,25,9,1,4,1,2,0,2
1006730,18,1,1995,1,female,29,25,9,1,29,1,29,0,0
2168412,21,31,1992,7,male,567,25,12,1,9,1,8,0,1
1020902,25,5,1988,5,female,628,25,9,1,2,1,2,0,0
1368074,25,7,1988,6,male,47,25,14,1,2,1,2,0,0
1878319,31,9,1982,2,female,551,25,16,1,7,1,6,0,1
2146645,35,10,1978,12,male,21,25,15,1,4,1,4,0,0
1474204,45,30,1968,12,female,271,25,13,1,3,1,3,0,0
1474992,45,7,1968,7,male,308,25,20,1,2,1,2,0,0
1387911,69,14,1944,6,male,400,25,11,1,2,1,2,0,0
2163756,25,13,1988,6,male,256,25,6,2,0,0,0,2,0
1913189,33,2,1980,4,male,633,25,13,2,0,0,0,2,0
1890314,42,13,1971,12,male,35,25,18,2,0,0,0,2,0
1798178,59,20,1954,8,male,1595,25,13,2,0,0,0,2,0
1574190,21,21,1992,6,male,38,25,12,2,17,0,13,2,4
2122917,60,12,1953,2,female,315,25,8,2,3,0,3,2,0
1809248,72,18,1941,10,male,12,25,22,2,5,0,3,2,2
2073308,31,7,1982,3,male,240,25,18,2,0,1,0,1,0
1439982,65,22,1948,5,female,949,25,11,2,0,1,0,1,0
1098219,67,10,1946,10,male,715,25,20,2,0,1,0,1,0
1986440,31,20,1982,2,male,140,25,22,2,26,1,19,1,7
2148087,16,15,1997,6,male,217,25,24,2,0,2,0,0,0
1842007,19,4,1994,1,male,285,25,21,2,0,2,0,0,0
1773887,20,14,1993,7,male,319,25,17,2,0,2,0,0,0
1322684,23,6,1990,9,female,177,25,12,2,0,2,0,0,0
1087997,25,28,1988,6,male,215,25,24,2,0,2,0,0,0
1889979,26,25,1987,4,male,3,25,20,2,0,2,0,0,0
1721789,26,12,1987,6,male,883,25,12,2,0,2,0,0,0
1683204,28,6,1985,6,male,24,25,19,2,0,2,0,0,0
1857693,32,13,1981,4,male,321,25,25,2,0,2,0,0,0
1666047,46,21,1967,9,female,116,25,11,2,0,2,0,0,0
1897140,60,16,1953,7,female,132,25,22,2,0,2,0,0,0
1995443,17,8,1996,4,male,97,25,21,2,1,2,1,0,0
1265971,21,18,1992,10,female,38,25,11,2,1,2,1,0,0
1904356,26,1,1987,1,male,71,25,18,2,1,2,1,0,0
1238690,48,24,1965,3,male,375,25,21,2,1,2,0,0,1
1825635,28,5,1985,7,male,313,25,17,2,2,2,2,0,0
1311717,50,29,1963,11,female,31,25,11,2,2,2,2,0,0
2095592,51,3,1962,7,male,43,25,21,2,2,2,2,0,0
1600055,51,27,1962,9,male,921,25,5,2,2,2,2,0,0
1705605,17,1,1996,10,male,260,25,13,2,4,2,2,0,2
1475360,22,16,1991,8,female,64,25,23,2,9,2,9,0,0
1190907,25,17,1988,8,male,76,25,20,2,3,2,3,0,0
1934261,28,29,1985,12,female,80,25,15,2,9,2,7,0,2
1632488,27,10,1986,10,female,229,25,8,2,7,2,6,0,1
1194931,29,20,1984,11,male,1152,25,9,2,6,2,1,0,5
1024930,34,2,1979,10,male,89,25,14,2,18,2,10,0,8
1451202,41,14,1972,1,male,292,25,18,2,3,2,3,0,0
1238537,44,27,1969,6,female,119,25,16,2,6,2,6,0,0
1327101,46,4,1967,8,male,34,25,22,2,9,2,3,0,6
2031003,15,8,1998,2,male,264,25,18,3,0,0,0,3,0
2063763,27,1,1986,1,female,244,25,14,3,0,0,0,3,0
2044435,42,23,1971,8,female,678,25,11,3,0,0,0,3,0
1015347,67,15,1946,10,male,811,25,17,3,1,0,0,3,1
1619237,45,9,1968,2,male,406,25,12,3,3,0,1,3,2
1699698,64,1,1949,9,female,488,25,24,3,5,0,0,3,5
1750235,20,17,1993,8,male,415,25,12,3,1,2,0,1,1
1035437,51,27,1962,5,female,621,25,18,3,6,2,3,1,3
1527546,13,1,2000,1,male,52,25,16,3,0,3,0,0,0
1094177,19,2,1994,10,male,146,25,9,3,0,3,0,0,0
1353961,26,10,1987,10,female,428,25,20,3,0,3,0,0,0
1906905,31,27,1982,9,male,342,25,11,3,0,3,0,0,0
1069077,37,11,1976,8,male,412,25,20,3,0,3,0,0,0
1172644,60,2,1953,8,female,985,25,15,3,0,3,0,0,0
1521245,64,9,1949,2,male,419,25,10,3,0,3,0,0,0
2014462,24,18,1989,1,male,287,25,14,3,3,3,1,0,2
1295533,30,14,1983,10,female,256,25,19,3,4,3,4,0,0
1932090,34,7,1979,8,male,45,25,23,3,4,3,4,0,0
1736630,15,6,1998,7,male,617,25,16,3,9,3,9,0,0
2004209,21,6,1992,5,male,294,25,13,3,10,3,7,0,3
1491998,28,1,1985,1,male,391,25,16,3,5,3,4,0,1
1742075,29,14,1984,8,male,287,25,20,3,6,3,4,0,2
1997376,37,21,1976,10,male,103,25,19,3,8,3,8,0,0
1480908,78,17,1935,2,female,1613,25,13,4,0,0,0,4,0
1297710,18,29,1995,12,female,9,25,12,4,1,0,1,4,0
1788415,23,13,1990,9,male,95,25,22,4,2,0,1,4,1
1647581,49,18,1964,2,female,335,25,6,4,1,0,1,4,0
1355901,65,18,1948,7,female,475,25,15,4,2,0,1,4,1
2048210,57,10,1956,3,male,1243,25,9,4,5,0,1,4,4
2178042,48,28,1965,1,female,23,25,23,4,10,0,9,4,1
1907600,48,27,1965,2,male,320,25,12,4,23,0,9,4,14
2042001,59,7,1954,12,male,1825,25,16,4,16,0,10,4,6
1164493,45,7,1968,10,male,649,25,6,4,37,2,1,2,36
1469665,59,6,1954,7,male,152,25,22,4,7,2,3,2,4
2012614,14,1,1999,1,male,108,25,22,4,0,4,0,0,0
1295906,18,25,1995,9,male,170,25,21,4,0,4,0,0,0
1385824,19,27,1994,1,male,572,25,14,4,0,4,0,0,0
1637722,25,14,1988,2,male,232,25,18,4,0,4,0,0,0
1253375,31,9,1982,2,female,173,25,4,4,0,4,0,0,0
2185995,44,22,1969,2,male,709,25,11,4,0,4,0,0,0
2051019,22,1,1991,7,female,429,25,10,4,2,4,0,0,2
1479458,22,24,1991,10,male,314,25,13,4,1,4,1,0,0
1040391,49,16,1964,11,female,800,25,18,4,1,4,0,0,1
2052521,21,19,1992,5,male,10,25,15,4,4,4,3,0,1
1969206,34,5,1979,11,male,162,25,23,4,5,4,4,0,1
1883792,35,3,1978,12,female,27,25,20,4,12,4,12,0,0
1847753,15,14,1998,6,female,266,25,13,5,2,0,2,5,0
1214252,72,16,1941,2,male,288,25,17,5,2,0,0,5,2
1067207,36,13,1977,5,male,109,25,8,5,5,0,4,5,1
2149264,58,5,1955,11,male,247,25,12,5,77,0,64,5,13
1741766,85,3,1928,7,female,565,25,19,5,1,3,1,2,0
1091248,48,27,1965,3,male,771,25,11,5,0,5,0,0,0
1469163,18,4,1995,5,female,70,25,16,5,4,5,4,0,0
1478736,57,30,1956,8,female,562,25,17,5,4,5,1,0,3
1140005,18,26,1995,12,male,160,25,24,6,1,0,1,6,0
1288119,74,10,1939,5,male,1600,25,3,6,1,0,1,6,0
1244731,18,6,1995,10,male,395,25,14,6,5,0,5,6,0
1911744,14,20,1999,2,female,502,25,14,6,0,6,0,0,0
2177110,34,16,1979,5,male,501,25,7,6,0,6,0,0,0
1153377,65,19,1948,1,female,460,25,21,6,0,6,0,0,0
2075993,103,1,1910,1,male,1615,25,20,6,0,6,0,0,0
1925285,24,5,1989,3,male,37,25,8,6,1,6,0,0,1
1069036,28,20,1985,10,male,650,25,18,6,1,6,1,0,0
1837211,33,11,1980,5,male,118,25,21,6,2,6,1,0,1
1675336,42,7,1971,6,female,271,25,22,6,1,6,1,0,0
1394394,65,1,1948,1,male,405,25,11,6,3,6,2,0,1
1102922,16,14,1997,8,male,39,25,20,6,4,6,4,0,0
1688616,71,17,1942,11,male,642,25,12,6,8,6,7,0,1
1800841,72,22,1941,7,female,224,25,21,6,4,6,3,0,1
1177949,44,11,1969,5,male,137,25,13,6,40,6,8,0,32
2006886,57,14,1956,6,female,354,25,13,6,20,6,19,0,1
1948458,78,6,1935,3,female,10,25,22,6,31,6,29,0,2
1814927,18,4,1995,12,male,2,25,23,7,1,0,0,7,1
2170500,99,24,1914,8,male,2162,25,9,7,0,0,0,7,0
1130878,61,16,1952,7,male,1096,25,7,7,3,1,1,6,2
1858676,64,30,1949,6,male,1345,25,8,7,1,4,0,3,1
2064263,65,18,1948,2,female,1022,25,5,7,2,4,2,3,0
1833720,21,26,1992,9,male,211,25,10,7,0,7,0,0,0
1689896,56,17,1957,10,female,910,25,6,7,24,7,20,0,4
2174069,59,9,1954,8,female,236,25,12,8,0,0,0,8,0
1344232,85,29,1928,2,female,1117,25,15,8,1,0,1,8,0
2000250,20,16,1993,12,male,1016,25,16,8,4,0,4,8,0
2068851,58,17,1955,1,female,268,25,14,8,4,1,2,7,2
1266558,38,31,1975,3,female,116,25,22,8,8,1,1,7,7
1811698,25,1,1988,1,female,194,25,16,8,1,8,0,0,1
1279626,32,17,1981,10,female,280,25,21,8,3,8,3,0,0
1625542,73,15,1940,5,male,360,25,22,8,4,8,4,0,0
1309451,23,11,1990,4,female,219,25,5,8,11,8,11,0,0
1036768,60,11,1953,10,male,956,25,17,8,5,8,5,0,0
1551140,20,15,1993,10,female,578,25,1,8,38,8,35,0,3
1613703,49,14,1964,10,male,171,25,18,9,6,0,4,9,2
1647261,36,21,1977,3,male,390,25,24,9,1,5,1,4,0
2144620,108,1,1905,1,male,1373,25,11,9,2,3,0,6,2
1268401,73,6,1940,6,female,690,25,16,9,10,2,2,7,8
1486818,61,11,1952,5,female,2079,25,10,9,13,7,10,2,3
2033276,43,26,1970,7,female,466,25,12,9,27,7,20,2,7
1499388,31,10,1982,8,male,381,25,6,9,1,9,0,0,1
1551744,57,2,1956,2,male,538,25,24,9,0,9,0,0,0
1639708,44,28,1969,11,male,732,25,9,9,5,9,2,0,3
2049688,19,29,1994,12,male,36,25,8,9,7,9,6,0,1
1290124,15,13,1998,8,male,76,25,20,10,0,1,0,9,0
1394159,60,7,1953,1,female,304,25,21,10,1,0,0,10,1
1251191,67,21,1946,4,female,1803,25,7,10,0,0,0,10,0
2049791,18,29,1995,10,female,316,25,16,10,6,0,4,10,2
1185174,35,27,1978,12,female,294,25,11,10,4,1,2,9,2
2192326,51,25,1962,8,male,182,25,8,10,2,0,0,10,2
1152071,68,13,1945,9,female,1131,25,9,10,7,0,1,10,6
2062625,93,12,1920,9,male,202,25,22,10,13,0,6,10,7
1478470,59,26,1954,8,female,1441,25,21,10,15,0,3,10,12
1515577,29,16,1984,11,male,614,25,15,10,12,7,9,3,3
1120947,66,5,1947,8,female,87,25,17,10,10,4,2,6,8
1411529,67,14,1946,8,male,961,25,9,10,3,9,0,1,3
1718905,20,24,1993,2,male,58,25,20,10,0,10,0,0,0
1791060,29,1,1984,1,male,460,25,21,10,1,10,1,0,0
1482554,40,9,1973,5,male,30,25,24,10,5,10,4,0,1
2001590,66,9,1947,11,female,425,25,9,10,6,10,5,0,1
2185652,55,9,1958,5,male,327,25,18,10,8,10,8,0,0
1845269,63,26,1950,1,female,299,25,24,10,8,10,6,0,2
1998199,25,12,1988,1,male,228,25,17,10,16,10,12,0,4
1111813,69,4,1944,3,female,126,25,19,11,0,0,0,11,0
1599711,68,22,1945,10,female,1432,25,18,11,7,0,0,11,7
2095331,18,12,1995,12,male,181,25,20,11,4,11,4,0,0
2047896,64,3,1949,9,female,1218,25,15,11,8,11,7,0,1
1894863,53,1,1960,11,female,980,25,16,12,1,2,0,10,1
2035460,15,4,1998,3,male,193,25,8,12,0,11,0,1,0
1391622,64,13,1949,7,female,1070,25,17,13,0,0,0,13,0
1787007,57,15,1956,4,female,458,25,21,13,3,0,1,13,2
1704396,55,13,1958,10,male,283,25,19,13,9,0,2,13,7
2040522,58,16,1955,6,male,134,25,11,13,37,8,26,5,11
1733514,53,5,1960,12,female,1375,25,10,13,62,12,24,1,38
2100048,23,10,1990,1,male,289,25,23,13,6,13,6,0,0
1596624,38,14,1975,4,male,138,25,21,13,4,13,2,0,2
1475703,25,7,1988,3,male,31,25,14,13,27,13,19,0,8
1747643,84,12,1929,10,female,943,25,13,14,52,1,26,13,26
1147483,108,6,1905,9,female,188,25,11,14,33,0,3,14,30
1931325,26,5,1987,9,male,440,25,12,14,1,14,1,0,0
1116126,18,11,1995,8,male,89,25,19,14,4,14,3,0,1
1970531,80,14,1933,5,female,14,25,21,14,9,14,3,0,6
1673964,63,30,1950,5,female,168,25,15,15,13,0,0,15,13
1076312,36,5,1977,11,male,1498,25,12,15,30,5,17,10,13
1195560,18,12,1995,5,male,8,25,24,15,6,15,6,0,0
1485190,27,1,1986,10,male,157,25,8,15,19,15,18,0,1
1841167,43,11,1970,10,male,512,25,4,15,16,15,15,0,1
2167230,30,17,1983,7,female,608,25,12,15,27,15,22,0,5
1490503,39,17,1974,10,male,366,25,15,15,25,15,12,0,13
1580554,63,2,1950,10,female,841,25,12,16,5,0,2,16,3
2076784,50,20,1963,5,male,1432,25,9,16,2,12,1,4,1
1586782,18,27,1995,7,female,614,25,14,16,8,16,7,0,1
1568015,20,11,1993,5,male,294,25,3,16,14,16,13,0,1
1977782,41,26,1972,1,female,603,25,16,16,15,16,15,0,0
1154882,43,5,1970,2,male,673,25,11,17,14,3,8,14,6
1848447,19,17,1994,11,male,244,25,5,17,2,17,2,0,0
1156765,30,24,1983,4,male,861,25,5,17,1,17,1,0,0
1930440,48,2,1965,9,male,77,25,6,17,2,17,2,0,0
2021058,16,16,1997,5,male,230,25,16,17,5,17,3,0,2
1902697,53,3,1960,3,male,126,25,21,17,7,17,4,0,3
1945308,55,25,1958,4,male,562,25,9,18,6,0,4,18,2
1233322,51,4,1962,4,male,640,25,4,18,21,1,8,17,13
1772160,27,14,1986,2,female,433,25,17,18,54,3,21,15,33
1280620,58,11,1955,1,male,842,25,19,18,12,5,1,13,11
2030687,25,10,1988,1,male,335,25,16,18,13,18,10,0,3
2174825,20,1,1993,1,male,841,25,22,19,10,19,6,0,4
2071643,58,9,1955,3,female,338,25,22,19,7,19,1,0,6
1934748,20,10,1993,12,male,449,25,22,20,1,0,0,20,1
1581404,55,8,1958,7,female,639,25,12,20,3,1,0,19,3
1925228,74,3,1939,8,female,675,25,18,20,2,0,1,20,1
1030444,78,8,1935,2,male,346,25,19,20,2,0,1,20,1
1593836,26,1,1987,1,male,268,25,22,20,4,20,4,0,0
1231665,38,13,1975,9,female,427,25,9,20,4,20,1,0,3
1982327,47,16,1966,11,male,418,25,25,21,16,17,12,4,4
2125635,34,15,1979,7,male,137,25,22,21,229,20,205,1,24
1697978,63,24,1950,2,female,416,25,12,21,2,21,2,0,0
1160072,64,25,1949,10,female,252,25,19,22,2,0,1,22,1
1109033,23,1,1990,1,female,249,25,5,22,10,0,1,22,9
1568561,20,18,1993,10,female,268,25,8,22,22,0,15,22,7
1051109,48,25,1965,4,male,114,25,23,22,18,1,3,21,15
1452119,48,12,1965,5,female,566,25,6,22,0,22,0,0,0
1730578,52,14,1961,2,female,399,25,12,22,1,22,1,0,0
1672806,69,8,1944,9,female,184,25,21,22,0,22,0,0,0
1206003,21,27,1992,3,male,4,25,24,23,2,0,1,23,1
1912417,21,14,1992,3,male,194,25,16,23,12,23,1,0,11
1743779,19,25,1994,9,male,25,25,22,23,18,23,11,0,7
1573720,27,20,1986,9,male,131,25,22,23,20,23,18,0,2
1513487,40,7,1973,11,male,334,25,10,24,0,24,0,0,0
1052675,47,26,1966,3,male,532,25,13,24,2,24,2,0,0
2148068,20,10,1993,10,male,126,25,15,25,8,5,5,20,3
1942681,15,21,1998,5,female,96,25,15,25,8,25,4,0,4
1302885,28,3,1985,9,female,431,25,6,25,13,25,10,0,3
1449531,35,7,1978,1,female,327,25,24,25,91,25,83,0,8
1313342,29,20,1984,9,male,424,25,21,27,3,0,0,27,3
1831952,101,15,1912,12,female,574,25,19,27,12,25,12,2,0
1263214,15,27,1998,6,male,336,25,18,27,14,27,6,0,8
1346346,34,4,1979,10,female,225,25,20,28,32,3,11,25,21
2152052,15,19,1998,7,female,34,25,19,28,1,28,1,0,0
1879507,46,22,1967,1,male,153,25,16,28,0,28,0,0,0
1180576,58,24,1955,9,female,630,25,23,28,0,28,0,0,0
2173012,25,1,1988,1,male,167,25,22,28,6,28,2,0,4
1379582,63,30,1950,12,male,308,25,18,28,10,28,9,0,1
1658404,67,12,1946,7,male,1570,25,4,29,1,29,1,0,0
1710512,34,4,1979,11,male,168,25,15,30,2,0,0,30,2
1885819,23,1,1990,10,male,64,25,20,31,2,26,0,5,2
1480273,20,8,1993,12,male,76,25,11,30,7,30,2,0,5
1425263,55,7,1958,6,male,313,25,20,30,7,30,5,0,2
2130536,100,1,1913,2,male,224,25,11,30,9,30,9,0,0
1793301,19,30,1994,4,male,124,25,19,32,32,0,0,32,32
1513767,30,17,1983,2,male,40,25,14,32,14,21,13,11,1
1537743,39,9,1974,12,male,23,25,16,33,14,33,8,0,6
1977398,51,27,1962,8,female,90,25,19,33,11,33,9,0,2
1463102,36,21,1977,4,male,425,25,8,34,2,0,0,34,2
2050915,38,1,1975,2,female,48,25,22,34,12,34,11,0,1
1841428,29,20,1984,2,male,128,25,24,34,30,34,24,0,6
1839847,54,14,1959,10,female,75,25,20,36,15,1,9,35,6
1368712,24,20,1989,12,male,556,25,22,35,19,22,15,13,4
1689490,28,28,1985,12,male,502,25,6,35,0,35,0,0,0
1250058,59,9,1954,4,male,782,25,11,36,17,36,14,0,3
1816432,33,3,1980,4,female,517,25,10,35,29,35,28,0,1
1205593,75,20,1938,6,male,1691,25,15,37,4,0,0,37,4
1920353,21,16,1992,2,male,326,25,16,38,3,38,3,0,0
1281209,23,5,1990,4,male,40,25,18,39,15,39,14,0,1
1399888,26,2,1987,6,male,313,25,17,39,19,39,19,0,0
1427522,41,1,1972,1,male,6,25,18,40,12,1,2,39,10
2022235,65,1,1948,4,female,732,25,18,40,27,0,11,40,16
1934966,63,5,1950,5,female,20,25,15,41,20,0,7,41,13
1213068,53,14,1960,1,female,174,25,6,41,4,40,3,1,1
2042865,19,26,1994,2,male,130,25,21,42,0,42,0,0,0
1442724,29,21,1984,10,female,333,25,18,41,0,41,0,0,0
1813831,38,3,1975,6,male,496,25,11,44,0,35,0,9,0
1339295,58,4,1955,10,female,1240,25,17,43,4,43,3,0,1
1348069,36,18,1977,2,female,333,25,14,45,2,45,1,0,1
1525748,42,28,1971,4,female,573,25,14,45,22,45,19,0,3
1585571,70,14,1943,3,female,1120,25,12,45,29,45,24,0,5
1515402,33,23,1980,5,male,74,25,9,47,7,0,2,47,5
1642988,56,5,1957,11,male,588,25,14,46,30,40,12,6,18
1427582,21,26,1992,1,male,512,25,10,47,5,47,5,0,0
1228646,20,14,1993,10,female,272,25,11,47,19,47,13,0,6
1988817,36,20,1977,4,male,303,25,21,49,0,24,0,25,0
1853338,20,6,1993,12,male,41,25,23,49,72,29,27,20,45
1861995,28,5,1985,10,male,64,25,19,51,37,51,26,0,11
1133945,69,11,1944,5,female,53,25,15,51,51,51,17,0,34
1157496,37,7,1976,8,female,530,25,15,53,20,0,7,53,13
1782036,51,18,1962,3,male,351,25,22,52,17,0,9,52,8
1035308,108,13,1905,9,male,132,25,23,53,25,1,6,52,19
1901520,56,26,1957,4,female,921,25,16,52,48,0,28,52,20
2041383,46,14,1967,1,male,507,25,12,52,23,26,5,26,18
1236502,28,30,1985,7,female,140,25,22,53,24,53,13,0,11
1980943,64,1,1949,2,male,1226,25,18,53,37,53,13,0,24
1028764,66,3,1947,8,female,600,25,15,55,5,0,2,55,3
1143190,52,19,1961,8,female,436,25,10,54,24,0,12,54,12
1481640,37,27,1976,11,male,264,25,19,55,1,55,0,0,1
1208422,35,11,1978,11,male,150,25,13,58,4,0,0,58,4
1561680,47,17,1966,10,male,152,25,16,58,9,0,3,58,6
1088540,26,22,1987,9,male,75,25,7,57,70,57,53,0,17
1542692,30,8,1983,4,female,430,25,24,59,11,59,10,0,1
1138805,68,17,1945,6,male,984,25,11,61,3,0,3,61,0
1492979,65,11,1948,4,female,204,25,10,61,20,0,6,61,14
2067877,51,19,1962,7,female,1003,25,11,62,284,41,88,21,196
1175463,27,1,1986,1,male,371,25,14,62,1,62,1,0,0
1332292,52,20,1961,8,female,35,25,21,61,30,61,30,0,0
2048462,33,12,1980,11,male,419,25,21,65,2,58,2,7,0
1710885,16,15,1997,5,female,820,25,7,66,21,0,12,66,9
1959005,60,5,1953,8,female,1384,25,9,68,14,0,1,68,13
2071610,66,6,1947,8,female,133,25,21,66,35,1,7,65,28
1604025,64,13,1949,6,male,1755,25,18,66,2,66,2,0,0
1045846,47,10,1966,1,male,512,25,12,70,6,68,6,2,0
1555819,25,20,1988,1,male,35,25,8,70,6,70,6,0,0
1401082,16,7,1997,11,male,155,25,19,74,22,67,11,7,11
1131475,23,23,1990,7,female,313,25,8,77,55,0,7,77,48
1847100,67,11,1946,10,female,490,25,18,75,31,74,13,1,18
1648406,20,1,1993,1,female,210,25,9,76,35,76,21,0,14
1368276,23,9,1990,11,male,171,25,17,78,0,0,0,78,0
1095947,41,28,1972,1,male,216,25,13,79,77,78,71,1,6
1134940,83,22,1930,8,female,1097,25,16,79,1,79,1,0,0
1369005,108,25,1905,4,female,906,25,17,83,24,0,4,83,20
1343119,49,20,1964,9,male,527,25,11,83,4,83,3,0,1
2057251,21,19,1992,8,male,409,25,16,87,16,27,6,60,10
1724647,45,24,1968,5,male,230,25,19,91,28,0,24,91,4
1512355,76,12,1937,11,female,259,25,19,90,34,2,16,88,18
1721443,40,10,1973,3,male,710,25,15,89,2,86,1,3,1
1564331,33,29,1980,11,female,208,25,5,89,43,89,21,0,22
1342623,31,25,1982,1,female,129,25,17,94,181,18,49,76,132
1702171,23,24,1990,10,male,173,25,14,93,77,36,49,57,28
1259790,18,9,1995,11,female,247,25,14,93,176,85,144,8,32
2162325,27,10,1986,3,female,114,25,14,93,8,93,5,0,3
1040249,33,29,1980,6,female,824,25,16,95,38,95,38,0,0
1625217,21,30,1992,9,male,49,25,12,93,57,93,54,0,3
1720037,28,19,1985,3,male,176,25,22,98,33,98,28,0,5
1410044,73,25,1940,1,male,53,25,20,104,16,104,12,0,4
1267487,29,15,1984,11,male,108,25,11,100,79,100,29,0,50
1392406,73,25,1940,7,female,645,25,12,106,37,104,21,2,16
2154941,15,12,1998,1,male,102,25,20,109,9,109,8,0,1
2179626,61,2,1952,3,female,1740,25,7,110,62,0,4,110,58
1393222,41,27,1972,7,female,203,25,18,111,70,0,16,111,54
1828434,18,1,1995,2,female,153,25,22,113,0,113,0,0,0
1820030,24,29,1989,12,male,206,25,15,118,2,111,1,7,1
1433055,35,2,1978,6,female,193,25,19,114,84,114,45,0,39
1593877,70,4,1943,8,male,180,25,23,123,18,0,3,123,15
1738345,46,24,1967,5,male,472,25,17,121,51,102,48,19,3
2127252,20,13,1993,10,female,373,25,13,122,13,122,12,0,1
1852591,75,8,1938,7,female,1299,25,12,127,65,0,10,127,55
1350087,37,2,1976,8,male,440,25,1,129,86,129,81,0,5
2004659,23,1,1990,1,male,250,25,15,131,44,81,33,50,11
1065697,19,1,1994,4,male,47,25,18,131,10,131,8,0,2
1363679,54,25,1959,12,female,490,25,9,136,82,136,37,0,45
1522979,25,5,1988,1,male,8,25,19,131,253,131,245,0,8
1821851,28,16,1985,12,female,26,25,20,143,12,142,11,1,1
1397833,21,13,1992,9,female,266,25,14,138,6,138,4,0,2
2104071,53,15,1960,6,male,93,25,24,140,15,140,12,0,3
1095109,61,26,1952,2,female,317,25,20,143,1,143,1,0,0
1994073,40,13,1973,3,female,95,25,7,141,28,141,18,0,10
1109775,27,10,1986,9,male,61,25,24,148,16,137,10,11,6
2045715,33,6,1980,11,male,131,25,5,155,9,155,8,0,1
1020815,64,13,1949,11,female,163,25,14,152,28,152,18,0,10
1012294,20,17,1993,2,male,43,25,23,169,5,169,4,0,1
1645715,45,20,1968,11,male,233,25,18,173,18,121,14,52,4
1210956,36,2,1977,7,female,191,25,4,173,5,171,4,2,1
1926112,35,15,1978,7,male,413,25,22,190,184,189,167,1,17
1727899,66,14,1947,8,female,201,25,15,201,235,0,87,201,148
2130650,46,28,1967,4,female,308,25,9,201,37,201,24,0,13
1569917,39,14,1974,10,male,246,25,10,224,2,0,0,224,2
1216394,15,1,1998,7,male,146,25,21,224,15,220,4,4,11
1833310,61,31,1952,12,female,355,25,12,240,7,173,2,67,5
1634856,23,1,1990,4,male,490,25,17,240,19,240,14,0,5
1100291,26,8,1987,2,female,109,25,15,254,50,163,24,91,26
1161701,108,4,1905,7,male,194,25,11,257,92,243,74,14,18
1260909,100,1,1913,9,male,108,25,23,262,178,122,99,140,79
1526479,46,29,1967,4,female,361,25,15,276,103,276,49,0,54
1084688,50,27,1963,6,female,252,25,13,278,24,278,4,0,20
2060033,95,13,1918,10,male,1469,25,12,341,125,5,57,336,68
1438347,48,6,1965,5,female,541,25,14,332,10,175,10,157,0
1377532,37,24,1976,8,male,524,25,12,372,27,348,21,24,6
1548739,62,28,1951,4,female,664,25,17,378,4,362,4,16,0
1940076,38,27,1975,6,male,507,25,23,455,44,355,13,100,31
1440882,57,9,1956,3,female,290,25,13,460,55,460,7,0,48
1604728,48,30,1965,5,female,322,25,23,499,44,0,3,499,41
1529623,60,1,1953,1,male,198,25,8,586,164,0,46,586,118
1628112,13,29,2000,2,female,243,25,7,608,40,608,20,0,20
1996424,17,6,1996,7,female,154,25,17,580,13,580,9,0,4
2183300,25,11,1988,5,male,330,25,21,591,40,591,34,0,6
1954460,31,20,1982,6,female,92,25,13,565,5,565,5,0,0
1960684,35,25,1978,4,female,236,25,19,677,148,677,112,0,36
1110703,25,6,1988,1,female,147,25,12,801,60,208,16,593,44
1547827,39,15,1974,4,male,325,25,12,1004,5,0,0,1004,5
1403906,51,22,1962,7,female,216,25,22,1464,78,0,5,1464,73
1623697,57,8,1956,9,female,780,25,10,1302,769,0,209,1302,560
2123135,33,15,1980,2,male,60,25,21,1335,328,1137,119,198,209
1723546,29,21,1984,5,female,80,25,20,1751,451,1717,409,34,42
1270467,19,17,1994,3,female,90,25,14,1761,257,1761,234,0,23
1392196,41,27,1972,1,female,1329,25,14,2018,244,1316,66,702,178
2113543,45,3,1968,12,female,89,25,16,2176,212,2176,66,0,146
1510941,28,4,1985,2,male,198,27,24,1,1,0,0,1,1
2062890,54,5,1959,4,female,255,27,12,1,1,0,0,1,1
1244477,69,18,1944,1,male,602,26,20,1,1,0,0,1,1
2133297,69,3,1944,2,female,620,27,1,1,1,0,0,1,1
2038922,70,11,1943,8,male,989,26,15,1,1,0,0,1,1
1332144,108,1,1905,5,male,180,26,11,1,1,0,1,1,0
1804456,16,30,1997,8,male,223,27,16,1,3,0,0,1,3
1274981,18,28,1995,1,male,969,26,25,1,4,0,2,1,2
1593328,23,12,1990,6,male,381,27,12,1,2,0,2,1,0
1082400,29,1,1984,1,male,656,27,16,1,8,0,4,1,4
1149426,31,23,1982,10,male,19,27,13,1,9,0,5,1,4
1226424,36,20,1977,6,male,153,27,21,1,14,0,7,1,7
1193884,48,13,1965,8,male,301,27,22,1,3,0,2,1,1
2149237,50,6,1963,1,male,130,27,6,1,6,0,4,1,2
1047748,51,14,1962,7,male,506,26,5,1,13,0,3,1,10
1244426,51,29,1962,7,female,224,26,20,1,4,0,1,1,3
1623787,54,4,1959,12,female,592,26,24,1,5,0,4,1,1
2010326,59,13,1954,2,female,754,26,12,1,5,0,2,1,3
1591720,63,15,1950,4,male,226,26,14,1,5,0,0,1,5
1442256,67,13,1946,7,female,337,26,20,1,2,0,0,1,2
2032165,72,14,1941,10,male,865,26,16,1,7,0,4,1,3
1945479,74,5,1939,7,female,625,26,11,1,4,0,1,1,3
1011351,77,24,1936,12,female,731,26,13,1,8,0,4,1,4
1725686,88,29,1925,8,male,1582,27,15,1,54,0,35,1,19
1436049,15,17,1998,12,female,15,26,2,1,0,1,0,0,0
1104133,15,1,1998,8,female,153,26,18,1,0,1,0,0,0
1748582,17,11,1996,10,male,239,26,26,1,0,1,0,0,0
2086909,18,1,1995,1,male,387,27,23,1,0,1,0,0,0
1924105,18,13,1995,7,female,346,27,20,1,0,1,0,0,0
1640092,19,1,1994,1,male,46,26,18,1,0,1,0,0,0
1561959,21,6,1992,11,male,325,26,26,1,0,1,0,0,0
1285385,20,12,1993,1,male,567,26,12,1,0,1,0,0,0
1236966,20,21,1993,3,male,417,27,22,1,0,1,0,0,0
1398003,22,29,1991,7,male,482,27,13,1,0,1,0,0,0
2010794,22,13,1991,8,female,185,26,14,1,0,1,0,0,0
1378766,23,17,1990,1,male,185,26,20,1,0,1,0,0,0
1396265,23,1,1990,1,male,398,27,7,1,0,1,0,0,0
1042368,23,3,1990,3,male,313,27,22,1,0,1,0,0,0
1691887,24,5,1989,2,male,306,27,8,1,0,1,0,0,0
1481535,25,1,1988,1,male,237,26,20,1,0,1,0,0,0
2042299,26,27,1987,7,male,537,26,23,1,0,1,0,0,0
1369158,28,24,1985,12,male,1064,26,19,1,0,1,0,0,0
1558942,27,9,1986,1,male,221,27,9,1,0,1,0,0,0
2143795,29,2,1984,5,male,188,26,18,1,0,1,0,0,0
1701286,30,15,1983,4,male,540,27,17,1,0,1,0,0,0
1165398,30,19,1983,7,male,356,26,14,1,0,1,0,0,0
1056638,32,10,1981,12,male,92,26,24,1,0,1,0,0,0
2045433,33,1,1980,1,male,342,26,16,1,0,1,0,0,0
1506255,33,18,1980,3,male,37,26,13,1,0,1,0,0,0
1446587,33,17,1980,7,male,48,26,24,1,0,1,0,0,0
2117260,34,22,1979,2,male,572,26,16,1,0,1,0,0,0
1725096,37,28,1976,11,male,1101,27,10,1,0,1,0,0,0
1975253,37,22,1976,3,male,347,26,20,1,0,1,0,0,0
1863633,48,20,1965,4,female,74,27,13,1,0,1,0,0,0
1467768,51,21,1962,3,female,380,26,1,1,0,1,0,0,0
1851425,52,10,1961,10,male,254,26,16,1,0,1,0,0,0
1858670,58,28,1955,2,female,615,27,25,1,0,1,0,0,0
1858162,58,6,1955,9,female,39,27,26,1,0,1,0,0,0
1998634,62,17,1951,12,male,164,27,24,1,0,1,0,0,0
1102186,62,24,1951,4,male,1093,27,24,1,0,1,0,0,0
1630142,68,17,1945,8,male,21,27,21,1,0,1,0,0,0
1078291,85,16,1928,1,male,1742,26,11,1,0,1,0,0,0
1800768,103,6,1910,3,male,66,26,20,1,0,1,0,0,0
2062338,16,5,1997,9,female,47,26,12,1,1,1,1,0,0
1296878,18,17,1995,7,male,29,26,22,1,1,1,1,0,0
1889409,19,29,1994,4,male,31,26,25,1,1,1,0,0,1
1004759,21,2,1992,11,male,14,26,26,1,1,1,1,0,0
1831783,26,2,1987,2,male,307,26,24,1,1,1,1,0,0
1852257,28,15,1985,1,female,89,26,23,1,1,1,1,0,0
1704899,29,1,1984,1,male,229,27,27,1,1,1,0,0,1
1104857,32,21,1981,11,male,134,26,23,1,1,1,0,0,1
1542815,32,13,1981,12,female,224,26,7,1,1,1,1,0,0
1966481,32,16,1981,2,male,102,27,19,1,1,1,1,0,0
1744615,33,10,1980,5,female,305,26,24,1,1,1,0,0,1
1520856,34,27,1979,9,female,462,26,20,1,1,1,1,0,0
1753876,49,31,1964,12,male,516,27,15,1,1,1,0,0,1
1440718,51,1,1962,4,female,416,27,9,1,1,1,1,0,0
2103653,69,1,1944,12,female,928,27,20,1,1,1,1,0,0
1881763,15,24,1998,6,male,21,27,14,1,5,1,2,0,3
2133308,15,20,1998,10,male,355,27,16,1,2,1,2,0,0
1333042,16,11,1997,10,female,296,27,14,1,8,1,0,0,8
1232804,19,5,1994,10,female,41,27,24,1,5,1,4,0,1
1710661,20,30,1993,10,male,298,27,16,1,3,1,3,0,0
1693732,23,12,1990,4,male,64,27,22,1,7,1,7,0,0
1110404,23,19,1990,8,male,219,27,21,1,12,1,5,0,7
1518200,26,18,1987,12,female,95,26,21,1,6,1,5,0,1
1562318,26,5,1987,12,male,75,27,7,1,4,1,4,0,0
1427962,25,29,1988,3,male,39,26,15,1,15,1,14,0,1
2186446,25,1,1988,7,female,288,26,8,1,3,1,3,0,0
1853094,25,5,1988,10,male,184,27,22,1,3,1,2,0,1
2189528,25,8,1988,10,female,147,27,14,1,2,1,2,0,0
1466280,28,23,1985,5,male,10,27,26,1,6,1,4,0,2
1178074,29,25,1984,3,female,729,27,12,1,3,1,2,0,1
2058367,31,14,1982,4,male,29,26,26,1,4,1,3,0,1
1835490,32,13,1981,4,male,884,27,16,1,4,1,4,0,0
2024148,33,23,1980,9,male,339,26,15,1,11,1,7,0,4
1700691,36,23,1977,11,male,484,27,18,1,6,1,5,0,1
2015217,38,17,1975,9,male,387,27,11,1,8,1,4,0,4
2016304,42,21,1971,3,male,115,26,7,1,26,1,8,0,18
1292871,44,1,1969,1,male,1554,27,13,1,4,1,1,0,3
1768698,46,27,1967,4,male,366,26,11,1,37,1,7,0,30
1724933,46,1,1967,7,male,71,27,22,1,12,1,11,0,1
1463923,49,24,1964,12,male,209,26,20,1,5,1,1,0,4
1880749,48,1,1965,4,female,54,27,10,1,12,1,8,0,4
1036053,51,19,1962,3,male,279,26,15,1,9,1,9,0,0
1432135,54,28,1959,11,female,306,27,24,1,2,1,1,0,1
2078803,55,18,1958,11,male,467,27,15,1,3,1,3,0,0
1242558,55,17,1958,4,male,1336,26,7,1,7,1,0,0,7
1680954,57,31,1956,10,male,1378,26,14,1,13,1,12,0,1
1713395,59,1,1954,5,male,1546,26,4,1,4,1,4,0,0
2025358,61,18,1952,4,female,754,27,14,1,5,1,5,0,0
1005472,100,1,1913,11,female,916,26,15,1,3,1,1,0,2
1311173,53,13,1960,3,female,611,26,10,2,0,0,0,2,0
1920730,45,8,1968,11,male,309,26,9,2,1,0,1,2,0
1683921,46,29,1967,8,male,346,26,25,2,1,0,1,2,0
1225825,70,9,1943,7,male,311,26,11,2,1,0,0,2,1
1471337,19,20,1994,1,female,172,26,15,2,2,0,2,2,0
1841227,21,22,1992,9,male,382,27,14,2,2,0,2,2,0
1616461,21,5,1992,4,male,294,26,19,2,7,0,5,2,2
1631577,25,9,1988,10,female,261,27,9,2,4,0,0,2,4
1964356,28,31,1985,12,male,660,26,23,2,7,0,6,2,1
1504764,32,13,1981,3,female,339,27,19,2,3,0,0,2,3
2019994,48,7,1965,4,male,1273,27,6,2,4,0,3,2,1
1462748,49,26,1964,3,male,543,27,11,2,24,0,15,2,9
1831192,58,8,1955,1,male,303,27,24,2,7,0,0,2,7
1429840,59,19,1954,10,female,1014,26,11,2,3,0,3,2,0
1923658,60,17,1953,7,male,1193,27,13,2,4,0,3,2,1
1534017,64,9,1949,3,male,394,27,21,2,3,0,1,2,2
2192288,64,11,1949,5,female,231,27,17,2,5,0,2,2,3
1757873,70,18,1943,5,male,1289,26,12,2,4,0,3,2,1
1707750,22,6,1991,1,female,299,26,24,2,0,1,0,1,0
1165717,29,26,1984,5,male,143,27,25,2,0,1,0,1,0
1241577,51,7,1962,4,male,1204,27,20,2,0,1,0,1,0
1226743,53,12,1960,12,male,158,26,8,2,1,1,1,1,0
1145693,62,17,1951,3,male,406,27,6,2,1,1,1,1,0
1427520,38,16,1975,1,female,669,26,16,2,10,1,3,1,7
1950694,61,15,1952,11,male,1417,26,9,2,4,1,3,1,1
1162699,19,7,1994,7,male,655,26,16,2,0,2,0,0,0
1704208,20,23,1993,5,male,606,26,4,2,0,2,0,0,0
1201393,24,8,1989,11,female,155,26,19,2,0,2,0,0,0
1117220,25,1,1988,5,male,4,27,27,2,0,2,0,0,0
2127919,25,10,1988,10,male,358,27,12,2,0,2,0,0,0
1264649,26,18,1987,1,male,593,27,17,2,0,2,0,0,0
2163080,28,23,1985,12,male,426,27,20,2,0,2,0,0,0
1422836,28,3,1985,3,male,376,27,11,2,0,2,0,0,0
2063326,28,6,1985,7,female,151,27,8,2,0,2,0,0,0
1113326,28,31,1985,10,male,338,26,26,2,0,2,0,0,0
1502129,41,10,1972,11,female,122,27,18,2,0,2,0,0,0
1758630,40,25,1973,1,male,312,27,2,2,0,2,0,0,0
1275477,55,10,1958,8,female,1106,26,19,2,0,2,0,0,0
1565930,56,4,1957,2,male,330,27,25,2,0,2,0,0,0
1092910,62,21,1951,7,female,159,27,15,2,0,2,0,0,0
2032549,65,12,1948,11,female,53,27,24,2,0,2,0,0,0
1827711,100,29,1913,1,male,1494,26,11,2,0,2,0,0,0
1409268,17,1,1996,2,female,37,26,13,2,1,2,1,0,0
1065571,18,1,1995,1,male,118,27,21,2,1,2,1,0,0
1233124,22,27,1991,2,male,155,26,24,2,1,2,1,0,0
1196675,23,10,1990,10,male,59,27,19,2,1,2,1,0,0
1189442,26,1,1987,1,male,138,26,26,2,1,2,1,0,0
1573673,34,2,1979,2,male,99,26,17,2,1,2,1,0,0
1227509,34,28,1979,4,female,400,27,16,2,1,2,0,0,1
1957395,39,23,1974,7,male,81,27,16,2,1,2,1,0,0
1627455,60,31,1953,1,male,397,27,21,2,1,2,1,0,0
1484635,28,10,1985,6,male,343,26,13,2,2,2,0,0,2
1500767,56,29,1957,6,male,706,27,21,2,2,2,2,0,0
1385005,15,11,1998,7,female,309,27,21,2,5,2,2,0,3
1844606,16,27,1997,2,male,506,26,5,2,3,2,1,0,2
2162024,18,11,1995,10,male,515,27,8,2,43,2,36,0,7
1817221,18,10,1995,10,female,109,27,22,2,3,2,3,0,0
1787398,21,22,1992,9,male,23,27,17,2,4,2,2,0,2
1522989,26,30,1987,11,female,262,27,16,2,3,2,3,0,0
1702044,26,10,1987,10,male,131,27,16,2,3,2,3,0,0
1103216,27,11,1986,7,female,249,27,1,2,4,2,3,0,1
1255399,29,19,1984,2,male,793,26,14,2,3,2,1,0,2
1479390,31,5,1982,5,male,159,27,26,2,8,2,2,0,6
1697000,32,14,1981,2,female,246,26,9,2,5,2,4,0,1
1078859,36,1,1977,5,male,23,26,25,2,3,2,3,0,0
1075014,43,23,1970,7,female,188,27,11,2,6,2,5,0,1
1204634,44,4,1969,2,female,135,27,23,2,5,2,5,0,0
1626886,44,25,1969,8,male,310,27,11,2,3,2,2,0,1
2001481,56,22,1957,5,male,1171,26,7,2,3,2,2,0,1
2002273,57,5,1956,8,male,1100,26,15,2,14,2,4,0,10
1515099,59,5,1954,7,male,511,27,21,2,20,2,10,0,10
1860974,61,10,1952,12,male,14,27,11,2,13,2,12,0,1
1303216,60,13,1953,6,female,1295,27,24,2,7,2,5,0,2
1396058,63,25,1950,3,male,906,27,12,2,7,2,7,0,0
1084766,70,31,1943,10,male,1742,27,11,2,7,2,4,0,3
2182893,14,29,1999,9,male,375,26,14,3,0,0,0,3,0
1272392,23,1,1990,1,male,178,26,18,3,0,0,0,3,0
1869577,44,18,1969,6,male,274,27,20,3,0,0,0,3,0
2065499,14,1,1999,3,male,121,27,21,3,1,0,0,3,1
1109263,15,14,1998,8,female,264,26,4,3,1,0,0,3,1
1918238,21,17,1992,6,female,312,27,6,3,1,0,1,3,0
1344675,36,7,1977,12,male,362,27,20,3,1,0,1,3,0
1466341,74,6,1939,6,female,844,27,16,3,1,0,0,3,1
1376768,52,10,1961,4,female,638,26,14,3,2,0,1,3,1
2122785,57,31,1956,5,female,288,26,8,3,3,0,2,3,1
1378849,60,23,1953,8,male,71,27,20,3,3,0,1,3,2
1468300,69,17,1944,8,female,395,26,15,3,2,0,0,3,2
1156639,32,23,1981,1,male,871,26,19,3,11,0,6,3,5
1168753,48,5,1965,1,female,288,27,23,3,7,0,3,3,4
1582250,69,14,1944,10,male,1642,26,20,3,8,0,5,3,3
1088110,76,1,1937,3,male,37,26,26,3,13,0,3,3,10
1421537,23,30,1990,10,male,296,27,27,3,0,2,0,1,0
2060106,31,22,1982,4,female,360,27,18,3,0,1,0,2,0
2138619,75,4,1938,7,male,303,27,10,3,1,1,0,2,1
1956302,40,23,1973,6,male,535,27,19,3,3,2,1,1,2
1536848,70,23,1943,11,male,1206,27,4,3,6,2,2,1,4
1296337,14,31,1999,1,male,78,27,22,3,0,3,0,0,0
1901985,16,7,1997,5,male,329,27,20,3,0,3,0,0,0
1471714,18,12,1995,12,male,149,26,19,3,0,3,0,0,0
1778021,21,12,1992,12,male,130,26,24,3,0,3,0,0,0
2121027,21,15,1992,5,female,556,27,14,3,0,3,0,0,0
2071798,23,11,1990,12,male,91,26,24,3,0,3,0,0,0
1508430,22,5,1991,7,male,417,26,25,3,0,3,0,0,0
1302245,25,18,1988,1,female,158,26,16,3,0,3,0,0,0
1262799,27,6,1986,12,male,195,26,22,3,0,3,0,0,0
1392965,27,24,1986,7,male,133,26,22,3,0,3,0,0,0
1870309,29,3,1984,7,male,253,27,11,3,0,3,0,0,0
1389246,31,4,1982,12,male,413,26,23,3,0,3,0,0,0
1817455,35,10,1978,4,female,1001,27,9,3,0,3,0,0,0
2043189,39,9,1974,8,male,774,27,14,3,0,3,0,0,0
1036977,44,16,1969,10,male,180,26,25,3,0,3,0,0,0
1784698,50,16,1963,9,female,508,27,19,3,0,3,0,0,0
1980139,61,21,1952,2,male,1735,27,10,3,0,3,0,0,0
1728067,67,10,1946,8,male,487,26,19,3,0,3,0,0,0
1406471,14,2,1999,1,male,165,26,17,3,1,3,1,0,0
1340621,27,13,1986,3,male,477,26,16,3,1,3,0,0,1
1111106,33,30,1980,12,male,825,26,25,3,1,3,1,0,0
1289354,33,12,1980,12,male,146,27,26,3,1,3,1,0,0
2046356,45,5,1968,1,female,55,26,13,3,1,3,1,0,0
1611998,69,29,1944,5,male,740,26,15,3,1,3,0,0,1
1877091,15,5,1998,9,male,29,27,24,3,2,3,2,0,0
1466273,23,25,1990,1,male,17,27,19,3,2,3,2,0,0
1842831,27,11,1986,11,female,105,27,11,3,2,3,2,0,0
1404880,17,1,1996,1,male,639,27,6,3,5,3,0,0,5
1725408,18,7,1995,6,male,112,26,16,3,21,3,16,0,5
1572162,21,18,1992,2,male,389,27,15,3,13,3,0,0,13
1413183,32,9,1981,3,male,666,27,22,3,7,3,6,0,1
2014445,37,17,1976,2,male,316,27,11,3,16,3,15,0,1
1000440,39,11,1974,10,male,143,26,23,3,14,3,8,0,6
1142280,43,9,1970,5,female,136,27,17,3,18,3,15,0,3
1210329,74,24,1939,9,female,292,26,5,3,6,3,4,0,2
1014125,108,1,1905,11,female,182,27,22,3,15,3,4,0,11
1283688,15,5,1998,11,male,148,27,6,4,0,0,0,4,0
1388080,54,2,1959,2,female,475,27,9,4,0,0,0,4,0
1727499,55,15,1958,3,female,1026,26,7,4,0,0,0,4,0
1739786,65,24,1948,3,female,726,26,16,4,0,0,0,4,0
1633348,70,4,1943,8,male,1478,26,6,4,0,0,0,4,0
1322328,20,25,1993,12,male,373,26,17,4,1,0,0,4,1
1948317,14,12,1999,9,male,351,27,9,4,12,0,4,4,8
1742446,64,4,1949,2,female,117,27,16,4,7,0,7,4,0
1040181,40,6,1973,8,male,161,26,16,4,0,1,0,3,0
1135718,57,25,1956,2,male,848,26,21,4,0,2,0,2,0
1408060,26,3,1987,4,male,140,27,21,4,2,1,0,3,2
1788596,46,5,1967,11,female,67,26,16,4,3,1,2,3,1
1278286,63,10,1950,3,female,752,26,11,4,15,2,10,2,5
1996811,71,1,1942,1,female,1176,26,20,4,5,3,2,1,3
1858036,17,22,1996,12,female,83,27,10,4,10,3,5,1,5
2016604,33,16,1980,1,female,184,26,17,4,7,3,2,1,5
1011454,18,13,1995,11,male,161,27,22,4,0,4,0,0,0
1823731,25,1,1988,1,male,38,27,27,4,0,4,0,0,0
1461970,25,15,1988,8,male,78,26,11,4,0,4,0,0,0
1146074,31,14,1982,7,male,144,27,27,4,0,4,0,0,0
2123833,36,8,1977,11,female,495,27,12,4,0,4,0,0,0
2061112,51,9,1962,3,female,292,27,16,4,0,4,0,0,0
1507480,20,10,1993,2,male,531,26,10,4,1,4,0,0,1
1665958,21,4,1992,3,male,85,27,27,4,2,4,0,0,2
1371792,26,1,1987,1,female,440,27,21,4,2,4,2,0,0
1950250,30,12,1983,2,male,26,27,23,4,1,4,1,0,0
1289244,37,24,1976,12,male,606,27,18,4,1,4,1,0,0
1808722,52,14,1961,1,male,244,26,14,4,2,4,2,0,0
1591860,57,12,1956,3,male,744,26,14,4,2,4,2,0,0
2117224,58,5,1955,2,female,653,26,17,4,1,4,1,0,0
1412866,59,18,1954,5,male,457,26,21,4,1,4,1,0,0
1353694,24,3,1989,3,male,278,26,10,4,3,4,3,0,0
1968239,25,1,1988,1,male,86,26,22,4,4,4,2,0,2
1730169,17,9,1996,5,male,4,27,12,4,15,4,15,0,0
1922848,23,1,1990,1,male,170,27,9,4,13,4,9,0,4
2123200,24,17,1989,10,male,527,27,9,4,12,4,1,0,11
2039156,25,1,1988,1,male,66,27,25,4,6,4,4,0,2
1735677,36,24,1977,8,male,392,27,19,4,17,4,17,0,0
1601808,42,11,1971,11,male,583,27,22,4,24,4,19,0,5
1832908,47,10,1966,9,male,927,26,19,4,18,4,17,0,1
1318029,65,10,1948,12,female,1183,27,14,4,19,4,15,0,4
1313315,16,12,1997,10,female,158,27,26,5,0,0,0,5,0
1483803,30,11,1983,11,male,704,26,22,5,0,0,0,5,0
1167812,53,7,1960,8,female,295,26,5,5,0,0,0,5,0
1312261,82,15,1931,7,female,1140,27,12,5,0,0,0,5,0
1011762,32,6,1981,3,male,575,26,16,5,3,0,0,5,3
1561230,48,6,1965,8,male,937,27,15,5,5,0,4,5,1
1230985,53,7,1960,9,female,1387,27,22,5,4,0,3,5,1
1911356,27,31,1986,10,male,259,27,18,5,16,0,7,5,9
2115596,65,9,1948,5,male,2270,26,8,5,18,0,15,5,3
2152149,55,3,1958,5,female,316,27,23,5,0,2,0,3,0
1406768,25,2,1988,4,male,47,27,13,5,7,1,5,4,2
1547967,25,14,1988,7,female,429,27,10,5,5,3,3,2,2
1051874,39,11,1974,12,female,347,27,15,5,6,1,0,4,6
2099242,56,18,1957,2,male,909,27,17,5,21,2,17,3,4
1052347,63,9,1950,4,female,1605,26,15,5,2,4,0,1,2
1965355,22,5,1991,8,male,7,27,20,5,4,4,2,1,2
1261593,26,5,1987,4,male,57,27,11,5,5,4,4,1,1
2120677,35,30,1978,7,female,520,27,17,5,0,5,0,0,0
1289582,38,18,1975,12,male,768,27,15,5,0,5,0,0,0
1404963,38,9,1975,6,male,180,26,23,5,0,5,0,0,0
2151667,26,20,1987,11,male,371,26,17,5,2,5,2,0,0
1566043,25,1,1988,1,female,43,27,11,5,3,5,2,0,1
1493506,26,1,1987,5,male,27,26,23,5,1,5,1,0,0
1823841,40,21,1973,8,male,62,26,18,5,2,5,2,0,0
1141412,45,1,1968,5,male,743,26,4,5,2,5,2,0,0
2177149,68,17,1945,2,male,24,26,14,5,2,5,2,0,0
1598006,69,25,1944,8,female,1368,27,11,5,2,5,0,0,2
1588409,78,13,1935,1,female,710,26,15,5,2,5,2,0,0
1222160,41,28,1972,7,male,512,27,23,5,5,5,5,0,0
1440116,108,28,1905,7,female,98,27,24,5,5,5,2,0,3
1321356,24,14,1989,2,female,16,26,26,5,9,5,7,0,2
1170882,28,8,1985,8,male,720,26,13,5,14,5,11,0,3
1210515,33,3,1980,7,female,1726,27,20,5,14,5,9,0,5
1885155,58,25,1955,8,female,332,26,9,5,22,5,22,0,0
1842890,37,14,1976,9,male,212,26,8,6,0,0,0,6,0
1608049,53,20,1960,12,male,797,27,25,6,0,1,0,5,0
1077697,70,22,1943,7,female,1130,27,12,6,2,0,1,6,1
1120473,81,29,1932,6,male,1461,26,16,6,3,0,1,6,2
1677218,69,24,1944,4,male,454,27,17,6,5,0,0,6,5
1495785,32,6,1981,2,female,361,27,19,6,25,0,4,6,21
2181590,20,3,1993,12,male,376,27,10,6,1,4,0,2,1
2088596,108,12,1905,5,male,996,26,8,6,1,3,1,3,0
1152744,26,1,1987,1,female,166,27,23,6,28,5,26,1,2
2129814,17,1,1996,10,male,51,27,25,6,0,6,0,0,0
1330305,20,10,1993,12,male,527,26,14,6,0,6,0,0,0
1070854,25,18,1988,12,male,611,27,20,6,0,6,0,0,0
1957889,33,10,1980,5,male,587,27,15,6,0,6,0,0,0
1307882,41,26,1972,1,male,691,27,10,6,0,6,0,0,0
1058630,44,12,1969,5,male,391,26,10,6,0,6,0,0,0
1578594,16,3,1997,9,male,244,27,21,6,3,6,3,0,0
1639233,30,20,1983,1,male,234,27,25,6,1,6,1,0,0
1279781,36,17,1977,4,male,259,26,16,6,3,6,1,0,2
1844478,37,14,1976,3,male,502,27,22,6,1,6,1,0,0
1851665,14,3,1999,6,male,149,27,13,6,7,6,6,0,1
1600060,43,17,1970,12,male,52,27,26,6,5,6,3,0,2
1640941,18,21,1995,7,male,18,27,9,6,17,6,7,0,10
1391629,20,6,1993,5,male,295,26,18,6,16,6,10,0,6
1058695,28,6,1985,12,female,700,26,12,6,10,6,10,0,0
1397136,62,5,1951,9,female,196,26,14,7,0,0,0,7,0
1870024,31,20,1982,2,female,181,26,5,7,4,0,2,7,2
1504388,69,29,1944,5,male,472,26,17,7,4,0,3,7,1
1617545,24,1,1989,1,male,182,26,20,7,15,0,0,7,15
2067774,37,12,1976,10,male,352,26,25,7,11,0,2,7,9
1309405,14,24,1999,7,male,71,26,15,7,6,5,6,2,0
2053482,59,29,1954,11,male,763,26,20,7,6,6,4,1,2
1246202,32,26,1981,4,male,106,27,25,7,0,7,0,0,0
1864261,56,14,1957,6,male,458,27,21,7,0,7,0,0,0
1323001,21,27,1992,9,male,190,27,25,7,2,7,1,0,1
1976863,22,1,1991,1,female,141,27,10,7,3,7,3,0,0
1210286,33,1,1980,1,male,339,26,22,7,2,7,0,0,2
1433364,33,20,1980,8,male,32,27,24,7,2,7,2,0,0
1322797,28,16,1985,12,male,49,26,22,7,10,7,10,0,0
1521507,56,27,1957,3,female,148,27,18,7,5,7,0,0,5
1752931,18,1,1995,8,female,183,26,18,7,14,7,9,0,5
1734203,19,11,1994,2,female,293,27,15,7,160,7,107,0,53
2165343,24,5,1989,2,male,144,26,23,7,13,7,9,0,4
2042706,41,7,1972,11,male,325,27,26,7,26,7,4,0,22
1995249,20,26,1993,7,male,65,26,20,8,0,0,0,8,0
1153319,44,18,1969,12,male,468,26,4,8,1,0,1,8,0
1017699,61,14,1952,12,male,1198,26,7,8,0,0,0,8,0
1463133,64,7,1949,8,male,1148,26,15,8,1,0,1,8,0
1648671,82,31,1931,5,female,1568,26,13,8,1,0,1,8,0
2154332,49,3,1964,2,female,575,26,10,8,5,0,3,8,2
1193140,64,14,1949,10,male,579,26,13,8,5,0,1,8,4
2131197,18,20,1995,2,female,254,27,17,8,19,0,11,8,8
1319155,25,17,1988,8,male,145,26,18,8,0,3,0,5,0
1477227,56,18,1957,3,male,499,27,2,8,17,2,4,6,13
1266659,61,9,1952,11,male,2245,27,12,8,6,7,3,1,3
1289040,69,20,1944,4,male,1294,26,8,8,7,7,3,1,4
1308831,21,29,1992,7,male,521,27,14,8,0,8,0,0,0
2140111,23,11,1990,12,male,317,27,24,8,1,8,0,0,1
2031247,37,28,1976,11,male,649,27,23,8,0,8,0,0,0
1267633,48,1,1965,5,female,638,27,10,8,1,8,1,0,0
1733107,49,28,1964,1,female,523,27,18,8,0,8,0,0,0
1790519,22,23,1991,8,male,393,27,24,8,3,8,2,0,1
1188671,47,17,1966,9,female,171,26,23,8,5,8,0,0,5
1701572,18,10,1995,8,female,41,27,11,8,20,8,13,0,7
1464497,67,12,1946,12,male,154,27,23,8,15,8,14,0,1
1107090,16,1,1997,1,male,146,27,24,9,0,0,0,9,0
1286116,34,15,1979,6,female,373,26,25,9,0,0,0,9,0
2068524,77,24,1936,1,male,726,26,22,9,1,0,0,9,1
2088666,31,19,1982,6,male,135,27,25,9,3,0,2,9,1
1886580,55,12,1958,5,female,789,27,15,9,3,0,1,9,2
1546196,68,5,1945,9,female,442,26,5,9,4,0,1,9,3
1622291,108,13,1905,12,female,1101,27,2,9,3,1,2,8,1
1177148,33,21,1980,11,male,391,26,16,9,8,0,1,9,7
1749308,55,25,1958,8,female,326,27,9,9,15,0,4,9,11
1814181,61,26,1952,10,male,1205,27,3,9,14,0,6,9,8
2018005,62,17,1951,12,female,574,27,11,9,0,6,0,3,0
2064915,33,19,1980,8,female,19,26,22,9,64,5,37,4,27
1697838,15,3,1998,7,male,499,26,14,9,0,9,0,0,0
1399963,23,17,1990,10,male,225,26,13,9,0,9,0,0,0
1491111,52,6,1961,3,female,1201,26,3,9,1,9,0,0,1
1974379,53,27,1960,4,male,1665,26,11,9,1,9,1,0,0
2094293,18,20,1995,2,male,46,27,26,9,3,9,2,0,1
1295807,19,13,1994,5,male,21,27,19,9,3,9,3,0,0
1194357,27,3,1986,10,male,9,27,11,9,3,9,3,0,0
1514870,46,14,1967,1,male,281,26,24,9,3,9,3,0,0
2146417,58,7,1955,1,female,441,26,2,9,4,9,3,0,1
1378648,28,22,1985,11,female,330,26,7,9,11,9,11,0,0
1203901,42,14,1971,7,male,265,26,16,9,9,9,8,0,1
1060489,19,18,1994,2,male,272,26,20,9,25,9,23,0,2
1104259,20,14,1993,2,male,17,27,23,9,17,9,14,0,3
1706721,55,1,1958,8,male,75,27,14,9,16,9,12,0,4
1196844,60,23,1953,10,female,603,26,13,9,21,9,18,0,3
2037185,19,20,1994,9,male,538,27,10,10,0,0,0,10,0
1909352,29,13,1984,12,female,308,27,7,10,1,0,0,10,1
1331298,44,14,1969,5,male,291,27,17,10,0,0,0,10,0
1561407,14,24,1999,7,female,294,26,21,10,5,0,2,10,3
2177521,23,5,1990,1,male,175,27,16,10,2,0,0,10,2
2088065,32,25,1981,6,male,1335,27,21,10,11,0,6,10,5
1955935,60,7,1953,1,male,768,27,22,10,0,2,0,8,0
2103414,47,25,1966,5,male,1239,27,6,10,3,6,1,4,2
1626210,61,26,1952,2,male,1114,27,8,10,5,4,3,6,2
1556854,22,21,1991,5,female,302,27,8,10,1,10,0,0,1
2073495,36,9,1977,9,male,445,27,13,10,0,10,0,0,0
2023237,43,31,1970,3,female,713,27,22,10,1,10,1,0,0
1545470,67,21,1946,1,male,1353,27,20,10,0,10,0,0,0
1848212,20,1,1993,1,male,654,26,9,10,2,10,1,0,1
1662142,30,11,1983,7,male,325,27,21,10,6,10,6,0,0
1184072,61,22,1952,5,male,530,26,5,10,25,10,24,0,1
2167458,63,7,1950,1,male,23,26,21,10,16,10,9,0,7
1124812,21,20,1992,8,male,705,27,16,11,1,0,0,11,1
2186169,87,7,1926,7,male,311,27,19,11,0,0,0,11,0
1255223,59,4,1954,4,female,257,27,22,11,2,2,1,9,1
1700730,71,6,1942,1,female,378,27,8,11,2,0,2,11,0
1847671,73,3,1940,8,female,2173,27,8,11,3,0,0,11,3
1831147,21,10,1992,12,male,612,27,15,11,10,0,3,11,7
1824115,29,17,1984,9,female,133,27,19,11,23,0,7,11,16
1363739,54,10,1959,2,female,1542,26,17,11,21,0,6,11,15
1841579,68,17,1945,8,female,46,27,22,11,82,2,26,9,56
1180778,28,2,1985,7,male,73,26,21,11,6,4,4,7,2
1552379,34,21,1979,3,male,719,26,13,11,5,7,4,4,1
2029338,25,1,1988,1,male,160,27,24,11,1,9,0,2,1
1287221,37,28,1976,5,female,470,27,12,11,0,8,0,3,0
1792600,51,28,1962,8,male,251,26,10,11,1,10,1,1,0
1208105,46,27,1967,3,female,290,27,12,11,7,10,1,1,6
1539280,25,6,1988,5,male,359,26,15,11,0,11,0,0,0
2070927,26,1,1987,1,female,492,27,25,11,1,11,1,0,0
1128711,29,2,1984,6,male,171,27,20,11,0,11,0,0,0
1984347,30,11,1983,6,male,199,27,13,11,1,11,0,0,1
1014153,49,15,1964,12,female,448,26,11,11,0,11,0,0,0
1964779,57,5,1956,11,male,299,27,9,11,0,11,0,0,0
2118312,61,1,1952,11,male,318,27,11,11,1,11,1,0,0
1391674,69,28,1944,4,male,89,26,9,11,0,11,0,0,0
1645293,38,1,1975,12,male,307,26,25,11,3,11,3,0,0
1997265,72,15,1941,5,female,173,26,12,11,2,11,1,0,1
1688239,24,31,1989,10,female,63,27,7,11,8,11,7,0,1
1617607,43,20,1970,3,female,761,27,23,11,10,11,9,0,1
1957712,69,9,1944,12,female,93,26,9,11,8,11,8,0,0
1587180,108,26,1905,11,male,59,26,24,11,15,11,11,0,4
1112844,32,4,1981,12,female,144,26,16,11,17,11,14,0,3
2125358,65,1,1948,12,female,471,26,22,12,0,0,0,12,0
1606582,82,8,1931,3,male,1942,26,12,12,3,0,3,12,0
1836962,61,21,1952,7,male,306,26,23,12,11,0,5,12,6
1497797,64,13,1949,2,male,36,26,16,12,9,0,5,12,4
1018817,72,28,1941,2,male,1132,26,21,12,9,0,2,12,7
2120669,19,25,1994,6,female,162,26,19,12,3,3,1,9,2
1506729,46,17,1967,12,male,250,27,18,12,2,4,1,8,1
1327275,76,13,1937,12,female,817,27,12,12,7,8,2,4,5
1940630,25,15,1988,5,male,45,26,18,12,15,7,11,5,4
1571595,38,20,1975,2,male,1528,26,12,12,0,9,0,3,0
1898372,47,13,1966,6,male,447,26,20,12,1,12,0,0,1
1744230,54,26,1959,7,female,591,26,15,12,1,12,1,0,0
1881558,38,18,1975,2,male,586,26,5,12,2,12,1,0,1
2003701,51,22,1962,6,female,657,27,22,12,3,12,2,0,1
1586010,56,21,1957,5,male,1409,27,22,12,5,12,2,0,3
1377376,34,14,1979,10,male,528,27,17,12,19,12,13,0,6
1385103,45,13,1968,11,female,155,27,15,12,45,12,28,0,17
1536464,81,20,1932,6,male,48,27,22,12,20,12,20,0,0
2023139,58,27,1955,7,male,228,27,14,13,3,0,0,13,3
1561767,61,21,1952,8,male,593,27,22,13,4,0,1,13,3
1150960,47,7,1966,8,male,494,27,17,13,0,12,0,1,0
1725509,19,1,1994,1,male,157,26,17,13,0,13,0,0,0
1475550,23,30,1990,8,male,204,26,14,13,0,13,0,0,0
2051959,34,26,1979,10,male,750,26,26,13,0,13,0,0,0
2121140,47,30,1966,6,female,358,26,19,13,1,13,1,0,0
2153183,21,18,1992,9,female,53,27,6,13,3,13,3,0,0
1674618,37,3,1976,9,female,392,26,15,13,5,13,1,0,4
1014814,76,23,1937,8,female,513,27,20,13,6,13,6,0,0
1712200,37,28,1976,8,female,625,26,7,13,9,13,7,0,2
1295590,47,23,1966,5,female,209,26,21,13,18,13,16,0,2
1378437,61,29,1952,10,female,522,27,11,13,8,13,7,0,1
1273931,18,26,1995,9,female,374,27,13,13,44,13,19,0,25
1915923,47,7,1966,9,female,186,26,20,13,37,13,27,0,10
1210099,29,15,1984,10,male,229,26,21,14,18,0,1,14,17
2088292,65,23,1948,3,male,2020,27,11,14,14,0,5,14,9
1303334,75,29,1938,7,female,590,26,17,14,10,0,8,14,2
2167447,79,14,1934,8,female,13,26,17,14,14,0,1,14,13
1236178,32,8,1981,1,male,133,26,24,14,0,5,0,9,0
2169517,33,1,1980,1,male,352,27,25,14,0,9,0,5,0
1358027,25,4,1988,4,female,24,27,19,14,0,13,0,1,0
1397393,51,10,1962,6,male,660,27,8,14,0,14,0,0,0
1923915,27,18,1986,7,female,86,27,12,14,4,14,4,0,0
1943238,29,1,1984,2,female,54,26,17,14,17,14,14,0,3
1080637,71,14,1942,12,male,3,26,9,14,20,14,11,0,9
2130934,45,17,1968,4,male,187,26,15,14,26,14,20,0,6
1958592,16,8,1997,5,male,78,26,26,15,0,0,0,15,0
1828449,27,9,1986,9,male,407,27,12,15,9,0,0,15,9
1090654,21,4,1992,2,female,437,27,21,15,9,3,4,12,5
1582386,56,2,1957,9,male,1482,27,6,15,31,5,16,10,15
1561575,16,15,1997,2,male,887,26,24,15,2,13,2,2,0
2068551,56,20,1957,12,male,302,26,20,15,8,14,7,1,1
1405318,16,2,1997,8,male,215,26,20,15,1,15,1,0,0
1918325,42,17,1971,10,male,361,27,13,15,0,15,0,0,0
1308646,108,12,1905,3,male,45,27,23,15,2,15,0,0,2
1582314,20,13,1993,11,male,19,26,22,15,9,15,8,0,1
2072475,37,15,1976,7,female,750,27,10,15,8,15,8,0,0
1768627,54,30,1959,4,male,36,26,18,15,3,15,3,0,0
1853718,23,17,1990,1,male,26,27,16,15,16,15,16,0,0
1032146,32,24,1981,5,male,430,27,12,15,26,15,26,0,0
1958185,35,20,1978,5,male,311,27,24,16,8,0,8,16,0
2105542,59,13,1954,12,male,1088,26,6,16,55,0,45,16,10
1833133,60,17,1953,3,male,532,27,5,16,39,0,7,16,32
1691194,17,11,1996,6,male,19,26,25,16,0,6,0,10,0
2039839,26,20,1987,8,female,275,27,12,16,8,4,1,12,7
2075423,13,6,2000,1,female,301,26,24,16,0,13,0,3,0
1721035,28,17,1985,7,NA,1864,27,16,16,47,13,29,3,18
1086718,20,15,1993,6,female,397,27,1,16,0,16,0,0,0
1094413,29,15,1984,11,male,376,27,22,16,2,16,2,0,0
1307840,33,1,1980,3,male,22,27,21,16,4,16,3,0,1
1942386,52,16,1961,6,female,271,26,20,16,4,16,2,0,2
1271937,19,15,1994,8,male,60,27,25,16,14,16,11,0,3
1017849,51,6,1962,10,female,754,27,14,16,20,16,16,0,4
1236567,25,11,1988,3,female,575,26,10,16,43,16,43,0,0
1256920,51,10,1962,2,male,215,26,18,17,0,0,0,17,0
1815271,41,6,1972,6,female,153,27,24,17,9,6,7,11,2
1322815,27,1,1986,11,male,660,27,13,17,1,15,1,2,0
1077043,17,11,1996,9,male,24,26,17,17,3,16,3,1,0
1441225,74,18,1939,7,male,1233,26,14,17,16,16,12,1,4
1718477,19,17,1994,2,male,89,26,16,17,3,17,3,0,0
1919081,51,11,1962,12,female,181,27,24,17,6,17,4,0,2
2004952,23,3,1990,7,female,557,26,13,17,18,17,16,0,2
1984419,74,28,1939,10,male,31,27,23,17,12,17,10,0,2
1864678,28,11,1985,7,female,9,26,25,18,7,0,0,18,7
1567920,38,5,1975,6,male,287,27,12,18,7,0,1,18,6
2094457,63,25,1950,11,male,831,26,17,18,9,0,3,18,6
1354027,66,27,1947,3,female,471,27,19,18,4,0,2,18,2
1273211,15,5,1998,6,female,308,26,4,18,20,0,4,18,16
1689856,68,1,1945,2,female,1557,27,16,18,2,18,0,0,2
2018692,31,25,1982,2,female,466,26,5,18,10,18,10,0,0
1418373,63,12,1950,12,female,135,26,21,18,105,18,48,0,57
2100931,18,22,1995,6,male,125,27,20,19,0,0,0,19,0
1158656,63,3,1950,9,female,486,26,15,19,3,0,2,19,1
1490717,46,10,1967,6,male,1008,26,9,19,2,18,2,1,0
1608478,25,8,1988,2,male,380,26,22,19,14,18,13,1,1
1792973,54,11,1959,10,female,579,27,17,19,22,18,13,1,9
1717867,23,18,1990,6,female,47,27,17,19,80,15,50,4,30
1695911,50,28,1963,11,male,820,26,10,19,29,16,14,3,15
1524296,34,5,1979,10,male,108,26,21,19,3,19,3,0,0
1536795,108,27,1905,2,male,78,26,25,20,1,0,1,20,0
2098517,54,5,1959,5,female,295,27,15,20,15,1,6,19,9
1366492,59,15,1954,7,female,539,26,4,20,28,8,18,12,10
1730619,69,11,1944,3,male,1401,26,13,20,31,11,24,9,7
1824762,38,15,1975,4,male,805,27,14,20,37,19,27,1,10
1174113,60,14,1953,3,male,973,26,6,20,3,20,2,0,1
2086619,52,11,1961,11,male,368,26,13,20,5,20,2,0,3
1430461,73,24,1940,9,female,787,27,13,21,4,0,1,21,3
1217304,55,9,1958,2,female,262,27,15,21,87,0,58,21,29
1426331,25,2,1988,7,male,451,26,18,21,1,21,1,0,0
1705022,54,25,1959,5,female,94,26,8,21,8,21,7,0,1
1391909,66,8,1947,3,female,1582,27,2,21,16,21,5,0,11
1361678,38,20,1975,1,male,304,27,14,22,8,21,4,1,4
1833894,20,16,1993,8,male,359,27,24,22,2,22,2,0,0
1497434,52,26,1961,12,female,157,26,25,22,0,22,0,0,0
1485727,21,24,1992,8,male,19,26,20,22,8,22,4,0,4
1707787,31,2,1982,10,female,422,26,13,22,7,22,7,0,0
1772369,65,27,1948,4,female,6,26,25,22,45,22,26,0,19
2071353,28,20,1985,4,male,526,26,23,23,1,0,0,23,1
1944591,51,12,1962,9,male,210,27,17,23,13,0,3,23,10
2124312,60,6,1953,8,male,382,27,19,23,28,0,4,23,24
1356828,15,5,1998,5,female,391,26,24,23,6,18,3,5,3
1800604,23,12,1990,3,male,24,26,19,23,7,19,5,4,2
1952926,57,19,1956,6,female,487,27,8,23,0,23,0,0,0
1520651,37,12,1976,12,female,296,27,12,23,5,23,5,0,0
1082685,31,23,1982,10,female,284,26,23,23,17,23,6,0,11
2031995,28,2,1985,1,male,286,26,12,24,0,0,0,24,0
1388184,30,5,1983,5,male,508,27,25,24,0,0,0,24,0
1778905,90,24,1923,8,male,673,27,14,24,13,15,7,9,6
1809079,26,1,1987,1,male,341,27,27,24,3,24,3,0,0
1658892,14,6,1999,7,male,42,27,25,24,6,24,6,0,0
2141977,22,30,1991,3,male,238,27,20,24,8,24,2,0,6
2038849,26,20,1987,3,male,483,26,20,24,7,24,7,0,0
2157620,17,5,1996,2,male,206,27,22,25,5,1,0,24,5
1862697,66,1,1947,8,male,1916,26,7,25,14,0,9,25,5
1408647,67,14,1946,11,female,719,26,25,25,30,0,0,25,30
1795225,25,10,1988,8,male,151,26,26,25,0,19,0,6,0
1364866,18,22,1995,5,female,279,27,21,25,39,22,26,3,13
1602310,29,5,1984,7,female,105,27,24,25,29,25,29,0,0
1819229,57,5,1956,5,female,1422,27,8,25,56,25,17,0,39
1899504,49,28,1964,2,female,238,26,16,26,0,17,0,9,0
1090612,26,1,1987,1,male,120,27,23,26,6,17,2,9,4
1904290,50,15,1963,9,female,240,27,23,26,2,26,0,0,2
1270588,21,20,1992,8,male,28,27,24,26,15,26,8,0,7
1417860,21,11,1992,6,female,189,27,16,26,37,26,24,0,13
1262088,26,1,1987,1,female,357,27,17,26,35,26,35,0,0
1222075,108,26,1905,8,female,156,27,16,27,5,0,0,27,5
1014843,20,4,1993,5,female,128,26,14,27,14,8,14,19,0
1049410,33,5,1980,10,male,162,26,18,27,0,27,0,0,0
1160190,31,29,1982,9,male,380,27,14,27,133,27,53,0,80
1287440,66,24,1947,3,female,1940,26,9,28,3,0,2,28,1
2078386,20,1,1993,11,male,515,27,18,28,6,0,1,28,5
2096894,20,19,1993,1,male,429,27,13,28,8,28,6,0,2
1074693,21,9,1992,9,male,440,27,24,28,5,28,4,0,1
1513532,32,28,1981,11,female,45,26,5,28,22,28,21,0,1
1448256,32,9,1981,5,male,151,26,24,28,28,28,18,0,10
1513233,33,4,1980,6,male,283,27,21,29,0,0,0,29,0
1443792,71,26,1942,9,male,1084,27,22,29,9,0,5,29,4
1477171,45,29,1968,11,female,170,27,22,29,8,16,3,13,5
1979900,22,10,1991,9,male,569,27,21,29,1,25,1,4,0
1967829,25,24,1988,12,male,157,26,21,29,11,29,6,0,5
1707732,26,3,1987,6,female,290,26,15,29,11,29,10,0,1
1167234,17,1,1996,2,female,6,26,21,29,35,29,15,0,20
1790517,26,12,1987,3,male,153,26,20,29,121,29,103,0,18
1485290,35,18,1978,5,female,411,26,12,29,47,29,11,0,36
1836215,46,28,1967,7,male,200,26,19,30,0,0,0,30,0
2005186,70,7,1943,5,female,225,26,17,31,4,4,2,27,2
2053937,83,5,1930,6,male,90,27,25,31,0,3,0,28,0
1231588,57,20,1956,3,female,163,27,16,30,19,13,3,17,16
1478089,23,1,1990,1,male,17,27,23,30,17,28,10,2,7
2039510,45,8,1968,8,female,454,27,13,31,21,27,11,4,10
1210217,24,5,1989,1,female,608,27,10,30,4,30,3,0,1
1050658,26,6,1987,12,female,51,27,11,30,1,30,1,0,0
1072847,45,12,1968,3,male,577,26,23,31,1,31,1,0,0
1782657,14,19,1999,3,male,245,26,23,30,5,30,5,0,0
2047148,17,2,1996,2,male,4,27,26,31,9,31,5,0,4
1320535,34,6,1979,2,female,609,27,22,31,10,31,10,0,0
1800179,37,30,1976,8,female,143,27,17,30,6,30,6,0,0
1865532,71,15,1942,12,female,99,27,22,30,20,30,20,0,0
1210256,20,6,1993,3,female,166,26,15,32,15,32,7,0,8
2169758,31,10,1982,3,male,242,26,19,32,9,32,5,0,4
1956860,28,5,1985,11,male,299,27,11,32,44,32,24,0,20
2184700,41,1,1972,2,male,383,27,14,33,3,1,1,32,2
1579605,60,17,1953,10,male,108,26,19,34,12,0,3,34,9
2083623,66,8,1947,9,female,615,27,15,34,13,0,8,34,5
2155862,47,4,1966,2,male,194,27,15,34,74,0,1,34,73
1777095,22,19,1991,11,female,107,26,17,34,42,13,26,21,16
1970921,30,6,1983,9,male,305,27,24,34,29,19,25,15,4
1304541,71,27,1942,6,male,212,26,21,34,33,9,12,25,21
1423344,21,1,1992,3,male,269,27,16,34,0,31,0,3,0
1989641,30,28,1983,9,female,430,26,10,34,1,34,1,0,0
2181634,59,23,1954,2,female,413,27,18,36,12,0,3,36,9
1967050,75,23,1938,8,female,354,26,19,36,6,0,6,36,0
1344492,65,28,1948,5,female,716,27,7,36,20,12,11,24,9
1730164,30,23,1983,1,male,203,26,23,36,5,35,3,1,2
1618213,44,4,1969,5,female,547,26,11,35,8,34,8,1,0
1552449,25,3,1988,6,male,31,26,18,35,38,34,26,1,12
1591508,25,1,1988,1,female,94,27,23,36,18,36,17,0,1
1254524,32,9,1981,6,female,512,27,19,36,15,36,6,0,9
1936962,59,26,1954,6,female,267,27,16,35,14,35,12,0,2
1814981,52,1,1961,3,male,419,26,8,37,0,31,0,6,0
1658403,29,7,1984,3,male,227,27,11,37,2,37,1,0,1
1439452,63,17,1950,12,female,1315,26,8,37,13,37,12,0,1
1636250,78,21,1935,11,male,1289,27,16,38,23,0,14,38,9
1271357,58,25,1955,3,female,88,27,13,38,5,38,1,0,4
2035475,63,15,1950,2,female,963,27,12,39,6,39,4,0,2
1920615,28,7,1985,6,female,151,26,15,38,23,38,20,0,3
1748263,32,30,1981,9,female,567,27,15,38,16,38,11,0,5
2143276,43,12,1970,12,female,1588,27,19,39,10,39,7,0,3
1946421,67,27,1946,1,female,679,27,13,38,7,38,5,0,2
1404725,25,15,1988,5,male,102,26,13,39,25,39,7,0,18
2106597,30,21,1983,7,female,169,27,17,38,28,38,26,0,2
1717616,33,20,1980,2,female,656,27,16,38,26,38,25,0,1
1527329,20,12,1993,12,female,297,26,14,38,181,38,149,0,32
1847039,48,24,1965,9,female,4,26,26,38,176,38,163,0,13
1192007,21,9,1992,8,male,76,26,21,40,4,40,0,0,4
1925288,22,21,1991,1,male,254,27,23,40,0,40,0,0,0
1965790,30,10,1983,3,male,164,26,18,40,0,40,0,0,0
1298339,25,12,1988,9,male,261,26,14,40,79,40,41,0,38
1529876,62,29,1951,5,female,1569,26,18,42,0,0,0,42,0
1470340,67,5,1946,10,male,1245,26,17,41,4,0,4,41,0
1736780,59,25,1954,12,female,12,26,13,41,33,0,22,41,11
1019350,59,14,1954,8,male,879,27,6,41,97,5,66,36,31
1794895,40,21,1973,12,female,513,26,15,41,50,32,44,9,6
2018769,55,9,1958,11,female,861,27,17,42,22,42,17,0,5
1824700,102,10,1911,12,male,241,27,20,41,8,41,1,0,7
1258179,16,25,1997,11,male,487,26,17,42,31,42,22,0,9
1331845,25,15,1988,5,female,15,26,16,41,50,41,29,0,21
2064360,33,11,1980,6,female,139,26,12,41,40,41,40,0,0
1772173,24,26,1989,9,male,358,27,21,44,0,0,0,44,0
1284687,62,23,1951,6,female,636,26,13,43,75,16,33,27,42
1906998,17,28,1996,8,male,62,26,23,43,6,43,4,0,2
1775768,36,4,1977,7,male,585,26,13,43,6,43,5,0,1
1797708,62,10,1951,4,female,125,27,21,43,11,43,8,0,3
1586404,21,10,1992,6,male,266,27,22,43,58,43,55,0,3
2171032,15,26,1998,7,male,94,27,21,45,25,45,8,0,17
1764563,113,24,1900,1,male,1203,27,14,47,7,34,3,13,4
1775385,42,1,1971,4,male,120,27,18,47,8,47,5,0,3
1380171,19,18,1994,8,male,15,27,15,46,49,46,35,0,14
1667824,65,30,1948,5,female,74,27,22,47,42,47,36,0,6
1017337,32,10,1981,2,female,375,27,19,49,13,1,13,48,0
1531212,51,21,1962,12,female,445,27,15,48,43,43,16,5,27
1906713,39,14,1974,10,male,377,27,13,51,0,26,0,25,0
2110867,47,2,1966,8,female,150,27,20,50,17,50,15,0,2
2122281,66,2,1947,5,male,300,27,15,52,7,0,3,52,4
2118224,49,7,1964,6,male,200,26,23,52,12,0,3,52,9
1912438,69,15,1944,4,male,92,26,18,53,23,48,18,5,5
1440560,45,17,1968,6,male,638,27,9,53,4,53,3,0,1
1239091,40,17,1973,12,female,328,26,21,52,22,52,21,0,1
2001904,30,28,1983,11,female,98,27,2,54,0,30,0,24,0
1838555,43,4,1970,6,male,282,27,8,55,1,20,1,35,0
1243048,18,13,1995,3,male,183,26,11,54,4,54,4,0,0
1642790,25,1,1988,1,female,279,27,18,55,10,55,7,0,3
2047190,49,23,1964,9,female,328,26,17,54,25,54,19,0,6
1797897,59,6,1954,8,female,986,26,13,56,13,0,8,56,5
1287030,70,25,1943,7,female,61,27,23,58,28,9,13,49,15
1548349,53,8,1960,11,female,1108,26,15,58,23,44,11,14,12
1199034,48,25,1965,1,female,430,26,13,57,5,57,2,0,3
2116802,20,17,1993,3,male,432,27,22,57,11,57,11,0,0
2077467,35,7,1978,9,female,573,27,9,56,13,56,12,0,1
1285256,25,4,1988,1,male,18,27,26,59,18,26,13,33,5
1117103,25,30,1988,9,female,302,27,18,59,44,27,14,32,30
2006405,40,9,1973,5,female,424,27,8,59,2,59,2,0,0
2016889,24,9,1989,11,female,460,27,12,59,13,59,13,0,0
1078274,57,23,1956,12,male,1177,26,19,62,6,7,5,55,1
2009673,19,5,1994,10,female,540,26,19,62,15,41,10,21,5
1038459,23,19,1990,8,male,152,27,25,63,43,35,33,28,10
1249136,50,2,1963,2,female,939,27,14,63,40,54,39,9,1
1981530,21,1,1992,1,male,10,26,21,63,84,63,44,0,40
2091008,34,6,1979,10,female,553,26,14,64,11,64,7,0,4
1156856,21,10,1992,4,female,328,27,19,67,5,0,1,67,4
1800252,20,26,1993,7,female,286,26,12,68,19,49,12,19,7
2045676,44,18,1969,4,male,71,26,23,67,57,67,51,0,6
2123431,15,11,1998,1,female,164,27,23,70,13,30,2,40,11
1668492,35,5,1978,5,female,542,27,15,71,86,48,32,23,54
1912574,17,29,1996,8,male,94,27,23,71,3,59,0,12,3
1205759,25,27,1988,4,female,190,27,13,69,4,69,4,0,0
1495476,35,20,1978,4,female,36,26,20,70,2,70,2,0,0
1817336,36,1,1977,7,male,26,27,18,70,190,70,143,0,47
2026079,17,29,1996,9,male,389,27,22,73,7,9,1,64,6
1549334,26,16,1987,6,female,1322,26,17,73,34,3,8,70,26
1115763,18,17,1995,1,female,220,26,18,74,22,74,17,0,5
1172780,40,13,1973,4,female,328,26,15,75,15,50,12,25,3
1273625,23,23,1990,6,female,417,27,16,79,5,79,4,0,1
2002446,68,16,1945,3,female,89,27,21,80,17,80,14,0,3
1917548,24,2,1989,4,female,43,27,10,83,6,5,4,78,2
1885962,50,31,1963,1,female,410,26,10,84,2,84,2,0,0
1816792,39,30,1974,8,female,400,27,13,81,53,81,49,0,4
1787013,33,4,1980,3,male,359,27,12,87,19,28,3,59,16
1882966,20,5,1993,2,female,134,26,20,87,13,87,13,0,0
1666447,67,3,1946,4,female,661,27,19,89,31,0,4,89,27
1085424,16,5,1997,6,male,50,27,22,90,34,28,29,62,5
1567035,36,15,1977,2,female,550,27,7,91,19,47,7,44,12
1519430,45,17,1968,5,male,499,27,13,88,43,88,31,0,12
1052782,51,16,1962,11,female,426,27,11,89,15,89,12,0,3
1414620,17,2,1996,9,female,3,26,17,93,26,1,14,92,12
1685952,63,27,1950,1,female,228,26,10,95,96,0,13,95,83
1793442,30,19,1983,4,female,711,27,15,93,0,91,0,2,0
1652809,48,3,1965,2,female,232,27,19,95,16,92,11,3,5
2016293,42,21,1971,2,male,152,26,19,92,72,86,20,6,52
2054456,14,10,1999,3,female,101,27,20,94,5,94,4,0,1
1020211,25,1,1988,1,male,46,26,26,94,48,94,44,0,4
1968676,28,15,1985,11,female,1245,27,10,94,47,94,45,0,2
1592038,37,4,1976,11,male,164,26,11,94,175,94,75,0,100
1323024,76,16,1937,11,female,746,26,16,97,12,0,5,97,7
1182989,18,15,1995,12,female,210,27,15,96,59,87,40,9,19
2020766,21,8,1992,1,male,39,27,20,96,4,96,0,0,4
1671075,38,5,1975,12,male,586,26,10,96,14,96,14,0,0
2152816,66,5,1947,11,female,357,27,13,98,5,98,5,0,0
1312740,34,11,1979,11,male,563,26,5,99,31,99,7,0,24
1739107,45,23,1968,10,male,360,26,20,96,33,96,30,0,3
1654755,108,4,1905,11,female,1311,26,14,99,23,99,21,0,2
2010477,60,1,1953,1,male,40,26,18,102,52,2,23,100,29
1456710,54,27,1959,11,female,815,27,14,100,9,27,6,73,3
1111123,43,13,1970,12,female,495,26,17,102,198,89,169,13,29
1489229,52,1,1961,8,male,289,26,18,102,8,102,6,0,2
2022446,63,16,1950,11,female,603,26,16,104,2,104,2,0,0
1737818,32,8,1981,9,male,328,27,24,101,22,101,19,0,3
2159715,31,30,1982,4,female,426,27,14,107,9,75,3,32,6
1704083,51,30,1962,5,female,130,27,25,107,14,33,5,74,9
1572642,24,1,1989,1,male,21,26,26,105,33,105,27,0,6
1569912,55,17,1958,10,male,311,27,13,111,22,0,3,111,19
1271987,28,21,1985,1,female,290,26,7,113,70,112,60,1,10
1014491,59,30,1954,9,female,502,27,15,111,55,111,34,0,21
1182565,61,28,1952,9,female,892,26,12,114,18,0,9,114,9
1384469,66,28,1947,6,female,217,27,25,119,35,0,24,119,11
2039346,23,2,1990,3,male,221,26,21,116,3,116,3,0,0
1180011,30,26,1983,8,female,341,26,12,117,24,117,19,0,5
1448824,41,17,1972,9,male,443,26,17,117,31,117,28,0,3
1230749,64,5,1949,8,female,430,26,19,119,31,119,31,0,0
1037191,51,15,1962,6,female,34,27,17,118,158,118,123,0,35
1381550,58,20,1955,3,male,523,27,12,122,47,0,14,122,33
1574246,17,14,1996,6,female,55,26,20,121,152,119,140,2,12
2188377,53,4,1960,4,female,420,27,17,122,8,122,6,0,2
1130770,49,16,1964,5,female,225,26,20,121,44,121,33,0,11
1282502,50,4,1963,8,male,2335,26,15,126,90,118,62,8,28
1696483,98,30,1915,11,female,1328,27,16,135,12,2,0,133,12
2141820,102,11,1911,11,male,82,26,22,132,15,0,3,132,12
1577084,34,2,1979,2,female,241,26,14,131,1,131,1,0,0
1152522,53,15,1960,10,female,1484,26,14,137,33,9,1,128,32
1885849,52,3,1961,6,female,1377,26,10,143,25,140,7,3,18
1506634,31,25,1982,2,female,336,27,26,140,18,140,18,0,0
1998011,14,13,1999,6,male,148,27,18,141,45,141,36,0,9
1676875,45,2,1968,9,female,242,27,15,140,95,140,90,0,5
2131923,64,17,1949,4,male,257,26,22,150,42,0,21,150,21
1078409,65,13,1948,6,female,1248,26,14,144,53,4,32,140,21
1582517,42,10,1971,2,female,70,26,13,148,158,53,112,95,46
1249308,53,7,1960,4,female,1098,26,20,144,62,126,31,18,31
1801841,30,8,1983,10,female,473,27,12,145,98,140,76,5,22
1891620,69,5,1944,10,female,393,26,17,147,67,147,57,0,10
1523305,27,25,1986,8,female,2218,27,24,149,129,149,97,0,32
1899377,29,15,1984,5,female,281,27,23,155,112,20,17,135,95
1941252,26,3,1987,11,male,27,26,15,156,160,57,37,99,123
1301275,50,13,1963,1,male,885,26,8,158,90,108,34,50,56
2025159,45,7,1968,10,male,44,26,18,158,11,158,2,0,9
1595564,71,26,1942,9,female,717,26,15,172,37,0,7,172,30
2040127,53,10,1960,10,female,746,26,16,178,316,0,50,178,266
1300183,25,9,1988,9,male,431,27,25,179,4,179,4,0,0
1145672,45,27,1968,1,male,103,26,21,174,73,174,38,0,35
1203969,20,1,1993,1,female,413,26,16,178,236,178,154,0,82
1127658,18,31,1995,3,female,836,27,21,189,13,105,5,84,8
1170481,19,22,1994,12,male,462,27,14,190,5,190,5,0,0
1698105,23,26,1990,7,female,98,27,18,188,85,188,67,0,18
2102733,23,12,1990,11,female,418,27,8,197,282,190,114,7,168
1099652,67,2,1946,4,female,1712,26,9,197,30,197,22,0,8
1339027,63,10,1950,11,female,1301,26,8,205,15,205,12,0,3
1591009,15,19,1998,12,female,41,27,24,220,211,8,101,212,110
1944506,26,28,1987,8,male,259,26,21,214,16,48,1,166,15
1173897,55,22,1958,3,female,113,26,13,219,121,218,77,1,44
1676635,52,6,1961,2,female,165,27,14,220,75,220,32,0,43
1055241,62,7,1951,8,female,549,26,14,229,84,0,27,229,57
2017241,25,27,1988,11,female,407,26,22,226,32,129,4,97,28
1483603,21,26,1992,1,male,92,26,18,229,187,159,113,70,74
1734314,19,13,1994,1,female,21,27,21,229,367,154,128,75,239
1339583,46,17,1967,7,female,416,27,18,224,10,224,10,0,0
1859497,37,9,1976,10,male,729,26,14,239,3,239,2,0,1
1287395,27,12,1986,12,female,108,26,15,259,137,21,40,238,97
2029117,34,26,1979,4,female,158,27,20,248,87,248,77,0,10
1454409,34,18,1979,8,female,615,27,23,265,132,265,77,0,55
1405515,41,6,1972,4,female,119,26,18,272,47,272,41,0,6
1350733,68,15,1945,7,female,421,26,23,282,143,0,31,282,112
1425571,15,9,1998,1,male,138,26,18,278,1,278,1,0,0
1795605,62,25,1951,9,male,380,27,22,288,87,288,36,0,51
1551001,23,14,1990,6,female,428,27,16,294,22,294,12,0,10
1458179,50,24,1963,6,female,237,27,18,302,27,302,21,0,6
1703740,48,16,1965,7,female,347,26,21,300,53,300,41,0,12
1526425,21,14,1992,4,male,278,26,20,321,76,186,15,135,61
1124553,23,1,1990,12,female,220,26,19,312,385,305,144,7,241
1796628,28,10,1985,11,male,35,27,18,312,28,312,22,0,6
1886969,60,12,1953,6,female,873,27,11,315,39,315,20,0,19
1245061,22,8,1991,12,female,208,27,16,338,1,338,1,0,0
1648591,21,3,1992,4,female,391,27,23,364,128,70,16,294,112
2113154,19,6,1994,2,female,551,27,6,367,19,364,14,3,5
1438900,43,4,1970,12,female,438,26,15,370,132,33,85,337,47
1272295,17,29,1996,4,female,318,26,18,393,235,380,104,13,131
2015689,22,29,1991,7,female,314,27,11,412,35,412,35,0,0
1641938,19,7,1994,1,male,30,27,22,437,112,437,110,0,2
1699749,65,8,1948,6,female,18,27,22,513,204,0,56,513,148
2032122,33,1,1980,1,male,456,27,23,495,23,396,22,99,1
1460517,35,21,1978,4,male,1902,26,23,512,298,510,265,2,33
2107217,25,21,1988,5,male,261,26,9,507,14,507,12,0,2
1216342,21,7,1992,2,female,178,26,11,551,516,546,171,5,345
1311903,46,15,1967,4,male,130,27,14,541,9,541,8,0,1
1033411,29,14,1984,10,male,279,26,16,529,101,529,77,0,24
1130687,66,27,1947,11,female,497,27,20,598,148,0,45,598,103
2163177,20,1,1993,7,female,314,26,17,583,44,568,32,15,12
1055711,50,26,1963,4,female,18,26,19,577,60,442,28,135,32
1690745,108,1,1905,1,male,6,27,23,599,25,598,12,1,13
1312229,33,1,1980,1,male,113,26,14,663,175,658,131,5,44
1532931,49,12,1964,2,male,56,26,11,665,143,100,84,565,59
1544895,38,25,1975,6,male,783,27,21,672,517,43,39,629,478
1783096,18,10,1995,10,female,38,26,17,705,487,468,203,237,284
2018696,36,3,1977,9,female,596,26,8,951,1173,818,150,133,1023
1754682,51,1,1962,1,female,170,26,6,994,15,0,1,994,14
1351926,25,7,1988,9,male,448,26,11,1048,121,1048,70,0,51
1380670,43,23,1970,9,female,48,27,22,990,145,990,50,0,95
1279172,74,12,1939,2,female,173,26,23,1145,21,1145,17,0,4
2179717,23,1,1990,10,female,18,27,21,1349,1336,1108,324,241,1012
1111497,43,10,1970,4,female,205,27,12,1713,769,297,343,1416,426
2125843,98,11,1915,10,female,78,27,24,1592,309,1,102,1591,207
1588935,18,16,1995,8,female,272,27,20,1672,67,798,24,874,43
1028331,59,17,1954,1,male,285,26,12,1771,54,1771,52,0,2
1494721,23,12,1990,5,female,971,26,20,2097,358,2064,139,33,219
1080741,63,7,1950,6,female,734,26,1,1903,116,1903,72,0,44
2087749,44,28,1969,2,male,743,28,18,30,5,30,3,0,2
1557953,22,17,1991,10,female,16,28,15,30,19,30,18,0,1
1858042,27,13,1986,5,female,85,28,18,31,193,31,140,0,53
1448028,56,13,1957,12,female,325,28,21,32,5,0,3,32,2
1812371,34,17,1979,3,female,40,28,20,32,9,32,4,0,5
1604503,52,3,1961,3,female,868,28,20,32,101,32,61,0,40
1002650,99,12,1914,7,male,364,28,18,33,4,2,1,31,3
1401473,17,8,1996,7,male,603,28,17,33,4,26,1,7,3
1458727,29,1,1984,12,female,698,28,23,33,23,30,6,3,17
1577119,25,1,1988,3,female,376,28,12,33,248,32,120,1,128
1328385,25,1,1988,1,male,34,28,23,33,16,33,12,0,4
2051094,22,12,1991,3,male,89,28,21,34,15,0,4,34,11
1951856,44,3,1969,11,male,73,28,10,34,18,0,9,34,9
2044908,23,20,1990,5,male,631,28,26,34,18,34,14,0,4
1139585,35,23,1978,10,female,375,28,17,34,6,34,6,0,0
1947865,43,23,1970,4,male,684,28,4,34,11,34,11,0,0
1551084,63,9,1950,1,female,583,28,18,36,19,0,7,36,12
1313490,49,1,1964,2,male,589,28,15,35,1,35,0,0,1
1565520,53,10,1960,3,male,303,28,25,36,2,36,1,0,1
1337972,18,29,1995,12,female,306,28,17,37,1,35,1,2,0
1850988,19,24,1994,11,male,32,28,9,37,5,37,4,0,1
1773030,33,6,1980,1,male,562,28,18,37,13,37,13,0,0
1505968,53,26,1960,10,female,40,28,25,38,98,30,59,8,39
2079115,28,1,1985,1,male,39,28,18,39,14,39,14,0,0
1764650,61,22,1952,5,female,1618,28,13,38,20,38,6,0,14
1494929,19,13,1994,10,female,153,28,11,41,6,35,5,6,1
2044546,27,26,1986,8,male,29,28,28,42,24,42,3,0,21
1311846,54,2,1959,5,male,402,28,11,43,11,0,2,43,9
1947362,26,6,1987,5,male,463,28,19,44,27,40,26,4,1
1012555,19,28,1994,10,male,159,28,24,44,2,44,2,0,0
1933560,42,7,1971,8,male,1557,28,14,44,31,44,24,0,7
2026195,43,12,1970,3,female,230,28,23,43,52,43,45,0,7
1912425,52,1,1961,3,male,470,28,24,45,0,45,0,0,0
1705830,46,1,1967,1,male,163,28,8,47,37,0,15,47,22
2106776,67,13,1946,2,female,781,28,10,46,4,25,0,21,4
2178391,67,11,1946,8,male,96,28,18,49,3,0,2,49,1
1005352,20,1,1993,1,male,31,28,28,49,8,49,8,0,0
1050090,62,17,1951,7,female,200,28,16,49,4,49,4,0,0
1604088,49,5,1964,9,male,81,28,15,51,43,5,20,46,23
1029731,53,12,1960,11,female,291,28,21,50,4,50,3,0,1
2015094,23,1,1990,10,male,107,28,24,51,31,51,23,0,8
1242765,21,10,1992,2,male,105,28,24,50,337,50,317,0,20
1978825,14,5,1999,6,male,6,28,28,52,4,28,2,24,2
1025462,67,31,1946,7,female,1853,28,23,53,30,16,7,37,23
2083628,30,26,1983,7,male,33,28,28,52,2,52,2,0,0
1971449,22,21,1991,8,male,6,28,11,52,11,52,11,0,0
1733623,33,20,1980,2,female,402,28,16,58,21,57,20,1,1
1011235,33,23,1980,7,male,19,28,26,57,7,57,3,0,4
1970680,15,6,1998,8,female,293,28,16,56,12,56,7,0,5
1488670,52,16,1961,8,female,432,28,22,58,41,58,28,0,13
1978010,51,12,1962,2,male,134,28,24,57,241,57,102,0,139
1451692,57,28,1956,11,female,434,28,19,60,23,0,5,60,18
1979389,61,26,1952,7,female,64,28,12,59,28,57,12,2,16
1541298,56,14,1957,8,female,106,28,21,61,231,15,178,46,53
1045188,16,28,1997,1,male,429,28,16,63,0,63,0,0,0
1539727,71,5,1942,5,female,75,28,20,63,35,63,33,0,2
1983980,36,10,1977,8,female,436,28,9,63,44,63,40,0,4
2077445,52,25,1961,7,female,257,28,25,67,27,1,18,66,9
1514064,36,30,1977,4,female,255,28,11,66,58,66,33,0,25
1787795,49,12,1964,12,male,121,28,13,68,59,68,53,0,6
1714222,57,20,1956,2,male,298,28,12,70,21,48,14,22,7
1648560,43,8,1970,4,male,113,28,24,70,1,70,0,0,1
1621121,53,15,1960,2,male,290,28,15,69,4,69,4,0,0
2053977,38,16,1975,6,female,439,28,17,71,19,71,18,0,1
2113661,18,26,1995,1,male,215,28,21,72,4,12,0,60,4
1563972,45,12,1968,9,male,398,28,8,72,2,72,1,0,1
1638795,44,13,1969,2,male,41,28,17,75,25,10,13,65,12
1827192,47,13,1966,6,male,718,28,14,77,0,54,0,23,0
1051594,43,23,1970,7,female,482,28,19,75,35,51,26,24,9
1879689,21,8,1992,9,female,3,28,23,77,86,65,49,12,37
1801445,39,1,1974,4,male,202,28,23,76,38,76,28,0,10
1305141,18,13,1995,9,female,298,28,3,77,96,77,85,0,11
1541522,39,8,1974,1,female,465,28,7,80,135,3,121,77,14
1811100,56,10,1957,6,female,951,28,17,81,6,0,3,81,3
2165242,47,11,1966,5,female,203,28,15,84,10,80,8,4,2
1491257,48,1,1965,2,female,1487,28,17,83,62,75,48,8,14
1404689,25,7,1988,6,female,407,28,21,84,14,84,12,0,2
1581849,52,13,1961,9,male,504,28,13,82,22,82,17,0,5
1269538,57,8,1956,9,female,506,28,19,82,46,82,39,0,7
2090396,40,4,1973,7,female,129,28,22,81,63,81,55,0,8
1271485,42,23,1971,10,female,444,28,10,82,56,82,50,0,6
1624888,25,1,1988,1,male,89,28,19,86,40,86,30,0,10
1932089,48,11,1965,9,female,389,28,20,86,17,86,9,0,8
1772442,43,16,1970,4,female,481,28,14,92,10,0,4,92,6
1190721,50,6,1963,7,male,2,28,20,97,35,87,11,10,24
1956084,108,1,1905,1,female,76,28,21,102,6,0,2,102,4
1241527,64,11,1949,6,male,131,28,22,102,32,102,30,0,2
1162380,51,23,1962,4,male,334,28,28,103,119,103,112,0,7
1446448,25,1,1988,1,female,31,28,23,101,326,101,312,0,14
1437061,54,25,1959,2,male,687,28,24,105,4,0,3,105,1
2055280,57,26,1956,8,female,1251,28,16,107,20,43,9,64,11
2002261,46,23,1967,5,female,816,28,27,105,13,105,5,0,8
1929090,63,25,1950,3,female,437,28,11,112,11,0,9,112,2
1172765,68,28,1945,3,male,1025,28,5,112,6,0,3,112,3
1397399,21,14,1992,1,female,286,28,14,110,142,76,72,34,70
1426852,57,27,1956,7,female,1545,28,4,110,58,98,23,12,35
1611414,19,3,1994,1,female,11,28,28,111,16,111,4,0,12
1799265,31,27,1982,8,female,116,28,24,113,61,113,60,0,1
2060558,47,12,1966,5,NA,2159,28,12,120,123,120,86,0,37
1659168,27,10,1986,8,male,584,28,13,126,8,126,8,0,0
1656291,34,13,1979,2,male,37,28,16,129,0,129,0,0,0
1749746,50,1,1963,8,female,150,28,28,125,0,125,0,0,0
2157339,36,18,1977,1,female,295,28,23,136,22,77,11,59,11
1855493,19,24,1994,11,male,216,28,8,132,73,132,37,0,36
1449082,50,1,1963,1,male,69,28,26,140,1,140,1,0,0
1246023,30,22,1983,4,male,144,28,24,149,15,149,15,0,0
1675907,22,15,1991,1,female,127,28,16,149,96,149,3,0,93
1046592,20,4,1993,10,male,106,28,24,157,46,155,27,2,19
2173081,29,25,1984,12,male,804,28,16,155,48,155,38,0,10
2056126,55,20,1958,1,female,890,28,15,158,11,81,2,77,9
2074687,51,24,1962,6,female,120,28,18,159,54,59,34,100,20
1448804,25,10,1988,6,male,64,28,28,161,4,161,4,0,0
1124920,31,31,1982,10,female,453,28,18,161,35,161,11,0,24
1809436,58,29,1955,4,female,288,28,15,167,179,0,55,167,124
1480603,47,31,1966,1,female,703,28,21,165,103,162,31,3,72
1469797,29,6,1984,11,female,403,28,25,166,26,166,16,0,10
1813508,26,24,1987,6,female,214,28,23,169,50,169,33,0,17
1014092,62,1,1951,1,female,183,28,22,165,62,165,51,0,11
1154199,41,24,1972,5,male,647,28,11,171,550,171,511,0,39
1597046,26,24,1987,12,female,668,28,19,175,111,154,63,21,48
1212927,23,26,1990,2,female,160,28,22,178,2,178,2,0,0
1403771,20,4,1993,2,female,150,28,18,185,15,185,15,0,0
1189300,23,1,1990,1,male,300,28,22,196,23,0,18,196,5
1588163,15,2,1998,6,male,48,28,20,197,15,197,9,0,6
1038409,32,29,1981,7,female,671,28,17,208,62,208,27,0,35
1469654,49,19,1964,1,female,330,28,14,217,16,6,3,211,13
1886958,59,22,1954,8,female,1014,28,13,219,78,0,11,219,67
1807735,43,31,1970,10,female,96,28,19,268,53,0,14,268,39
1414791,24,23,1989,1,female,490,28,20,282,218,282,184,0,34
1585767,61,14,1952,5,female,1017,28,16,331,59,164,38,167,21
1012569,44,19,1969,3,male,161,28,20,342,75,342,33,0,42
1493196,52,11,1961,4,female,107,28,21,363,75,0,58,363,17
1204683,61,1,1952,1,male,567,28,20,403,47,403,46,0,1
1349342,28,4,1985,4,male,117,28,13,432,28,432,19,0,9
1487711,50,24,1963,8,male,284,28,18,570,17,518,3,52,14
1457547,18,1,1995,8,female,174,28,21,566,97,566,64,0,33
2184376,26,8,1987,10,male,325,28,26,624,9,522,5,102,4
1397510,45,12,1968,4,female,650,28,10,703,125,8,19,695,106
2189117,17,11,1996,9,female,317,28,21,668,103,641,87,27,16
1832483,24,1,1989,1,female,196,28,13,726,35,726,22,0,13
1689121,64,12,1949,11,male,147,28,12,703,71,703,53,0,18
1660411,51,17,1962,11,male,533,28,27,791,115,791,109,0,6
1110073,27,10,1986,10,female,529,28,15,844,360,844,187,0,173
1108802,42,20,1971,3,female,655,28,15,870,208,870,183,0,25
1914843,43,18,1970,7,female,305,28,18,1324,1028,128,87,1196,941
1999030,43,20,1970,9,female,29,28,8,1421,103,913,37,508,66
1100814,59,13,1954,1,male,49,28,21,6592,82,6592,42,0,40
1502298,18,11,1995,10,male,250,30,21,2,28,0,13,2,15
1585926,23,14,1990,5,male,391,30,13,2,3,0,0,2,3
1985880,26,29,1987,11,male,381,30,16,2,9,0,3,2,6
1908323,31,9,1982,10,female,442,30,23,2,12,0,9,2,3
2018562,46,16,1967,2,female,11,30,16,2,6,0,1,2,5
1247857,49,24,1964,10,male,208,29,13,2,4,0,0,2,4
1848028,55,3,1958,10,male,784,30,16,2,28,0,16,2,12
1874762,70,18,1943,12,female,1687,29,17,2,3,0,0,2,3
2170491,69,27,1944,7,female,319,29,22,2,25,0,16,2,9
1641123,78,24,1935,9,female,2231,29,14,2,37,0,22,2,15
1496590,19,17,1994,8,male,465,30,21,2,0,1,0,1,0
1195501,68,5,1945,12,male,1813,30,6,2,0,1,0,1,0
1478304,33,27,1980,10,male,350,29,18,2,2,1,2,1,0
1387136,20,2,1993,11,female,207,30,17,2,10,1,8,1,2
1603599,27,10,1986,6,female,703,29,23,2,56,1,49,1,7
1763995,15,22,1998,11,female,369,29,7,2,0,2,0,0,0
1949313,15,2,1998,7,male,119,30,5,2,0,2,0,0,0
1199394,21,7,1992,11,male,344,30,23,2,0,2,0,0,0
1259022,23,22,1990,11,female,557,30,8,2,0,2,0,0,0
1090755,22,1,1991,1,male,1299,30,12,2,0,2,0,0,0
2005476,24,1,1989,11,male,503,29,12,2,0,2,0,0,0
1806642,25,18,1988,4,male,163,30,15,2,0,2,0,0,0
1270973,26,20,1987,8,male,195,29,22,2,0,2,0,0,0
1878388,31,27,1982,11,male,147,29,20,2,0,2,0,0,0
1479058,32,20,1981,2,male,621,30,16,2,0,2,0,0,0
1213279,38,13,1975,11,male,316,29,21,2,0,2,0,0,0
1240279,49,11,1964,11,female,1357,30,19,2,0,2,0,0,0
2133533,62,6,1951,5,male,1369,29,11,2,0,2,0,0,0
1691587,69,1,1944,5,female,553,29,23,2,0,2,0,0,0
1466761,17,11,1996,11,male,660,30,13,2,1,2,1,0,0
1965095,26,1,1987,1,male,419,30,9,2,1,2,1,0,0
2078245,31,19,1982,3,male,176,30,18,2,1,2,1,0,0
1882043,33,31,1980,3,male,266,29,18,2,1,2,1,0,0
2071129,38,9,1975,9,male,130,29,25,2,1,2,0,0,1
1414090,43,1,1970,11,female,1147,29,12,2,1,2,0,0,1
1145561,19,13,1994,6,male,106,29,25,2,2,2,2,0,0
2111349,25,6,1988,4,female,146,29,20,2,2,2,2,0,0
1565454,26,13,1987,2,male,651,29,13,2,2,2,1,0,1
1555415,29,10,1984,2,male,56,30,22,2,2,2,2,0,0
1463719,38,14,1975,6,male,110,29,21,2,2,2,2,0,0
1680946,58,25,1955,7,male,28,30,13,2,2,2,2,0,0
1852140,13,24,2000,3,male,101,30,20,2,4,2,0,0,4
1596642,18,31,1995,12,female,233,30,21,2,7,2,6,0,1
2002382,20,21,1993,3,male,235,30,16,2,10,2,9,0,1
1904380,24,25,1989,5,male,68,30,20,2,6,2,2,0,4
1059301,26,7,1987,4,male,174,30,21,2,7,2,5,0,2
2037222,27,2,1986,9,male,322,29,27,2,15,2,13,0,2
1636336,32,30,1981,7,male,416,30,14,2,20,2,18,0,2
1349982,42,24,1971,10,male,822,30,20,2,14,2,12,0,2
2050497,52,24,1961,11,male,1012,30,3,2,16,2,12,0,4
1496825,61,29,1952,4,male,1283,29,9,2,5,2,3,0,2
1605131,72,23,1941,5,male,10,29,27,2,3,2,3,0,0
2150594,19,1,1994,1,female,391,30,17,3,0,0,0,3,0
1041253,24,8,1989,1,male,685,29,23,3,0,0,0,3,0
1384632,33,10,1980,7,male,847,30,10,3,0,0,0,3,0
1394906,39,16,1974,7,male,246,29,15,3,0,0,0,3,0
1099258,55,17,1958,4,male,252,29,26,3,0,0,0,3,0
2075130,81,24,1932,1,female,586,29,22,3,0,0,0,3,0
1749618,82,13,1931,8,female,747,30,23,3,0,0,0,3,0
2167356,14,26,1999,6,male,165,29,22,3,1,0,1,3,0
1402773,15,4,1998,4,male,527,30,9,3,1,0,1,3,0
1171870,20,14,1993,8,male,114,30,27,3,1,0,1,3,0
1023197,25,20,1988,9,female,597,29,17,3,1,0,0,3,1
1513728,35,22,1978,11,male,296,30,27,3,1,0,0,3,1
1331209,49,15,1964,8,male,171,29,23,3,1,0,0,3,1
2165109,68,24,1945,9,male,165,30,11,3,1,0,1,3,0
1203006,21,2,1992,2,male,1175,30,26,3,3,0,1,3,2
1288777,51,1,1962,12,male,280,29,17,3,2,0,1,3,1
1818948,55,10,1958,12,female,560,29,18,3,3,0,2,3,1
1862511,54,12,1959,5,male,476,30,18,3,2,0,0,3,2
1307886,59,23,1954,4,male,209,30,18,3,2,0,2,3,0
1497572,69,1,1944,4,male,303,30,19,3,2,0,2,3,0
1178216,18,19,1995,1,male,153,29,27,3,10,0,1,3,9
1695262,45,20,1968,9,female,1494,29,4,3,28,0,20,3,8
1879517,48,28,1965,3,female,20,29,17,3,5,0,1,3,4
1337102,68,10,1945,1,female,659,29,20,3,5,0,2,3,3
2176849,72,2,1941,3,male,1366,29,18,3,8,0,4,3,4
1701713,30,13,1983,3,male,487,30,24,3,1,2,1,1,0
1730470,75,14,1938,10,female,1523,30,18,3,1,1,1,2,0
1241387,18,4,1995,6,male,213,30,1,3,0,3,0,0,0
1350330,19,1,1994,1,male,418,30,18,3,0,3,0,0,0
1155761,24,6,1989,8,male,477,29,20,3,0,3,0,0,0
1297391,29,15,1984,4,male,295,30,25,3,0,3,0,0,0
1010553,31,1,1982,1,male,259,30,29,3,0,3,0,0,0
1537955,50,26,1963,9,male,465,30,21,3,0,3,0,0,0
1562184,53,20,1960,12,male,737,30,6,3,0,3,0,0,0
2022498,52,16,1961,7,male,76,29,11,3,0,3,0,0,0
1475381,52,20,1961,10,male,231,29,12,3,0,3,0,0,0
1857319,18,12,1995,7,male,311,29,18,3,1,3,0,0,1
1493358,23,2,1990,3,male,50,29,27,3,1,3,1,0,0
1851236,25,4,1988,4,male,341,29,26,3,1,3,1,0,0
1699876,26,23,1987,8,male,228,30,28,3,1,3,1,0,0
1151802,33,11,1980,4,female,226,30,16,3,1,3,1,0,0
1927256,35,5,1978,2,female,1204,30,10,3,1,3,1,0,0
2137246,43,16,1970,1,male,1901,30,15,3,1,3,1,0,0
1333668,59,15,1954,11,male,528,29,12,3,1,3,0,0,1
2103673,25,15,1988,5,male,5,29,27,3,7,3,3,0,4
1293387,28,22,1985,9,female,267,29,18,3,7,3,6,0,1
2020857,33,28,1980,7,male,515,29,21,3,5,3,2,0,3
1903699,36,27,1977,10,male,442,29,10,3,8,3,8,0,0
1729703,37,22,1976,10,male,344,29,6,3,7,3,1,0,6
1651224,39,15,1974,9,male,63,30,10,3,72,3,15,0,57
2126141,54,19,1959,10,female,343,30,19,3,32,3,22,0,10
1848172,64,6,1949,10,female,166,30,9,3,5,3,2,0,3
1662838,61,28,1952,3,female,1103,30,16,4,0,0,0,4,0
1187298,64,4,1949,9,male,1779,30,24,4,0,0,0,4,0
1539605,111,1,1902,1,female,1602,30,14,4,0,0,0,4,0
1759687,22,1,1991,1,male,186,30,30,4,1,0,1,4,0
1685451,35,27,1978,1,male,636,29,14,4,1,0,0,4,1
1602291,57,14,1956,12,female,1077,29,15,4,2,0,0,4,2
1913776,25,13,1988,11,male,282,29,25,4,4,0,2,4,2
2048839,57,25,1956,1,female,370,29,13,4,3,0,0,4,3
1871682,20,20,1993,3,male,291,29,16,4,12,0,4,4,8
1359019,60,4,1953,2,male,699,30,16,4,1,1,0,3,1
1640575,28,6,1985,6,male,1520,29,13,4,23,3,7,1,16
1256304,15,4,1998,12,male,151,29,18,4,0,4,0,0,0
2078636,25,28,1988,7,male,536,29,2,4,0,4,0,0,0
1960830,25,2,1988,8,male,345,30,29,4,0,4,0,0,0
1643846,28,13,1985,4,male,26,29,28,4,0,4,0,0,0
1379143,30,1,1983,1,male,7,29,28,4,0,4,0,0,0
2116299,48,4,1965,12,female,355,29,20,4,0,4,0,0,0
1653817,16,1,1997,5,male,19,29,25,4,1,4,0,0,1
1250620,33,10,1980,11,female,332,29,22,4,1,4,1,0,0
1231222,34,28,1979,8,female,445,29,20,4,2,4,2,0,0
1911506,18,8,1995,2,male,615,29,8,4,4,4,2,0,2
1805577,49,22,1964,9,male,577,29,19,4,5,4,3,0,2
1910400,23,31,1990,7,female,36,29,23,4,9,4,7,0,2
1744590,25,1,1988,1,male,146,29,18,4,38,4,38,0,0
1765593,27,29,1986,6,female,164,29,23,4,11,4,10,0,1
2082434,30,15,1983,4,female,159,29,11,4,15,4,10,0,5
1361089,30,27,1983,7,female,712,30,13,4,12,4,12,0,0
1951249,31,12,1982,4,male,205,30,15,4,7,4,6,0,1
1484129,31,17,1982,10,female,30,30,21,4,12,4,12,0,0
1437133,33,19,1980,11,male,37,30,30,4,20,4,14,0,6
1828095,32,30,1981,5,male,231,29,22,4,55,4,48,0,7
1220036,33,11,1980,1,male,520,29,16,4,6,4,4,0,2
1750232,34,9,1979,6,female,1110,29,11,4,25,4,14,0,11
1415229,37,20,1976,5,male,295,30,24,4,13,4,4,0,9
1671834,41,8,1972,2,male,379,30,12,4,17,4,9,0,8
1134250,43,10,1970,10,male,1586,29,7,4,40,4,23,0,17
1634277,20,1,1993,3,male,19,29,23,5,0,0,0,5,0
1959055,30,5,1983,12,male,71,30,27,5,0,0,0,5,0
1314603,18,14,1995,6,male,525,29,25,5,1,0,0,5,1
1605810,23,16,1990,3,male,153,29,21,5,2,0,0,5,2
1765744,34,26,1979,5,male,523,29,14,5,6,0,0,5,6
1771113,42,4,1971,12,male,711,29,13,5,4,0,3,5,1
1713461,71,10,1942,7,female,1094,29,13,5,6,0,1,5,5
1420730,58,15,1955,2,male,658,29,24,5,13,0,12,5,1
1949013,16,10,1997,10,male,144,29,19,5,3,3,3,2,0
2078709,22,10,1991,2,male,193,29,13,5,2,3,2,2,0
1865439,46,20,1967,8,male,237,29,17,5,1,2,0,3,1
2104786,36,21,1977,6,male,936,29,13,5,5,2,0,3,5
1383515,19,15,1994,11,male,137,29,25,5,10,1,2,4,8
1199854,111,1,1902,1,female,1895,30,12,5,1,4,0,1,1
1881531,61,22,1952,11,male,877,29,11,5,8,4,8,1,0
1067049,60,9,1953,3,male,1383,30,15,5,18,4,10,1,8
1548673,33,13,1980,12,male,670,30,17,5,0,5,0,0,0
1894020,35,2,1978,1,male,416,30,20,5,0,5,0,0,0
1502155,25,1,1988,1,male,194,30,27,5,3,5,3,0,0
1019402,25,1,1988,1,female,94,29,13,5,2,5,2,0,0
1373415,35,5,1978,5,female,479,30,13,5,2,5,1,0,1
1931783,66,12,1947,7,female,446,30,20,5,1,5,0,0,1
2129934,74,10,1939,7,female,582,29,20,5,1,5,1,0,0
1504508,27,12,1986,2,male,295,29,18,5,4,5,1,0,3
1062843,28,31,1985,10,male,570,29,25,5,5,5,5,0,0
1703770,39,4,1974,10,female,243,30,19,5,5,5,1,0,4
1755198,74,28,1939,5,female,66,30,25,5,7,5,6,0,1
1920969,16,18,1997,8,female,146,29,16,5,41,5,26,0,15
1156288,23,17,1990,10,male,270,29,20,5,8,5,8,0,0
1418438,35,15,1978,12,male,274,29,10,5,22,5,15,0,7
1755731,42,10,1971,7,female,230,30,23,5,13,5,10,0,3
1759503,47,19,1966,7,male,1161,30,6,5,10,5,6,0,4
1764100,47,12,1966,7,female,611,30,10,5,21,5,16,0,5
1189931,57,2,1956,2,male,103,29,11,5,10,5,6,0,4
1826916,48,2,1965,12,male,519,29,17,6,0,0,0,6,0
1745209,73,7,1940,11,female,430,30,27,6,0,0,0,6,0
1734450,19,5,1994,1,female,134,30,13,6,4,0,3,6,1
1378154,43,12,1970,10,male,344,29,14,6,4,1,4,5,0
1886441,68,26,1945,4,male,510,29,15,6,6,0,2,6,4
1226134,21,18,1992,11,male,255,29,18,6,38,0,2,6,36
1321299,62,18,1951,3,female,652,29,24,6,11,1,10,5,1
1153587,71,19,1942,6,male,1004,30,3,6,9,0,6,6,3
1553245,45,25,1968,8,male,586,30,22,6,0,3,0,3,0
1631029,58,15,1955,8,female,308,29,21,6,6,4,2,2,4
1322601,79,5,1934,2,male,825,29,11,6,4,3,4,3,0
1183454,42,20,1971,2,female,309,29,10,6,15,3,8,3,7
1915046,16,26,1997,8,male,123,29,20,6,5,5,4,1,1
1894806,18,5,1995,6,female,253,29,21,6,0,6,0,0,0
1456420,28,25,1985,10,male,122,30,20,6,0,6,0,0,0
1165732,29,1,1984,1,male,85,29,25,6,0,6,0,0,0
2171364,27,28,1986,4,female,323,29,24,6,1,6,1,0,0
1774053,30,23,1983,11,female,627,29,11,6,1,6,1,0,0
1203904,49,5,1964,11,male,1128,30,26,6,2,6,1,0,1
1920324,48,1,1965,3,male,92,29,4,6,2,6,2,0,0
1735685,19,11,1994,12,male,5,29,23,6,4,6,4,0,0
1434669,26,4,1987,6,male,54,29,21,6,4,6,3,0,1
2112766,71,17,1942,11,male,1017,29,11,6,8,6,4,0,4
1008438,23,11,1990,1,female,405,29,15,6,13,6,12,0,1
1855904,29,17,1984,3,male,34,29,23,6,18,6,10,0,8
2010720,31,2,1982,1,male,674,30,12,6,10,6,10,0,0
1106095,31,31,1982,1,male,108,29,22,6,18,6,5,0,13
1080030,33,24,1980,6,female,285,29,22,6,39,6,38,0,1
2081774,20,23,1993,8,female,154,29,13,7,0,0,0,7,0
1294244,42,15,1971,9,female,308,29,21,7,4,0,0,7,4
1170303,15,23,1998,4,female,702,29,22,7,8,1,3,6,5
2077767,66,19,1947,2,male,1044,30,16,7,8,0,2,7,6
1942839,31,5,1982,4,female,93,29,21,7,13,1,11,6,2
1786682,53,21,1960,12,female,138,29,17,7,12,0,11,7,1
2048379,53,21,1960,7,male,1851,30,9,7,43,0,26,7,17
2012788,39,16,1974,6,female,157,30,23,7,23,5,12,2,11
1316387,39,18,1974,9,male,317,29,18,7,32,4,15,3,17
2143376,46,27,1967,2,male,681,29,17,7,13,5,8,2,5
2191366,108,12,1905,4,female,102,30,20,7,11,5,6,2,5
2047902,61,4,1952,6,female,681,30,26,7,3,6,1,1,2
1247039,13,3,2000,3,male,21,29,26,7,19,6,11,1,8
1162246,18,22,1995,2,male,24,29,10,7,17,6,7,1,10
1368580,66,3,1947,2,male,217,29,14,7,160,6,75,1,85
1429942,57,6,1956,3,female,546,29,19,7,0,7,0,0,0
1183132,29,5,1984,12,male,112,29,22,7,2,7,1,0,1
1679163,30,27,1983,7,male,428,30,19,7,3,7,2,0,1
1466604,33,6,1980,10,male,615,29,20,7,2,7,2,0,0
1534039,51,30,1962,4,male,226,30,18,7,3,7,3,0,0
1668530,69,12,1944,9,male,1512,29,18,7,3,7,2,0,1
1597202,14,1,1999,1,male,514,29,19,7,7,7,7,0,0
1894150,22,19,1991,2,male,649,30,27,7,7,7,7,0,0
2038137,25,5,1988,8,male,185,30,29,7,9,7,8,0,1
2126011,26,20,1987,8,female,153,29,20,7,6,7,6,0,0
1001424,27,27,1986,7,male,202,30,26,7,6,7,6,0,0
1938692,22,15,1991,1,female,89,29,18,7,31,7,30,0,1
1846606,33,30,1980,8,female,116,30,23,7,15,7,8,0,7
1332413,17,20,1996,5,male,96,30,22,8,0,0,0,8,0
2114123,18,23,1995,12,male,346,30,21,8,2,0,0,8,2
2122251,27,8,1986,5,male,162,29,9,8,2,0,0,8,2
1388884,48,31,1965,5,female,270,30,20,8,5,0,1,8,4
1210920,61,9,1952,10,female,161,29,17,8,6,0,1,8,5
1823806,79,24,1934,2,female,559,29,23,8,10,0,6,8,4
1810783,43,14,1970,11,female,123,30,23,8,17,2,8,6,9
1283509,50,14,1963,8,male,408,30,8,8,2,7,2,1,0
1797780,29,19,1984,9,male,619,30,20,8,5,6,5,2,0
1570989,18,20,1995,3,male,193,29,23,8,31,6,5,2,26
1698183,30,17,1983,10,female,466,29,6,8,1,8,1,0,0
1946588,54,28,1959,10,male,1088,30,11,8,1,8,1,0,0
1505557,33,2,1980,4,male,744,30,26,8,2,8,2,0,0
1469796,40,24,1973,3,male,769,30,18,8,3,8,3,0,0
1819096,46,14,1967,7,female,681,30,12,8,4,8,4,0,0
2051615,42,5,1971,3,female,123,29,21,8,7,8,5,0,2
1486863,52,7,1961,1,male,296,29,19,8,5,8,5,0,0
1498670,32,15,1981,4,male,41,30,23,8,12,8,8,0,4
2073512,46,21,1967,9,male,714,30,8,8,101,8,70,0,31
1825814,54,31,1959,8,male,662,29,24,8,22,8,10,0,12
1488772,65,7,1948,12,female,1779,30,17,8,16,8,15,0,1
2029714,74,18,1939,7,male,239,30,24,8,16,8,9,0,7
1837358,56,4,1957,6,male,950,29,6,9,0,0,0,9,0
1066305,58,19,1955,10,male,452,29,14,9,1,0,1,9,0
1087675,46,8,1967,1,female,432,30,15,9,22,1,7,8,15
1743369,26,17,1987,5,male,560,30,22,9,4,4,1,5,3
1294349,36,3,1977,7,male,151,30,19,9,24,5,20,4,4
1620958,14,2,1999,3,male,25,29,29,9,1,9,1,0,0
1487228,25,7,1988,9,male,796,29,12,9,1,9,0,0,1
1379835,32,2,1981,4,male,283,29,14,9,0,9,0,0,0
1586945,62,3,1951,10,male,666,30,19,9,1,9,0,0,1
1160396,13,7,2000,3,female,49,30,27,9,4,9,1,0,3
1531415,27,7,1986,8,male,605,30,24,9,2,9,2,0,0
1546854,17,3,1996,12,male,155,29,22,9,12,9,10,0,2
1713747,21,23,1992,5,female,138,29,4,9,16,9,9,0,7
2048393,27,1,1986,4,male,381,30,22,9,25,9,23,0,2
1030636,36,15,1977,8,male,84,29,20,9,16,9,15,0,1
1633057,62,25,1951,3,male,484,29,9,10,0,0,0,10,0
2006295,63,17,1950,1,female,86,29,25,10,9,1,6,9,3
1037885,18,4,1995,3,male,189,30,13,10,17,0,7,10,10
1362425,20,1,1993,1,male,361,29,12,10,2,6,1,4,1
1230173,22,18,1991,12,male,234,30,30,10,4,3,2,7,2
1738884,21,6,1992,4,male,20,30,23,10,6,3,2,7,4
1937068,83,30,1930,4,male,183,29,27,10,16,3,9,7,7
2178890,68,11,1945,2,female,986,29,22,10,1,8,1,2,0
1907580,27,1,1986,11,male,92,30,23,10,18,9,6,1,12
1593926,24,19,1989,6,male,191,29,20,10,0,10,0,0,0
1618107,27,15,1986,11,male,394,30,25,10,0,10,0,0,0
1976030,43,27,1970,4,female,448,30,13,10,0,10,0,0,0
2099823,21,20,1992,4,female,99,29,21,10,4,10,2,0,2
1866801,23,1,1990,6,male,311,30,20,10,3,10,3,0,0
1785227,30,4,1983,1,male,179,30,24,10,2,10,2,0,0
1982575,43,1,1970,4,male,507,30,23,10,2,10,0,0,2
1646578,48,5,1965,1,female,172,30,24,10,3,10,0,0,3
2013205,51,11,1962,12,male,1589,29,3,10,2,10,1,0,1
1001698,50,28,1963,9,female,196,29,14,10,6,10,5,0,1
2030682,57,1,1956,4,female,267,29,15,10,15,10,11,0,4
1936879,13,1,2000,1,male,401,30,5,11,0,0,0,11,0
1421027,19,1,1994,1,male,306,30,19,11,0,0,0,11,0
1272943,61,23,1952,4,male,316,30,17,11,0,0,0,11,0
1042083,47,31,1966,10,male,56,29,8,11,19,0,14,11,5
1303126,57,9,1956,5,female,1272,30,11,11,25,1,10,10,15
1995357,74,5,1939,9,female,835,29,19,11,28,0,3,11,25
1565355,57,12,1956,12,female,535,30,16,11,1,5,1,6,0
1204819,20,6,1993,12,male,363,30,22,11,4,3,2,8,2
1284240,49,17,1964,5,male,779,29,26,11,5,6,5,5,0
1201561,20,6,1993,3,female,702,30,10,11,0,11,0,0,0
1974394,22,20,1991,12,female,501,30,28,11,0,11,0,0,0
1102124,23,1,1990,1,female,117,29,26,11,0,11,0,0,0
1680974,23,20,1990,5,male,355,29,10,11,1,11,1,0,0
1474515,36,3,1977,10,male,729,30,12,11,0,11,0,0,0
1000167,15,17,1998,8,female,166,30,18,11,2,11,2,0,0
1969202,21,9,1992,7,female,85,29,16,11,2,11,1,0,1
1819341,23,10,1990,10,female,997,29,29,11,3,11,2,0,1
1756358,25,23,1988,7,male,29,29,23,11,5,11,4,0,1
1284621,38,19,1975,11,male,487,29,13,11,4,11,4,0,0
1664444,50,6,1963,7,female,593,30,9,11,6,11,4,0,2
1999668,64,29,1949,12,female,1371,29,11,11,3,11,3,0,0
1900208,82,1,1931,1,male,237,29,18,11,5,11,4,0,1
1143183,50,10,1963,9,male,1478,29,11,11,9,11,9,0,0
1389772,32,22,1981,1,female,92,29,27,11,22,11,16,0,6
2018147,17,1,1996,6,male,310,30,11,12,5,0,4,12,1
2178413,68,27,1945,3,female,1490,29,9,12,7,0,2,12,5
2188492,73,28,1940,6,female,1764,29,14,12,8,2,2,10,6
1826390,108,9,1905,2,female,1790,30,22,12,8,0,3,12,5
1364206,31,20,1982,4,female,599,30,12,12,25,0,3,12,22
1525210,20,25,1993,1,male,480,30,24,12,0,3,0,9,0
1599438,15,19,1998,5,female,806,30,8,12,3,6,2,6,1
1512995,56,16,1957,8,male,76,30,24,12,6,10,2,2,4
1534796,65,12,1948,8,female,2312,30,13,12,6,9,4,3,2
1944299,46,18,1967,8,female,369,29,15,12,0,12,0,0,0
1728106,59,1,1954,1,male,527,29,7,12,0,12,0,0,0
1443741,69,12,1944,10,female,885,29,19,12,7,12,2,0,5
1167260,48,10,1965,8,male,227,29,23,12,10,12,2,0,8
1283942,59,22,1954,7,male,111,30,26,12,8,12,8,0,0
1982663,32,25,1981,11,male,200,30,17,12,34,12,21,0,13
2181259,37,22,1976,2,male,30,30,16,12,87,12,50,0,37
1262696,50,20,1963,9,male,1554,29,10,12,21,12,21,0,0
1923631,24,19,1989,9,male,257,30,18,13,0,0,0,13,0
1470357,54,28,1959,5,female,56,29,22,13,2,0,1,13,1
1607482,62,10,1951,4,male,1051,29,9,13,0,0,0,13,0
2168268,41,30,1972,4,male,941,30,12,13,3,0,0,13,3
1039810,64,13,1949,9,female,925,30,12,13,7,0,6,13,1
1590102,16,4,1997,4,male,26,29,26,13,0,13,0,0,0
1061159,23,1,1990,1,female,41,30,14,13,4,13,3,0,1
1460452,51,27,1962,1,male,1446,30,11,13,16,13,14,0,2
1688288,38,30,1975,9,female,114,30,5,13,21,13,16,0,5
1241273,47,2,1966,2,female,677,29,16,13,112,13,108,0,4
1280129,56,27,1957,7,female,391,30,19,13,34,13,20,0,14
1968602,79,6,1934,12,male,992,30,17,14,7,0,5,14,2
1473918,69,28,1944,11,male,1227,29,13,14,14,0,6,14,8
1616980,52,20,1961,8,female,18,29,26,14,24,0,16,14,8
1229735,66,14,1947,10,female,858,30,18,14,24,0,2,14,22
1987455,58,24,1955,4,male,973,29,15,14,13,9,9,5,4
2041443,102,11,1911,11,female,465,29,23,14,22,6,18,8,4
1126815,52,2,1961,2,female,163,29,18,14,1,14,1,0,0
2047184,21,9,1992,1,male,253,30,25,14,6,14,5,0,1
1433260,29,1,1984,1,male,143,30,25,14,8,14,8,0,0
1604254,32,5,1981,7,female,254,30,16,14,5,14,3,0,2
2129756,42,22,1971,10,male,162,30,16,14,5,14,5,0,0
1080224,55,1,1958,9,female,155,29,25,14,3,14,3,0,0
1653112,19,19,1994,7,female,183,30,11,14,15,14,11,0,4
2047898,22,24,1991,7,female,140,29,20,14,20,14,10,0,10
1568915,27,8,1986,9,female,44,29,20,14,54,14,29,0,25
1493432,28,1,1985,3,female,33,30,16,14,142,14,104,0,38
1119409,39,13,1974,9,male,690,30,18,14,36,14,26,0,10
1881722,19,17,1994,5,female,217,30,23,15,15,1,5,14,10
1699508,28,25,1985,4,female,419,30,17,15,7,9,3,6,4
1167950,19,17,1994,8,male,215,30,21,15,23,5,4,10,19
1213884,18,30,1995,6,male,32,30,24,15,24,14,7,1,17
1437860,16,28,1997,2,female,911,29,25,15,1,15,0,0,1
1517128,26,1,1987,1,female,321,30,17,15,1,15,1,0,0
1903465,37,25,1976,11,male,91,29,22,15,0,15,0,0,0
1551907,60,3,1953,1,female,798,30,7,15,1,15,1,0,0
1223825,69,24,1944,10,male,1039,30,18,15,2,15,2,0,0
1554469,43,19,1970,5,male,539,30,21,15,4,15,3,0,1
1527532,44,2,1969,10,male,278,30,28,15,8,15,7,0,1
1651156,34,7,1979,10,female,9,29,20,15,10,15,9,0,1
1871425,38,16,1975,7,male,344,30,15,15,60,15,48,0,12
1842844,41,16,1972,2,male,221,30,10,15,42,15,41,0,1
1722286,41,27,1972,12,male,331,30,6,16,1,0,1,16,0
1973441,59,14,1954,3,male,517,30,19,16,11,0,1,16,10
1228318,51,1,1962,1,female,45,30,18,16,28,0,2,16,26
1648467,33,20,1980,11,male,645,30,23,16,0,6,0,10,0
2026277,26,9,1987,6,male,557,29,15,16,5,7,0,9,5
1638828,17,13,1996,9,male,931,29,17,16,18,10,9,6,9
1858955,35,1,1978,1,male,80,29,28,16,0,16,0,0,0
1185246,38,13,1975,9,female,517,29,10,16,0,16,0,0,0
1146131,45,6,1968,5,female,555,30,9,16,2,16,2,0,0
1692237,59,24,1954,8,male,310,29,10,16,0,16,0,0,0
1082782,64,7,1949,7,female,1347,29,15,16,3,16,1,0,2
1658801,28,20,1985,8,female,39,30,16,16,23,16,15,0,8
1330434,28,22,1985,9,female,521,30,14,16,22,16,15,0,7
1156237,25,22,1988,8,female,301,29,28,17,0,0,0,17,0
1741946,28,18,1985,4,male,631,30,25,17,0,0,0,17,0
1572092,71,19,1942,12,male,558,29,16,17,0,0,0,17,0
2089191,51,25,1962,2,male,572,29,15,17,5,0,0,17,5
1794146,67,5,1946,11,female,538,30,3,17,10,0,2,17,8
1238249,50,16,1963,11,male,324,29,20,17,24,5,2,12,22
1152266,31,18,1982,1,female,670,29,21,17,4,16,2,1,2
1536064,55,4,1958,12,male,1747,29,12,17,7,15,7,2,0
1287682,88,29,1925,7,male,923,30,14,17,10,16,1,1,9
1724414,14,7,1999,1,female,71,29,7,17,0,17,0,0,0
1969406,52,28,1961,7,male,380,29,23,17,0,17,0,0,0
1948844,21,25,1992,6,female,195,29,14,17,6,17,2,0,4
1417754,24,12,1989,4,male,128,29,20,17,14,17,5,0,9
2112410,42,24,1971,11,female,314,29,12,17,11,17,9,0,2
1490968,23,29,1990,8,male,755,30,13,17,42,17,30,0,12
1852610,61,16,1952,1,female,22,30,17,17,28,17,11,0,17
1270432,56,6,1957,5,female,781,29,17,18,5,0,5,18,0
2123918,75,21,1938,5,female,431,29,19,18,24,0,9,18,15
1514069,61,23,1952,9,male,818,29,19,18,1,5,1,13,0
2032399,64,6,1949,8,male,1459,30,13,18,1,12,1,6,0
1175588,19,27,1994,2,female,387,30,10,18,5,12,3,6,2
1794209,53,2,1960,5,male,255,30,13,18,7,12,6,6,1
2011636,34,30,1979,8,male,20,30,28,18,5,15,5,3,0
1144024,29,17,1984,11,female,14,29,24,18,85,16,55,2,30
1151513,17,16,1996,10,male,208,29,26,18,1,18,1,0,0
1587661,26,20,1987,5,male,1033,29,22,18,4,18,1,0,3
1820422,37,24,1976,4,male,467,29,24,18,3,18,2,0,1
1002439,52,26,1961,1,female,608,29,24,18,12,18,7,0,5
1056377,35,19,1978,5,male,130,30,18,18,41,18,35,0,6
1966550,38,3,1975,6,male,212,30,25,19,0,0,0,19,0
1755410,46,23,1967,10,male,717,29,9,19,5,0,0,19,5
2061553,24,18,1989,9,male,589,30,27,19,11,19,9,0,2
1307469,58,12,1955,4,male,18,29,18,19,5,19,3,0,2
1019680,45,4,1968,4,female,287,29,24,19,13,19,11,0,2
1495646,22,18,1991,9,male,412,30,16,20,0,0,0,20,0
1898264,37,4,1976,2,male,255,30,21,20,3,0,0,20,3
1113597,51,6,1962,10,male,347,30,27,20,1,0,0,20,1
1900632,16,29,1997,10,male,133,30,19,20,13,9,6,11,7
1907123,44,16,1969,6,male,370,30,16,20,27,14,20,6,7
1562160,40,29,1973,6,female,424,30,23,20,40,11,20,9,20
1398577,67,29,1946,9,male,1402,30,28,20,1,19,1,1,0
1649467,74,13,1939,6,female,1888,29,10,20,9,17,1,3,8
2182900,24,30,1989,10,female,76,29,23,20,39,19,35,1,4
1796177,20,15,1993,6,male,16,29,27,20,10,20,10,0,0
1998554,79,26,1934,5,male,1156,30,23,20,5,20,2,0,3
1278792,23,4,1990,3,female,249,29,21,21,0,0,0,21,0
1202805,69,19,1944,9,female,1337,30,6,21,2,0,0,21,2
1745300,68,6,1945,2,male,1784,29,15,21,8,0,6,21,2
2041944,49,5,1964,5,male,142,29,11,21,20,0,3,21,17
2000850,77,30,1936,10,female,994,29,20,21,2,8,0,13,2
1134408,15,7,1998,3,male,319,29,17,21,9,11,2,10,7
1263618,59,26,1954,11,male,248,29,8,21,2,19,0,2,2
1011821,14,27,1999,1,female,265,29,4,21,0,21,0,0,0
1930161,46,17,1967,6,female,198,30,18,21,0,21,0,0,0
2175174,35,25,1978,1,male,416,30,18,21,13,21,12,0,1
1776415,15,8,1998,6,male,495,29,17,22,0,0,0,22,0
1127949,42,1,1971,1,female,55,29,20,22,13,1,9,21,4
1618962,71,30,1942,7,male,469,30,15,22,8,0,2,22,6
1088212,73,30,1940,10,female,187,29,24,22,4,0,0,22,4
1099770,49,6,1964,11,female,252,29,20,22,47,7,15,15,32
1718255,53,28,1960,7,male,81,30,21,22,2,22,2,0,0
1046954,27,5,1986,8,female,209,30,15,22,13,22,9,0,4
1383406,44,8,1969,4,male,166,30,12,22,4,22,1,0,3
1364552,54,9,1959,7,female,290,29,19,22,6,22,6,0,0
2043277,52,11,1961,4,female,23,29,11,22,17,22,9,0,8
1064803,105,17,1908,9,female,1891,30,14,23,6,12,4,11,2
2053321,58,25,1955,6,female,1807,29,17,23,17,22,15,1,2
1125211,28,16,1985,8,male,631,30,20,23,4,23,2,0,2
1385524,27,28,1986,11,female,213,29,7,23,26,23,16,0,10
2089398,60,19,1953,1,male,221,30,15,23,60,23,54,0,6
1377045,48,26,1965,10,female,613,29,8,24,18,0,9,24,9
2189238,29,7,1984,9,male,472,30,29,24,0,24,0,0,0
1841626,49,20,1964,12,male,663,29,19,24,0,24,0,0,0
2085916,16,19,1997,5,male,80,29,18,24,6,24,6,0,0
1448178,27,28,1986,8,male,305,30,13,24,11,24,1,0,10
1256436,53,12,1960,7,female,307,29,22,24,4,24,4,0,0
2011492,43,8,1970,2,male,609,29,11,24,19,24,11,0,8
1461964,48,25,1965,7,male,378,30,24,25,11,0,0,25,11
1349734,60,24,1953,5,female,383,30,20,25,8,0,6,25,2
1369385,85,3,1928,3,female,1592,29,19,25,9,0,5,25,4
1651962,49,9,1964,11,female,334,30,25,25,5,7,4,18,1
1162158,19,28,1994,2,male,387,29,22,25,7,25,4,0,3
1506478,67,14,1946,5,female,966,29,22,25,5,25,5,0,0
1999407,76,5,1937,6,female,1635,29,7,25,5,25,4,0,1
1321096,40,28,1973,3,male,275,29,8,25,24,25,20,0,4
1891599,52,3,1961,4,female,728,30,19,25,18,25,12,0,6
1481947,19,19,1994,2,female,330,29,8,26,1,1,0,25,1
1607448,39,21,1974,10,male,511,30,3,26,11,5,8,21,3
1744920,64,20,1949,6,male,1001,30,17,26,9,1,6,25,3
1127910,31,11,1982,3,female,279,30,18,26,5,25,1,1,4
1955288,58,10,1955,1,male,1039,30,16,26,43,23,23,3,20
1199693,25,13,1988,12,male,422,29,21,26,2,26,2,0,0
2001476,25,22,1988,2,female,1826,29,16,26,0,26,0,0,0
2023330,47,3,1966,1,male,1576,30,19,26,29,26,19,0,10
1098061,48,2,1965,6,male,1849,30,8,26,17,26,8,0,9
1901488,17,1,1996,2,male,440,29,20,27,3,0,0,27,3
1985956,61,4,1952,5,male,558,30,24,27,40,26,34,1,6
1863336,30,26,1983,11,male,577,29,26,27,0,27,0,0,0
1092522,35,20,1978,5,male,751,30,18,27,3,27,3,0,0
1605816,35,15,1978,9,male,518,30,11,27,5,27,4,0,1
1237377,50,25,1963,9,female,27,30,26,27,10,27,10,0,0
1461357,33,25,1980,7,male,391,29,12,27,34,27,29,0,5
1012105,68,21,1945,2,male,1395,29,21,27,18,27,10,0,8
2113551,30,7,1983,7,male,273,29,26,27,45,27,41,0,4
1285969,61,14,1952,8,female,142,29,18,28,2,1,1,27,1
1319301,30,18,1983,4,female,222,30,19,28,112,2,16,26,96
1761651,21,22,1992,1,male,502,30,20,28,20,13,5,15,15
1071965,46,20,1967,4,male,622,29,20,28,0,28,0,0,0
1892221,33,25,1980,8,male,89,30,26,28,9,28,4,0,5
2089873,64,2,1949,6,female,238,29,24,28,9,28,8,0,1
1389007,60,22,1953,3,female,13,30,24,28,54,28,38,0,16
1197541,73,30,1940,7,female,1465,30,13,29,0,0,0,29,0
1129142,50,22,1963,4,female,168,29,27,29,2,18,1,11,1
1180189,64,10,1949,1,male,360,30,19,29,0,29,0,0,0
2130315,43,18,1970,1,female,76,29,26,29,5,29,3,0,2
1850888,44,20,1969,8,female,506,30,16,29,35,29,35,0,0
1889998,45,10,1968,3,male,254,29,26,30,6,4,6,26,0
1890351,62,1,1951,1,male,1265,29,19,30,9,18,3,12,6
2014442,55,27,1958,6,male,1768,30,11,31,7,29,6,2,1
2011542,22,3,1991,5,female,385,30,20,30,0,30,0,0,0
2103902,14,9,1999,4,male,246,29,21,31,11,31,3,0,8
1351019,19,14,1994,2,female,245,30,11,31,10,31,7,0,3
1101896,21,8,1992,4,female,533,30,7,31,9,31,8,0,1
1650385,26,27,1987,7,male,57,30,23,30,7,30,6,0,1
1325840,62,19,1951,10,male,1354,29,12,31,18,31,12,0,6
1673506,71,11,1942,7,female,1586,30,19,31,8,31,2,0,6
1942108,22,17,1991,12,female,88,30,16,31,22,31,16,0,6
1341313,27,11,1986,10,male,155,29,18,30,22,30,10,0,12
2059001,31,21,1982,10,female,437,30,22,30,27,30,26,0,1
1825556,32,15,1981,3,male,190,30,25,30,41,30,37,0,4
1662446,66,16,1947,12,male,403,30,16,32,60,0,35,32,25
1816828,71,16,1942,10,female,1179,29,12,32,56,0,39,32,17
1157482,20,18,1993,4,male,154,30,23,32,23,22,11,10,12
1852555,18,1,1995,1,male,45,29,26,32,10,32,10,0,0
2008083,100,17,1913,7,male,108,29,25,32,26,32,15,0,11
1719373,68,20,1945,6,female,1007,29,21,33,6,0,6,33,0
1727067,34,14,1979,3,female,218,30,18,33,8,33,4,0,4
1557669,20,4,1993,4,male,209,30,26,34,36,0,2,34,34
1095397,47,6,1966,4,female,451,30,16,34,113,10,54,24,59
1141961,60,10,1953,10,male,1249,30,12,34,177,15,131,19,46
1816723,28,2,1985,2,male,639,30,25,34,2,32,1,2,1
1282985,32,24,1981,8,male,173,30,16,34,15,34,10,0,5
1600234,26,2,1987,5,male,204,30,24,34,61,34,57,0,4
2067472,14,21,1999,4,female,262,30,10,35,1,1,1,34,0
1293235,35,4,1978,12,male,712,29,22,36,8,0,7,36,1
1674871,26,6,1987,5,male,421,29,15,35,44,0,5,35,39
1602724,39,1,1974,7,male,168,30,26,36,43,6,21,30,22
1963116,25,2,1988,8,female,550,30,19,36,4,12,0,24,4
1979679,44,19,1969,10,female,223,29,26,35,42,11,8,24,34
2118000,23,15,1990,6,male,267,29,17,36,22,35,22,1,0
1306098,61,17,1952,3,female,1742,29,25,37,11,3,2,34,9
1636773,70,3,1943,11,female,775,30,17,37,19,0,5,37,14
1239719,49,21,1964,1,male,1257,30,9,37,12,13,2,24,10
1807281,55,6,1958,12,female,204,29,4,37,106,32,73,5,33
1090308,40,12,1973,1,female,174,29,18,37,19,37,17,0,2
1438527,31,21,1982,7,female,47,30,14,37,23,37,22,0,1
2166387,21,19,1992,11,male,293,29,6,38,0,0,0,38,0
2147279,54,15,1959,6,female,658,30,15,38,4,6,1,32,3
1207701,39,24,1974,7,female,826,29,20,39,15,0,11,39,4
1999250,51,5,1962,11,female,474,29,16,39,14,0,2,39,12
1080518,75,7,1938,5,male,432,29,14,38,20,0,7,38,13
1289925,75,24,1938,7,male,1298,30,15,38,22,1,7,37,15
1521115,95,26,1918,3,male,72,30,25,38,79,0,53,38,26
1163884,14,20,1999,6,female,397,30,15,39,3,9,2,30,1
1753873,60,14,1953,6,female,753,29,17,39,5,11,2,28,3
1122710,28,2,1985,7,male,658,30,19,38,20,37,12,1,8
1293283,35,22,1978,4,female,495,30,18,38,135,33,115,5,20
1671286,17,11,1996,12,male,235,29,8,38,14,38,11,0,3
1792359,40,29,1973,5,male,878,30,11,39,22,39,21,0,1
2017537,44,14,1969,6,male,117,30,16,38,22,38,17,0,5
1660782,50,5,1963,2,female,262,30,14,39,22,39,20,0,2
1929615,69,22,1944,10,female,1680,29,10,40,15,0,2,40,13
1857874,43,16,1970,10,female,430,30,11,40,3,40,3,0,0
1953469,26,20,1987,8,male,646,30,6,40,24,40,18,0,6
1641295,51,17,1962,6,female,361,30,27,42,24,0,4,42,20
1711135,69,26,1944,3,female,124,29,19,42,10,0,4,42,6
1106065,30,2,1983,9,male,27,29,23,41,56,4,4,37,52
1495258,21,24,1992,9,male,40,29,15,42,22,15,15,27,7
1834230,20,16,1993,1,male,356,29,20,42,0,39,0,3,0
1609815,14,8,1999,12,male,276,29,18,41,0,41,0,0,0
1353632,48,27,1965,5,female,643,29,18,41,38,41,12,0,26
1081597,67,24,1946,6,male,1880,29,9,42,54,42,29,0,25
1699885,60,22,1953,3,male,472,29,18,43,3,0,0,43,3
1424538,83,26,1930,9,male,1766,29,4,43,12,0,3,43,9
2176924,20,24,1993,8,male,562,29,24,43,7,20,5,23,2
1452083,29,14,1984,9,female,59,29,25,43,0,17,0,26,0
1009324,33,13,1980,1,female,243,29,21,43,7,43,3,0,4
1701447,37,8,1976,10,female,437,29,19,44,0,44,0,0,0
1015043,17,8,1996,9,female,524,29,14,44,16,44,16,0,0
2100705,30,23,1983,8,female,77,29,10,46,6,0,3,46,3
1131373,47,24,1966,11,female,260,29,9,47,39,0,30,47,9
1291442,27,30,1986,3,female,202,30,15,46,51,15,31,31,20
1925217,55,28,1958,11,female,181,30,8,46,0,46,0,0,0
1268675,19,19,1994,12,male,399,29,9,46,20,46,11,0,9
1731427,37,12,1976,4,female,307,29,11,46,23,46,17,0,6
2094326,18,18,1995,5,male,45,29,17,47,34,47,33,0,1
1908195,35,27,1978,4,male,434,30,8,46,39,46,36,0,3
2017581,59,8,1954,6,male,651,30,16,49,2,0,1,49,1
1950156,85,29,1928,7,male,1537,30,2,48,5,0,3,48,2
1116605,22,25,1991,6,male,80,30,18,48,20,37,12,11,8
1778051,26,17,1987,3,male,358,29,18,48,5,48,5,0,0
1199362,69,1,1944,6,female,397,30,25,48,4,48,4,0,0
1837767,37,17,1976,5,female,397,30,20,48,13,48,12,0,1
1065702,62,1,1951,3,female,150,30,26,49,16,49,13,0,3
1948072,63,11,1950,1,female,48,30,15,51,2,0,1,51,1
1423383,29,25,1984,10,female,240,30,17,50,43,44,38,6,5
2049261,30,18,1983,5,male,438,30,23,50,54,49,35,1,19
1316569,49,27,1964,5,female,352,29,22,50,3,50,1,0,2
1711530,53,18,1960,2,male,136,29,22,50,9,50,5,0,4
1099656,53,8,1960,8,female,1084,29,12,51,12,51,12,0,0
1513722,73,21,1940,9,female,951,29,11,50,20,50,4,0,16
1828666,31,18,1982,8,female,150,29,22,50,31,50,21,0,10
1521304,41,14,1972,11,male,1052,29,14,51,42,51,41,0,1
1175599,66,26,1947,7,female,307,29,19,53,7,0,2,53,5
1187822,56,25,1957,5,female,889,29,17,52,11,9,4,43,7
1529379,61,7,1952,8,female,2108,29,14,52,10,0,5,52,5
1512728,55,19,1958,4,female,357,29,24,53,36,0,3,53,33
1490944,57,6,1956,9,female,66,30,28,53,71,0,32,53,39
1250319,20,12,1993,1,male,455,29,9,52,8,24,7,28,1
1388731,50,18,1963,4,female,207,30,24,53,37,47,30,6,7
1751490,16,28,1997,9,male,24,30,27,53,42,53,34,0,8
1723886,45,1,1968,1,male,148,30,22,52,33,52,28,0,5
1096845,73,24,1940,6,female,822,30,17,55,9,0,7,55,2
1199096,18,12,1995,7,male,120,30,16,54,30,1,4,53,26
1407622,18,5,1995,10,male,207,30,14,55,12,0,0,55,12
1270582,68,29,1945,12,female,1327,29,7,55,40,1,6,54,34
2053084,22,25,1991,6,female,302,30,10,55,31,55,22,0,9
1415249,38,1,1975,1,male,170,30,22,55,28,55,23,0,5
1416030,69,23,1944,12,female,306,30,19,55,26,55,15,0,11
1589151,31,1,1982,1,male,301,29,28,54,45,54,28,0,17
1418860,26,15,1987,10,female,383,30,13,54,98,54,76,0,22
1434558,51,18,1962,2,female,671,30,17,58,11,0,2,58,9
1962459,71,13,1942,1,female,282,29,24,57,73,0,18,57,55
2088409,37,27,1976,4,female,133,30,28,56,65,32,27,24,38
2088802,33,16,1980,5,male,249,30,20,58,10,51,10,7,0
2118837,71,11,1942,3,female,354,29,13,56,30,44,22,12,8
1664599,22,1,1991,1,male,105,29,26,58,6,58,5,0,1
1907355,54,26,1959,10,female,169,30,27,58,2,58,2,0,0
1372349,47,19,1966,4,female,448,30,22,59,0,0,0,59,0
2100642,57,15,1956,11,female,513,29,24,60,0,0,0,60,0
1341296,57,10,1956,6,male,702,29,3,60,58,0,3,60,55
1812098,33,6,1980,8,female,303,29,11,59,102,0,2,59,100
1991530,19,6,1994,4,male,3,29,25,62,19,1,13,61,6
1152920,64,13,1949,11,male,1551,29,8,62,68,0,43,62,25
1976007,14,13,1999,12,female,246,29,22,62,80,16,15,46,65
1309239,69,25,1944,10,male,586,30,10,61,27,50,20,11,7
1331616,21,1,1992,1,male,297,29,27,63,10,63,8,0,2
1075779,34,24,1979,8,female,145,29,25,62,0,62,0,0,0
1767692,96,28,1917,7,female,423,29,9,61,16,61,16,0,0
1070805,60,19,1953,8,female,93,29,15,64,14,0,5,64,9
1317849,75,1,1938,3,female,128,29,25,65,12,0,4,65,8
1610803,63,17,1950,3,female,421,29,19,64,50,0,10,64,40
1097234,82,10,1931,9,female,676,30,24,65,2,62,1,3,1
1892918,22,13,1991,9,female,82,30,19,65,22,65,13,0,9
1976939,53,18,1960,12,male,377,30,13,65,27,65,18,0,9
1204359,84,31,1929,7,female,95,29,22,67,1,0,0,67,1
1689142,23,3,1990,6,male,413,29,15,68,14,0,0,68,14
1141440,27,4,1986,3,male,14,30,28,67,8,57,5,10,3
1959407,42,7,1971,9,female,366,29,28,67,6,67,4,0,2
1577397,38,23,1975,5,male,222,29,17,68,16,68,8,0,8
1693913,51,17,1962,4,female,55,30,22,67,26,67,20,0,6
1182154,18,4,1995,3,female,286,29,14,67,89,67,47,0,42
1462964,28,26,1985,6,female,1425,29,17,69,5,5,1,64,4
2133554,37,1,1976,12,male,278,29,18,69,73,0,21,69,52
1773084,19,25,1994,12,male,17,29,24,69,22,63,21,6,1
1770313,23,10,1990,7,male,88,30,23,70,2,70,0,0,2
2025541,30,23,1983,8,male,645,29,14,69,11,69,8,0,3
1232633,25,25,1988,8,male,10,30,27,69,27,69,16,0,11
1214006,58,20,1955,12,female,623,29,15,71,39,71,37,0,2
2097769,74,13,1939,11,female,360,29,22,71,58,71,24,0,34
1759502,37,7,1976,5,female,244,29,19,72,1,0,0,72,1
1169641,40,23,1973,8,male,307,29,17,74,29,72,23,2,6
1796714,64,4,1949,4,female,638,29,24,74,0,74,0,0,0
1032473,22,6,1991,11,female,134,29,21,74,28,74,25,0,3
1838250,28,7,1985,7,male,78,30,18,74,17,74,17,0,0
1928117,57,28,1956,8,female,207,29,19,74,31,74,29,0,2
1642415,13,27,2000,4,male,5,29,19,73,64,73,42,0,22
1470668,72,20,1941,1,female,606,30,25,75,9,0,1,75,8
1762769,63,25,1950,8,male,602,30,21,75,4,75,4,0,0
1511906,65,2,1948,10,female,573,29,22,75,5,75,1,0,4
1899345,28,14,1985,9,female,346,30,5,75,18,75,17,0,1
1632824,42,6,1971,9,male,58,29,28,77,33,77,20,0,13
1018986,67,12,1946,6,female,269,29,24,79,10,15,2,64,8
1147232,21,22,1992,11,male,434,30,24,80,48,0,4,80,44
1624662,66,24,1947,10,female,348,30,18,80,19,0,10,80,9
1861003,16,25,1997,6,male,485,30,24,78,5,78,5,0,0
1972346,47,11,1966,10,male,27,29,21,78,22,78,17,0,5
1563677,63,8,1950,3,female,176,30,20,82,10,0,6,82,4
1216774,54,10,1959,6,female,197,29,4,81,24,0,2,81,22
1752486,44,8,1969,6,female,474,30,19,83,31,25,9,58,22
2150309,19,5,1994,5,female,240,29,26,82,3,72,2,10,1
1329668,103,2,1910,9,female,604,30,28,82,4,82,4,0,0
1843978,15,3,1998,9,female,91,30,23,84,40,84,21,0,19
1280984,31,21,1982,8,female,742,30,14,87,35,25,14,62,21
1105560,31,25,1982,12,female,354,30,18,85,164,84,37,1,127
2095638,25,1,1988,1,male,169,29,22,87,28,87,28,0,0
1873710,37,5,1976,3,female,68,29,14,87,72,87,41,0,31
1521872,39,17,1974,2,female,77,29,24,90,7,0,0,90,7
2094906,52,21,1961,6,female,531,29,17,89,15,0,3,89,12
1292426,18,12,1995,11,male,352,29,19,91,4,21,2,70,2
2097103,18,27,1995,8,male,11,30,28,90,2,51,1,39,1
1152243,33,16,1980,4,female,285,29,13,94,1,94,1,0,0
1783785,26,1,1987,1,female,313,29,13,95,26,95,22,0,4
1792962,34,20,1979,3,female,411,30,26,92,33,92,33,0,0
1453076,58,6,1955,8,female,600,30,22,96,10,0,0,96,10
1863829,17,3,1996,2,male,88,30,27,98,1,98,1,0,0
1422634,34,15,1979,12,female,483,30,13,97,96,97,61,0,35
1321204,34,3,1979,4,male,726,29,16,99,96,99,51,0,45
1000150,50,7,1963,8,female,588,29,16,99,107,99,104,0,3
1406634,54,18,1959,8,female,818,30,17,101,19,0,11,101,8
1531858,23,10,1990,12,female,256,30,26,104,25,58,3,46,22
1860502,26,17,1987,3,male,644,29,21,103,49,43,26,60,23
1321331,41,15,1972,2,female,404,30,10,101,84,85,80,16,4
1079817,22,24,1991,12,female,745,30,17,104,1,104,1,0,0
1000198,43,18,1970,12,male,179,30,25,100,43,100,38,0,5
1831649,43,4,1970,3,male,478,30,16,103,57,103,41,0,16
1148978,62,14,1951,5,female,68,30,18,100,19,100,12,0,7
1078379,108,21,1905,3,male,37,29,24,107,201,1,57,106,144
1331211,62,16,1951,2,male,342,30,20,107,14,70,10,37,4
1669675,26,30,1987,7,female,148,29,25,106,133,94,77,12,56
1423578,36,1,1977,1,male,66,29,28,107,3,107,3,0,0
1412419,36,7,1977,11,male,195,30,14,108,38,108,33,0,5
2069827,58,17,1955,11,female,1489,30,3,106,52,106,25,0,27
1585904,50,1,1963,3,female,493,29,9,113,42,0,9,113,33
1052986,52,28,1961,6,female,778,30,14,113,5,113,4,0,1
1166318,19,18,1994,9,female,310,29,17,112,20,112,20,0,0
1338670,36,31,1977,3,female,441,29,17,113,125,113,111,0,14
1974129,60,11,1953,9,male,446,29,20,114,8,12,3,102,5
1876285,62,25,1951,5,female,1880,30,8,116,20,0,12,116,8
1549626,59,31,1954,12,female,74,29,26,114,2,88,2,26,0
2009890,37,17,1976,6,male,728,29,10,117,139,113,102,4,37
1721359,33,28,1980,9,female,476,30,15,114,60,113,24,1,36
1899840,38,16,1975,2,male,388,30,11,117,1,117,1,0,0
1227732,43,6,1970,7,female,377,29,11,114,11,114,6,0,5
1077730,44,4,1969,6,female,699,29,20,119,8,119,7,0,1
1503439,51,14,1962,8,male,482,30,24,118,6,118,3,0,3
1700361,54,29,1959,11,male,429,29,19,121,44,120,23,1,21
1210308,65,29,1948,2,female,454,29,4,123,11,123,11,0,0
1478358,15,4,1998,5,female,358,30,15,125,55,0,7,125,48
1071657,70,21,1943,3,female,497,30,28,130,77,0,6,130,71
1631185,15,18,1998,10,female,298,29,21,129,101,92,37,37,64
2008294,46,1,1967,2,female,216,29,26,128,14,128,14,0,0
2040942,26,4,1987,6,female,366,29,14,129,25,129,15,0,10
1047429,29,24,1984,8,female,438,30,13,125,59,125,52,0,7
1374769,35,15,1978,4,female,308,29,13,126,72,126,56,0,16
1261100,31,27,1982,12,female,162,30,15,128,94,128,92,0,2
1071095,49,15,1964,11,male,693,30,9,132,30,90,13,42,17
1084590,108,20,1905,10,female,1146,29,16,136,47,67,31,69,16
1709439,29,28,1984,4,female,285,30,16,132,33,132,32,0,1
1771694,40,12,1973,5,female,558,30,9,139,14,0,7,139,7
1555881,47,2,1966,3,female,241,30,17,139,49,21,15,118,34
1253354,36,15,1977,9,female,588,29,24,145,8,24,3,121,5
1664593,40,23,1973,8,female,79,29,22,146,106,0,13,146,93
1576918,16,27,1997,5,female,558,29,23,145,119,141,112,4,7
1332399,65,1,1948,10,male,399,29,16,150,12,150,8,0,4
1074764,78,29,1935,4,female,188,29,14,148,3,148,2,0,1
1358191,50,27,1963,7,male,284,30,21,153,17,0,13,153,4
2051877,19,2,1994,5,female,245,29,18,157,48,0,1,157,47
2000516,62,8,1951,6,female,310,29,14,152,75,0,30,152,45
1737723,24,9,1989,3,male,145,29,26,152,1,152,1,0,0
1453187,19,25,1994,2,female,124,29,6,164,329,0,48,164,281
1372002,37,8,1976,8,female,126,29,18,162,12,132,7,30,5
1472366,31,12,1982,5,female,336,29,18,160,4,160,3,0,1
2010529,25,1,1988,1,female,21,30,24,158,124,158,76,0,48
1193244,64,21,1949,5,female,63,30,29,165,95,0,13,165,82
1201931,53,5,1960,5,female,1467,30,14,172,30,172,6,0,24
1174626,53,6,1960,5,male,360,30,14,167,28,167,16,0,12
2191127,23,4,1990,8,female,63,29,11,169,260,169,181,0,79
1146591,38,14,1975,9,male,1016,29,27,175,44,175,34,0,10
1211771,63,6,1950,6,female,815,29,18,185,51,0,4,185,47
1070394,88,18,1925,7,female,1561,29,20,186,0,184,0,2,0
2011894,48,16,1965,11,female,522,30,22,184,78,147,36,37,42
1009370,23,1,1990,3,male,118,29,26,189,10,189,7,0,3
1631286,71,5,1942,11,female,725,29,20,197,64,0,7,197,57
2007444,33,28,1980,9,male,1766,29,20,191,40,90,31,101,9
2140423,24,3,1989,6,male,718,30,23,191,19,182,13,9,6
1527936,42,17,1971,8,female,231,29,17,192,4,192,4,0,0
1388085,24,28,1989,2,male,55,29,28,206,15,206,10,0,5
1404837,53,27,1960,11,female,47,30,16,204,123,204,90,0,33
1398146,97,8,1916,11,female,397,29,23,222,62,0,7,222,55
1798547,46,5,1967,7,female,40,29,15,224,23,182,4,42,19
2028625,23,21,1990,8,female,56,30,21,227,106,221,69,6,37
1139688,46,20,1967,10,female,465,29,21,224,11,224,4,0,7
1700790,55,25,1958,9,male,30,30,23,233,4,233,3,0,1
1958570,62,25,1951,5,female,1052,29,7,225,30,225,27,0,3
1733582,36,13,1977,4,male,247,30,17,232,74,232,46,0,28
1452388,20,14,1993,4,female,596,29,18,233,244,233,86,0,158
1121424,64,12,1949,10,female,24,30,25,240,14,0,2,240,12
1385999,56,23,1957,11,female,161,30,29,258,43,0,2,258,41
1348276,58,4,1955,9,female,650,30,13,249,44,0,32,249,12
1884362,24,19,1989,4,male,233,29,24,247,45,247,45,0,0
1428275,68,13,1945,11,female,720,29,15,270,52,11,25,259,27
1244662,14,30,1999,12,male,304,29,26,267,25,246,15,21,10
1764771,54,28,1959,10,female,1185,30,16,262,42,199,35,63,7
1399504,19,1,1994,1,female,219,30,24,269,241,266,158,3,83
1934010,30,1,1983,1,male,33,30,19,269,31,269,23,0,8
2133043,57,19,1956,6,female,614,30,23,266,24,266,14,0,10
1922188,65,16,1948,10,female,590,29,10,272,3,272,1,0,2
1339634,19,22,1994,5,female,328,30,16,291,405,79,129,212,276
1003143,18,4,1995,2,female,34,30,28,289,211,250,134,39,77
1025337,21,30,1992,8,female,346,30,19,319,149,316,114,3,35
1937354,43,30,1970,9,female,458,30,17,322,44,322,31,0,13
1101319,62,6,1951,1,female,374,30,20,330,41,0,29,330,12
1693301,71,29,1942,4,female,26,30,15,339,16,0,5,339,11
1897542,15,2,1998,1,female,25,29,15,332,301,181,4,151,297
1962863,31,5,1982,6,female,635,30,17,336,126,336,68,0,58
1671150,55,23,1958,12,female,634,29,17,343,158,343,158,0,0
1487888,49,7,1964,6,male,326,29,20,391,88,48,38,343,50
1055182,23,19,1990,5,female,246,29,16,388,329,239,206,149,123
2097021,45,14,1968,5,female,431,30,24,395,159,395,111,0,48
1687397,32,14,1981,12,female,501,30,14,447,14,0,5,447,9
1176568,22,16,1991,2,female,35,29,28,435,84,426,75,9,9
1045554,17,26,1996,1,female,290,29,17,443,838,346,489,97,349
1325421,30,1,1983,2,male,227,30,18,430,22,430,9,0,13
1355313,21,15,1992,7,male,537,30,13,422,570,422,492,0,78
1716084,57,26,1956,11,female,852,30,26,463,32,456,15,7,17
1987550,37,28,1976,12,female,712,30,17,472,166,434,144,38,22
1768170,46,3,1967,10,female,186,30,25,511,24,272,2,239,22
1970495,54,6,1959,6,female,228,29,22,490,12,490,11,0,1
1191204,50,9,1963,9,male,412,29,16,510,181,510,143,0,38
1255246,43,26,1970,10,female,283,30,24,526,97,201,82,325,15
2129896,68,3,1945,6,female,1352,30,20,546,13,535,3,11,10
1605955,37,29,1976,12,male,180,29,25,570,51,570,16,0,35
1415088,59,9,1954,9,female,1533,29,16,604,112,604,56,0,56
1806873,63,23,1950,2,female,30,29,26,611,32,0,3,611,29
2183552,28,10,1985,4,female,230,30,24,644,21,644,20,0,1
2022122,17,15,1996,5,male,1256,29,10,685,0,685,0,0,0
1580823,38,8,1975,9,female,55,30,23,745,97,745,78,0,19
1472560,33,1,1980,1,female,321,30,11,829,117,0,1,829,116
1558044,23,13,1990,5,female,91,30,19,902,857,902,473,0,384
1920981,47,30,1966,4,female,169,29,23,1054,263,0,69,1054,194
1635098,53,2,1960,2,female,142,30,13,1365,1566,674,1074,691,492
1131776,44,21,1969,9,female,321,29,18,1290,64,1290,40,0,24
2152603,52,12,1961,6,female,392,30,23,1486,554,1486,173,0,381
1216134,46,25,1967,3,female,515,29,13,3188,1319,3188,918,0,401
1391031,14,8,1999,12,male,140,31,7,0,7,0,7,0,0
1865875,15,27,1998,2,male,98,31,28,0,0,0,0,0,0
1766969,15,25,1998,7,female,31,31,9,0,0,0,0,0,0
1649994,15,15,1998,9,male,401,31,21,0,1,0,0,0,1
1083988,15,16,1998,10,male,174,31,28,0,0,0,0,0,0
1948661,17,11,1996,12,female,189,31,7,0,9,0,1,0,8
2101823,16,17,1997,2,male,345,31,28,0,0,0,0,0,0
1253780,16,3,1997,6,male,386,31,23,0,0,0,0,0,0
2079637,16,4,1997,10,male,256,31,22,0,1,0,1,0,0
1242830,18,25,1995,11,male,75,31,28,0,0,0,0,0,0
1293139,18,19,1995,12,male,191,31,24,0,1,0,0,0,1
1227559,17,13,1996,3,male,454,31,17,0,1,0,1,0,0
1536972,17,15,1996,3,male,105,31,30,0,0,0,0,0,0
1632717,17,27,1996,7,female,12,31,19,0,0,0,0,0,0
2167238,19,9,1994,11,male,180,31,23,0,0,0,0,0,0
1172255,18,31,1995,1,male,268,31,22,0,0,0,0,0,0
1919103,18,18,1995,3,male,79,31,24,0,1,0,1,0,0
1319995,18,11,1995,4,male,239,31,21,0,1,0,1,0,0
1912917,18,14,1995,5,male,100,31,19,0,0,0,0,0,0
1733692,18,21,1995,6,male,641,31,17,0,0,0,0,0,0
2141519,18,14,1995,6,male,153,31,31,0,0,0,0,0,0
2191877,18,6,1995,6,male,92,31,20,0,1,0,0,0,1
1963484,18,20,1995,8,male,158,31,19,0,1,0,1,0,0
1920634,20,6,1993,12,male,696,31,17,0,0,0,0,0,0
1720597,19,15,1994,1,male,1134,31,8,0,0,0,0,0,0
1004992,19,1,1994,3,male,213,31,14,0,2,0,2,0,0
1724501,19,5,1994,4,female,654,31,13,0,2,0,2,0,0
1111531,19,28,1994,7,male,193,31,26,0,0,0,0,0,0
1048656,19,19,1994,8,male,373,31,21,0,0,0,0,0,0
1393015,19,20,1994,8,male,157,31,22,0,0,0,0,0,0
2140777,19,27,1994,10,male,87,31,22,0,5,0,2,0,3
1134073,21,23,1992,11,male,318,31,19,0,0,0,0,0,0
1680924,21,9,1992,12,male,351,31,19,0,0,0,0,0,0
1040380,20,1,1993,1,female,28,31,9,0,1,0,1,0,0
2048555,20,11,1993,3,male,44,31,18,0,0,0,0,0,0
1602143,20,10,1993,4,female,90,31,24,0,0,0,0,0,0
1254820,20,7,1993,4,female,91,31,27,0,0,0,0,0,0
1703701,20,12,1993,7,female,222,31,24,0,0,0,0,0,0
2067506,20,10,1993,9,female,955,31,22,0,0,0,0,0,0
1579361,20,5,1993,9,male,200,31,16,0,0,0,0,0,0
1547412,22,20,1991,11,female,350,31,19,0,0,0,0,0,0
1104038,21,24,1992,4,female,403,31,25,0,0,0,0,0,0
1201069,21,11,1992,4,male,185,31,28,0,0,0,0,0,0
1513484,21,22,1992,5,male,387,31,21,0,0,0,0,0,0
1252335,21,8,1992,5,female,49,31,24,0,1,0,1,0,0
1662905,21,11,1992,6,male,492,31,21,0,0,0,0,0,0
1124626,21,3,1992,6,male,369,31,18,0,2,0,1,0,1
1492317,21,9,1992,9,male,959,31,17,0,3,0,3,0,0
2190469,21,1,1992,11,male,438,31,5,0,3,0,3,0,0
1242518,23,8,1990,12,male,999,31,18,0,0,0,0,0,0
1700718,22,19,1991,1,male,212,31,21,0,1,0,0,0,1
1559819,22,7,1991,3,female,97,31,3,0,0,0,0,0,0
1327709,22,13,1991,5,male,395,31,26,0,0,0,0,0,0
2175312,22,3,1991,8,male,616,31,17,0,0,0,0,0,0
1710009,24,23,1989,12,male,415,31,14,0,0,0,0,0,0
1932310,23,26,1990,1,female,420,31,9,0,8,0,0,0,8
1628285,23,21,1990,2,male,644,31,5,0,1,0,0,0,1
1464870,23,20,1990,4,male,229,31,17,0,0,0,0,0,0
2094833,23,24,1990,5,male,161,31,1,0,0,0,0,0,0
2040414,23,18,1990,6,male,474,31,8,0,3,0,3,0,0
1846921,23,4,1990,6,male,100,31,28,0,5,0,3,0,2
1439723,23,8,1990,8,male,360,31,31,0,0,0,0,0,0
1634203,25,4,1988,11,female,273,31,11,0,3,0,0,0,3
1031324,24,22,1989,1,male,50,31,28,0,0,0,0,0,0
2043333,24,1,1989,2,male,165,31,23,0,0,0,0,0,0
1759877,24,26,1989,4,female,193,31,20,0,0,0,0,0,0
2044031,24,2,1989,4,male,132,31,28,0,1,0,1,0,0
1376190,24,25,1989,8,male,760,31,14,0,0,0,0,0,0
1441875,24,17,1989,8,male,306,31,27,0,0,0,0,0,0
2080823,25,28,1988,1,male,404,31,17,0,2,0,2,0,0
1330980,25,15,1988,1,female,214,31,17,0,0,0,0,0,0
1933912,25,1,1988,1,male,106,31,29,0,0,0,0,0,0
2138118,25,11,1988,2,male,207,31,9,0,0,0,0,0,0
1014832,25,21,1988,3,male,134,31,18,0,0,0,0,0,0
1593301,25,17,1988,4,male,257,31,8,0,0,0,0,0,0
1164813,25,13,1988,6,female,362,31,21,0,0,0,0,0,0
2013151,25,4,1988,6,female,51,31,28,0,0,0,0,0,0
1687782,25,5,1988,7,female,871,31,22,0,0,0,0,0,0
1072674,26,2,1987,1,male,33,31,19,0,1,0,0,0,1
1974087,26,17,1987,3,male,658,31,0,0,4,0,4,0,0
2146716,26,1,1987,4,female,270,31,29,0,0,0,0,0,0
1349619,26,1,1987,6,male,258,31,24,0,0,0,0,0,0
1293178,28,22,1985,11,male,183,31,23,0,0,0,0,0,0
1565544,28,24,1985,12,male,232,31,26,0,0,0,0,0,0
1309536,27,7,1986,1,male,261,31,20,0,2,0,0,0,2
1746221,27,1,1986,1,female,719,31,9,0,0,0,0,0,0
2139885,27,1,1986,1,male,314,31,22,0,8,0,6,0,2
1337452,27,26,1986,2,male,385,31,13,0,0,0,0,0,0
1943122,27,15,1986,5,female,203,31,21,0,0,0,0,0,0
1963557,27,27,1986,5,male,41,31,23,0,0,0,0,0,0
1459899,27,13,1986,6,male,513,31,16,0,0,0,0,0,0
2182609,27,5,1986,7,male,1160,31,2,0,0,0,0,0,0
1876057,27,23,1986,10,male,106,31,27,0,0,0,0,0,0
1751905,28,7,1985,2,male,273,31,20,0,3,0,3,0,0
1518958,28,12,1985,4,male,1001,31,16,0,0,0,0,0,0
2179803,28,5,1985,5,male,607,31,17,0,2,0,2,0,0
1746963,28,28,1985,8,male,324,31,11,0,1,0,1,0,0
1793302,29,4,1984,1,male,640,31,26,0,0,0,0,0,0
1436890,29,2,1984,1,male,39,31,28,0,1,0,0,0,1
1658715,29,20,1984,2,male,169,31,20,0,0,0,0,0,0
1356210,29,24,1984,3,male,71,31,15,0,0,0,0,0,0
2102979,29,6,1984,4,female,242,31,15,0,1,0,1,0,0
2156636,29,9,1984,9,male,550,31,10,0,0,0,0,0,0
1238485,29,10,1984,10,male,246,31,27,0,8,0,8,0,0
1888850,31,14,1982,12,female,628,31,9,0,0,0,0,0,0
1598896,30,1,1983,1,male,103,31,13,0,0,0,0,0,0
1435631,30,12,1983,5,female,62,31,22,0,0,0,0,0,0
1046652,30,5,1983,8,male,176,31,14,0,0,0,0,0,0
1478317,32,15,1981,12,male,612,31,18,0,0,0,0,0,0
1277778,31,23,1982,6,male,727,31,7,0,0,0,0,0,0
1478571,31,5,1982,6,male,92,31,25,0,2,0,2,0,0
1030140,31,16,1982,7,female,573,31,4,0,11,0,11,0,0
1339823,33,23,1980,11,female,397,31,20,0,23,0,10,0,13
1146407,33,28,1980,11,female,43,31,13,0,0,0,0,0,0
1205995,32,20,1981,1,male,389,31,14,0,0,0,0,0,0
1594673,34,7,1979,11,male,222,31,22,0,0,0,0,0,0
1120647,34,15,1979,12,male,359,31,28,0,0,0,0,0,0
1786293,33,1,1980,1,male,391,31,31,0,0,0,0,0,0
1200089,33,20,1980,3,male,208,31,31,0,0,0,0,0,0
1196452,33,8,1980,3,male,164,31,20,0,0,0,0,0,0
1902529,33,17,1980,6,female,518,31,16,0,0,0,0,0,0
1390796,35,17,1978,3,male,490,31,22,0,3,0,3,0,0
2113664,35,21,1978,4,male,87,31,23,0,0,0,0,0,0
1877461,37,21,1976,12,male,658,31,20,0,2,0,2,0,0
1956918,36,16,1977,6,male,384,31,15,0,0,0,0,0,0
1508681,36,28,1977,8,female,335,31,11,0,0,0,0,0,0
1464956,36,28,1977,9,male,180,31,25,0,0,0,0,0,0
1749972,38,30,1975,11,male,467,31,16,0,0,0,0,0,0
1537979,37,29,1976,9,female,440,31,25,0,0,0,0,0,0
1465311,37,30,1976,9,female,340,31,16,0,0,0,0,0,0
1582979,38,18,1975,1,male,436,31,24,0,0,0,0,0,0
2135908,38,1,1975,1,male,297,31,30,0,1,0,0,0,1
1563518,38,15,1975,2,male,298,31,30,0,2,0,0,0,2
1140445,38,22,1975,3,male,274,31,6,0,0,0,0,0,0
1565904,38,16,1975,4,male,337,31,15,0,0,0,0,0,0
1368764,38,21,1975,4,male,262,31,24,0,9,0,6,0,3
1438076,38,30,1975,6,male,389,31,14,0,0,0,0,0,0
1757130,38,4,1975,8,male,485,31,24,0,0,0,0,0,0
2067853,40,19,1973,11,male,170,31,28,0,0,0,0,0,0
1973687,39,12,1974,1,male,212,31,26,0,0,0,0,0,0
1230176,39,8,1974,9,male,382,31,3,0,0,0,0,0,0
1829537,41,24,1972,12,male,843,31,11,0,0,0,0,0,0
1587392,41,13,1972,10,female,704,31,18,0,24,0,16,0,8
1263938,43,8,1970,12,male,1243,31,24,0,0,0,0,0,0
1639161,43,1,1970,2,male,1739,31,13,0,0,0,0,0,0
1057003,43,1,1970,3,male,25,31,31,0,2,0,2,0,0
2063849,44,28,1969,10,male,792,31,17,0,0,0,0,0,0
1615380,46,11,1967,1,male,1135,31,13,0,0,0,0,0,0
1961467,47,4,1966,5,male,277,31,28,0,1,0,0,0,1
1636149,47,3,1966,10,female,335,31,23,0,2,0,1,0,1
1586129,49,19,1964,7,male,421,31,19,0,0,0,0,0,0
1469720,50,18,1963,1,male,515,31,8,0,0,0,0,0,0
1645134,50,2,1963,2,male,197,31,22,0,3,0,1,0,2
1184946,50,1,1963,3,male,697,31,21,0,20,0,3,0,17
1229119,51,11,1962,9,male,1922,31,9,0,0,0,0,0,0
1035190,52,9,1961,1,male,871,31,10,0,0,0,0,0,0
1370293,52,12,1961,5,male,368,31,7,0,0,0,0,0,0
1023266,53,5,1960,4,female,1425,31,14,0,1,0,1,0,0
1129008,53,20,1960,6,female,246,31,23,0,7,0,2,0,5
1536368,54,3,1959,2,female,165,31,23,0,0,0,0,0,0
1793875,54,19,1959,8,male,1190,31,11,0,0,0,0,0,0
1385931,54,1,1959,11,female,254,31,18,0,3,0,2,0,1
1994227,55,24,1958,6,female,609,31,24,0,0,0,0,0,0
1223884,59,20,1954,8,female,1342,31,9,0,0,0,0,0,0
1284787,59,14,1954,8,male,421,31,27,0,0,0,0,0,0
1127960,60,28,1953,4,male,354,31,20,0,0,0,0,0,0
1664538,61,12,1952,4,female,345,31,22,0,14,0,5,0,9
1897268,61,27,1952,6,female,535,31,14,0,0,0,0,0,0
1752861,64,6,1949,1,female,258,31,22,0,7,0,2,0,5
1925296,64,11,1949,6,male,1520,31,20,0,0,0,0,0,0
1272583,64,26,1949,7,male,1354,31,14,0,0,0,0,0,0
1006324,64,25,1949,7,female,263,31,14,0,0,0,0,0,0
1909977,66,14,1947,5,male,1064,31,20,0,0,0,0,0,0
1167211,66,13,1947,8,female,1453,31,14,0,0,0,0,0,0
1385181,68,13,1945,9,male,861,31,20,0,0,0,0,0,0
1283652,68,4,1945,9,male,600,31,21,0,5,0,1,0,4
1427497,70,15,1943,8,male,794,31,17,0,10,0,8,0,2
1912054,71,3,1942,9,male,1591,31,14,0,0,0,0,0,0
1396412,72,8,1941,10,male,1296,31,19,0,0,0,0,0,0
2098521,73,22,1940,5,male,1602,31,8,0,0,0,0,0,0
1496916,78,30,1935,10,female,428,31,28,0,0,0,0,0,0
1352621,100,4,1913,9,male,848,31,17,0,3,0,3,0,0
2069168,105,28,1908,11,male,214,31,26,0,0,0,0,0,0
1966199,106,7,1907,7,male,1465,31,28,0,0,0,0,0,0
1427674,108,9,1905,6,male,135,31,28,0,0,0,0,0,0
1956512,18,17,1995,1,male,707,31,28,1,0,0,0,1,0
1009273,23,4,1990,5,female,51,31,26,1,0,0,0,1,0
1494771,24,14,1989,10,male,76,31,31,1,1,0,1,1,0
1068580,33,23,1980,3,female,981,31,17,1,1,0,1,1,0
2130736,58,6,1955,11,female,202,31,17,1,1,0,0,1,1
1662849,56,16,1957,2,male,1007,31,21,1,2,0,0,1,2
1982878,56,29,1957,10,female,404,31,12,1,3,0,1,1,2
1454228,62,6,1951,11,male,1363,31,18,1,19,0,13,1,6
1181834,63,24,1950,8,male,1113,31,12,1,4,0,0,1,4
1880553,64,7,1949,3,male,1084,31,18,1,23,0,21,1,2
1556313,68,11,1945,1,male,1938,31,13,1,11,0,5,1,6
1364857,108,15,1905,6,female,1932,31,13,1,13,0,5,1,8
2180065,15,26,1998,12,female,156,31,26,1,0,1,0,0,0
2052248,14,1,1999,1,female,254,31,18,1,0,1,0,0,0
1580874,14,6,1999,3,male,112,31,22,1,0,1,0,0,0
1059013,15,13,1998,5,male,189,31,20,1,0,1,0,0,0
1406755,16,23,1997,5,female,268,31,5,1,0,1,0,0,0
1261442,16,26,1997,10,male,540,31,21,1,0,1,0,0,0
1576570,17,12,1996,6,male,268,31,25,1,0,1,0,0,0
1056617,18,18,1995,3,male,233,31,21,1,0,1,0,0,0
1653493,19,8,1994,3,male,115,31,22,1,0,1,0,0,0
1710003,23,13,1990,3,male,257,31,29,1,0,1,0,0,0
1315394,24,4,1989,9,female,301,31,25,1,0,1,0,0,0
1234160,25,2,1988,2,male,136,31,26,1,0,1,0,0,0
2096199,25,16,1988,2,female,101,31,24,1,0,1,0,0,0
1455106,26,1,1987,1,male,230,31,15,1,0,1,0,0,0
1381376,26,7,1987,6,male,525,31,18,1,0,1,0,0,0
2048772,27,27,1986,10,female,772,31,15,1,0,1,0,0,0
1618411,29,18,1984,11,female,440,31,6,1,0,1,0,0,0
1010254,29,24,1984,1,male,1567,31,16,1,0,1,0,0,0
1711996,29,29,1984,6,male,297,31,17,1,0,1,0,0,0
1575112,32,5,1981,4,female,487,31,14,1,0,1,0,0,0
1961891,33,10,1980,7,male,326,31,23,1,0,1,0,0,0
1877357,45,1,1968,1,female,675,31,17,1,0,1,0,0,0
1731887,47,10,1966,3,male,234,31,22,1,0,1,0,0,0
1770284,47,15,1966,6,male,610,31,17,1,0,1,0,0,0
2085679,48,14,1965,2,female,203,31,26,1,0,1,0,0,0
1207829,50,17,1963,6,male,290,31,30,1,0,1,0,0,0
1987520,34,26,1979,2,male,44,31,13,1,1,1,1,0,0
1183259,14,13,1999,12,male,23,31,20,1,18,1,9,0,9
1562005,14,29,1999,7,male,142,31,29,1,2,1,2,0,0
2022161,18,1,1995,8,male,21,31,29,1,2,1,2,0,0
1997287,23,23,1990,11,female,542,31,11,1,8,1,5,0,3
1026021,23,14,1990,8,male,490,31,8,1,2,1,2,0,0
1904430,26,1,1987,8,male,323,31,18,1,3,1,3,0,0
2071485,27,10,1986,10,female,281,31,14,1,6,1,6,0,0
1334306,31,17,1982,9,male,687,31,21,1,12,1,9,0,3
1058672,33,26,1980,1,female,154,31,19,1,5,1,4,0,1
2073785,34,29,1979,1,male,339,31,12,1,2,1,1,0,1
1947845,36,26,1977,4,male,115,31,21,1,28,1,22,0,6
1542411,37,28,1976,10,male,146,31,27,1,5,1,5,0,0
1210506,40,1,1973,8,male,240,31,12,1,3,1,2,0,1
1401837,54,4,1959,3,male,306,31,28,1,28,1,19,0,9
1306829,56,26,1957,8,female,262,31,15,1,6,1,4,0,2
1740391,57,30,1956,9,male,738,31,14,1,6,1,6,0,0
1327354,60,22,1953,11,male,96,31,19,1,3,1,3,0,0
1500493,65,13,1948,8,female,57,31,21,1,5,1,1,0,4
2189446,67,16,1946,9,female,678,31,24,1,6,1,4,0,2
2129365,74,14,1939,8,female,905,31,22,1,27,1,13,0,14
1203562,22,23,1991,9,male,196,31,27,2,0,0,0,2,0
1911561,52,20,1961,8,male,432,31,4,2,0,0,0,2,0
1257845,84,14,1929,6,female,996,31,23,2,0,0,0,2,0
1054994,60,17,1953,5,male,304,31,26,2,1,0,0,2,1
1928308,67,28,1946,5,male,554,31,24,2,1,0,0,2,1
1930908,65,1,1948,3,female,22,31,18,2,9,0,5,2,4
1086892,78,20,1935,9,male,896,31,12,2,6,0,3,2,3
1438526,65,30,1948,10,male,1719,31,12,2,1,1,0,1,1
1920057,18,3,1995,4,male,248,31,27,2,6,1,0,1,6
1694380,15,11,1998,9,male,473,31,23,2,0,2,0,0,0
1276276,18,3,1995,9,male,173,31,25,2,0,2,0,0,0
2161361,20,20,1993,5,male,315,31,21,2,0,2,0,0,0
2110474,24,15,1989,6,female,215,31,9,2,0,2,0,0,0
1912877,28,21,1985,3,male,139,31,24,2,0,2,0,0,0
1651243,31,27,1982,11,female,320,31,19,2,0,2,0,0,0
1718236,36,13,1977,5,male,157,31,16,2,0,2,0,0,0
1814786,46,16,1967,5,female,329,31,30,2,0,2,0,0,0
1058221,56,26,1957,4,male,97,31,30,2,0,2,0,0,0
1863112,80,6,1933,1,male,237,31,26,2,0,2,0,0,0
1529574,14,19,1999,3,male,287,31,19,2,1,2,1,0,0
2031855,21,27,1992,8,female,180,31,29,2,1,2,1,0,0
1433374,23,29,1990,1,female,389,31,7,2,1,2,1,0,0
1266354,38,1,1975,1,male,544,31,16,2,1,2,1,0,0
2175417,56,31,1957,8,female,627,31,13,2,1,2,0,0,1
1246152,64,21,1949,8,male,1751,31,9,2,2,2,0,0,2
1280773,17,31,1996,5,male,293,31,18,2,3,2,1,0,2
1495156,20,8,1993,8,male,508,31,19,2,9,2,8,0,1
1863751,21,9,1992,10,male,467,31,21,2,4,2,2,0,2
1122134,21,8,1992,10,male,219,31,22,2,4,2,4,0,0
1347957,30,18,1983,11,male,454,31,6,2,12,2,11,0,1
1612079,29,25,1984,10,male,339,31,13,2,3,2,3,0,0
1017948,47,14,1966,6,male,355,31,29,2,4,2,3,0,1
1714953,48,2,1965,10,male,201,31,11,2,8,2,7,0,1
1228663,49,19,1964,2,female,10,31,27,2,3,2,1,0,2
2043553,21,14,1992,2,male,249,31,23,3,0,0,0,3,0
1261222,44,17,1969,12,male,194,31,30,3,0,0,0,3,0
1750799,50,5,1963,6,male,1268,31,17,3,1,0,0,3,1
2054881,19,31,1994,12,female,171,31,6,3,3,0,3,3,0
1104234,74,28,1939,12,male,1594,31,13,3,3,0,3,3,0
1490202,14,5,1999,2,male,35,31,22,3,7,0,2,3,5
1854922,18,19,1995,4,male,438,31,26,3,5,0,3,3,2
2137899,42,1,1971,4,male,43,31,9,3,7,0,0,3,7
1007850,16,2,1997,4,male,259,31,21,3,0,2,0,1,0
1355675,58,31,1955,7,male,1312,31,15,3,33,1,0,2,33
1472223,18,8,1995,4,male,562,31,30,3,0,3,0,0,0
1297379,19,23,1994,3,male,410,31,31,3,0,3,0,0,0
1944279,23,15,1990,7,female,838,31,26,3,0,3,0,0,0
1877750,33,10,1980,2,male,114,31,28,3,0,3,0,0,0
1888496,42,15,1971,4,male,250,31,20,3,0,3,0,0,0
1657561,63,29,1950,6,male,533,31,13,3,0,3,0,0,0
1170540,20,27,1993,11,female,78,31,27,3,1,3,0,0,1
2015275,26,1,1987,10,male,250,31,25,3,1,3,1,0,0
1168975,65,18,1948,6,female,1397,31,14,3,1,3,1,0,0
2009553,69,30,1944,8,female,1299,31,15,3,1,3,1,0,0
1139578,66,15,1947,12,male,14,31,28,3,3,3,1,0,2
1000682,26,1,1987,1,female,183,31,22,3,18,3,6,0,12
1997202,42,2,1971,1,male,299,31,15,3,10,3,6,0,4
1850989,108,22,1905,12,female,1586,31,17,4,0,0,0,4,0
1983799,17,9,1996,12,male,486,31,12,4,2,0,0,4,2
1126654,80,12,1933,2,male,1705,31,21,4,2,0,0,4,2
1847393,67,4,1946,5,female,762,31,19,4,4,0,1,4,3
1012588,70,14,1943,7,male,1474,31,6,4,4,0,1,4,3
1980544,75,7,1938,9,male,452,31,30,4,6,3,2,1,4
1072550,40,5,1973,12,male,72,31,26,4,0,4,0,0,0
1516821,59,12,1954,1,male,1796,31,19,4,0,4,0,0,0
1213982,19,5,1994,11,male,263,31,11,4,1,4,1,0,0
1149739,19,8,1994,7,male,499,31,25,4,2,4,2,0,0
1797493,26,7,1987,9,female,454,31,15,4,2,4,2,0,0
1330569,29,2,1984,9,male,294,31,19,4,2,4,2,0,0
2041508,22,11,1991,12,male,420,31,27,4,5,4,4,0,1
2107646,23,28,1990,9,male,125,31,27,4,4,4,2,0,2
1483000,45,18,1968,9,female,300,31,27,4,5,4,5,0,0
1805543,56,14,1957,9,female,1066,31,22,4,3,4,3,0,0
1737872,30,8,1983,11,male,146,31,13,4,11,4,4,0,7
1109126,49,25,1964,5,female,249,31,19,4,79,4,48,0,31
1126358,58,30,1955,10,female,75,31,23,4,29,4,18,0,11
1134559,15,9,1998,10,male,434,31,12,5,4,0,2,5,2
1720360,67,20,1946,9,female,91,31,29,5,7,0,0,5,7
1373896,69,8,1944,7,female,450,31,30,5,10,0,0,5,10
2040413,43,16,1970,3,male,999,31,11,5,0,1,0,4,0
1025611,15,4,1998,6,male,402,31,20,5,1,1,1,4,0
1287109,78,20,1935,3,male,2221,31,17,5,1,2,0,3,1
1714782,21,1,1992,2,male,33,31,21,5,22,4,10,1,12
1125782,18,1,1995,2,male,47,31,22,5,0,5,0,0,0
1840809,18,8,1995,5,male,500,31,15,5,0,5,0,0,0
1537173,43,1,1970,1,male,159,31,31,5,0,5,0,0,0
1984143,20,13,1993,2,male,173,31,29,5,1,5,1,0,0
2129502,23,1,1990,2,female,691,31,12,5,1,5,1,0,0
2189858,23,22,1990,3,female,263,31,17,5,3,5,3,0,0
1100383,26,12,1987,6,female,421,31,19,5,3,5,2,0,1
1920923,39,6,1974,8,male,675,31,16,5,5,5,2,0,3
1926441,17,13,1996,10,male,305,31,11,5,11,5,10,0,1
1982463,34,20,1979,3,male,136,31,14,5,13,5,8,0,5
1672888,48,22,1965,3,female,417,31,15,5,9,5,7,0,2
1022113,68,22,1945,1,female,28,31,17,5,9,5,5,0,4
1542614,33,7,1980,3,male,264,31,24,6,0,0,0,6,0
1578004,45,6,1968,12,male,615,31,24,6,2,1,0,5,2
1184367,101,7,1912,7,male,349,31,29,6,3,0,1,6,2
1920048,24,13,1989,4,male,78,31,26,6,11,1,7,5,4
1396176,43,23,1970,12,male,396,31,28,6,10,0,4,6,6
1911218,18,27,1995,7,male,1405,31,22,6,4,5,0,1,4
2015256,36,14,1977,10,female,526,31,24,6,5,5,4,1,1
1756607,23,3,1990,7,male,420,31,24,6,0,6,0,0,0
2084917,54,3,1959,11,male,349,31,21,6,0,6,0,0,0
2016379,58,27,1955,4,male,522,31,31,6,0,6,0,0,0
2161729,71,13,1942,2,male,1486,31,13,6,0,6,0,0,0
1963391,29,11,1984,11,female,607,31,11,6,1,6,1,0,0
1114619,29,25,1984,6,female,320,31,19,6,1,6,1,0,0
1387262,63,8,1950,5,male,1699,31,12,6,1,6,1,0,0
1359363,26,15,1987,10,female,151,31,17,6,39,6,31,0,8
1305769,43,19,1970,6,female,215,31,23,7,14,0,1,7,13
1747328,65,12,1948,2,male,641,31,22,7,11,0,11,7,0
1563424,23,7,1990,11,male,672,31,14,7,5,6,2,1,3
1643401,24,27,1989,8,male,147,31,25,7,6,6,6,1,0
1913968,16,2,1997,4,female,32,31,25,7,0,7,0,0,0
1755832,19,8,1994,2,female,838,31,10,7,0,7,0,0,0
1047825,23,17,1990,8,male,187,31,11,7,1,7,1,0,0
1611398,27,1,1986,1,female,671,31,21,7,0,7,0,0,0
1895203,21,9,1992,8,male,151,31,14,7,5,7,2,0,3
1465103,24,10,1989,11,female,393,31,19,7,17,7,8,0,9
1242235,25,14,1988,2,male,39,31,22,7,15,7,14,0,1
2026454,26,20,1987,1,male,638,31,13,7,30,7,12,0,18
1184776,16,18,1997,10,male,327,31,9,8,4,0,0,8,4
1245954,108,1,1905,1,male,1606,31,20,8,6,0,2,8,4
1046385,70,27,1943,12,female,355,31,22,8,18,0,3,8,15
1732511,108,1,1905,1,female,1757,31,6,8,0,4,0,4,0
1305050,68,5,1945,12,male,1644,31,11,8,36,5,32,3,4
1560659,37,11,1976,2,male,301,31,14,8,1,7,0,1,1
1050023,23,24,1990,12,male,239,31,21,8,15,6,4,2,11
1580311,14,27,1999,8,male,95,31,22,8,1,8,1,0,0
1741745,33,19,1980,10,male,532,31,10,8,0,8,0,0,0
1964211,19,1,1994,12,male,22,31,14,8,2,8,2,0,0
1424309,27,14,1986,3,male,13,31,29,8,3,8,1,0,2
1204985,36,22,1977,8,male,140,31,28,8,4,8,4,0,0
2112277,58,30,1955,7,male,918,31,3,9,1,0,1,9,0
1595955,74,29,1939,8,male,1538,31,13,9,8,0,7,9,1
2146280,23,22,1990,6,male,22,31,11,9,13,2,8,7,5
1138527,25,1,1988,1,male,138,31,26,9,2,8,2,1,0
1796572,26,1,1987,7,male,175,31,25,9,1,9,0,0,1
1333658,30,29,1983,11,male,459,31,20,9,0,9,0,0,0
1776064,39,29,1974,9,male,65,31,21,9,1,9,1,0,0
1590721,23,6,1990,12,male,85,31,22,9,7,9,7,0,0
1383744,25,7,1988,5,female,302,31,21,9,20,9,12,0,8
1599417,35,2,1978,4,male,320,31,28,9,42,9,35,0,7
1143309,52,6,1961,10,female,152,31,25,9,14,9,8,0,6
1328748,58,23,1955,9,female,460,31,13,9,21,9,18,0,3
1074766,47,16,1966,10,male,814,31,8,10,44,0,9,10,35
1289579,25,18,1988,6,female,453,31,26,10,1,7,1,3,0
1901282,18,22,1995,2,male,150,31,15,10,2,6,0,4,2
1999217,18,19,1995,7,male,1049,31,8,10,0,10,0,0,0
1185498,31,17,1982,8,male,22,31,24,10,7,10,5,0,2
1016591,48,19,1965,10,female,592,31,14,10,33,10,19,0,14
1357907,61,16,1952,6,male,531,31,25,11,1,0,0,11,1
1365276,27,28,1986,11,female,365,31,21,11,4,0,0,11,4
1500030,57,15,1956,6,male,1258,31,15,11,7,0,4,11,3
1870676,81,17,1932,11,male,835,31,18,11,5,9,4,2,1
1277813,40,9,1973,1,male,246,31,19,11,1,11,0,0,1
1745004,21,7,1992,7,male,374,31,29,11,4,11,3,0,1
1487837,36,19,1977,4,female,631,31,17,11,5,11,5,0,0
1196235,20,10,1993,6,female,218,31,14,11,51,11,33,0,18
2082509,44,9,1969,3,female,384,31,16,11,35,11,17,0,18
1180338,57,18,1956,11,male,349,31,10,11,25,11,13,0,12
2094347,23,5,1990,4,female,208,31,18,12,3,0,0,12,3
1862674,78,20,1935,4,female,215,31,24,12,98,0,14,12,84
2039520,60,24,1953,12,female,458,31,14,12,20,3,13,9,7
1252910,17,17,1996,4,male,74,31,29,12,3,9,3,3,0
2064020,15,10,1998,10,male,24,31,23,12,5,12,4,0,1
1033329,23,14,1990,6,female,220,31,27,13,0,0,0,13,0
1081418,31,11,1982,8,male,274,31,18,13,30,1,12,12,18
1871998,42,23,1971,10,female,312,31,25,13,1,13,0,0,1
1380350,38,24,1975,1,male,540,31,15,13,3,13,2,0,1
1883393,17,15,1996,1,male,272,31,1,13,13,13,13,0,0
1989242,41,21,1972,6,female,477,31,23,14,31,0,4,14,27
2147840,66,10,1947,4,male,1343,31,18,14,32,0,15,14,17
1669496,51,11,1962,12,male,675,31,10,14,1,3,1,11,0
2067284,27,18,1986,6,male,260,31,14,14,15,4,7,10,8
1682347,63,16,1950,3,female,361,31,23,14,21,13,14,1,7
1289395,63,25,1950,12,female,1390,31,12,14,1,14,1,0,0
1747301,67,30,1946,9,female,449,31,21,14,0,14,0,0,0
1616081,16,19,1997,4,male,197,31,24,14,19,14,3,0,16
1692196,25,1,1988,4,female,182,31,20,14,12,14,12,0,0
1843813,25,16,1988,11,female,354,31,22,14,58,14,56,0,2
2052775,52,31,1961,12,female,74,31,20,14,55,14,26,0,29
1304910,29,12,1984,4,male,264,31,23,15,0,15,0,0,0
1164877,35,1,1978,1,male,123,31,24,15,0,15,0,0,0
1598774,23,7,1990,6,male,121,31,17,15,5,15,4,0,1
1392373,25,24,1988,6,male,180,31,31,15,28,15,22,0,6
2011919,25,12,1988,1,male,444,31,19,16,3,0,2,16,1
1960302,21,13,1992,10,female,286,31,18,16,2,16,2,0,0
1769421,46,12,1967,4,female,411,31,18,16,16,16,14,0,2
1160909,23,15,1990,2,female,60,31,21,16,51,16,50,0,1
2045822,64,18,1949,7,female,984,31,8,17,0,0,0,17,0
1748980,67,15,1946,10,female,112,31,27,17,5,0,3,17,2
1327012,43,22,1970,12,male,232,31,12,17,163,0,37,17,126
1066296,23,2,1990,2,male,304,31,29,17,3,8,2,9,1
1545243,19,7,1994,8,male,653,31,11,17,45,5,17,12,28
1000297,30,8,1983,12,male,217,31,18,17,9,17,9,0,0
1960351,25,6,1988,1,male,34,31,28,17,14,17,12,0,2
1891172,25,16,1988,5,female,16,31,29,17,13,17,12,0,1
1491830,20,21,1993,3,male,716,31,21,18,2,0,1,18,1
2130118,83,15,1930,9,female,370,31,19,18,1,0,0,18,1
1965051,108,19,1905,12,male,125,31,30,18,2,0,1,18,1
1437663,34,4,1979,4,male,523,31,27,18,3,16,1,2,2
1764691,44,17,1969,7,male,573,31,25,18,0,18,0,0,0
1904557,22,22,1991,10,male,135,31,5,18,9,18,9,0,0
1722130,56,28,1957,3,male,702,31,26,18,11,18,8,0,3
1582146,66,6,1947,5,female,1746,31,14,18,25,18,20,0,5
1237697,50,24,1963,9,male,190,31,23,18,32,18,18,0,14
1205660,57,17,1956,6,male,270,31,8,19,4,9,1,10,3
1224768,54,15,1959,1,female,478,31,12,19,2,19,2,0,0
1181491,31,30,1982,6,female,447,31,12,19,5,19,2,0,3
1047690,108,28,1905,3,male,32,31,28,20,32,0,10,20,22
2115760,16,26,1997,4,female,54,31,11,20,0,19,0,1,0
1542005,56,5,1957,9,female,697,31,16,20,7,18,5,2,2
2030655,66,20,1947,8,male,2431,31,13,20,38,15,20,5,18
2190524,20,28,1993,6,male,100,31,22,20,2,20,1,0,1
1309517,22,9,1991,8,female,491,31,13,20,3,20,1,0,2
1126689,68,28,1945,10,female,1290,31,4,20,3,20,3,0,0
1801718,26,22,1987,4,male,125,31,8,20,8,20,7,0,1
1972436,43,22,1970,11,male,1529,31,13,21,1,2,1,19,0
1036910,66,16,1947,10,female,1734,31,14,21,30,0,14,21,16
1945802,54,29,1959,8,female,542,31,22,21,5,19,3,2,2
1778405,43,22,1970,2,male,47,31,25,21,13,20,11,1,2
2048806,33,7,1980,7,male,122,31,21,21,0,21,0,0,0
1848299,37,30,1976,10,male,198,31,22,22,3,22,3,0,0
1094476,48,7,1965,4,male,56,31,26,22,1,22,1,0,0
1155892,53,8,1960,8,female,19,31,28,22,11,22,9,0,2
1477940,49,1,1964,8,male,813,31,23,23,0,0,0,23,0
1078364,44,8,1969,2,male,584,31,11,23,6,16,6,7,0
1390402,28,17,1985,2,female,372,31,14,23,12,23,11,0,1
1600217,50,13,1963,8,male,533,31,6,23,5,23,1,0,4
1459715,53,27,1960,4,male,959,31,15,23,9,23,4,0,5
1351003,25,2,1988,7,female,604,31,19,23,26,23,21,0,5
1885484,32,25,1981,7,male,174,31,21,23,22,23,19,0,3
2068844,26,31,1987,1,male,254,31,20,23,44,23,31,0,13
1609042,28,19,1985,12,female,182,31,19,24,13,24,11,0,2
2017157,65,15,1948,9,female,743,31,13,25,1,0,1,25,0
1192484,56,14,1957,8,female,228,31,17,25,13,0,0,25,13
1399450,26,13,1987,1,male,278,31,23,25,1,25,0,0,1
1403336,34,14,1979,1,female,655,31,18,25,4,25,4,0,0
2109438,40,27,1973,8,male,291,31,25,25,0,25,0,0,0
2087460,31,30,1982,6,female,290,31,23,26,5,0,1,26,4
1862175,73,12,1940,5,male,222,31,24,26,20,0,4,26,16
1965397,59,16,1954,3,male,148,31,28,26,99,0,66,26,33
1367544,18,8,1995,4,male,61,31,23,26,1,8,0,18,1
1444860,17,5,1996,2,female,64,31,21,26,10,26,4,0,6
2181411,25,30,1988,10,female,34,31,25,26,38,26,37,0,1
1988731,30,19,1983,12,male,90,31,19,26,24,26,22,0,2
2187969,61,18,1952,6,female,1293,31,11,27,60,27,13,0,47
1342967,58,16,1955,6,female,1190,31,21,28,3,3,3,25,0
1883367,37,3,1976,9,female,76,31,19,28,12,7,4,21,8
1262169,58,12,1955,6,male,1722,31,7,28,3,28,3,0,0
2053638,47,24,1966,5,female,781,31,13,28,7,28,6,0,1
1855710,60,26,1953,5,NA,1951,31,16,29,24,0,1,29,23
1481190,67,27,1946,12,male,1461,31,18,29,1,29,1,0,0
1417153,71,30,1942,5,female,1105,31,23,30,2,0,1,30,1
1724300,16,1,1997,10,male,401,31,18,31,6,0,1,31,5
1426155,59,24,1954,4,male,101,31,21,31,0,31,0,0,0
1061589,57,11,1956,2,female,164,31,26,32,1,0,0,32,1
1432406,100,10,1913,10,male,1751,31,19,32,26,0,1,32,25
1949851,40,12,1973,1,male,52,31,17,32,3,32,3,0,0
1352155,30,13,1983,10,male,677,31,14,32,25,32,20,0,5
2100045,53,22,1960,11,female,244,31,21,33,10,33,9,0,1
1855343,20,14,1993,7,male,48,31,28,34,13,32,5,2,8
2019003,34,28,1979,7,male,97,31,29,34,0,34,0,0,0
1212537,32,1,1981,9,male,145,31,15,34,9,34,9,0,0
1662385,59,23,1954,8,female,380,31,16,35,19,6,13,29,6
1081907,15,28,1998,4,male,449,31,19,35,10,14,3,21,7
1090482,21,1,1992,1,male,102,31,29,35,2,35,2,0,0
1834621,19,28,1994,3,male,97,31,26,36,14,36,4,0,10
1453362,42,7,1971,1,female,470,31,10,35,17,35,13,0,4
1579520,22,25,1991,6,female,427,31,17,35,24,35,22,0,2
1032744,41,17,1972,8,female,279,31,13,37,5,11,1,26,4
1525461,55,25,1958,1,male,481,31,24,37,5,37,2,0,3
1589571,51,19,1962,6,male,158,31,21,39,50,38,20,1,30
1383926,39,23,1974,6,male,489,31,21,38,18,38,17,0,1
1567562,43,20,1970,10,female,300,31,18,38,48,38,41,0,7
1930998,57,18,1956,5,male,948,31,14,41,16,0,5,41,11
1544028,25,1,1988,1,male,245,31,29,41,3,41,1,0,2
1576422,37,5,1976,12,male,535,31,15,41,0,41,0,0,0
1539156,19,5,1994,11,male,136,31,23,42,9,42,5,0,4
1382664,34,1,1979,1,female,299,31,22,43,33,43,11,0,22
1866216,58,28,1955,12,male,80,31,30,45,43,17,31,28,12
1276857,24,28,1989,6,male,196,31,26,45,4,45,2,0,2
1194359,26,24,1987,9,male,21,31,20,46,79,37,75,9,4
1489492,15,5,1998,8,male,269,31,20,47,2,47,2,0,0
2136660,25,1,1988,1,female,293,31,28,46,38,46,31,0,7
1639632,34,1,1979,1,female,604,31,13,49,31,4,11,45,20
2009958,43,1,1970,11,male,404,31,26,48,70,34,61,14,9
1460003,60,17,1953,10,female,314,31,28,48,0,48,0,0,0
1027406,72,1,1941,7,male,398,31,17,51,18,49,10,2,8
1311699,18,12,1995,1,male,311,31,11,50,0,50,0,0,0
1972383,18,15,1995,1,male,115,31,23,51,3,51,3,0,0
1117993,62,27,1951,3,female,195,31,19,50,3,50,1,0,2
1571083,26,13,1987,2,male,422,31,13,51,16,51,15,0,1
1674002,19,1,1994,1,male,435,31,29,52,1,43,0,9,1
2058505,67,7,1946,7,female,109,31,28,52,3,52,1,0,2
1738449,41,20,1972,3,female,272,31,20,53,27,53,27,0,0
1670154,98,2,1915,12,female,119,31,10,52,16,52,14,0,2
1744953,26,25,1987,6,male,474,31,11,53,34,53,33,0,1
2007688,38,22,1975,11,female,408,31,17,52,63,52,58,0,5
1340902,60,30,1953,11,male,924,31,20,54,11,44,10,10,1
1286857,53,3,1960,9,female,1074,31,11,54,50,47,40,7,10
1262983,39,14,1974,11,male,102,31,16,55,1,55,1,0,0
2073844,67,25,1946,5,female,616,31,17,56,9,35,9,21,0
2037009,58,20,1955,8,male,1705,31,8,56,27,20,24,36,3
1735890,37,15,1976,8,male,721,31,19,56,16,51,11,5,5
1660014,32,30,1981,1,female,258,31,11,58,5,58,0,0,5
1473519,17,1,1996,4,female,218,31,4,57,32,57,20,0,12
1792172,49,29,1964,12,male,1261,31,12,56,10,56,10,0,0
1189519,108,25,1905,8,male,1918,31,14,59,45,10,15,49,30
1153412,50,11,1963,8,female,1460,31,14,60,0,54,0,6,0
1230625,19,5,1994,6,female,139,31,18,59,70,59,52,0,18
1197498,50,17,1963,1,female,605,31,14,63,25,63,20,0,5
1391306,25,19,1988,8,female,254,31,20,62,61,62,51,0,10
1906906,57,19,1956,5,female,17,31,21,61,65,61,58,0,7
1108689,73,22,1940,11,female,1089,31,21,64,9,0,2,64,7
1806184,46,9,1967,1,female,506,31,16,64,37,10,25,54,12
1323085,35,24,1978,11,female,414,31,15,65,77,65,75,0,2
1826089,32,26,1981,1,female,242,31,20,68,110,65,82,3,28
1610873,24,6,1989,1,female,43,31,5,68,27,68,27,0,0
2191821,44,29,1969,12,male,385,31,18,68,39,68,21,0,18
1234001,58,4,1955,4,female,238,31,21,67,18,67,18,0,0
2010226,30,23,1983,1,male,573,31,12,66,87,66,85,0,2
1515905,27,29,1986,5,male,669,31,13,69,18,15,2,54,16
2056810,34,24,1979,9,female,260,31,26,70,7,70,2,0,5
1051054,52,12,1961,10,female,798,31,6,71,27,71,24,0,3
1110385,30,16,1983,10,male,435,31,25,72,2,48,1,24,1
1823218,48,25,1965,11,male,727,31,8,74,35,29,24,45,11
1031614,44,14,1969,6,female,376,31,24,73,46,73,24,0,22
1537491,56,15,1957,2,male,165,31,26,76,0,76,0,0,0
1853913,66,14,1947,8,female,723,31,15,76,34,76,33,0,1
1479810,21,13,1992,6,male,474,31,17,78,32,15,17,63,15
1256523,48,20,1965,10,female,274,31,19,80,9,80,7,0,2
1502609,19,15,1994,3,male,333,31,19,81,1,0,1,81,0
1257216,20,13,1993,4,male,108,31,18,81,8,0,2,81,6
1996642,61,1,1952,6,female,395,31,11,83,2,24,2,59,0
1998060,62,7,1951,4,female,761,31,17,83,15,83,6,0,9
1081511,14,5,1999,1,male,260,31,31,85,7,38,7,47,0
2164816,54,29,1959,6,male,1057,31,13,85,143,59,73,26,70
1947885,32,5,1981,12,female,115,31,9,87,122,87,70,0,52
1452413,37,3,1976,6,female,464,31,25,91,111,64,64,27,47
1610375,40,1,1973,5,female,428,31,19,95,28,95,22,0,6
1087300,46,20,1967,4,female,1238,31,15,93,48,93,47,0,1
1500914,48,2,1965,9,female,453,31,18,97,15,17,2,80,13
1372842,19,28,1994,12,female,455,31,29,98,80,1,33,97,47
1031023,17,1,1996,1,female,46,31,26,97,46,97,42,0,4
1345286,16,18,1997,7,male,230,31,17,101,0,8,0,93,0
1788291,56,27,1957,8,male,489,31,8,101,26,13,19,88,7
1191733,59,28,1954,6,female,304,31,18,101,15,101,13,0,2
1872330,108,5,1905,3,female,251,31,21,109,12,28,4,81,8
1395715,67,7,1946,6,female,112,31,14,108,9,102,8,6,1
1609676,42,17,1971,9,male,261,31,24,109,1,109,0,0,1
2015196,47,3,1966,1,female,274,31,4,107,43,107,26,0,17
1885775,25,4,1988,4,female,534,31,29,115,76,91,34,24,42
1660785,15,2,1998,9,female,48,31,21,123,4,123,4,0,0
2062758,24,30,1989,6,male,217,31,18,129,1,0,0,129,1
2057354,46,8,1967,1,male,50,31,29,125,39,0,28,125,11
1309964,55,10,1958,5,female,306,31,21,128,5,128,3,0,2
1690399,32,21,1981,2,male,247,31,10,133,23,103,4,30,19
1848259,27,1,1986,4,male,316,31,21,134,11,134,8,0,3
1451753,66,5,1947,8,female,258,31,19,132,14,132,13,0,1
1939087,38,1,1975,1,female,285,31,16,135,59,135,59,0,0
1625329,57,26,1956,5,female,1041,31,8,137,41,0,20,137,21
1645888,59,3,1954,12,female,1106,31,22,141,149,135,63,6,86
1200990,48,28,1965,11,male,480,31,11,137,72,137,56,0,16
1351070,51,6,1962,4,female,1050,31,20,145,78,0,15,145,63
1733777,25,21,1988,3,female,288,31,26,150,75,71,34,79,41
2156958,27,19,1986,12,female,102,31,23,147,17,147,14,0,3
1551456,31,14,1982,11,female,736,31,8,157,57,157,43,0,14
2010455,23,1,1990,4,female,298,31,20,163,123,31,30,132,93
1595371,15,23,1998,9,female,243,31,16,160,177,56,99,104,78
1928972,59,15,1954,2,female,621,31,16,160,84,160,34,0,50
1046249,62,12,1951,9,female,356,31,15,177,58,4,15,173,43
2154818,31,21,1982,1,female,351,31,27,180,9,180,9,0,0
1434692,52,28,1961,3,female,786,31,16,180,4,180,3,0,1
2149258,14,8,1999,2,female,146,31,19,176,67,176,49,0,18
1470738,55,29,1958,7,male,622,31,18,190,224,0,62,190,162
1365106,94,28,1919,9,female,36,31,26,185,127,185,126,0,1
1691883,44,1,1969,6,female,83,31,14,192,37,192,31,0,6
1414344,56,18,1957,2,female,1255,31,20,210,19,0,1,210,18
1103656,22,1,1991,1,female,410,31,20,204,12,139,11,65,1
2113787,15,9,1998,8,female,235,31,19,216,359,14,56,202,303
2184245,36,7,1977,10,female,64,31,22,212,14,212,10,0,4
1527276,23,5,1990,8,male,1014,31,13,251,236,152,146,99,90
1919187,75,24,1938,12,male,1861,31,9,266,6,0,3,266,3
1243950,46,3,1967,2,male,141,31,23,274,120,0,68,274,52
1728895,40,27,1973,7,female,382,31,29,299,12,299,8,0,4
1885306,57,21,1956,9,female,162,31,19,297,91,297,82,0,9
1265896,23,20,1990,8,female,1350,31,28,297,206,297,118,0,88
1329296,41,26,1972,3,male,305,31,25,310,78,309,69,1,9
1228721,61,30,1952,3,female,317,31,12,335,35,0,9,335,26
1526780,29,29,1984,12,female,360,31,19,334,214,12,26,322,188
1142010,49,18,1964,12,female,1148,31,18,329,719,76,123,253,596
2162989,45,11,1968,4,male,248,31,11,355,243,310,233,45,10
2036788,17,14,1996,9,female,487,31,15,369,47,369,20,0,27
1076975,68,18,1945,7,female,234,31,11,377,56,377,42,0,14
2052687,19,1,1994,12,male,53,31,14,402,451,385,68,17,383
1075338,17,31,1996,7,female,284,31,29,447,158,444,101,3,57
1877778,35,1,1978,2,female,246,31,18,518,68,518,68,0,0
1327650,28,10,1985,8,male,48,31,24,529,314,529,298,0,16
1469148,50,21,1963,5,male,1048,31,24,568,1,567,1,1,0
1946137,26,20,1987,3,male,439,31,15,621,112,105,82,516,30
1334251,56,1,1957,6,female,1280,31,12,632,539,448,168,184,371
2125724,25,1,1988,1,female,23,31,18,717,75,713,40,4,35
1779546,57,10,1956,3,female,514,31,23,839,18,839,8,0,10
1465606,24,26,1989,12,female,556,31,14,906,74,906,73,0,1
1832007,100,10,1913,12,male,128,31,23,888,30,888,26,0,4
1201072,33,1,1980,1,female,1558,31,11,1043,302,1042,140,1,162
1140449,24,8,1989,7,female,162,31,10,1049,532,1049,480,0,52
1800642,62,25,1951,5,female,340,31,15,1190,160,0,27,1190,133
2106756,39,8,1974,8,female,132,31,15,1215,397,1215,259,0,138
1696857,64,4,1949,7,female,1397,31,12,6834,25,0,4,6834,21
2055167,14,28,1999,11,male,178,33,21,0,1,0,0,0,1
1265511,15,9,1998,12,male,52,32,27,0,1,0,1,0,0
1101947,14,1,1999,1,male,91,32,25,0,0,0,0,0,0
2018824,14,5,1999,3,male,134,33,21,0,0,0,0,0,0
1375576,14,19,1999,5,male,333,32,15,0,0,0,0,0,0
1912589,15,14,1998,3,female,166,33,22,0,0,0,0,0,0
1563011,15,25,1998,7,male,509,32,27,0,1,0,1,0,0
1515716,15,29,1998,8,male,92,33,25,0,0,0,0,0,0
1684370,15,2,1998,9,male,242,32,27,0,1,0,1,0,0
1043044,15,1,1998,10,male,176,33,22,0,0,0,0,0,0
1046707,17,30,1996,11,male,646,33,23,0,1,0,1,0,0
1780577,17,3,1996,11,male,175,32,25,0,0,0,0,0,0
1042098,17,11,1996,11,female,41,32,27,0,7,0,5,0,2
1465274,16,15,1997,1,male,212,33,15,0,1,0,0,0,1
2059803,16,18,1997,3,female,126,33,20,0,5,0,4,0,1
1052059,16,7,1997,7,male,304,33,22,0,0,0,0,0,0
1354535,16,8,1997,8,male,242,32,14,0,3,0,3,0,0
2137441,16,14,1997,9,male,49,33,24,0,0,0,0,0,0
1256591,18,7,1995,11,male,542,32,17,0,5,0,0,0,5
1894807,18,2,1995,12,male,153,32,25,0,0,0,0,0,0
1868909,18,1,1995,12,male,194,32,27,0,0,0,0,0,0
2019988,17,3,1996,1,male,558,33,20,0,0,0,0,0,0
2074160,17,21,1996,3,male,366,32,28,0,0,0,0,0,0
1577017,17,13,1996,3,male,150,33,32,0,0,0,0,0,0
1518215,17,13,1996,7,female,391,33,23,0,1,0,0,0,1
1385649,17,17,1996,7,female,181,32,22,0,5,0,5,0,0
1964723,17,7,1996,9,male,60,33,28,0,0,0,0,0,0
2022510,17,1,1996,9,male,229,33,17,0,0,0,0,0,0
1530427,17,19,1996,10,male,392,33,15,0,0,0,0,0,0
1104306,17,15,1996,10,female,192,32,21,0,0,0,0,0,0
2049819,17,24,1996,10,male,184,32,22,0,0,0,0,0,0
1738948,17,1,1996,10,female,72,32,20,0,0,0,0,0,0
1451366,18,1,1995,1,male,209,33,26,0,0,0,0,0,0
1537228,18,19,1995,2,female,212,32,28,0,0,0,0,0,0
1504291,18,25,1995,3,male,151,32,29,0,0,0,0,0,0
2007060,18,22,1995,5,male,397,33,28,0,0,0,0,0,0
2146470,18,10,1995,6,male,77,33,29,0,0,0,0,0,0
2081212,18,27,1995,7,male,79,32,14,0,4,0,1,0,3
1895671,18,23,1995,9,male,144,32,22,0,0,0,0,0,0
1675185,18,27,1995,9,male,111,32,28,0,6,0,3,0,3
1369773,18,5,1995,9,male,62,32,29,0,5,0,2,0,3
1337301,18,1,1995,9,male,53,32,25,0,1,0,0,0,1
1445776,20,17,1993,11,male,243,32,12,0,0,0,0,0,0
1779483,20,13,1993,11,male,120,32,19,0,0,0,0,0,0
1908025,20,2,1993,12,male,256,33,30,0,0,0,0,0,0
1267622,19,14,1994,2,male,1014,32,29,0,0,0,0,0,0
1711320,19,22,1994,2,male,487,33,14,0,0,0,0,0,0
1776496,19,13,1994,2,female,192,32,18,0,0,0,0,0,0
1202341,19,28,1994,2,male,54,33,32,0,12,0,0,0,12
2146096,19,6,1994,3,male,273,33,28,0,0,0,0,0,0
1704130,19,12,1994,5,male,126,33,32,0,8,0,1,0,7
1866270,19,15,1994,6,male,461,33,28,0,0,0,0,0,0
2060364,19,18,1994,10,male,311,33,24,0,24,0,13,0,11
1401298,21,10,1992,12,male,336,33,20,0,26,0,5,0,21
1335876,20,1,1993,1,male,59,33,25,0,1,0,1,0,0
1817064,20,2,1993,2,male,397,33,11,0,0,0,0,0,0
1136047,20,14,1993,2,female,419,32,26,0,23,0,6,0,17
1257719,20,10,1993,3,male,96,33,11,0,0,0,0,0,0
1878227,20,17,1993,6,male,468,33,21,0,1,0,0,0,1
1659654,20,16,1993,7,male,379,33,24,0,0,0,0,0,0
1896122,20,14,1993,7,male,135,33,24,0,0,0,0,0,0
1519910,22,26,1991,12,male,189,33,14,0,0,0,0,0,0
1030080,21,6,1992,1,male,112,32,22,0,13,0,8,0,5
1161357,21,4,1992,3,male,226,32,27,0,0,0,0,0,0
1608273,21,2,1992,4,female,524,32,30,0,0,0,0,0,0
1898817,21,3,1992,6,female,532,32,23,0,7,0,1,0,6
1346631,21,14,1992,6,male,418,32,28,0,0,0,0,0,0
1972088,21,9,1992,9,male,514,32,26,0,0,0,0,0,0
1065534,21,11,1992,9,male,457,33,22,0,4,0,4,0,0
1808891,21,24,1992,9,male,424,32,0,0,4,0,0,0,4
1132000,21,14,1992,9,male,164,32,14,0,0,0,0,0,0
1297658,21,1,1992,11,female,700,32,16,0,47,0,31,0,16
2137769,22,23,1991,1,female,151,32,24,0,0,0,0,0,0
2151231,22,1,1991,1,male,498,33,32,0,0,0,0,0,0
1612739,22,15,1991,4,male,237,33,23,0,0,0,0,0,0
2178881,22,5,1991,5,male,369,32,3,0,2,0,0,0,2
2190542,22,20,1991,5,female,405,33,24,0,0,0,0,0,0
1383304,22,13,1991,9,male,97,32,26,0,2,0,0,0,2
1009174,22,27,1991,10,male,121,33,19,0,0,0,0,0,0
1518419,24,11,1989,12,male,320,33,12,0,0,0,0,0,0
1574894,24,14,1989,12,male,308,32,17,0,2,0,2,0,0
1158302,23,1,1990,1,male,885,32,16,0,0,0,0,0,0
1820373,23,1,1990,1,male,238,33,27,0,3,0,0,0,3
2170024,23,1,1990,1,male,180,32,9,0,0,0,0,0,0
1603642,23,1,1990,1,male,87,32,29,0,6,0,6,0,0
1226877,23,15,1990,2,male,370,32,21,0,0,0,0,0,0
1095689,23,12,1990,3,male,342,32,10,0,1,0,0,0,1
1201042,23,16,1990,3,male,230,33,13,0,5,0,5,0,0
1334780,23,15,1990,4,male,362,33,26,0,0,0,0,0,0
1862523,23,3,1990,4,male,234,33,17,0,0,0,0,0,0
1199023,23,5,1990,5,female,823,33,26,0,0,0,0,0,0
1093317,23,12,1990,5,male,192,32,15,0,0,0,0,0,0
1461526,23,17,1990,6,female,1048,33,19,0,0,0,0,0,0
1319358,23,21,1990,6,female,227,32,24,0,0,0,0,0,0
2019209,23,12,1990,7,female,166,32,24,0,1,0,1,0,0
1804410,23,27,1990,8,male,421,33,26,0,1,0,1,0,0
1175825,23,29,1990,8,male,386,33,30,0,9,0,6,0,3
1618608,23,2,1990,8,male,356,32,20,0,2,0,1,0,1
1562029,23,21,1990,9,male,457,32,24,0,8,0,6,0,2
1306364,23,10,1990,10,male,1181,32,13,0,0,0,0,0,0
1533383,25,22,1988,11,male,540,33,27,0,8,0,3,0,5
1475369,24,1,1989,1,male,88,32,30,0,0,0,0,0,0
1161632,24,26,1989,2,male,188,32,19,0,0,0,0,0,0
1688963,24,19,1989,3,male,148,32,31,0,0,0,0,0,0
1404499,24,21,1989,5,female,207,32,7,0,0,0,0,0,0
1458165,24,18,1989,7,male,448,32,27,0,0,0,0,0,0
1498898,24,26,1989,8,male,357,33,27,0,0,0,0,0,0
1782876,24,10,1989,10,male,161,32,30,0,1,0,0,0,1
1328840,25,3,1988,1,male,402,33,20,0,1,0,1,0,0
1841491,25,1,1988,1,male,255,33,30,0,0,0,0,0,0
1548105,25,16,1988,5,male,66,33,9,0,0,0,0,0,0
1967057,25,19,1988,8,female,463,32,22,0,0,0,0,0,0
1862898,25,31,1988,8,male,228,32,26,0,0,0,0,0,0
1887661,27,9,1986,11,male,765,33,4,0,0,0,0,0,0
1393189,27,14,1986,12,female,654,33,6,0,1,0,0,0,1
2035833,27,25,1986,12,male,260,32,31,0,3,0,3,0,0
1058942,26,11,1987,1,male,431,33,22,0,1,0,0,0,1
1393531,26,10,1987,1,male,242,33,33,0,0,0,0,0,0
1603774,26,2,1987,1,male,223,32,28,0,0,0,0,0,0
1032498,26,1,1987,1,male,335,32,21,0,2,0,2,0,0
1636408,26,1,1987,1,male,325,32,26,0,0,0,0,0,0
2191094,26,1,1987,1,male,309,32,19,0,3,0,3,0,0
1416286,26,14,1987,4,female,379,33,20,0,2,0,1,0,1
1943052,26,19,1987,4,male,392,32,6,0,0,0,0,0,0
2065146,26,5,1987,6,female,440,32,15,0,0,0,0,0,0
2187358,26,4,1987,6,female,116,32,32,0,8,0,0,0,8
2189199,26,10,1987,7,male,199,32,26,0,0,0,0,0,0
1958683,26,6,1987,8,male,267,32,12,0,0,0,0,0,0
1867721,26,6,1987,9,male,530,33,29,0,0,0,0,0,0
1835212,26,9,1987,10,male,403,33,12,0,0,0,0,0,0
1909610,28,30,1985,11,male,479,32,31,0,0,0,0,0,0
1910513,28,9,1985,12,female,62,33,21,0,13,0,11,0,2
1505096,27,4,1986,1,male,400,32,25,0,0,0,0,0,0
1161636,27,1,1986,1,male,795,33,14,0,8,0,2,0,6
1031007,27,1,1986,1,male,386,33,24,0,1,0,0,0,1
1216757,27,2,1986,2,female,385,33,29,0,0,0,0,0,0
1340201,27,8,1986,5,male,396,33,21,0,1,0,0,0,1
1033632,27,3,1986,6,male,190,33,23,0,0,0,0,0,0
2141363,27,16,1986,9,male,5,32,24,0,9,0,0,0,9
1542991,27,17,1986,10,female,439,33,18,0,0,0,0,0,0
1379773,27,1,1986,10,male,630,32,26,0,0,0,0,0,0
1580936,29,1,1984,12,male,127,32,14,0,1,0,1,0,0
2009289,28,14,1985,2,male,528,33,24,0,0,0,0,0,0
1850712,28,28,1985,4,male,222,33,27,0,0,0,0,0,0
2070395,28,4,1985,4,male,201,33,9,0,2,0,2,0,0
1681674,28,12,1985,5,male,268,33,11,0,3,0,3,0,0
1770497,28,19,1985,6,male,117,32,24,0,0,0,0,0,0
1003040,28,14,1985,7,female,359,32,28,0,0,0,0,0,0
1669093,28,19,1985,7,female,305,32,28,0,2,0,0,0,2
1311578,28,13,1985,8,male,306,32,8,0,0,0,0,0,0
1119481,28,7,1985,8,male,272,33,18,0,0,0,0,0,0
1424430,28,13,1985,9,male,543,33,33,0,0,0,0,0,0
2067576,29,28,1984,2,male,365,32,2,0,2,0,2,0,0
1998379,29,23,1984,2,male,201,33,29,0,0,0,0,0,0
1803974,29,17,1984,3,male,233,33,31,0,2,0,2,0,0
2125190,29,16,1984,4,male,1603,32,13,0,4,0,4,0,0
1411083,29,25,1984,5,male,380,32,11,0,0,0,0,0,0
1739358,29,18,1984,5,male,385,32,24,0,0,0,0,0,0
2015818,29,14,1984,5,female,212,33,18,0,1,0,0,0,1
1442767,29,14,1984,6,female,244,33,23,0,27,0,10,0,17
1440004,29,1,1984,7,male,117,32,15,0,1,0,1,0,0
1207164,29,13,1984,8,male,421,32,13,0,0,0,0,0,0
1708745,29,10,1984,9,male,113,32,32,0,0,0,0,0,0
1363920,31,17,1982,11,male,851,33,17,0,81,0,34,0,47
1808020,31,17,1982,12,male,167,33,24,0,0,0,0,0,0
1378675,30,15,1983,1,male,211,32,20,0,2,0,2,0,0
1071137,30,1,1983,1,male,835,32,20,0,0,0,0,0,0
1287180,30,4,1983,2,male,771,32,20,0,19,0,11,0,8
2046117,30,9,1983,5,male,282,33,32,0,4,0,3,0,1
2081336,30,12,1983,8,male,398,33,15,0,0,0,0,0,0
1229334,30,27,1983,8,female,144,32,15,0,0,0,0,0,0
1872547,30,13,1983,9,male,520,33,14,0,0,0,0,0,0
1183189,32,3,1981,11,male,1316,32,3,0,0,0,0,0,0
2132498,32,3,1981,12,female,206,33,1,0,6,0,2,0,4
1836077,31,20,1982,2,male,264,33,32,0,1,0,0,0,1
1011588,31,29,1982,3,female,363,33,17,0,0,0,0,0,0
1271567,31,11,1982,5,male,217,33,28,0,1,0,1,0,0
1126605,31,7,1982,6,male,334,32,19,0,0,0,0,0,0
1397322,31,6,1982,6,male,235,32,22,0,1,0,1,0,0
1716457,31,25,1982,7,male,368,33,6,0,0,0,0,0,0
1597459,31,14,1982,8,female,174,32,19,0,2,0,2,0,0
1550293,32,20,1981,2,female,287,33,18,0,0,0,0,0,0
1050339,32,26,1981,6,male,758,33,16,0,0,0,0,0,0
1068113,33,1,1980,1,male,661,32,10,0,0,0,0,0,0
1310075,33,17,1980,5,male,237,33,23,0,1,0,0,0,1
1551581,33,22,1980,10,male,466,33,24,0,0,0,0,0,0
1710108,35,13,1978,12,male,297,33,29,0,1,0,1,0,0
1738273,34,6,1979,3,male,366,33,21,0,0,0,0,0,0
2153927,34,9,1979,3,male,168,33,30,0,1,0,1,0,0
1960735,34,10,1979,5,male,332,33,17,0,0,0,0,0,0
1965905,34,26,1979,7,male,1026,32,3,0,3,0,3,0,0
1295303,34,7,1979,9,male,378,32,14,0,4,0,1,0,3
1943505,34,7,1979,9,male,43,32,26,0,0,0,0,0,0
1941461,34,7,1979,10,male,418,33,22,0,0,0,0,0,0
1241038,36,14,1977,11,male,306,33,20,0,2,0,0,0,2
1388050,35,2,1978,2,male,411,32,11,0,0,0,0,0,0
1688565,35,15,1978,6,male,488,33,8,0,0,0,0,0,0
1771268,35,23,1978,7,male,270,32,21,0,0,0,0,0,0
1476292,35,18,1978,9,female,110,32,22,0,1,0,0,0,1
1123445,36,31,1977,1,male,160,32,13,0,0,0,0,0,0
1488272,36,28,1977,4,male,215,32,14,0,3,0,3,0,0
2056905,36,5,1977,5,male,1580,32,13,0,3,0,1,0,2
1353358,36,18,1977,5,male,755,33,20,0,0,0,0,0,0
1186813,36,4,1977,7,male,559,33,12,0,1,0,0,0,1
1670845,36,18,1977,10,male,1134,32,27,0,4,0,4,0,0
1139022,38,19,1975,12,male,341,33,26,0,0,0,0,0,0
1371194,37,15,1976,3,male,732,32,8,0,0,0,0,0,0
1304288,37,3,1976,6,female,433,33,20,0,2,0,1,0,1
1112782,37,27,1976,8,female,1648,32,10,0,0,0,0,0,0
1069071,39,4,1974,11,male,196,32,26,0,0,0,0,0,0
1750744,38,10,1975,2,male,179,33,23,0,0,0,0,0,0
2066930,38,7,1975,8,female,328,33,18,0,6,0,3,0,3
1793172,38,18,1975,9,male,507,33,30,0,0,0,0,0,0
1205037,39,1,1974,1,female,542,33,15,0,0,0,0,0,0
1207354,39,26,1974,9,male,512,32,15,0,21,0,16,0,5
1012000,39,17,1974,10,female,355,32,16,0,0,0,0,0,0
2116236,40,22,1973,2,male,382,32,3,0,0,0,0,0,0
1111051,40,14,1973,8,male,736,33,18,0,1,0,0,0,1
1918083,40,4,1973,9,male,382,32,23,0,0,0,0,0,0
1713337,42,6,1971,12,female,347,33,20,0,6,0,3,0,3
1344931,41,1,1972,1,male,188,33,20,0,0,0,0,0,0
1548169,41,8,1972,2,male,402,33,29,0,0,0,0,0,0
1049473,41,21,1972,10,female,657,32,15,0,2,0,2,0,0
1583609,42,19,1971,1,male,59,33,20,0,9,0,5,0,4
1524326,42,27,1971,2,male,608,32,14,0,0,0,0,0,0
1150088,42,12,1971,9,female,280,32,27,0,4,0,4,0,0
1633427,43,5,1970,1,male,220,32,24,0,4,0,4,0,0
1909069,43,10,1970,2,female,492,32,9,0,0,0,0,0,0
1777122,43,26,1970,5,female,313,33,14,0,0,0,0,0,0
1010362,44,5,1969,1,male,317,33,10,0,4,0,2,0,2
1499994,44,26,1969,4,female,437,33,19,0,2,0,0,0,2
1931512,44,19,1969,5,female,416,33,30,0,0,0,0,0,0
1960662,44,22,1969,7,male,72,32,14,0,0,0,0,0,0
2030464,44,18,1969,10,male,1942,32,9,0,0,0,0,0,0
1415621,45,29,1968,5,male,579,33,20,0,0,0,0,0,0
2078259,46,4,1967,1,male,500,33,29,0,0,0,0,0,0
1984388,46,9,1967,2,female,281,32,17,0,0,0,0,0,0
1719435,46,10,1967,5,male,292,32,22,0,0,0,0,0,0
1055658,47,28,1966,3,male,1109,33,4,0,0,0,0,0,0
1578405,48,18,1965,2,male,543,32,23,0,0,0,0,0,0
1798731,48,15,1965,3,male,233,33,7,0,0,0,0,0,0
2006378,48,1,1965,3,male,798,33,10,0,2,0,2,0,0
2056150,48,19,1965,9,female,353,32,22,0,5,0,3,0,2
1416829,49,26,1964,1,male,1484,33,25,0,0,0,0,0,0
1511261,50,9,1963,9,male,432,33,14,0,15,0,8,0,7
1276992,50,28,1963,10,male,1041,33,23,0,0,0,0,0,0
1101857,51,23,1962,5,male,125,33,24,0,1,0,1,0,0
2119716,52,17,1961,9,female,1486,32,11,0,0,0,0,0,0
1959849,53,30,1960,8,male,523,33,27,0,15,0,0,0,15
1041398,53,2,1960,10,male,807,32,18,0,0,0,0,0,0
2099005,55,30,1958,11,male,740,32,24,0,13,0,0,0,13
2022803,55,7,1958,11,male,551,33,18,0,0,0,0,0,0
1599525,55,8,1958,12,male,265,32,7,0,0,0,0,0,0
1108192,54,10,1959,1,female,313,33,30,0,3,0,3,0,0
1253402,54,31,1959,5,male,278,33,21,0,0,0,0,0,0
1182402,54,3,1959,10,male,472,33,19,0,4,0,2,0,2
1166181,55,9,1958,2,female,284,32,18,0,0,0,0,0,0
1826421,55,2,1958,3,male,668,33,11,0,0,0,0,0,0
1862547,55,29,1958,7,male,415,32,17,0,0,0,0,0,0
2178147,55,11,1958,10,male,245,33,27,0,2,0,2,0,0
1571632,56,20,1957,4,female,294,32,21,0,1,0,0,0,1
1198349,56,11,1957,7,female,318,32,17,0,0,0,0,0,0
2131894,56,28,1957,10,male,507,33,21,0,1,0,1,0,0
1984008,56,4,1957,10,male,237,33,29,0,0,0,0,0,0
1381666,58,1,1955,12,male,105,32,23,0,1,0,1,0,0
2072979,57,4,1956,4,male,93,33,22,0,1,0,1,0,0
1483152,57,30,1956,7,male,499,33,18,0,0,0,0,0,0
1260796,57,14,1956,7,male,494,32,23,0,0,0,0,0,0
2047576,57,23,1956,7,female,355,33,21,0,1,0,1,0,0
1618311,58,1,1955,2,male,1647,32,19,0,1,0,0,0,1
1554695,58,3,1955,3,male,1513,32,6,0,5,0,2,0,3
1398157,58,8,1955,5,female,53,33,32,0,0,0,0,0,0
1151995,58,16,1955,10,female,96,32,29,0,0,0,0,0,0
1158040,60,28,1953,12,male,283,32,30,0,0,0,0,0,0
1241494,59,21,1954,1,male,392,33,18,0,10,0,10,0,0
1943754,59,3,1954,1,male,163,32,24,0,0,0,0,0,0
1175641,59,24,1954,7,male,1027,32,23,0,0,0,0,0,0
2081166,59,12,1954,9,female,502,33,24,0,0,0,0,0,0
1368112,59,5,1954,10,male,1467,32,14,0,0,0,0,0,0
1468909,60,3,1953,5,male,559,32,22,0,0,0,0,0,0
2111247,60,30,1953,6,male,936,32,12,0,0,0,0,0,0
2012023,60,9,1953,7,female,659,32,11,0,1,0,1,0,0
2042321,62,30,1951,11,male,653,33,23,0,0,0,0,0,0
1807078,61,28,1952,2,female,496,33,24,0,0,0,0,0,0
2150011,61,1,1952,2,male,2379,32,3,0,0,0,0,0,0
1961331,62,19,1951,3,male,500,33,10,0,2,0,2,0,0
1557871,62,1,1951,7,male,565,33,16,0,0,0,0,0,0
1722460,64,3,1949,12,male,469,33,8,0,3,0,1,0,2
1959549,63,8,1950,1,male,974,33,11,0,0,0,0,0,0
1811594,63,29,1950,3,male,488,33,26,0,0,0,0,0,0
1468063,63,15,1950,4,female,280,32,29,0,0,0,0,0,0
1370008,63,24,1950,6,male,1225,32,28,0,0,0,0,0,0
1342626,63,28,1950,10,male,1207,32,15,0,0,0,0,0,0
1604306,65,6,1948,12,male,425,32,10,0,0,0,0,0,0
2183787,64,1,1949,2,male,331,33,14,0,0,0,0,0,0
1129722,64,23,1949,5,male,696,32,12,0,10,0,5,0,5
1853315,64,10,1949,6,female,2147,32,15,0,0,0,0,0,0
1679820,64,21,1949,6,male,518,32,10,0,5,0,5,0,0
1666390,65,26,1948,2,female,1166,32,17,0,0,0,0,0,0
1647793,65,2,1948,8,male,549,32,8,0,0,0,0,0,0
1131647,65,22,1948,10,female,292,32,22,0,0,0,0,0,0
1227617,66,17,1947,1,male,727,33,10,0,1,0,0,0,1
2104179,66,11,1947,2,male,285,32,8,0,0,0,0,0,0
2002857,66,14,1947,4,male,117,33,9,0,0,0,0,0,0
1746024,66,14,1947,5,female,1671,33,15,0,1,0,1,0,0
1354826,66,7,1947,5,female,1741,33,22,0,0,0,0,0,0
2075923,67,18,1946,4,male,597,33,18,0,0,0,0,0,0
1203382,67,28,1946,5,male,1885,33,6,0,0,0,0,0,0
1409253,67,12,1946,7,male,660,33,19,0,0,0,0,0,0
1105640,69,22,1944,11,female,871,32,4,0,15,0,4,0,11
1822960,68,1,1945,4,male,510,33,15,0,0,0,0,0,0
1740170,68,15,1945,10,male,1699,33,12,0,1,0,0,0,1
1151155,68,18,1945,10,male,591,33,23,0,0,0,0,0,0
1991845,70,2,1943,11,female,13,32,24,0,0,0,0,0,0
1505139,69,24,1944,7,male,993,33,19,0,5,0,1,0,4
1656976,71,27,1942,12,male,1061,32,19,0,2,0,0,0,2
1856033,70,20,1943,4,female,1301,33,15,0,0,0,0,0,0
1284990,70,2,1943,5,female,409,32,15,0,0,0,0,0,0
1104510,72,13,1941,11,male,1518,32,5,0,0,0,0,0,0
2069719,71,8,1942,7,female,12,32,18,0,0,0,0,0,0
1215999,72,16,1941,3,female,1521,33,8,0,5,0,1,0,4
1549387,72,6,1941,8,female,352,33,28,0,0,0,0,0,0
2172220,73,28,1940,7,male,1934,32,4,0,11,0,1,0,10
1012020,73,24,1940,7,female,133,33,23,0,0,0,0,0,0
1490530,74,16,1939,1,female,2011,32,20,0,0,0,0,0,0
2059462,74,12,1939,1,female,481,33,20,0,0,0,0,0,0
1670914,74,3,1939,5,male,1573,32,12,0,0,0,0,0,0
1620161,75,9,1938,3,male,144,33,24,0,0,0,0,0,0
1365365,77,14,1936,6,female,594,32,18,0,0,0,0,0,0
1797682,77,25,1936,7,male,987,33,15,0,0,0,0,0,0
1696245,77,11,1936,8,female,644,32,23,0,2,0,2,0,0
1712800,78,3,1935,5,male,1095,33,9,0,0,0,0,0,0
1130895,81,26,1932,11,female,343,32,29,0,4,0,4,0,0
1531994,80,3,1933,3,male,1171,33,14,0,0,0,0,0,0
2119271,82,29,1931,6,male,1273,32,8,0,0,0,0,0,0
1250192,83,29,1930,6,male,1194,32,4,0,8,0,2,0,6
2126104,84,15,1929,3,female,48,32,18,0,1,0,1,0,0
2027706,85,5,1928,3,male,1580,32,6,0,0,0,0,0,0
1516875,85,1,1928,9,female,1425,32,9,0,0,0,0,0,0
1566264,86,1,1927,7,female,466,33,25,0,2,0,2,0,0
1080477,90,1,1923,1,male,2,33,32,0,0,0,0,0,0
1093960,91,17,1922,8,female,1911,32,4,0,1,0,0,0,1
1589087,92,21,1921,3,male,1599,32,10,0,1,0,0,0,1
1034082,94,1,1919,10,female,552,33,28,0,0,0,0,0,0
1645290,108,30,1905,1,male,82,33,17,0,6,0,0,0,6
1098211,108,1,1905,1,female,1645,32,19,0,0,0,0,0,0
2015837,108,23,1905,4,female,176,32,21,0,4,0,1,0,3
1108477,13,19,2000,1,male,257,32,23,1,0,0,0,1,0
2027797,14,9,1999,9,male,50,32,22,1,0,0,0,1,0
1714587,16,11,1997,8,female,363,32,17,1,0,0,0,1,0
2046326,17,16,1996,10,male,54,33,31,1,0,0,0,1,0
1979677,19,8,1994,11,male,338,33,8,1,0,0,0,1,0
2099226,24,8,1989,12,female,514,32,8,1,0,0,0,1,0
1936325,25,12,1988,6,male,128,32,32,1,0,0,0,1,0
2085211,33,26,1980,5,male,48,33,30,1,0,0,0,1,0
1203683,55,26,1958,8,male,706,33,27,1,0,0,0,1,0
1019295,57,30,1956,11,male,1577,33,13,1,0,0,0,1,0
1825680,58,13,1955,10,male,534,32,19,1,0,0,0,1,0
2004307,61,28,1952,7,female,102,33,7,1,0,0,0,1,0
2100890,62,4,1951,7,female,776,32,16,1,0,0,0,1,0
1080753,70,20,1943,8,male,970,33,22,1,0,0,0,1,0
1133511,71,3,1942,5,male,698,33,26,1,0,0,0,1,0
1964524,28,17,1985,12,male,774,33,32,1,1,0,1,1,0
1402155,33,17,1980,2,male,291,32,26,1,1,0,1,1,0
1736551,49,13,1964,2,male,197,32,23,1,1,0,0,1,1
1795483,56,9,1957,3,male,137,32,25,1,1,0,0,1,1
1936887,58,1,1955,4,female,668,33,28,1,1,0,0,1,1
1671450,62,5,1951,4,male,1894,32,18,1,1,0,0,1,1
2020168,78,8,1935,8,female,1331,33,18,1,1,0,1,1,0
2128661,82,8,1931,8,female,1201,32,17,1,1,0,1,1,0
1896556,18,28,1995,7,male,224,33,16,1,2,0,1,1,1
1680366,27,9,1986,4,female,468,33,20,1,2,0,0,1,2
1338174,28,19,1985,3,female,942,33,13,1,11,0,5,1,6
1488190,33,26,1980,5,male,1107,32,18,1,4,0,3,1,1
1818231,49,24,1964,11,male,387,33,23,1,2,0,0,1,2
1113615,54,10,1959,3,female,56,33,32,1,7,0,6,1,1
1189347,57,6,1956,7,female,924,32,11,1,26,0,12,1,14
2029863,61,5,1952,1,female,1016,33,16,1,17,0,5,1,12
1842545,67,27,1946,2,male,1195,33,8,1,43,0,3,1,40
2030467,70,26,1943,8,male,1649,32,16,1,3,0,3,1,0
1827837,72,10,1941,12,male,992,33,24,1,42,0,19,1,23
2169907,74,17,1939,9,male,607,32,26,1,3,0,1,1,2
2072191,75,24,1938,1,female,1281,33,15,1,5,0,1,1,4
2099277,75,10,1938,2,female,1014,32,21,1,14,0,13,1,1
1474970,17,10,1996,12,male,47,33,19,1,0,1,0,0,0
1940637,17,29,1996,2,female,291,33,26,1,0,1,0,0,0
1470237,18,21,1995,4,male,429,33,28,1,0,1,0,0,0
1168540,18,2,1995,9,male,502,32,18,1,0,1,0,0,0
1410988,19,1,1994,6,female,152,32,4,1,0,1,0,0,0
1119257,21,3,1992,7,male,372,32,22,1,0,1,0,0,0
2109169,22,23,1991,5,male,69,32,11,1,0,1,0,0,0
1483003,24,1,1989,1,male,233,33,23,1,0,1,0,0,0
1907637,26,25,1987,12,female,437,32,19,1,0,1,0,0,0
1169772,26,27,1987,12,male,386,32,31,1,0,1,0,0,0
1625879,25,8,1988,8,male,43,33,23,1,0,1,0,0,0
1297083,26,14,1987,5,male,202,33,29,1,0,1,0,0,0
1942973,26,4,1987,7,male,53,33,27,1,0,1,0,0,0
1106994,29,24,1984,11,male,272,33,17,1,0,1,0,0,0
1498273,30,9,1983,5,female,426,33,18,1,0,1,0,0,0
1531397,30,19,1983,6,male,168,32,24,1,0,1,0,0,0
2109469,30,4,1983,7,female,216,33,27,1,0,1,0,0,0
1208308,32,28,1981,11,male,462,32,6,1,0,1,0,0,0
1418915,31,19,1982,6,female,741,33,28,1,0,1,0,0,0
1150961,33,14,1980,11,female,651,32,22,1,0,1,0,0,0
1475161,35,27,1978,5,male,64,32,23,1,0,1,0,0,0
1490293,44,3,1969,5,male,1036,32,19,1,0,1,0,0,0
1339340,48,2,1965,12,male,989,33,18,1,0,1,0,0,0
1375787,56,27,1957,11,male,1378,33,18,1,0,1,0,0,0
2010721,60,17,1953,3,male,547,33,32,1,0,1,0,0,0
2074333,61,25,1952,3,female,412,33,5,1,0,1,0,0,0
1026807,65,8,1948,2,NA,2018,32,6,1,0,1,0,0,0
1750115,72,14,1941,1,male,270,32,8,1,0,1,0,0,0
1911533,14,27,1999,9,male,29,32,22,1,1,1,0,0,1
1438408,18,12,1995,1,male,74,32,21,1,1,1,1,0,0
1913541,18,29,1995,10,male,228,32,31,1,1,1,1,0,0
1171090,20,14,1993,6,male,353,32,19,1,1,1,0,0,1
1899962,21,29,1992,1,male,125,33,21,1,1,1,1,0,0
2099956,23,12,1990,3,male,175,33,24,1,1,1,1,0,0
2023083,24,15,1989,8,male,78,33,25,1,1,1,1,0,0
1416892,25,1,1988,1,male,253,32,31,1,1,1,1,0,0
1744001,25,1,1988,1,male,49,33,33,1,1,1,0,0,1
1471784,28,6,1985,11,male,177,33,25,1,1,1,1,0,0
1503510,28,20,1985,4,male,421,33,20,1,1,1,0,0,1
1882901,34,3,1979,9,male,236,32,30,1,1,1,1,0,0
1206837,39,26,1974,12,female,368,32,15,1,1,1,1,0,0
1053493,38,7,1975,2,male,633,33,23,1,1,1,1,0,0
1882626,38,10,1975,5,male,824,33,14,1,1,1,1,0,0
1058858,52,8,1961,10,male,643,32,21,1,1,1,0,0,1
2117304,86,10,1927,7,male,396,32,27,1,1,1,1,0,0
1079439,108,1,1905,1,male,1080,32,25,1,1,1,0,0,1
1153397,16,27,1997,9,male,27,33,24,1,22,1,22,0,0
1404895,17,1,1996,1,male,91,33,30,1,6,1,3,0,3
1082134,17,17,1996,4,female,513,33,28,1,2,1,0,0,2
1025504,18,3,1995,7,female,426,33,27,1,5,1,2,0,3
1102699,20,9,1993,11,male,53,32,18,1,3,1,2,0,1
1489040,19,2,1994,2,male,90,33,19,1,3,1,0,0,3
1946493,21,1,1992,1,male,358,33,15,1,2,1,1,0,1
1706976,23,5,1990,11,female,18,33,30,1,4,1,4,0,0
2099165,23,10,1990,12,male,277,33,14,1,5,1,4,0,1
1222778,22,1,1991,1,male,286,33,13,1,2,1,1,0,1
1162669,25,10,1988,10,male,260,33,20,1,54,1,54,0,0
1240647,25,30,1988,10,male,102,32,9,1,3,1,3,0,0
1753532,27,3,1986,5,male,247,32,19,1,8,1,4,0,4
2168188,28,19,1985,6,male,155,33,11,1,2,1,1,0,1
2186016,29,10,1984,3,female,150,32,23,1,2,1,1,0,1
1653808,29,18,1984,10,male,393,32,10,1,7,1,2,0,5
1373556,30,22,1983,9,male,254,32,28,1,8,1,3,0,5
1796901,32,1,1981,5,male,378,33,8,1,2,1,2,0,0
1186545,37,7,1976,1,male,90,32,28,1,5,1,4,0,1
1144391,42,30,1971,10,male,856,33,9,1,2,1,0,0,2
1642181,43,24,1970,1,female,164,32,26,1,14,1,11,0,3
2100023,44,20,1969,3,male,631,32,19,1,14,1,3,0,11
1114760,45,5,1968,7,male,119,33,14,1,4,1,2,0,2
1106585,47,22,1966,5,male,10,32,30,1,11,1,5,0,6
1823009,51,22,1962,10,female,1225,32,4,1,2,1,1,0,1
1172309,53,17,1960,10,female,491,32,13,1,2,1,2,0,0
1411307,53,29,1960,10,male,172,32,15,1,4,1,2,0,2
1871218,54,2,1959,1,female,456,33,22,1,2,1,2,0,0
1909435,59,15,1954,4,male,466,32,25,1,2,1,2,0,0
1563920,59,3,1954,6,male,344,33,18,1,6,1,6,0,0
1178491,62,6,1951,7,female,795,33,13,1,3,1,0,0,3
1883782,64,7,1949,12,male,251,32,23,1,4,1,4,0,0
1185403,68,7,1945,9,female,41,33,21,1,5,1,4,0,1
2004654,79,6,1934,11,female,410,32,26,1,26,1,25,0,1
1807888,81,30,1932,12,female,631,32,21,1,3,1,3,0,0
1045486,16,26,1997,10,male,221,33,26,2,0,0,0,2,0
1634927,17,15,1996,2,male,430,33,28,2,0,0,0,2,0
1616378,27,17,1986,4,male,166,33,20,2,0,0,0,2,0
2182342,27,11,1986,6,male,281,33,21,2,0,0,0,2,0
1860542,33,10,1980,4,male,259,33,26,2,0,0,0,2,0
1703284,47,10,1966,10,female,380,33,12,2,0,0,0,2,0
2038610,49,10,1964,12,female,599,33,14,2,0,0,0,2,0
1663677,55,10,1958,6,male,407,33,30,2,0,0,0,2,0
1372746,38,25,1975,5,male,189,32,21,2,1,0,0,2,1
1501576,46,7,1967,6,female,1004,33,13,2,1,0,0,2,1
1586204,46,13,1967,9,male,1201,33,24,2,2,0,1,2,1
1057341,75,18,1938,4,male,335,32,16,2,2,0,2,2,0
1629533,17,5,1996,2,male,306,32,21,2,12,0,4,2,8
2096633,29,18,1984,5,male,557,33,23,2,4,0,2,2,2
1364421,49,22,1964,2,female,187,33,24,2,5,0,2,2,3
2023892,54,19,1959,6,female,439,33,10,2,7,0,0,2,7
1252103,64,31,1949,12,male,283,33,32,2,3,0,3,2,0
1048848,73,21,1940,6,female,214,32,31,2,16,0,7,2,9
1510426,78,15,1935,7,female,725,32,12,2,11,0,1,2,10
1359483,31,2,1982,1,male,282,33,22,2,0,1,0,1,0
2146405,47,1,1966,4,male,1160,33,8,2,0,1,0,1,0
1511051,33,1,1980,1,male,1257,33,2,2,1,1,1,1,0
1117742,49,27,1964,8,male,1514,32,24,2,2,1,1,1,1
1743280,27,10,1986,7,male,362,33,31,2,36,1,27,1,9
1342555,43,9,1970,7,female,51,33,27,2,5,1,1,1,4
1490738,50,19,1963,11,female,333,32,20,2,9,1,9,1,0
2097867,14,17,1999,2,male,72,33,28,2,0,2,0,0,0
1393565,15,19,1998,6,female,283,33,11,2,0,2,0,0,0
1722691,16,1,1997,1,male,35,32,30,2,0,2,0,0,0
1957518,17,26,1996,6,male,163,33,27,2,0,2,0,0,0
2047475,19,30,1994,7,male,31,32,14,2,0,2,0,0,0
1662918,31,26,1982,5,male,326,33,22,2,0,2,0,0,0
1611393,32,24,1981,4,female,879,33,15,2,0,2,0,0,0
1057390,44,1,1969,3,female,293,33,19,2,0,2,0,0,0
1121655,58,7,1955,7,male,638,33,12,2,0,2,0,0,0
1179517,62,24,1951,6,female,1288,33,13,2,0,2,0,0,0
1258741,28,9,1985,9,male,63,32,2,2,1,2,1,0,0
1114595,30,12,1983,8,male,233,32,15,2,1,2,0,0,1
2005940,40,16,1973,5,male,422,32,14,2,1,2,1,0,0
2126891,42,8,1971,8,male,236,33,23,2,1,2,1,0,0
1651925,45,21,1968,12,male,44,32,26,2,1,2,0,0,1
1742093,50,12,1963,3,female,373,32,28,2,1,2,0,0,1
1362905,17,1,1996,1,male,434,32,20,2,2,2,2,0,0
1165761,17,13,1996,2,female,169,32,15,2,2,2,2,0,0
1329969,30,12,1983,12,female,380,33,19,2,2,2,1,0,1
1709209,29,28,1984,3,male,28,32,26,2,2,2,0,0,2
2085451,52,15,1961,2,female,615,33,16,2,2,2,2,0,0
1254234,14,13,1999,5,male,100,33,26,2,9,2,8,0,1
1615421,18,29,1995,11,female,348,32,21,2,5,2,2,0,3
2073780,19,14,1994,5,male,615,33,20,2,11,2,3,0,8
1314417,20,21,1993,4,male,295,33,29,2,10,2,8,0,2
1684321,27,2,1986,12,female,468,32,29,2,7,2,4,0,3
1405118,27,1,1986,1,male,32,32,26,2,21,2,6,0,15
1244755,35,14,1978,2,female,397,33,12,2,5,2,5,0,0
1029385,36,28,1977,1,female,631,33,22,2,14,2,6,0,8
2056346,36,1,1977,2,male,167,33,32,2,8,2,7,0,1
2025194,38,1,1975,1,male,248,33,25,2,40,2,8,0,32
1038524,56,23,1957,2,male,402,33,19,2,4,2,3,0,1
1693834,60,27,1953,2,female,241,32,18,2,7,2,6,0,1
1084346,62,1,1951,10,female,391,33,22,2,3,2,2,0,1
1726110,18,15,1995,5,male,510,32,18,3,0,0,0,3,0
1225916,24,25,1989,11,male,594,32,30,3,0,0,0,3,0
1549081,23,10,1990,9,female,402,32,25,3,0,0,0,3,0
1277861,29,9,1984,5,male,262,33,16,3,0,0,0,3,0
1554071,29,4,1984,7,male,449,33,14,3,0,0,0,3,0
1653686,32,9,1981,9,male,142,32,27,3,0,0,0,3,0
1721027,40,18,1973,9,male,1551,32,19,3,0,0,0,3,0
1272617,44,23,1969,1,male,496,32,31,3,0,0,0,3,0
2136020,77,8,1936,5,male,322,33,22,3,0,0,0,3,0
1343736,18,11,1995,11,female,632,32,16,3,2,0,0,3,2
1246515,31,3,1982,8,male,536,33,22,3,2,0,0,3,2
2058813,35,8,1978,10,male,586,32,19,3,4,0,0,3,4
1761454,44,18,1969,9,female,348,32,20,3,4,0,2,3,2
2130776,63,20,1950,3,male,1741,32,11,3,2,0,2,3,0
1510299,88,6,1925,2,male,1359,32,6,3,3,0,1,3,2
1615865,50,5,1963,3,female,646,32,19,3,9,0,4,3,5
1650378,66,13,1947,2,male,419,33,17,3,7,0,0,3,7
1445415,71,11,1942,11,female,675,33,16,3,11,0,7,3,4
1331520,27,28,1986,11,male,1885,32,8,3,0,2,0,1,0
1445224,59,29,1954,5,male,98,33,29,3,0,2,0,1,0
1845264,30,1,1983,1,male,257,32,21,3,2,2,2,1,0
2100275,62,5,1951,2,male,777,32,17,3,2,2,1,1,1
1252823,41,3,1972,11,male,2036,33,10,3,10,2,6,1,4
1222227,54,22,1959,8,male,957,33,26,3,16,1,10,2,6
2006294,71,30,1942,4,male,15,33,27,3,9,1,1,2,8
1163753,14,19,1999,6,male,73,32,26,3,0,3,0,0,0
1527899,18,11,1995,12,male,343,32,20,3,0,3,0,0,0
2129748,27,10,1986,12,male,521,33,23,3,0,3,0,0,0
1244220,26,17,1987,8,female,643,33,13,3,0,3,0,0,0
1759064,30,2,1983,2,male,532,32,29,3,0,3,0,0,0
1056113,32,6,1981,4,male,636,32,16,3,0,3,0,0,0
1394405,38,23,1975,7,male,432,32,28,3,0,3,0,0,0
1085362,44,27,1969,9,male,121,32,26,3,0,3,0,0,0
1290207,52,24,1961,9,female,1466,32,24,3,0,3,0,0,0
1145441,13,5,2000,6,female,41,33,22,3,1,3,0,0,1
1961476,27,7,1986,9,male,79,32,19,3,1,3,1,0,0
1852318,35,10,1978,5,male,48,32,32,3,1,3,1,0,0
1986982,42,6,1971,6,female,118,33,23,3,1,3,1,0,0
1410410,84,30,1929,5,male,851,33,25,3,1,3,1,0,0
1068330,18,27,1995,11,male,561,33,22,3,2,3,1,0,1
1759356,20,17,1993,10,male,233,33,27,3,3,3,3,0,0
1901744,25,1,1988,1,male,59,32,21,3,3,3,3,0,0
1064854,25,2,1988,10,male,46,32,30,3,2,3,2,0,0
1354547,32,21,1981,10,male,426,32,13,3,3,3,3,0,0
1854322,33,18,1980,5,male,560,33,22,3,4,3,2,0,2
1365355,51,30,1962,8,female,94,33,4,3,4,3,3,0,1
1477796,61,29,1952,9,female,1466,32,20,3,3,3,3,0,0
1762255,63,1,1950,1,male,83,33,32,3,3,3,3,0,0
1737367,65,19,1948,1,male,1458,32,21,3,3,3,1,0,2
1630331,13,30,2000,1,male,213,32,15,3,45,3,26,0,19
2007890,15,5,1998,8,female,28,32,19,3,6,3,1,0,5
1930447,17,1,1996,1,male,166,32,22,3,8,3,8,0,0
1057418,17,25,1996,10,male,707,32,19,3,23,3,20,0,3
1196872,18,31,1995,1,male,66,33,29,3,7,3,5,0,2
1538624,18,30,1995,5,female,316,33,27,3,6,3,5,0,1
1421203,21,2,1992,3,male,108,33,14,3,12,3,5,0,7
2104879,22,27,1991,9,female,9,32,32,3,10,3,10,0,0
2074079,23,16,1990,6,male,496,32,21,3,10,3,8,0,2
1381758,27,6,1986,9,female,304,32,17,3,7,3,6,0,1
1054634,28,1,1985,1,male,138,32,24,3,13,3,6,0,7
1351337,28,1,1985,11,male,288,33,22,3,22,3,6,0,16
1136745,33,1,1980,1,male,271,32,18,3,30,3,20,0,10
1663052,33,20,1980,5,male,401,32,17,3,5,3,5,0,0
1085462,37,23,1976,12,male,190,33,17,3,6,3,3,0,3
1882130,38,14,1975,6,male,513,33,16,3,11,3,7,0,4
1699826,56,2,1957,3,male,1318,32,16,3,27,3,26,0,1
1896359,57,22,1956,1,female,146,32,13,3,6,3,6,0,0
1998079,59,22,1954,8,female,1123,32,16,3,5,3,5,0,0
2077168,69,6,1944,12,male,2082,33,9,3,8,3,3,0,5
2046764,108,25,1905,12,female,454,33,11,3,7,3,2,0,5
1924674,19,15,1994,8,female,483,33,31,4,0,0,0,4,0
1237433,21,31,1992,1,female,745,33,20,4,0,0,0,4,0
1466155,54,22,1959,7,female,541,33,16,4,2,0,2,4,0
1048803,23,11,1990,10,male,330,32,11,4,5,0,3,4,2
1179685,26,1,1987,4,male,299,32,18,4,3,0,0,4,3
1044326,51,4,1962,7,male,754,32,13,4,3,0,2,4,1
1388473,17,26,1996,9,male,51,32,24,4,49,0,2,4,47
1572136,21,10,1992,7,male,109,33,20,4,7,0,4,4,3
2016763,89,29,1924,2,female,818,32,15,4,27,0,16,4,11
1616116,27,27,1986,5,female,420,32,18,4,0,1,0,3,0
1897696,53,9,1960,3,male,1506,32,11,4,2,3,2,1,0
1818647,18,7,1995,7,female,426,33,18,4,0,4,0,0,0
1166066,18,24,1995,7,male,101,32,12,4,0,4,0,0,0
1849121,27,22,1986,5,male,48,32,6,4,0,4,0,0,0
1388465,29,13,1984,11,male,58,32,28,4,0,4,0,0,0
1761890,40,24,1973,6,female,568,33,14,4,0,4,0,0,0
1890493,62,11,1951,8,male,1561,33,15,4,0,4,0,0,0
1648182,18,17,1995,11,male,70,32,26,4,1,4,1,0,0
2129384,50,5,1963,7,male,245,32,24,4,2,4,2,0,0
2124565,20,12,1993,10,male,556,32,16,4,5,4,5,0,0
1794720,34,19,1979,7,male,101,32,22,4,4,4,4,0,0
1515201,36,1,1977,3,male,629,32,12,4,3,4,1,0,2
1953978,42,13,1971,2,male,602,33,30,4,5,4,5,0,0
2010998,51,31,1962,12,male,612,33,20,4,3,4,3,0,0
2011348,68,8,1945,10,male,328,33,27,4,5,4,3,0,2
1889541,23,22,1990,8,male,124,33,30,4,8,4,4,0,4
1144187,33,22,1980,6,male,375,32,6,4,109,4,89,0,20
1722854,39,28,1974,1,female,355,32,28,4,16,4,16,0,0
1099049,108,7,1905,6,male,47,33,28,4,8,4,7,0,1
1622670,21,17,1992,1,male,332,33,27,5,0,0,0,5,0
1037541,27,6,1986,10,male,356,32,19,5,1,0,0,5,1
1623115,43,22,1970,5,male,880,32,16,5,1,0,0,5,1
1658578,52,4,1961,1,male,37,32,16,5,3,0,1,5,2
1281736,57,16,1956,5,female,593,33,16,5,3,0,2,5,1
1899526,62,9,1951,6,male,144,32,21,5,3,0,1,5,2
2191945,34,22,1979,8,male,602,33,15,5,5,0,2,5,3
1026766,48,4,1965,12,female,354,33,19,5,7,0,3,5,4
1544363,21,14,1992,11,male,170,32,28,5,12,0,8,5,4
2030442,22,27,1991,10,male,491,33,18,5,8,0,2,5,6
1550314,45,1,1968,10,female,500,32,16,5,19,0,5,5,14
1301600,93,28,1920,1,NA,1322,33,19,5,19,0,6,5,13
1784455,22,28,1991,7,male,641,32,21,5,0,3,0,2,0
1668557,59,5,1954,1,male,2132,33,26,5,0,2,0,3,0
1182085,23,21,1990,7,female,139,33,23,5,41,4,41,1,0
1158705,19,10,1994,11,male,207,32,16,5,0,5,0,0,0
1546631,19,13,1994,7,male,377,32,24,5,0,5,0,0,0
1234506,20,7,1993,7,male,116,32,15,5,0,5,0,0,0
1676422,22,17,1991,4,female,369,32,30,5,0,5,0,0,0
1706925,38,19,1975,4,male,404,32,11,5,0,5,0,0,0
1667531,44,3,1969,3,female,136,33,15,5,0,5,0,0,0
1663885,64,30,1949,12,female,132,33,26,5,0,5,0,0,0
1099075,75,12,1938,4,female,312,32,14,5,0,5,0,0,0
1055379,69,4,1944,12,male,1403,33,17,5,2,5,2,0,0
1327351,20,12,1993,6,male,118,33,29,5,7,5,6,0,1
2125337,60,6,1953,4,male,1613,33,11,5,4,5,4,0,0
1087559,19,6,1994,3,female,430,33,10,5,8,5,3,0,5
2093378,24,13,1989,4,male,183,32,22,5,22,5,19,0,3
1050795,31,2,1982,1,male,64,33,20,5,16,5,15,0,1
1505603,31,24,1982,2,male,602,33,21,5,11,5,10,0,1
1207690,34,11,1979,12,male,590,33,8,5,11,5,8,0,3
2095130,35,18,1978,5,male,169,32,26,5,8,5,6,0,2
1110079,76,11,1937,12,female,139,33,24,5,14,5,14,0,0
1788564,18,18,1995,6,male,84,33,19,6,0,0,0,6,0
1101553,27,4,1986,6,male,667,33,3,6,0,0,0,6,0
1472122,31,6,1982,8,female,302,32,23,6,0,0,0,6,0
1049096,44,5,1969,7,male,402,33,29,6,1,0,1,6,0
1436112,75,18,1938,7,female,393,32,24,6,1,0,0,6,1
1869053,85,29,1928,8,female,997,32,26,6,2,0,2,6,0
1164828,24,19,1989,4,male,637,33,16,6,5,0,2,6,3
1710264,54,4,1959,1,female,38,33,22,6,8,0,5,6,3
1512546,63,12,1950,4,female,35,32,23,6,5,0,0,6,5
2088392,58,24,1955,3,female,114,32,20,6,25,0,14,6,11
1948874,64,19,1949,7,male,331,32,21,6,16,0,4,6,12
1576979,79,20,1934,4,male,849,32,14,6,54,0,17,6,37
1511728,84,23,1929,8,male,1462,33,14,6,24,5,12,1,12
1691129,15,13,1998,3,male,38,32,22,6,0,6,0,0,0
1880443,17,17,1996,9,male,317,32,3,6,0,6,0,0,0
1187319,21,1,1992,1,female,148,33,14,6,0,6,0,0,0
1151060,46,3,1967,8,male,501,33,27,6,0,6,0,0,0
1952097,67,28,1946,10,female,628,33,22,6,0,6,0,0,0
1889624,41,23,1972,7,male,407,32,24,6,1,6,1,0,0
1164074,42,20,1971,3,female,616,32,19,6,1,6,1,0,0
1637208,47,11,1966,6,female,773,32,19,6,1,6,0,0,1
1239385,65,15,1948,11,male,43,33,15,6,2,6,1,0,1
1232662,19,14,1994,1,male,17,33,3,6,6,6,4,0,2
2049220,19,4,1994,4,male,199,33,26,6,5,6,5,0,0
1532347,24,7,1989,3,male,136,33,32,6,5,6,5,0,0
1491758,35,6,1978,10,male,896,33,26,6,8,6,6,0,2
2141556,70,31,1943,10,female,1636,33,13,6,4,6,2,0,2
1748426,75,13,1938,3,male,356,32,11,6,5,6,5,0,0
1803147,19,20,1994,12,male,372,33,19,6,22,6,12,0,10
1595783,22,9,1991,2,female,561,33,22,6,19,6,19,0,0
1691875,25,31,1988,12,male,377,32,11,6,11,6,9,0,2
1040858,29,25,1984,2,male,105,33,27,6,45,6,34,0,11
2186915,30,30,1983,1,male,89,32,24,6,18,6,8,0,10
1058110,23,30,1990,1,male,229,33,25,7,1,0,1,7,0
1941742,27,10,1986,7,male,147,33,29,7,1,0,0,7,1
2028582,37,15,1976,5,male,571,33,20,7,1,0,0,7,1
2089112,108,21,1905,4,male,241,32,20,7,0,0,0,7,0
1109543,15,12,1998,9,male,530,32,24,7,2,0,0,7,2
2192769,34,20,1979,9,male,522,32,23,7,2,0,0,7,2
2023763,41,14,1972,7,female,657,32,16,7,2,0,1,7,1
1383438,58,2,1955,11,female,220,32,28,7,2,0,2,7,0
1462166,30,1,1983,5,female,417,32,18,7,11,0,7,7,4
1080627,56,8,1957,1,female,412,32,26,7,11,0,10,7,1
1248685,67,23,1946,3,female,1691,32,14,7,46,1,32,6,14
2052092,20,26,1993,6,female,299,33,24,7,0,5,0,2,0
1241492,33,23,1980,5,male,102,32,18,7,3,3,3,4,0
1684055,43,20,1970,4,female,227,33,16,7,2,4,0,3,2
1058300,44,22,1969,9,male,526,33,17,7,1,7,1,0,0
1209209,14,10,1999,7,male,474,32,21,7,3,7,1,0,2
1021075,22,11,1991,11,male,138,33,18,7,3,7,3,0,0
1425145,65,29,1948,2,female,1568,33,9,7,4,7,4,0,0
2040102,108,28,1905,8,female,70,33,21,7,4,7,3,0,1
1336610,21,11,1992,11,male,46,32,10,7,6,7,5,0,1
1456882,23,15,1990,4,male,305,33,29,7,5,7,5,0,0
1125785,29,10,1984,4,male,231,32,24,7,5,7,5,0,0
1109841,44,5,1969,10,male,1395,32,20,7,10,7,9,0,1
1125419,20,13,1993,9,male,228,32,13,7,17,7,7,0,10
1860661,23,10,1990,9,male,417,32,28,7,42,7,39,0,3
1358692,31,6,1982,4,female,246,32,15,7,47,7,38,0,9
1099133,41,7,1972,9,male,464,33,4,7,22,7,13,0,9
1107305,43,11,1970,5,male,216,32,19,7,16,7,16,0,0
1698751,22,18,1991,7,male,468,32,19,8,1,0,1,8,0
1375366,28,14,1985,5,male,298,32,24,8,1,0,0,8,1
2043713,31,2,1982,3,male,136,32,31,8,0,0,0,8,0
1331717,54,1,1959,10,male,157,32,21,8,0,0,0,8,0
1103110,63,28,1950,7,male,340,32,17,8,0,0,0,8,0
1116725,73,22,1940,5,male,351,33,19,8,1,0,0,8,1
1892074,15,10,1998,11,male,176,33,26,8,4,0,0,8,4
1615517,58,23,1955,7,male,242,32,28,8,3,0,1,8,2
1873077,72,4,1941,12,female,320,33,11,8,7,0,0,8,7
1117758,56,25,1957,10,female,928,33,18,8,19,0,8,8,11
1210206,66,1,1947,2,male,1230,33,11,8,20,1,10,7,10
1247072,18,10,1995,2,male,70,32,29,8,8,5,5,3,3
1950081,17,30,1996,5,male,303,32,17,8,1,8,1,0,0
2158631,18,12,1995,6,male,64,33,14,8,1,8,1,0,0
1988477,24,1,1989,8,male,177,33,28,8,0,8,0,0,0
1224890,26,6,1987,9,male,459,32,19,8,1,8,0,0,1
1828590,32,4,1981,2,male,902,33,13,8,0,8,0,0,0
1213136,41,24,1972,8,male,320,32,13,8,0,8,0,0,0
1419438,52,21,1961,6,male,403,33,27,8,0,8,0,0,0
1017390,16,1,1997,1,male,57,32,20,8,3,8,3,0,0
1909747,21,19,1992,3,male,172,33,26,8,4,8,0,0,4
2147268,28,7,1985,9,female,32,32,1,8,3,8,3,0,0
1735186,47,29,1966,5,female,895,33,15,8,3,8,0,0,3
2165636,48,14,1965,9,female,660,33,3,8,2,8,1,0,1
1234354,55,29,1958,12,female,1337,33,12,8,3,8,3,0,0
1237235,58,29,1955,6,female,886,33,23,8,2,8,2,0,0
1965815,27,10,1986,4,female,148,32,20,8,6,8,4,0,2
1428206,108,13,1905,4,male,1003,32,24,8,6,8,6,0,0
1776197,46,5,1967,9,female,342,32,10,8,16,8,12,0,4
1438263,48,21,1965,11,female,1284,32,19,8,12,8,10,0,2
1368628,48,21,1965,10,male,26,32,28,8,14,8,8,0,6
1215550,18,28,1995,12,male,62,33,30,9,0,0,0,9,0
1189493,33,1,1980,1,male,742,32,26,9,0,0,0,9,0
2016299,56,8,1957,10,female,526,32,25,9,0,0,0,9,0
1432324,61,30,1952,12,male,1325,32,14,9,1,0,0,9,1
1576925,72,29,1941,6,female,1742,32,18,9,0,0,0,9,0
1944375,69,18,1944,4,female,275,32,22,9,5,0,4,9,1
1123184,74,3,1939,8,male,1573,32,20,9,3,0,2,9,1
1366420,22,4,1991,5,male,305,32,16,9,8,0,4,9,4
1018397,62,2,1951,9,female,437,33,16,9,6,0,3,9,3
2170637,66,30,1947,11,female,220,33,18,9,38,1,18,8,20
1033689,113,12,1900,5,female,1282,32,15,9,16,0,8,9,8
1407925,36,20,1977,2,male,320,32,10,9,5,6,2,3,3
1869829,52,18,1961,6,male,2159,32,16,9,6,8,5,1,1
2067701,67,21,1946,10,female,789,33,22,9,16,7,10,2,6
1428266,23,27,1990,9,female,188,33,19,9,0,9,0,0,0
1108982,46,17,1967,4,male,287,32,29,9,1,9,0,0,1
1638916,54,1,1959,1,female,838,33,25,9,1,9,1,0,0
2031967,16,6,1997,11,female,180,32,29,9,3,9,3,0,0
2141786,29,21,1984,6,male,491,32,24,9,2,9,1,0,1
1794326,31,17,1982,9,male,121,32,22,9,2,9,2,0,0
1191458,18,24,1995,7,male,136,32,19,9,6,9,6,0,0
1404065,20,24,1993,7,female,6,32,30,9,13,9,8,0,5
2102404,20,3,1993,9,female,848,32,24,9,10,9,10,0,0
1992055,21,26,1992,4,male,20,32,27,9,13,9,2,0,11
1180806,43,13,1970,3,male,33,33,19,9,9,9,0,0,9
1077935,46,10,1967,3,male,682,32,12,9,9,9,9,0,0
1388800,23,13,1990,3,male,370,32,28,10,6,0,4,10,2
1136858,52,13,1961,4,female,285,32,18,10,12,0,10,10,2
1866071,23,7,1990,8,female,437,33,5,10,0,7,0,3,0
1480163,33,9,1980,2,female,262,33,30,10,0,3,0,7,0
2167663,68,23,1945,5,female,144,33,23,10,2,6,1,4,1
1033412,33,19,1980,3,female,593,32,6,10,9,5,6,5,3
1536747,22,2,1991,4,male,244,33,16,10,3,9,2,1,1
1725768,15,12,1998,2,male,221,33,15,10,0,10,0,0,0
2065107,21,27,1992,4,male,384,33,21,10,0,10,0,0,0
1342584,22,24,1991,8,male,437,33,31,10,0,10,0,0,0
1603764,24,15,1989,2,male,28,33,14,10,0,10,0,0,0
2162398,43,5,1970,6,female,438,33,32,10,1,10,1,0,0
1749901,41,5,1972,11,male,70,32,28,10,9,10,6,0,3
1458054,38,14,1975,7,female,185,32,18,10,50,10,35,0,15
2155558,15,24,1998,12,female,242,32,29,11,3,2,1,9,2
2032245,66,2,1947,4,female,731,33,20,11,2,1,0,10,2
2066150,46,5,1967,8,male,74,33,28,11,16,0,1,11,15
1464330,56,27,1957,6,male,374,32,24,11,16,0,8,11,8
1408857,41,3,1972,4,female,154,33,20,11,36,10,15,1,21
1115603,19,15,1994,5,male,324,33,22,11,1,11,1,0,0
2044446,37,8,1976,6,male,354,33,29,11,0,11,0,0,0
1645491,66,6,1947,5,male,46,33,17,11,0,11,0,0,0
2083828,21,4,1992,5,female,633,32,11,11,3,11,2,0,1
1182024,25,21,1988,8,male,336,33,14,11,6,11,6,0,0
1847450,26,3,1987,6,male,77,33,32,11,2,11,2,0,0
1858469,43,3,1970,6,male,166,32,23,11,5,11,4,0,1
1900456,51,8,1962,2,male,992,32,14,11,6,11,5,0,1
2072485,27,12,1986,5,male,342,32,21,11,8,11,5,0,3
1546991,44,9,1969,10,female,151,32,30,11,14,11,3,0,11
1063658,17,11,1996,2,male,101,33,23,11,32,11,14,0,18
1296069,23,17,1990,6,female,226,33,16,11,19,11,19,0,0
1148815,25,20,1988,7,female,1305,32,16,11,46,11,42,0,4
1559528,57,2,1956,3,female,384,32,19,12,7,0,2,12,5
1458377,17,18,1996,7,male,407,32,29,12,14,1,1,11,13
1853406,68,5,1945,8,male,121,32,27,12,9,1,3,11,6
2038824,103,21,1910,8,male,1201,33,26,12,0,8,0,4,0
1502271,39,2,1974,10,female,665,32,18,12,8,11,7,1,1
2117958,19,19,1994,1,male,16,32,32,12,0,12,0,0,0
2050681,32,20,1981,3,male,665,33,13,12,0,12,0,0,0
1149275,45,17,1968,11,female,292,32,20,12,1,12,1,0,0
2001397,56,12,1957,11,female,384,32,13,12,1,12,0,0,1
1203878,20,13,1993,2,female,112,33,16,12,4,12,4,0,0
2021652,30,2,1983,2,male,329,32,23,12,2,12,2,0,0
1834127,34,4,1979,4,male,218,32,29,12,4,12,4,0,0
1975081,37,20,1976,8,male,286,32,23,12,4,12,1,0,3
1691566,44,16,1969,6,female,573,32,22,12,5,12,5,0,0
2122730,21,14,1992,4,male,23,33,24,12,16,12,16,0,0
1692539,49,5,1964,5,female,894,32,25,12,8,12,3,0,5
1367803,51,28,1962,6,female,566,33,9,12,11,12,3,0,8
1521890,55,24,1958,12,female,406,32,10,12,31,12,24,0,7
1380453,71,4,1942,3,female,871,33,8,13,13,0,13,13,0
1894065,14,15,1999,6,male,399,32,19,13,8,3,3,10,5
1375314,36,18,1977,4,female,269,32,19,13,20,9,12,4,8
1200051,23,12,1990,12,male,305,33,25,13,0,13,0,0,0
2047939,29,13,1984,8,female,523,32,25,13,0,13,0,0,0
1549257,47,7,1966,1,male,343,33,30,13,1,13,0,0,1
1186255,50,7,1963,4,female,610,32,21,13,0,13,0,0,0
2175680,60,18,1953,8,female,320,32,25,13,2,13,2,0,0
2042554,22,14,1991,8,male,512,33,16,13,3,13,2,0,1
1413611,27,9,1986,11,male,136,32,28,13,3,13,1,0,2
1215263,28,15,1985,4,female,280,32,30,13,4,13,4,0,0
1507692,33,12,1980,1,male,108,33,29,13,5,13,5,0,0
1759010,51,1,1962,3,female,1220,32,10,13,7,13,7,0,0
1377018,67,21,1946,6,female,952,33,24,13,4,13,4,0,0
1768179,25,8,1988,10,male,22,33,23,13,12,13,8,0,4
2093724,28,1,1985,1,male,452,33,25,13,16,13,12,0,4
1103977,52,4,1961,5,female,1447,32,9,13,10,13,10,0,0
1512334,68,15,1945,9,male,1062,32,14,13,29,13,22,0,7
1451807,14,10,1999,11,male,62,33,10,14,1,0,1,14,0
1189936,47,28,1966,2,male,325,33,13,14,0,0,0,14,0
1107344,18,17,1995,4,male,321,32,25,14,5,0,0,14,5
1806206,75,29,1938,12,male,461,32,14,14,6,0,5,14,1
1643293,74,10,1939,5,female,1094,32,16,14,3,0,1,14,2
1996337,23,15,1990,7,female,510,32,11,14,15,0,3,14,12
1495726,39,22,1974,10,male,396,32,26,14,13,0,3,14,10
1029378,84,11,1929,11,female,611,33,21,14,9,0,2,14,7
1426218,18,14,1995,12,male,326,32,27,14,0,9,0,5,0
1138217,44,25,1969,6,female,688,32,13,14,1,10,0,4,1
2176145,25,21,1988,5,male,709,33,23,14,1,14,0,0,1
2157777,25,1,1988,1,male,165,32,27,14,3,14,3,0,0
2047013,33,15,1980,7,male,50,33,21,14,5,14,5,0,0
2002417,48,29,1965,1,female,503,33,27,14,5,14,2,0,3
1038572,21,29,1992,5,female,585,33,13,14,17,14,16,0,1
1060069,30,22,1983,7,male,183,33,30,14,10,14,9,0,1
1817821,53,7,1960,10,male,362,33,14,14,17,14,15,0,2
2084521,22,24,1991,12,female,268,33,31,14,42,14,14,0,28
1217119,39,22,1974,8,female,242,32,18,14,27,14,9,0,18
2025636,44,10,1969,11,female,259,33,26,14,57,14,38,0,19
1356380,68,16,1945,2,male,14,33,27,15,1,0,0,15,1
1841187,18,22,1995,4,male,1003,32,20,15,6,0,3,15,3
1256355,59,16,1954,2,female,99,32,14,15,4,0,1,15,3
1343269,56,28,1957,4,female,814,33,25,15,9,10,8,5,1
1578432,43,4,1970,1,female,194,33,19,15,50,10,35,5,15
1370980,64,30,1949,4,NA,2213,32,17,15,26,9,18,6,8
1079375,26,1,1987,1,female,345,33,21,15,2,15,2,0,0
1481712,43,12,1970,12,female,50,32,24,15,0,15,0,0,0
1341421,25,1,1988,1,male,22,33,31,15,8,15,6,0,2
1120627,26,1,1987,1,male,267,33,29,15,3,15,3,0,0
1272921,29,28,1984,5,male,437,32,25,15,11,15,9,0,2
1456309,36,8,1977,1,female,809,33,13,15,17,15,14,0,3
2021640,55,15,1958,11,male,249,32,20,15,17,15,13,0,4
1993448,13,7,2000,5,male,95,33,25,16,1,1,0,15,1
1096170,52,18,1961,1,male,211,32,23,16,0,0,0,16,0
2185864,69,5,1944,8,male,188,32,16,16,3,0,1,16,2
1851787,43,15,1970,2,female,585,33,12,16,40,0,27,16,13
1783581,23,15,1990,10,male,497,33,17,16,5,5,4,11,1
1079996,33,27,1980,4,male,572,33,23,16,0,16,0,0,0
1903410,19,25,1994,5,female,46,33,28,16,4,16,4,0,0
1815777,46,16,1967,9,female,147,33,21,16,23,16,17,0,6
1798683,23,29,1990,9,female,343,32,28,17,1,0,1,17,0
1840324,68,14,1945,10,female,852,33,23,17,22,0,6,17,16
1574902,15,15,1998,1,male,40,33,22,17,4,10,0,7,4
1274216,58,22,1955,8,female,1123,33,9,17,7,6,6,11,1
1275269,50,19,1963,2,male,209,33,23,17,2,15,1,2,1
1893686,36,5,1977,11,female,250,32,21,17,5,14,1,3,4
1988029,18,19,1995,12,male,225,33,24,17,23,17,14,0,9
1658240,63,11,1950,12,female,454,33,25,18,4,0,0,18,4
1895342,59,6,1954,5,female,195,32,30,18,19,8,12,10,7
1507138,38,8,1975,9,female,270,32,25,18,2,17,1,1,1
1531170,23,1,1990,1,female,138,33,27,18,1,18,1,0,0
1761540,38,8,1975,6,male,108,32,25,18,2,18,2,0,0
1746950,16,23,1997,6,male,481,32,15,18,6,18,6,0,0
2097535,24,25,1989,2,male,759,33,31,18,10,18,7,0,3
1401806,26,4,1987,5,male,550,33,15,18,9,18,8,0,1
1484972,35,11,1978,7,male,679,33,20,18,9,18,3,0,6
2174354,71,13,1942,1,male,1503,33,20,18,8,18,8,0,0
1232584,77,22,1936,2,female,1769,33,16,18,5,18,0,0,5
1607103,23,5,1990,9,male,53,33,21,18,21,18,6,0,15
1728368,43,16,1970,4,male,75,32,12,18,17,18,9,0,8
2087028,22,2,1991,10,male,31,32,30,18,27,18,11,0,16
1696627,64,7,1949,8,female,1138,33,16,18,29,18,23,0,6
1631448,23,5,1990,5,male,194,33,30,19,0,0,0,19,0
1977606,71,31,1942,10,male,889,32,15,19,2,0,1,19,1
1881095,67,26,1946,7,female,258,32,29,19,6,0,0,19,6
1585789,52,2,1961,10,female,790,32,26,19,12,0,6,19,6
1396405,108,29,1905,10,female,117,33,28,19,20,0,12,19,8
1538545,24,10,1989,3,female,113,32,15,19,0,19,0,0,0
1790334,45,1,1968,1,male,242,32,5,19,2,19,0,0,2
1170727,43,19,1970,2,male,336,33,32,19,8,19,5,0,3
2017030,55,5,1958,2,female,1295,33,16,20,2,19,1,1,1
1051254,37,17,1976,2,male,585,32,5,20,0,20,0,0,0
1462426,47,26,1966,4,female,468,32,24,20,1,20,1,0,0
1379112,64,17,1949,1,female,1109,33,18,20,9,20,8,0,1
1158547,32,19,1981,7,female,507,33,24,20,27,20,25,0,2
1253992,107,10,1906,10,female,22,32,28,21,128,3,14,18,114
1230470,41,5,1972,3,male,158,33,22,21,4,21,4,0,0
1696227,62,11,1951,5,female,356,33,27,21,5,21,4,0,1
2058042,20,20,1993,6,female,371,33,31,21,16,21,10,0,6
1261980,18,21,1995,4,male,180,33,27,22,1,0,1,22,0
1783126,66,12,1947,7,male,590,32,15,22,7,1,2,21,5
1970592,82,22,1931,5,female,609,32,25,22,25,0,10,22,15
1225541,38,25,1975,9,female,349,32,12,22,3,22,3,0,0
1706855,42,1,1971,1,male,294,33,24,22,1,22,0,0,1
1625954,15,17,1998,9,male,70,32,14,22,8,22,7,0,1
1258857,18,12,1995,5,male,25,32,25,22,6,22,4,0,2
1597767,40,12,1973,11,female,457,32,18,22,9,22,9,0,0
1433286,27,5,1986,2,male,473,33,18,22,19,22,12,0,7
1688828,32,19,1981,5,female,152,33,13,22,40,22,38,0,2
1493568,35,14,1978,1,male,497,32,11,22,40,22,37,0,3
1294207,48,24,1965,10,male,231,33,29,23,1,1,0,22,1
1542485,48,11,1965,2,female,390,33,3,23,17,0,12,23,5
1637674,56,9,1957,6,female,1266,33,23,23,4,22,4,1,0
1005598,73,1,1940,1,female,34,32,20,23,21,22,14,1,7
2127910,31,18,1982,11,female,460,33,11,23,10,23,3,0,7
1071337,67,15,1946,7,female,312,32,23,23,4,23,2,0,2
1101755,26,1,1987,1,female,244,33,12,23,29,23,11,0,18
1611989,53,1,1960,9,male,196,32,24,23,31,23,21,0,10
1276911,38,10,1975,12,male,453,33,23,24,5,0,1,24,4
1284731,18,27,1995,11,female,361,33,19,24,18,11,4,13,14
1126898,30,23,1983,4,male,67,32,20,24,16,10,9,14,7
2173047,27,3,1986,3,female,212,33,7,24,11,18,9,6,2
2191493,19,14,1994,8,female,195,33,10,24,1,24,0,0,1
1326779,21,13,1992,4,male,437,32,9,24,4,24,2,0,2
1395801,45,18,1968,5,male,339,32,9,24,17,24,11,0,6
1947078,51,28,1962,6,male,150,33,31,24,16,24,13,0,3
1566894,57,2,1956,9,female,884,33,17,24,17,24,9,0,8
2170233,65,27,1948,8,female,131,33,28,24,22,24,18,0,4
1744766,22,26,1991,1,male,195,32,20,25,8,0,5,25,3
1458252,55,17,1958,9,male,2077,32,10,25,10,0,6,25,4
1234430,51,9,1962,3,female,1513,32,13,25,10,11,2,14,8
1067158,50,15,1963,3,male,637,32,19,25,14,23,10,2,4
1735056,38,16,1975,7,male,385,33,26,25,23,24,11,1,12
1109008,36,25,1977,8,female,318,32,27,25,0,25,0,0,0
1656641,63,19,1950,1,female,517,32,27,25,4,25,2,0,2
1463534,43,26,1970,9,female,215,32,13,25,12,25,10,0,2
2027604,18,20,1995,12,female,39,33,25,25,19,25,8,0,11
1242662,32,18,1981,10,female,607,33,14,25,34,25,33,0,1
1481044,59,26,1954,11,female,20,32,30,25,40,25,30,0,10
1439259,33,18,1980,5,male,414,33,14,26,9,20,9,6,0
1028147,20,22,1993,2,male,157,32,24,26,3,26,3,0,0
1873862,23,24,1990,6,male,811,33,22,26,1,26,1,0,0
1144046,55,17,1958,5,female,297,32,25,26,5,26,4,0,1
1640271,23,31,1990,10,male,79,32,19,26,31,26,31,0,0
2165818,56,25,1957,1,female,312,33,17,26,20,26,14,0,6
1982765,47,7,1966,1,male,310,32,11,26,62,26,56,0,6
1353350,21,18,1992,1,male,936,33,28,27,1,0,0,27,1
1779161,36,18,1977,11,male,518,33,19,27,7,0,5,27,2
1191801,43,31,1970,5,male,435,32,20,27,10,4,0,23,10
2037925,69,1,1944,3,female,286,33,25,27,30,0,22,27,8
1316595,112,1,1901,1,male,1455,33,21,27,18,0,8,27,10
1044793,51,3,1962,9,male,546,32,17,27,3,18,2,9,1
1324783,17,1,1996,1,male,158,33,28,27,11,27,9,0,2
1824878,17,19,1996,7,male,301,33,15,27,9,27,9,0,0
2029022,78,3,1935,10,female,440,33,22,28,13,0,4,28,9
1521762,60,19,1953,8,female,179,32,17,28,7,15,5,13,2
1125282,32,7,1981,5,female,236,32,25,28,12,22,3,6,9
1661609,59,19,1954,3,female,1641,33,20,28,3,28,2,0,1
2048940,17,12,1996,6,male,40,33,31,28,25,28,24,0,1
1067191,37,6,1976,12,female,550,33,21,29,12,0,7,29,5
1039692,62,15,1951,6,female,142,33,32,29,14,0,5,29,9
2063982,113,14,1900,4,female,1541,32,20,29,7,1,3,28,4
1460011,83,25,1930,4,male,649,33,33,29,0,29,0,0,0
1013806,27,2,1986,2,male,76,33,29,29,12,29,8,0,4
1979342,16,2,1997,2,male,162,33,27,29,24,29,11,0,13
1526179,53,12,1960,8,female,225,33,24,29,30,29,9,0,21
2084327,16,19,1997,2,female,475,33,27,30,2,0,0,30,2
1249358,64,3,1949,9,female,155,33,17,31,1,3,0,28,1
1297616,66,14,1947,1,female,379,33,29,30,4,2,1,28,3
1926968,24,11,1989,11,female,363,33,11,30,32,0,20,30,12
1123751,51,22,1962,10,female,285,32,20,30,42,4,12,26,30
1657841,37,29,1976,8,male,713,33,17,31,48,4,33,27,15
1704164,66,5,1947,9,male,636,33,24,30,40,27,29,3,11
1803419,21,27,1992,7,male,308,33,17,31,5,31,5,0,0
2067411,25,1,1988,1,female,157,33,24,30,0,30,0,0,0
1982233,27,20,1986,8,male,78,33,27,31,3,31,1,0,2
1176717,34,30,1979,5,male,136,32,17,31,1,31,1,0,0
1257800,54,13,1959,2,male,1056,32,17,31,1,31,0,0,1
2095169,23,1,1990,5,female,420,32,21,31,10,31,10,0,0
2184903,25,28,1988,4,male,118,33,29,31,139,31,104,0,35
1933766,28,27,1985,10,female,42,32,22,30,223,30,155,0,68
2146177,28,31,1985,1,female,257,32,18,32,25,2,12,30,13
1497426,53,7,1960,3,male,646,33,12,32,106,0,59,32,47
1087298,35,15,1978,3,male,476,33,20,32,2,14,1,18,1
1588252,25,15,1988,11,female,517,33,8,32,114,29,52,3,62
1060367,55,30,1958,8,male,282,33,25,32,5,32,2,0,3
1909700,56,5,1957,2,female,1703,33,11,32,5,32,5,0,0
1454935,52,27,1961,9,male,34,32,29,32,8,32,6,0,2
1606382,64,26,1949,1,female,79,33,20,32,11,32,10,0,1
2085815,24,5,1989,10,male,414,33,21,32,34,32,21,0,13
1613366,83,28,1930,11,female,655,33,11,32,23,32,22,0,1
1282591,43,14,1970,5,male,666,32,14,32,54,32,42,0,12
1989276,70,10,1943,6,female,257,32,10,33,16,0,13,33,3
1103710,42,2,1971,6,female,740,32,21,33,15,23,10,10,5
1685946,44,3,1969,7,male,1656,32,21,33,7,11,6,22,1
2069244,17,27,1996,10,male,910,33,13,33,3,33,1,0,2
1606297,36,18,1977,4,female,798,33,19,33,1,33,1,0,0
1999553,38,6,1975,9,male,731,32,10,33,3,33,3,0,0
1756945,66,2,1947,4,male,531,33,14,33,9,33,7,0,2
1336976,52,21,1961,10,female,272,32,11,33,63,33,45,0,18
1966618,67,12,1946,10,female,984,32,10,34,40,0,0,34,40
1722210,47,18,1966,9,female,275,33,20,34,2,34,2,0,0
2168728,18,29,1995,9,male,99,33,17,34,24,34,22,0,2
1410910,103,1,1910,9,male,1049,32,11,34,27,34,14,0,13
1271431,64,3,1949,2,female,116,33,16,36,10,3,8,33,2
1444038,76,9,1937,6,female,1117,33,10,35,11,0,7,35,4
1112693,57,3,1956,10,male,236,32,14,35,9,23,8,12,1
1837522,47,23,1966,2,female,292,32,28,35,1,35,1,0,0
1360558,17,12,1996,10,female,217,32,22,35,14,35,8,0,6
1711798,19,11,1994,2,male,35,32,24,35,7,35,4,0,3
2187077,33,4,1980,10,female,601,32,26,35,21,35,17,0,4
2192422,47,22,1966,7,male,1532,33,19,35,6,35,3,0,3
1363148,57,10,1956,6,female,1036,32,26,36,8,36,2,0,6
1933231,100,1,1913,1,male,418,32,21,35,15,35,12,0,3
1313257,14,30,1999,1,male,252,32,23,36,24,36,10,0,14
1962296,37,5,1976,9,female,1316,32,14,35,79,35,28,0,51
1431682,73,28,1940,11,female,1406,32,24,37,5,0,1,37,4
1192628,60,8,1953,7,female,872,32,16,37,16,2,4,35,12
1606019,40,3,1973,3,female,271,33,22,39,4,1,3,38,1
1550488,74,15,1939,9,female,1717,32,8,39,21,0,3,39,18
2167719,30,9,1983,6,female,326,33,21,38,23,38,22,0,1
1295860,24,15,1989,5,female,61,33,13,38,48,38,39,0,9
1459342,21,28,1992,7,female,107,32,32,40,42,17,21,23,21
1825692,38,1,1975,5,male,23,33,22,40,70,14,12,26,58
1087106,46,14,1967,11,female,64,32,24,41,5,0,4,41,1
1886518,58,15,1955,10,male,467,32,25,41,34,13,12,28,22
2021097,37,6,1976,8,male,741,33,15,42,17,37,11,5,6
1504342,29,18,1984,6,male,540,33,15,41,13,41,12,0,1
1505534,29,9,1984,9,male,85,32,6,42,14,42,14,0,0
1462143,47,29,1966,12,female,110,33,30,41,18,41,15,0,3
2001054,35,16,1978,11,male,143,33,30,41,55,41,25,0,30
1673206,57,7,1956,10,female,93,33,24,41,77,41,43,0,34
1889945,34,21,1979,6,male,376,33,15,43,50,31,50,12,0
1805791,33,26,1980,6,male,1001,33,13,44,41,42,26,2,15
1081781,59,8,1954,6,female,207,33,25,44,30,38,22,6,8
2019704,25,19,1988,11,male,184,33,16,44,20,44,14,0,6
1686363,53,18,1960,7,female,719,32,9,43,25,43,19,0,6
1341333,29,20,1984,11,female,119,33,15,44,54,44,39,0,15
2154622,33,28,1980,10,female,35,32,26,43,41,43,29,0,12
1580131,57,13,1956,7,male,289,33,19,43,68,43,52,0,16
1019925,30,8,1983,3,female,320,32,23,45,15,34,10,11,5
1285052,54,24,1959,7,male,1565,32,10,45,10,42,9,3,1
1245958,38,23,1975,5,male,780,33,17,45,5,45,4,0,1
1679979,38,18,1975,4,male,488,33,19,45,58,45,49,0,9
1725561,34,1,1979,1,male,120,33,27,45,136,45,57,0,79
2175662,84,10,1929,4,female,312,33,20,46,42,0,4,46,38
1443035,59,10,1954,3,female,576,33,26,46,19,12,5,34,14
1245383,35,1,1978,5,female,604,32,13,46,9,39,8,7,1
1888687,50,20,1963,3,male,63,33,25,46,9,46,8,0,1
1987207,57,24,1956,9,female,1812,32,9,49,119,6,34,43,85
1268043,46,26,1967,3,male,211,32,21,49,29,20,17,29,12
2088704,56,13,1957,4,male,1724,32,4,49,26,23,7,26,19
1541561,31,25,1982,3,male,470,32,30,48,0,48,0,0,0
1382739,47,26,1966,4,female,444,33,11,48,3,48,1,0,2
1117053,25,7,1988,10,female,896,32,30,48,9,48,9,0,0
1117216,43,25,1970,4,female,608,33,16,49,35,49,32,0,3
1177967,30,29,1983,3,male,271,33,22,48,141,48,94,0,47
1678308,35,30,1978,9,female,433,33,13,48,144,48,120,0,24
1561514,61,13,1952,8,female,1290,32,19,50,5,0,3,50,2
1086258,65,9,1948,7,male,291,33,24,51,37,0,17,51,20
1065610,23,9,1990,12,male,176,33,31,50,6,27,3,23,3
1647257,61,4,1952,9,male,663,32,23,50,4,46,4,4,0
1455655,20,1,1993,1,female,901,33,30,50,7,50,3,0,4
1487102,34,24,1979,7,female,173,33,25,51,1,51,0,0,1
1774678,54,23,1959,4,female,708,33,7,51,5,51,2,0,3
1322286,59,6,1954,3,female,374,32,25,51,4,51,3,0,1
1780876,24,24,1989,5,male,183,33,17,50,25,50,25,0,0
1737029,51,21,1962,8,male,558,32,19,51,28,51,22,0,6
1726613,33,30,1980,7,male,864,33,29,50,32,50,27,0,5
1493486,61,9,1952,9,male,155,33,7,53,9,0,5,53,4
1408899,14,11,1999,2,female,79,33,13,52,10,52,9,0,1
1509410,56,21,1957,1,female,324,33,23,53,17,53,17,0,0
1990085,30,24,1983,7,male,342,32,31,54,235,0,107,54,128
1903278,37,19,1976,6,male,263,33,22,54,0,53,0,1,0
1781878,50,10,1963,2,female,627,33,19,55,9,55,8,0,1
2156058,15,11,1998,8,male,297,33,23,55,35,55,13,0,22
1916730,21,10,1992,4,male,312,32,24,54,47,54,7,0,40
1645721,19,6,1994,6,male,316,33,1,58,5,0,0,58,5
2084910,39,27,1974,3,male,418,33,26,56,2,0,0,56,2
2008221,18,23,1995,8,female,390,33,20,56,10,0,4,56,6
1977934,26,17,1987,3,female,361,32,19,58,11,0,1,58,10
1356078,29,1,1984,8,female,151,32,17,57,7,57,5,0,2
2182141,34,3,1979,12,male,443,32,10,56,32,56,21,0,11
2132167,39,4,1974,5,female,81,32,19,57,15,57,13,0,2
1435879,37,20,1976,1,male,168,32,23,58,36,58,17,0,19
1126667,59,17,1954,2,female,2350,33,16,57,80,57,44,0,36
1713398,75,18,1938,12,female,202,32,22,56,36,56,26,0,10
1070180,61,21,1952,1,male,436,33,12,60,31,1,19,59,12
1578674,39,9,1974,4,male,401,33,28,59,25,58,15,1,10
1974916,108,1,1905,1,male,251,33,30,60,1,60,1,0,0
1851875,42,29,1971,8,female,76,33,23,59,22,59,6,0,16
1476230,45,29,1968,5,female,499,33,25,60,24,60,21,0,3
1104401,25,14,1988,5,female,342,32,18,61,9,0,2,61,7
1454266,107,25,1906,1,female,16,33,15,61,22,0,1,61,21
1956140,103,5,1910,1,female,1265,32,18,61,65,59,56,2,9
1739151,28,12,1985,12,male,207,32,28,61,4,61,3,0,1
2024272,65,3,1948,6,female,912,33,22,61,41,61,30,0,11
1056851,82,13,1931,3,female,521,33,28,65,20,0,16,65,4
2185860,31,3,1982,3,male,85,33,30,65,3,65,1,0,2
2093456,34,28,1979,12,female,486,33,15,67,17,0,3,67,14
1469322,72,22,1941,5,female,579,33,20,67,48,0,18,67,30
1625139,54,29,1959,10,male,1577,33,21,66,48,26,5,40,43
1970802,57,23,1956,9,female,284,33,15,66,29,63,20,3,9
1655157,18,18,1995,2,female,34,32,20,68,141,62,94,6,47
1019249,45,27,1968,9,male,528,33,19,68,17,68,16,0,1
1297526,64,14,1949,2,male,181,32,9,71,0,0,0,71,0
1588550,55,5,1958,5,male,480,33,25,70,78,0,1,70,77
2192877,24,4,1989,6,female,192,32,29,69,3,61,2,8,1
1228619,21,1,1992,1,male,478,33,23,71,41,64,3,7,38
1055873,20,22,1993,8,female,205,33,18,70,27,70,12,0,15
1680791,53,28,1960,12,female,308,32,23,69,93,69,27,0,66
1542481,18,16,1995,2,female,503,32,23,70,156,70,106,0,50
2179821,64,26,1949,12,female,552,33,25,73,10,0,6,73,4
2010951,51,5,1962,7,male,612,33,24,73,3,69,3,4,0
1469381,21,30,1992,5,male,189,32,21,73,3,73,3,0,0
1162753,36,3,1977,4,male,49,32,16,72,44,72,40,0,4
2140881,42,29,1971,8,female,199,32,19,73,96,73,88,0,8
1239685,56,22,1957,1,female,395,33,24,72,94,72,51,0,43
1988379,49,12,1964,11,female,102,32,16,77,19,72,10,5,9
1162817,18,15,1995,5,male,56,32,30,75,1,75,1,0,0
1510290,30,15,1983,2,female,297,33,19,75,42,75,38,0,4
1880466,34,7,1979,12,female,812,33,13,77,25,77,16,0,9
2024940,39,3,1974,6,male,300,33,27,75,13,75,11,0,2
2160892,40,25,1973,3,male,813,33,16,76,18,76,17,0,1
1612572,66,2,1947,8,female,2310,32,11,75,39,75,6,0,33
1531484,64,25,1949,12,female,759,32,21,78,2,0,1,78,1
2121183,75,6,1938,8,female,1180,33,16,79,10,0,6,79,4
2059080,53,1,1960,4,female,594,33,14,79,143,5,75,74,68
2029110,31,30,1982,12,female,1153,33,23,78,102,43,86,35,16
1012560,61,28,1952,10,female,118,32,14,78,36,77,34,1,2
1450551,22,3,1991,8,female,500,32,23,78,11,78,3,0,8
1224865,31,22,1982,9,female,156,32,24,80,0,80,0,0,0
2023850,65,14,1948,4,female,374,32,27,78,14,78,8,0,6
2099491,24,10,1989,12,female,297,33,29,83,28,83,21,0,7
1199674,36,14,1977,1,female,404,33,19,84,187,84,152,0,35
1853861,23,21,1990,12,female,361,33,12,87,39,87,7,0,32
1036338,47,9,1966,8,male,505,33,7,86,23,86,16,0,7
1270726,90,9,1923,8,male,1622,32,9,88,13,1,1,87,12
1373934,28,12,1985,3,female,369,33,27,91,19,91,14,0,5
1672768,52,9,1961,8,female,311,33,17,89,54,89,18,0,36
1787321,16,22,1997,12,male,103,33,28,93,6,93,3,0,3
1020965,26,24,1987,10,male,342,32,24,92,5,92,5,0,0
2080366,23,11,1990,5,female,157,32,20,95,31,95,26,0,5
1628376,25,1,1988,1,male,27,32,24,95,36,95,33,0,3
1260417,28,29,1985,10,male,287,33,14,94,36,94,33,0,3
1505617,19,9,1994,10,female,724,32,11,99,16,43,8,56,8
1927516,34,21,1979,6,female,683,32,17,98,7,98,4,0,3
1222057,21,24,1992,10,female,681,33,17,98,29,98,13,0,16
1645299,26,1,1987,1,male,101,33,19,103,55,102,27,1,28
1316450,29,3,1984,12,female,262,33,32,102,1,102,1,0,0
1823632,45,5,1968,7,female,366,32,22,100,92,100,87,0,5
2038032,76,23,1937,8,male,1277,32,13,107,32,7,6,100,26
2130746,17,1,1996,1,female,480,33,24,106,242,0,63,106,179
2153256,44,21,1969,1,female,441,32,8,106,12,106,4,0,8
1651188,54,12,1959,8,female,127,32,23,106,19,106,16,0,3
1197485,33,25,1980,1,male,96,32,12,109,104,109,97,0,7
1884540,28,11,1985,12,male,265,32,25,110,110,75,61,35,49
1616738,56,28,1957,10,female,1377,32,22,113,68,95,64,18,4
1714109,46,22,1967,11,female,288,32,15,112,20,112,7,0,13
2071324,47,19,1966,2,female,434,33,27,113,23,113,10,0,13
2180027,45,13,1968,8,female,461,32,21,111,129,111,123,0,6
1939449,26,1,1987,1,female,554,33,14,113,201,113,173,0,28
1136186,35,3,1978,5,male,347,32,15,117,47,0,18,117,29
1550187,27,8,1986,4,male,454,32,17,115,13,73,11,42,2
1344062,61,23,1952,7,female,400,32,7,116,7,82,7,34,0
1352240,52,10,1961,12,male,735,33,21,116,187,30,115,86,72
1435453,37,5,1976,11,male,424,33,30,117,158,117,73,0,85
1704107,48,25,1965,2,female,48,33,28,124,198,62,113,62,85
2079786,21,10,1992,9,male,59,32,21,123,249,94,191,29,58
1246716,25,4,1988,12,female,226,32,29,123,18,123,17,0,1
1040847,30,25,1983,9,female,375,32,5,124,1,124,1,0,0
1826853,34,3,1979,6,female,367,32,22,120,20,120,16,0,4
1736611,59,20,1954,9,female,844,33,21,123,26,123,21,0,5
1977050,56,18,1957,5,male,16,32,30,123,149,123,77,0,72
2101446,73,24,1940,6,male,330,32,27,128,118,6,18,122,100
1599526,66,18,1947,4,female,660,32,13,127,93,91,57,36,36
1276246,43,18,1970,8,male,235,33,21,125,0,111,0,14,0
2103903,56,16,1957,2,female,385,33,30,127,0,127,0,0,0
1636676,62,17,1951,8,male,93,32,28,127,65,127,33,0,32
1942803,68,17,1945,12,female,1731,32,9,135,35,0,10,135,25
1936186,18,7,1995,2,male,400,32,13,131,119,35,40,96,79
1771408,19,5,1994,12,female,506,32,23,132,6,123,5,9,1
1729900,28,18,1985,9,male,74,33,19,136,73,136,72,0,1
1398124,36,26,1977,10,female,610,32,11,132,28,132,21,0,7
1079958,37,29,1976,4,female,313,33,23,132,37,132,32,0,5
1336073,52,17,1961,2,female,447,33,19,143,129,0,9,143,120
1385253,58,20,1955,5,female,476,32,20,139,21,139,12,0,9
1551234,69,9,1944,4,female,1376,33,17,142,1,142,0,0,1
2006016,28,28,1985,5,female,254,32,13,142,65,142,26,0,39
1284048,26,10,1987,6,female,258,33,10,137,155,137,102,0,53
1659925,38,3,1975,7,female,71,33,24,144,114,56,106,88,8
1518643,55,24,1958,8,male,119,32,19,149,92,149,64,0,28
1633086,25,11,1988,11,male,185,32,12,146,230,146,105,0,125
2073944,20,6,1993,12,male,138,33,9,156,15,6,3,150,12
2061410,26,1,1987,1,female,339,32,31,157,7,157,2,0,5
1262993,45,5,1968,9,female,422,33,30,152,29,152,24,0,5
1582325,59,3,1954,9,female,219,33,17,160,12,0,10,160,2
2039397,56,2,1957,1,female,34,32,27,162,35,0,13,162,22
1995932,60,9,1953,12,male,719,32,17,160,121,157,84,3,37
1971373,40,26,1973,11,female,81,33,28,168,36,0,14,168,22
1669192,72,22,1941,2,female,1489,32,23,165,72,31,11,134,61
1118858,25,20,1988,6,male,129,32,20,171,1,171,1,0,0
2129695,43,1,1970,7,male,118,33,21,172,28,172,27,0,1
1731446,54,18,1959,4,male,208,33,18,177,53,0,27,177,26
2145959,65,9,1948,4,female,1874,32,11,173,33,18,16,155,17
1770701,61,11,1952,5,female,740,32,17,180,1,180,1,0,0
2014866,53,16,1960,1,female,258,33,21,176,223,176,95,0,128
1354639,19,20,1994,1,male,80,32,21,183,56,153,35,30,21
1408347,24,18,1989,7,male,24,33,28,188,9,188,9,0,0
2038441,40,2,1973,8,female,724,32,14,190,31,190,13,0,18
1256719,26,1,1987,1,female,199,33,6,183,231,183,67,0,164
1957035,45,1,1968,7,female,299,32,12,190,144,190,121,0,23
1201986,66,12,1947,10,female,180,33,15,200,139,0,64,200,75
1917243,50,21,1963,7,male,185,32,27,199,26,199,8,0,18
2003114,22,17,1991,4,female,60,32,20,206,149,157,22,49,127
1901622,25,23,1988,7,female,94,33,29,208,8,208,8,0,0
1873664,44,22,1969,9,female,188,33,24,211,43,211,35,0,8
1331522,55,12,1958,11,male,160,33,16,211,88,211,61,0,27
1312030,27,20,1986,3,female,288,33,27,212,42,0,7,212,35
2096443,66,15,1947,1,female,854,32,16,214,343,0,40,214,303
2181090,35,30,1978,4,female,137,32,7,221,45,221,34,0,11
1085083,29,2,1984,8,male,115,33,25,220,232,220,157,0,75
1528540,23,25,1990,8,female,20,33,7,232,116,230,72,2,44
2000272,31,23,1982,5,female,511,32,16,228,53,228,32,0,21
1750666,36,2,1977,12,female,1174,32,26,241,0,0,0,241,0
1468158,52,5,1961,9,female,741,32,14,241,26,0,11,241,15
1859773,58,25,1955,5,female,1282,32,20,235,3,0,2,235,1
1303457,15,7,1998,8,male,34,33,9,242,0,168,0,74,0
1358629,26,7,1987,12,female,329,33,12,241,25,241,17,0,8
1207692,17,10,1996,5,male,476,33,25,234,43,234,29,0,14
1265693,68,27,1945,11,female,56,33,18,237,122,237,74,0,48
1933610,60,24,1953,12,male,767,32,16,247,15,225,2,22,13
1077718,23,16,1990,9,male,118,33,13,280,41,228,9,52,32
1078015,21,1,1992,12,male,223,32,28,289,52,286,34,3,18
1053414,34,9,1979,8,female,45,33,28,292,216,236,180,56,36
1870133,28,15,1985,6,female,153,32,31,289,21,289,6,0,15
2000299,27,5,1986,4,male,86,33,30,302,141,227,50,75,91
1280386,44,12,1969,6,female,1072,33,16,308,286,249,264,59,22
1710524,44,4,1969,11,male,721,32,24,301,43,301,35,0,8
1147049,20,29,1993,9,female,148,32,12,296,155,296,123,0,32
1584414,71,3,1942,12,female,114,33,17,308,94,308,92,0,2
1667765,54,24,1959,11,female,1070,33,19,310,132,0,73,310,59
1417562,33,13,1980,12,female,214,32,19,326,119,326,83,0,36
1521021,68,11,1945,8,female,1507,33,20,324,58,324,42,0,16
1757063,20,13,1993,4,female,465,33,26,338,175,330,137,8,38
1233325,54,5,1959,2,female,1227,32,11,351,311,100,129,251,182
1828802,49,1,1964,1,male,96,32,16,369,102,364,29,5,73
2132156,62,17,1951,4,female,75,33,17,360,158,360,42,0,116
1950725,64,17,1949,10,female,539,32,22,382,6,0,3,382,3
1055134,18,16,1995,3,male,534,32,24,427,49,424,45,3,4
2124880,37,9,1976,11,female,602,32,19,437,416,437,391,0,25
1233635,18,8,1995,5,male,39,33,29,461,21,443,7,18,14
1415347,18,6,1995,10,male,222,32,21,455,42,455,16,0,26
1712339,51,7,1962,5,female,750,33,5,516,1283,65,945,451,338
2009574,64,17,1949,12,female,645,33,18,504,26,496,15,8,11
1322619,31,11,1982,8,male,421,33,16,521,26,521,24,0,2
1517789,54,23,1959,7,male,146,33,16,521,105,521,56,0,49
1233087,53,5,1960,3,male,785,32,22,598,5,0,0,598,5
2114881,48,13,1965,6,male,82,33,28,576,1,576,1,0,0
1462581,61,18,1952,3,female,266,32,5,566,208,566,154,0,54
1261579,31,3,1982,9,female,364,32,17,654,140,641,76,13,64
2163350,42,20,1971,6,female,868,32,15,612,337,603,222,9,115
1838660,30,1,1983,1,female,189,32,15,708,133,681,119,27,14
1532900,19,15,1994,7,male,425,33,27,719,6,719,4,0,2
2046581,58,15,1955,9,female,799,33,15,669,4,669,1,0,3
1324263,54,29,1959,1,female,374,33,24,1027,105,0,17,1027,88
1641059,31,1,1982,1,female,248,32,21,1178,5,1178,3,0,2
1750665,33,15,1980,7,male,22,32,30,1233,56,1233,38,0,18
2128785,22,21,1991,5,female,298,33,20,1804,1462,1066,1010,738,452
1374925,60,27,1953,5,female,1586,33,13,1552,2963,403,1328,1149,1635
1264653,22,6,1991,11,male,141,32,24,1806,789,1784,748,22,41
1581942,20,28,1993,4,female,447,32,8,1747,70,1747,58,0,12
2156294,22,15,1991,1,female,330,33,15,2047,686,1304,420,743,266
1305961,16,19,1997,10,female,186,33,24,1926,488,1895,223,31,265
1791020,72,28,1941,2,female,1690,33,18,1971,32,1971,23,0,9
1166045,28,15,1985,11,female,259,32,18,1908,823,1908,618,0,205
1676290,53,14,1960,1,male,779,33,21,1997,477,1997,348,0,129
1122592,22,11,1991,12,female,498,33,22,2378,3060,20,885,2358,2175
2024465,13,5,2000,1,male,292,34,22,0,0,0,0,0,0
1998954,13,10,2000,7,female,102,34,25,0,0,0,0,0,0
1155348,15,26,1998,11,female,6,35,30,0,3,0,2,0,1
1073774,15,10,1998,12,male,226,34,7,0,0,0,0,0,0
2046919,14,12,1999,1,male,226,35,29,0,0,0,0,0,0
1155442,14,6,1999,4,female,330,35,34,0,1,0,0,0,1
1418695,14,13,1999,5,male,172,35,7,0,0,0,0,0,0
1058134,14,13,1999,9,male,196,35,20,0,2,0,2,0,0
1766978,14,26,1999,10,male,134,34,23,0,0,0,0,0,0
2134651,16,18,1997,12,male,104,34,29,0,0,0,0,0,0
1819488,15,6,1998,1,female,481,35,23,0,0,0,0,0,0
1866684,15,22,1998,3,male,237,34,24,0,1,0,0,0,1
1664726,15,1,1998,4,male,117,35,23,0,3,0,2,0,1
1947535,15,15,1998,9,male,69,34,34,0,0,0,0,0,0
1740615,17,8,1996,11,male,234,35,30,0,0,0,0,0,0
1466385,17,17,1996,12,male,259,35,15,0,0,0,0,0,0
2094865,16,23,1997,1,male,474,35,15,0,1,0,1,0,0
1643848,16,15,1997,3,male,374,34,27,0,1,0,0,0,1
2109983,16,24,1997,3,male,266,35,29,0,0,0,0,0,0
1378321,16,1,1997,7,female,99,35,31,0,0,0,0,0,0
1099240,16,11,1997,8,male,122,34,27,0,0,0,0,0,0
1953376,18,17,1995,11,male,281,35,22,0,0,0,0,0,0
2074644,17,6,1996,2,male,512,34,28,0,0,0,0,0,0
2083126,17,2,1996,7,male,471,34,19,0,0,0,0,0,0
1106602,17,17,1996,7,male,31,34,22,0,1,0,1,0,0
1049861,17,7,1996,8,male,157,35,24,0,6,0,3,0,3
1145309,17,14,1996,8,male,43,34,17,0,1,0,1,0,0
1616433,17,3,1996,10,female,29,34,34,0,0,0,0,0,0
1919088,18,3,1995,1,male,106,34,30,0,0,0,0,0,0
1210642,18,1,1995,1,male,196,34,12,0,3,0,3,0,0
1887634,18,11,1995,4,male,51,35,25,0,0,0,0,0,0
1610617,18,4,1995,5,female,549,35,32,0,0,0,0,0,0
1506841,18,25,1995,10,male,696,35,19,0,0,0,0,0,0
1042976,18,15,1995,10,male,499,34,20,0,0,0,0,0,0
1799179,18,3,1995,10,male,117,35,25,0,0,0,0,0,0
1399155,20,10,1993,11,male,303,35,17,0,1,0,1,0,0
1150180,19,5,1994,1,male,235,35,28,0,0,0,0,0,0
1370607,19,1,1994,1,female,157,34,21,0,5,0,1,0,4
1788723,19,2,1994,2,male,403,34,23,0,7,0,7,0,0
1697618,19,18,1994,2,male,322,34,20,0,0,0,0,0,0
1634366,19,5,1994,2,male,101,35,28,0,0,0,0,0,0
1898783,19,27,1994,3,male,580,34,18,0,0,0,0,0,0
2047768,19,24,1994,3,male,418,34,13,0,5,0,0,0,5
1141592,19,23,1994,3,male,243,34,33,0,0,0,0,0,0
1994964,19,1,1994,6,male,819,35,29,0,0,0,0,0,0
1222442,19,31,1994,8,male,902,34,1,0,0,0,0,0,0
1150954,19,5,1994,10,male,244,35,7,0,0,0,0,0,0
1608931,20,15,1993,3,male,401,35,18,0,0,0,0,0,0
1149008,20,11,1993,4,male,104,35,33,0,0,0,0,0,0
2190872,20,11,1993,8,male,315,34,18,0,0,0,0,0,0
2110068,20,28,1993,8,male,297,35,19,0,12,0,7,0,5
1171737,20,1,1993,10,male,822,35,26,0,0,0,0,0,0
1048142,22,8,1991,12,male,175,35,25,0,0,0,0,0,0
1079890,21,13,1992,1,male,472,34,19,0,2,0,2,0,0
1306979,21,15,1992,2,male,186,35,26,0,0,0,0,0,0
2052121,21,18,1992,6,female,260,35,11,0,0,0,0,0,0
1991094,21,27,1992,7,male,1135,34,22,0,0,0,0,0,0
1180386,23,11,1990,11,male,284,35,20,0,2,0,2,0,0
1810181,23,9,1990,11,male,136,35,24,0,0,0,0,0,0
1110727,23,28,1990,12,male,386,34,17,0,0,0,0,0,0
1644319,22,15,1991,1,male,1093,34,25,0,1,0,1,0,0
1788939,22,1,1991,1,female,525,34,32,0,0,0,0,0,0
2028844,22,9,1991,2,male,385,34,18,0,0,0,0,0,0
1918113,22,8,1991,5,male,452,34,19,0,0,0,0,0,0
1832688,22,31,1991,5,female,352,34,22,0,0,0,0,0,0
1446658,22,3,1991,6,male,1277,35,19,0,0,0,0,0,0
1588004,22,6,1991,6,male,726,35,29,0,0,0,0,0,0
1656969,22,10,1991,7,female,402,34,16,0,0,0,0,0,0
1439171,22,21,1991,9,male,373,34,27,0,0,0,0,0,0
1644503,22,9,1991,9,male,188,35,29,0,1,0,1,0,0
1732501,22,6,1991,10,male,449,34,13,0,1,0,0,0,1
2160845,24,11,1989,12,male,230,34,31,0,0,0,0,0,0
1190637,23,5,1990,1,male,179,35,17,0,6,0,0,0,6
2135865,23,17,1990,2,male,465,35,27,0,3,0,3,0,0
1760698,23,15,1990,2,male,184,35,23,0,0,0,0,0,0
1358725,23,25,1990,3,female,103,34,17,0,1,0,1,0,0
1507218,23,20,1990,4,male,473,35,13,0,2,0,0,0,2
1112629,23,11,1990,4,male,472,34,19,0,1,0,0,0,1
1513213,23,8,1990,7,female,943,34,27,0,20,0,17,0,3
1065519,23,5,1990,8,male,158,35,16,0,0,0,0,0,0
2117463,23,30,1990,9,male,387,35,22,0,0,0,0,0,0
1113656,23,11,1990,9,male,162,34,22,0,0,0,0,0,0
2060616,23,15,1990,10,male,462,34,19,0,2,0,0,0,2
1513010,23,6,1990,10,male,123,35,32,0,5,0,1,0,4
1635239,25,10,1988,11,male,1379,34,18,0,0,0,0,0,0
1096581,25,14,1988,11,male,782,34,15,0,0,0,0,0,0
2128553,25,16,1988,11,male,691,35,0,0,0,0,0,0,0
1654832,25,16,1988,12,male,198,35,31,0,0,0,0,0,0
1742973,25,15,1988,12,female,157,35,23,0,1,0,1,0,0
1369239,25,29,1988,12,male,65,34,17,0,0,0,0,0,0
1281292,24,19,1989,2,male,735,34,30,0,1,0,1,0,0
1347088,24,18,1989,5,female,374,34,23,0,1,0,1,0,0
1577620,24,5,1989,5,male,391,35,28,0,6,0,2,0,4
1190502,24,17,1989,5,male,264,35,15,0,0,0,0,0,0
1696761,24,19,1989,5,female,40,34,18,0,0,0,0,0,0
1568871,24,1,1989,5,male,345,34,24,0,0,0,0,0,0
1540805,24,22,1989,7,male,478,34,17,0,5,0,3,0,2
1286226,24,10,1989,7,female,312,35,16,0,3,0,3,0,0
2072699,24,5,1989,9,female,131,34,28,0,0,0,0,0,0
1371342,24,21,1989,10,male,271,35,15,0,0,0,0,0,0
2038376,26,3,1987,11,male,284,34,9,0,0,0,0,0,0
1991635,25,2,1988,1,male,573,35,13,0,0,0,0,0,0
1512508,25,29,1988,1,male,107,34,33,0,3,0,0,0,3
2062482,25,1,1988,1,male,33,35,22,0,0,0,0,0,0
1898171,25,25,1988,5,male,153,35,17,0,0,0,0,0,0
2031473,25,20,1988,6,male,589,35,20,0,0,0,0,0,0
1066107,25,12,1988,6,female,388,34,19,0,0,0,0,0,0
1749058,25,12,1988,6,male,317,34,28,0,3,0,2,0,1
1226679,25,18,1988,9,male,665,34,26,0,14,0,9,0,5
1215567,25,17,1988,10,male,415,34,22,0,0,0,0,0,0
1736201,27,19,1986,12,female,609,34,21,0,0,0,0,0,0
2148951,27,6,1986,12,male,317,35,30,0,0,0,0,0,0
1581394,27,22,1986,12,female,147,35,31,0,0,0,0,0,0
1275969,26,1,1987,1,male,453,35,19,0,0,0,0,0,0
2174514,26,1,1987,1,male,149,34,10,0,0,0,0,0,0
2095875,26,25,1987,2,male,209,34,32,0,0,0,0,0,0
2043257,26,1,1987,2,female,289,35,20,0,0,0,0,0,0
1524800,26,23,1987,3,male,329,35,30,0,0,0,0,0,0
1426277,26,18,1987,5,female,538,34,22,0,0,0,0,0,0
1158324,26,6,1987,5,male,312,34,5,0,11,0,4,0,7
1405265,26,15,1987,5,male,335,35,32,0,1,0,1,0,0
1952851,26,1,1987,7,female,400,35,14,0,0,0,0,0,0
1015626,26,14,1987,9,male,46,34,22,0,1,0,0,0,1
1614023,26,12,1987,9,male,39,35,23,0,0,0,0,0,0
1749102,28,11,1985,11,male,243,34,33,0,0,0,0,0,0
1451446,28,29,1985,12,male,317,34,33,0,0,0,0,0,0
1967151,27,15,1986,1,male,57,34,32,0,2,0,1,0,1
1459877,27,20,1986,2,male,719,35,15,0,2,0,2,0,0
1057796,27,12,1986,2,female,276,34,27,0,0,0,0,0,0
1663433,27,5,1986,5,male,1138,34,8,0,0,0,0,0,0
1374082,27,7,1986,5,male,307,34,29,0,0,0,0,0,0
1968641,27,15,1986,5,female,243,34,15,0,0,0,0,0,0
1554940,27,7,1986,6,male,530,34,7,0,3,0,1,0,2
1541995,27,22,1986,8,male,420,34,32,0,0,0,0,0,0
1115438,27,20,1986,10,female,453,34,20,0,0,0,0,0,0
1443375,28,9,1985,1,male,526,35,26,0,0,0,0,0,0
1846535,28,15,1985,1,male,40,35,31,0,0,0,0,0,0
1997961,28,9,1985,2,male,546,34,10,0,17,0,11,0,6
1199073,28,21,1985,2,male,286,34,27,0,0,0,0,0,0
1930953,28,16,1985,2,male,246,35,33,0,1,0,0,0,1
1311183,28,2,1985,3,male,331,34,22,0,0,0,0,0,0
1118586,28,12,1985,3,male,504,35,5,0,0,0,0,0,0
1147089,28,25,1985,6,male,378,34,19,0,39,0,14,0,25
1954817,28,8,1985,6,male,275,35,29,0,0,0,0,0,0
2091397,28,30,1985,6,male,28,34,34,0,0,0,0,0,0
1744642,28,7,1985,7,male,631,35,31,0,0,0,0,0,0
1131493,28,19,1985,8,male,274,35,11,0,0,0,0,0,0
1133801,28,12,1985,8,male,297,35,28,0,0,0,0,0,0
1532731,28,13,1985,9,male,1103,34,31,0,1,0,1,0,0
1860353,28,30,1985,10,female,606,34,5,0,0,0,0,0,0
1913164,28,20,1985,10,male,358,34,29,0,3,0,2,0,1
1275481,29,14,1984,2,female,406,34,11,0,0,0,0,0,0
1638056,29,12,1984,4,male,541,34,10,0,0,0,0,0,0
1840640,29,13,1984,5,male,254,35,28,0,0,0,0,0,0
1978257,29,25,1984,5,male,221,34,22,0,0,0,0,0,0
1199339,29,22,1984,10,male,391,35,14,0,0,0,0,0,0
1397860,31,2,1982,12,male,579,35,18,0,0,0,0,0,0
1602398,30,24,1983,5,male,288,34,22,0,0,0,0,0,0
1591344,30,20,1983,9,female,541,34,24,0,0,0,0,0,0
2103188,32,14,1981,12,male,525,34,33,0,1,0,0,0,1
1618139,32,4,1981,12,female,372,34,21,0,0,0,0,0,0
1028949,32,1,1981,12,male,303,35,20,0,0,0,0,0,0
1484952,31,6,1982,1,male,675,35,6,0,0,0,0,0,0
1439501,31,7,1982,5,male,319,34,24,0,16,0,9,0,7
1223757,31,23,1982,6,female,374,35,21,0,2,0,2,0,0
1896891,31,3,1982,10,male,221,35,19,0,0,0,0,0,0
2095881,31,20,1982,10,male,97,34,25,0,0,0,0,0,0
1729391,33,18,1980,11,male,494,35,35,0,0,0,0,0,0
1038313,33,17,1980,12,female,503,34,28,0,0,0,0,0,0
1141889,32,20,1981,1,male,596,35,24,0,0,0,0,0,0
1350750,32,19,1981,2,male,290,35,21,0,0,0,0,0,0
1636199,32,30,1981,3,male,233,35,33,0,0,0,0,0,0
1700263,32,6,1981,3,male,109,35,33,0,0,0,0,0,0
1463481,32,11,1981,6,male,1158,34,24,0,0,0,0,0,0
1571806,32,5,1981,8,male,882,34,24,0,3,0,1,0,2
1303865,32,9,1981,10,male,674,34,21,0,0,0,0,0,0
1501940,34,30,1979,12,male,509,34,18,0,1,0,1,0,0
1252804,33,11,1980,1,male,493,35,27,0,0,0,0,0,0
1166512,33,28,1980,2,female,552,34,19,0,0,0,0,0,0
2165143,33,21,1980,2,male,399,34,15,0,1,0,0,0,1
1234402,33,25,1980,2,female,309,35,20,0,0,0,0,0,0
1546974,33,17,1980,4,male,475,34,19,0,0,0,0,0,0
1645730,33,6,1980,5,male,368,35,19,0,0,0,0,0,0
2158112,33,29,1980,9,female,237,35,27,0,1,0,1,0,0
1120157,34,26,1979,2,male,580,35,11,0,0,0,0,0,0
1180380,34,13,1979,4,male,498,34,5,0,2,0,2,0,0
1510700,34,17,1979,6,male,571,34,31,0,0,0,0,0,0
1394342,34,23,1979,7,male,178,35,28,0,0,0,0,0,0
1628145,34,29,1979,8,female,295,34,12,0,0,0,0,0,0
1224800,36,21,1977,11,male,481,34,19,0,0,0,0,0,0
1206868,35,5,1978,1,male,251,35,20,0,0,0,0,0,0
2157593,35,4,1978,3,male,369,35,18,0,0,0,0,0,0
1951153,35,28,1978,3,male,704,34,29,0,0,0,0,0,0
1383641,35,12,1978,6,male,160,34,26,0,0,0,0,0,0
1613901,35,12,1978,9,male,74,34,31,0,0,0,0,0,0
1430815,37,20,1976,12,female,116,35,25,0,0,0,0,0,0
1655513,36,2,1977,7,male,536,34,29,0,0,0,0,0,0
1728079,37,17,1976,6,male,455,35,16,0,23,0,12,0,11
2099634,37,15,1976,9,male,504,35,17,0,0,0,0,0,0
1712266,37,19,1976,10,male,220,35,21,0,10,0,6,0,4
2036538,38,9,1975,1,male,457,34,13,0,2,0,0,0,2
1404300,38,4,1975,1,female,202,35,27,0,0,0,0,0,0
1500373,38,19,1975,4,female,83,34,33,0,3,0,2,0,1
2034063,38,30,1975,8,male,763,34,19,0,0,0,0,0,0
1798376,38,19,1975,9,male,516,35,17,0,0,0,0,0,0
1939136,38,16,1975,10,male,488,34,24,0,0,0,0,0,0
1763012,39,28,1974,5,male,355,34,21,0,0,0,0,0,0
1713192,39,4,1974,6,female,317,34,33,0,0,0,0,0,0
1320763,39,27,1974,10,female,431,34,20,0,0,0,0,0,0
2102291,39,1,1974,10,male,338,34,15,0,4,0,1,0,3
2137119,40,5,1973,3,male,125,35,35,0,0,0,0,0,0
1343389,40,13,1973,7,male,383,34,27,0,0,0,0,0,0
2067821,41,1,1972,1,male,251,34,8,0,2,0,1,0,1
1162210,41,1,1972,3,female,155,34,15,0,0,0,0,0,0
1132069,41,1,1972,5,male,603,34,30,0,0,0,0,0,0
2189633,42,1,1971,1,male,293,34,9,0,0,0,0,0,0
1287689,42,24,1971,3,male,675,34,26,0,5,0,3,0,2
2152623,42,23,1971,4,male,879,35,14,0,0,0,0,0,0
1303674,42,5,1971,4,female,144,35,28,0,2,0,1,0,1
1145978,42,9,1971,5,male,43,35,30,0,0,0,0,0,0
1501117,42,11,1971,7,male,169,35,14,0,0,0,0,0,0
1007511,42,16,1971,10,male,369,34,25,0,7,0,5,0,2
2116763,44,18,1969,12,male,429,35,19,0,1,0,0,0,1
1916602,43,31,1970,3,male,600,34,34,0,0,0,0,0,0
1560617,43,24,1970,4,male,659,34,19,0,0,0,0,0,0
1831794,43,29,1970,4,female,381,35,30,0,2,0,2,0,0
2013982,43,19,1970,5,female,444,34,12,0,0,0,0,0,0
2091699,44,10,1969,1,male,616,34,21,0,2,0,2,0,0
1540316,44,1,1969,1,male,382,34,27,0,0,0,0,0,0
1884997,44,19,1969,6,male,573,35,25,0,4,0,3,0,1
1010253,44,30,1969,9,male,254,35,32,0,0,0,0,0,0
1118923,44,29,1969,9,female,84,35,26,0,0,0,0,0,0
1054713,44,27,1969,10,male,498,35,13,0,0,0,0,0,0
1967784,45,15,1968,4,male,105,35,7,0,0,0,0,0,0
1955770,45,9,1968,5,male,259,34,30,0,4,0,4,0,0
1194757,45,24,1968,10,female,206,34,32,0,0,0,0,0,0
2022715,46,21,1967,7,female,297,35,22,0,0,0,0,0,0
1364579,48,13,1965,11,male,429,34,30,0,0,0,0,0,0
1786307,47,4,1966,1,male,328,35,29,0,9,0,5,0,4
2083808,47,19,1966,4,male,350,34,29,0,7,0,2,0,5
1207057,48,10,1965,1,female,412,34,21,0,0,0,0,0,0
1436052,48,21,1965,8,female,311,35,30,0,0,0,0,0,0
1262742,48,3,1965,9,male,500,35,12,0,0,0,0,0,0
1317925,48,23,1965,10,female,1182,34,9,0,6,0,1,0,5
1080890,50,27,1963,12,male,371,34,29,0,1,0,0,0,1
1688150,49,28,1964,2,female,628,34,17,0,0,0,0,0,0
1173406,49,14,1964,8,male,1067,35,21,0,3,0,1,0,2
1269075,50,5,1963,2,male,997,34,12,0,0,0,0,0,0
1064793,50,29,1963,10,male,406,34,7,0,0,0,0,0,0
2064440,52,6,1961,12,male,1321,35,31,0,0,0,0,0,0
1100725,52,15,1961,12,male,582,35,33,0,8,0,8,0,0
1466990,52,28,1961,12,male,464,35,27,0,0,0,0,0,0
2066541,52,23,1961,3,male,1178,34,8,0,0,0,0,0,0
2039357,52,25,1961,4,male,278,35,18,0,0,0,0,0,0
1205027,52,24,1961,6,male,632,35,23,0,0,0,0,0,0
1135007,53,1,1960,1,male,1236,35,8,0,0,0,0,0,0
1419652,53,26,1960,5,female,145,34,18,0,0,0,0,0,0
1849987,53,22,1960,8,male,381,35,15,0,2,0,2,0,0
1938103,53,24,1960,8,male,300,34,32,0,0,0,0,0,0
1714598,55,8,1958,11,male,668,34,30,0,0,0,0,0,0
1615855,55,25,1958,12,female,1223,35,11,0,3,0,2,0,1
1679425,54,14,1959,6,male,971,34,15,0,4,0,4,0,0
1026182,56,17,1957,12,female,395,35,15,0,1,0,1,0,0
2033515,55,6,1958,8,female,538,35,6,0,0,0,0,0,0
1723192,55,20,1958,10,male,702,34,11,0,0,0,0,0,0
1136316,57,10,1956,11,male,416,35,21,0,0,0,0,0,0
1720371,57,24,1956,12,female,501,34,20,0,0,0,0,0,0
1584655,56,2,1957,5,male,266,34,17,0,0,0,0,0,0
2151137,56,27,1957,10,male,167,35,29,0,0,0,0,0,0
1845662,58,16,1955,11,female,304,35,18,0,2,0,0,0,2
1259363,57,18,1956,3,female,1440,35,27,0,0,0,0,0,0
1332071,57,26,1956,5,male,435,35,11,0,0,0,0,0,0
1579219,57,30,1956,9,male,321,35,19,0,0,0,0,0,0
1457354,57,1,1956,9,male,631,34,4,0,6,0,3,0,3
1622039,59,29,1954,11,male,786,35,32,0,3,0,0,0,3
1873198,59,19,1954,11,male,86,34,17,0,3,0,2,0,1
1676081,59,29,1954,12,female,1490,35,11,0,1,0,1,0,0
1264803,58,20,1955,1,male,1281,35,16,0,0,0,0,0,0
1884324,58,31,1955,1,female,416,35,31,0,0,0,0,0,0
1702807,58,21,1955,2,male,930,34,10,0,14,0,4,0,10
1141616,58,11,1955,4,male,275,34,24,0,7,0,5,0,2
1602297,58,15,1955,6,female,210,34,31,0,0,0,0,0,0
1050291,59,6,1954,3,male,96,35,25,0,0,0,0,0,0
1599063,59,4,1954,9,male,444,34,13,0,0,0,0,0,0
2081913,60,18,1953,3,female,292,34,9,0,0,0,0,0,0
2047798,60,28,1953,4,male,1675,35,21,0,0,0,0,0,0
1121896,60,28,1953,8,female,1020,34,22,0,2,0,1,0,1
1292527,60,8,1953,9,female,554,34,21,0,0,0,0,0,0
2179113,62,24,1951,12,male,141,35,27,0,0,0,0,0,0
1252559,61,19,1952,7,female,606,34,23,0,0,0,0,0,0
1688174,61,26,1952,9,male,414,35,23,0,0,0,0,0,0
1703336,62,15,1951,1,male,281,35,14,0,3,0,1,0,2
1249375,62,6,1951,7,female,243,34,19,0,0,0,0,0,0
1707248,62,31,1951,8,male,261,35,12,0,0,0,0,0,0
2044650,62,12,1951,9,male,512,35,26,0,1,0,0,0,1
1834675,64,8,1949,12,male,665,35,14,0,0,0,0,0,0
1712645,63,5,1950,1,male,41,34,8,0,5,0,2,0,3
2061377,63,13,1950,10,female,1492,34,16,0,5,0,2,0,3
1317008,65,11,1948,11,female,1598,34,17,0,0,0,0,0,0
1649048,64,28,1949,3,female,576,35,29,0,0,0,0,0,0
1805959,64,13,1949,5,male,1245,35,16,0,3,0,0,0,3
1558605,64,25,1949,5,male,946,34,16,0,0,0,0,0,0
1358646,64,19,1949,7,male,1753,34,18,0,7,0,7,0,0
2005268,66,14,1947,11,male,370,35,19,0,11,0,7,0,4
1284119,65,6,1948,4,female,1235,34,25,0,0,0,0,0,0
1995755,65,4,1948,4,male,152,34,18,0,53,0,33,0,20
1559903,65,20,1948,7,female,1308,35,18,0,0,0,0,0,0
1796318,65,20,1948,10,female,414,35,19,0,6,0,1,0,5
2173438,65,7,1948,10,female,474,34,18,0,0,0,0,0,0
1090100,67,23,1946,12,female,1014,34,7,0,0,0,0,0,0
1963560,67,19,1946,7,male,183,35,32,0,4,0,4,0,0
2177064,67,19,1946,8,male,1925,34,15,0,2,0,1,0,1
1447563,67,8,1946,10,female,322,35,29,0,0,0,0,0,0
1140936,68,24,1945,1,male,235,35,17,0,2,0,1,0,1
1630551,68,7,1945,7,male,1144,34,25,0,0,0,0,0,0
1579464,71,15,1942,12,male,1032,34,20,0,0,0,0,0,0
1443542,70,4,1943,6,female,1524,35,19,0,1,0,0,0,1
1757251,71,13,1942,1,female,179,34,29,0,9,0,2,0,7
2000391,72,10,1941,6,female,109,35,25,0,0,0,0,0,0
1110142,73,4,1940,2,male,1510,34,9,0,0,0,0,0,0
1665382,73,24,1940,2,female,817,35,11,0,4,0,4,0,0
1600415,73,1,1940,3,female,1515,35,16,0,0,0,0,0,0
1617763,73,30,1940,5,male,1435,34,16,0,1,0,1,0,0
1816562,73,4,1940,7,female,819,35,23,0,7,0,1,0,6
1420645,76,19,1937,3,male,283,34,29,0,4,0,2,0,2
1435006,76,21,1937,5,male,1023,34,22,0,13,0,10,0,3
1911261,78,10,1935,6,male,1014,35,18,0,2,0,1,0,1
1070820,79,9,1934,9,male,2239,35,12,0,0,0,0,0,0
1037685,83,30,1930,3,female,615,35,16,0,1,0,1,0,0
1717563,86,2,1927,7,male,277,34,31,0,6,0,6,0,0
1969091,92,9,1921,9,female,1100,35,14,0,3,0,3,0,0
1620656,96,30,1917,8,male,845,35,23,0,0,0,0,0,0
2150337,100,7,1913,2,male,923,34,11,0,0,0,0,0,0
1571715,103,25,1910,12,male,726,35,29,0,1,0,1,0,0
1150913,108,18,1905,12,male,1117,35,22,0,0,0,0,0,0
2039342,108,1,1905,1,male,857,34,15,0,0,0,0,0,0
1242618,108,18,1905,2,male,983,35,34,0,0,0,0,0,0
1435053,112,1,1901,1,male,1760,34,13,0,0,0,0,0,0
1327599,16,8,1997,8,male,458,34,29,1,0,0,0,1,0
1242883,17,18,1996,9,male,133,35,32,1,0,0,0,1,0
1955645,18,14,1995,3,male,246,34,25,1,0,0,0,1,0
1760034,19,1,1994,1,male,251,35,17,1,0,0,0,1,0
2009998,21,16,1992,5,female,59,35,27,1,0,0,0,1,0
1163987,21,17,1992,9,female,205,35,10,1,0,0,0,1,0
1480124,22,4,1991,2,male,345,35,28,1,0,0,0,1,0
1212550,22,26,1991,10,male,123,34,28,1,0,0,0,1,0
1040517,26,5,1987,12,female,289,34,27,1,0,0,0,1,0
1596995,50,17,1963,6,male,1846,35,10,1,0,0,0,1,0
1328910,54,20,1959,12,female,318,35,17,1,0,0,0,1,0
1725524,55,18,1958,11,female,588,35,25,1,0,0,0,1,0
1220006,61,26,1952,7,male,351,34,23,1,0,0,0,1,0
1064848,63,2,1950,2,female,1008,35,22,1,0,0,0,1,0
1408225,65,18,1948,10,female,155,34,31,1,0,0,0,1,0
2111353,68,18,1945,3,female,203,35,22,1,0,0,0,1,0
1088676,68,30,1945,5,male,1797,35,17,1,0,0,0,1,0
1469282,69,22,1944,8,male,747,35,22,1,0,0,0,1,0
1441170,72,27,1941,1,female,1093,35,21,1,0,0,0,1,0
1576943,103,28,1910,4,male,128,35,26,1,0,0,0,1,0
2022323,16,23,1997,8,male,753,35,23,1,1,0,1,1,0
1600483,17,1,1996,1,male,461,34,24,1,1,0,0,1,1
1545219,21,18,1992,5,male,419,34,27,1,1,0,1,1,0
1710528,23,21,1990,10,female,358,34,7,1,1,0,1,1,0
1673234,26,18,1987,10,male,348,34,15,1,1,0,0,1,1
1141119,28,3,1985,9,male,1021,34,10,1,1,0,1,1,0
2080693,31,20,1982,2,male,152,34,15,1,1,0,1,1,0
1489186,48,14,1965,4,female,360,35,8,1,1,0,0,1,1
1228185,54,3,1959,8,female,1177,35,14,1,1,0,1,1,0
1048576,65,24,1948,9,female,465,34,24,1,1,0,1,1,0
1830527,71,11,1942,2,female,194,34,32,1,1,0,1,1,0
1632214,24,8,1989,1,male,137,34,24,1,5,0,2,1,3
1879692,33,6,1980,7,male,86,34,28,1,4,0,0,1,4
1453677,35,8,1978,11,male,63,34,30,1,2,0,2,1,0
2067191,34,3,1979,5,female,484,34,9,1,16,0,10,1,6
1725419,38,10,1975,10,male,1041,35,23,1,2,0,1,1,1
1205408,39,10,1974,7,female,255,35,11,1,3,0,0,1,3
1540256,40,14,1973,7,female,279,34,22,1,2,0,2,1,0
1555002,45,9,1968,12,male,822,35,26,1,39,0,24,1,15
2178194,50,14,1963,8,male,405,35,23,1,2,0,1,1,1
1276496,50,21,1963,10,female,949,35,26,1,3,0,1,1,2
1404417,52,8,1961,10,female,302,34,17,1,16,0,3,1,13
2134952,54,30,1959,3,female,205,35,20,1,6,0,3,1,3
1803076,55,7,1958,7,female,462,34,7,1,18,0,10,1,8
1108456,58,4,1955,4,male,119,35,32,1,2,0,1,1,1
1599554,59,9,1954,10,male,992,35,14,1,7,0,0,1,7
1615163,61,12,1952,9,male,1637,34,18,1,24,0,4,1,20
1941541,62,9,1951,3,female,592,35,27,1,19,0,17,1,2
1224343,64,18,1949,1,male,1336,35,7,1,6,0,2,1,4
1983961,70,4,1943,4,female,1571,35,14,1,10,0,4,1,6
1704007,74,6,1939,2,male,827,34,25,1,15,0,14,1,1
1465784,77,6,1936,8,female,632,34,23,1,20,0,2,1,18
2103185,103,12,1910,5,female,781,34,27,1,19,0,8,1,11
1473204,16,30,1997,11,male,338,34,24,1,0,1,0,0,0
1602616,16,15,1997,2,female,320,35,11,1,0,1,0,0,0
2149317,17,1,1996,7,male,133,34,33,1,0,1,0,0,0
1628452,19,13,1994,11,male,227,34,21,1,0,1,0,0,0
1388813,18,11,1995,2,female,314,34,32,1,0,1,0,0,0
2081803,23,30,1990,11,male,324,35,26,1,0,1,0,0,0
1371848,23,17,1990,11,female,108,34,27,1,0,1,0,0,0
2152021,22,8,1991,1,male,364,34,25,1,0,1,0,0,0
1198780,23,1,1990,1,male,79,34,25,1,0,1,0,0,0
1115676,25,1,1988,1,male,233,34,32,1,0,1,0,0,0
2094248,25,1,1988,1,male,123,34,24,1,0,1,0,0,0
1269672,28,3,1985,3,male,863,35,31,1,0,1,0,0,0
2128356,28,19,1985,6,male,349,35,16,1,0,1,0,0,0
1676763,28,2,1985,7,female,460,35,16,1,0,1,0,0,0
1943964,28,12,1985,8,male,174,34,26,1,0,1,0,0,0
1493839,30,19,1983,12,male,285,35,30,1,0,1,0,0,0
1636692,31,1,1982,2,male,85,34,20,1,0,1,0,0,0
2106161,31,9,1982,5,male,240,34,19,1,0,1,0,0,0
1241374,32,7,1981,4,male,411,35,31,1,0,1,0,0,0
1831961,33,17,1980,5,male,616,34,25,1,0,1,0,0,0
1684288,36,14,1977,11,female,35,34,31,1,0,1,0,0,0
2167365,36,3,1977,3,female,132,35,34,1,0,1,0,0,0
2021032,39,10,1974,10,male,253,34,17,1,0,1,0,0,0
1148127,41,30,1972,1,female,178,35,24,1,0,1,0,0,0
1754209,42,26,1971,2,female,874,35,21,1,0,1,0,0,0
2069335,48,10,1965,12,male,577,35,18,1,0,1,0,0,0
1316174,49,27,1964,2,female,734,35,25,1,0,1,0,0,0
2014762,52,24,1961,4,female,649,35,23,1,0,1,0,0,0
1979999,66,3,1947,8,male,1743,34,26,1,0,1,0,0,0
1264310,67,28,1946,7,male,433,34,29,1,0,1,0,0,0
1296372,67,1,1946,8,male,1528,35,12,1,0,1,0,0,0
1579510,16,15,1997,3,male,12,34,32,1,1,1,1,0,0
2032982,16,9,1997,7,male,415,35,25,1,1,1,0,0,1
1838627,16,2,1997,7,male,29,34,29,1,1,1,1,0,0
1566654,20,20,1993,2,male,735,35,21,1,1,1,0,0,1
1252660,20,10,1993,5,male,84,34,0,1,1,1,1,0,0
1638260,21,3,1992,3,male,258,34,22,1,1,1,0,0,1
1112648,23,30,1990,11,male,528,34,30,1,1,1,0,0,1
1183525,28,15,1985,11,male,427,35,19,1,1,1,0,0,1
2001191,27,3,1986,2,male,220,34,30,1,1,1,1,0,0
1963389,29,5,1984,6,male,162,34,29,1,1,1,0,0,1
1408749,30,2,1983,10,male,179,35,27,1,1,1,0,0,1
2007247,35,1,1978,6,male,532,34,32,1,1,1,1,0,0
1849243,40,18,1973,4,female,684,35,8,1,1,1,1,0,0
1440373,50,9,1963,3,female,333,34,28,1,1,1,1,0,0
1369734,52,27,1961,4,female,274,35,13,1,1,1,0,0,1
1972087,59,19,1954,6,female,129,35,32,1,1,1,1,0,0
1143821,71,6,1942,1,male,1391,35,7,1,1,1,1,0,0
1329661,15,1,1998,9,female,261,35,7,1,5,1,5,0,0
1469648,17,7,1996,7,female,516,35,14,1,5,1,1,0,4
1848272,20,1,1993,1,male,81,34,16,1,2,1,1,0,1
1838962,21,14,1992,7,male,543,35,16,1,6,1,6,0,0
1053639,21,16,1992,10,male,326,35,17,1,2,1,2,0,0
1986662,25,2,1988,5,male,58,34,16,1,5,1,5,0,0
2045300,27,6,1986,10,male,388,34,25,1,3,1,1,0,2
1774775,29,9,1984,10,female,445,35,7,1,3,1,3,0,0
1169881,30,24,1983,1,male,687,35,13,1,20,1,20,0,0
1953731,34,12,1979,6,female,102,35,29,1,10,1,9,0,1
2084050,35,5,1978,3,female,383,34,11,1,5,1,3,0,2
1366788,35,3,1978,4,male,375,34,31,1,14,1,12,0,2
1296085,35,26,1978,6,male,46,35,32,1,5,1,5,0,0
1231143,36,3,1977,5,male,344,35,24,1,54,1,49,0,5
1630369,38,6,1975,6,male,158,35,23,1,7,1,7,0,0
1610191,40,10,1973,12,male,321,34,16,1,2,1,2,0,0
1309784,40,7,1973,12,male,100,34,33,1,7,1,2,0,5
1323281,41,24,1972,11,male,696,34,23,1,9,1,5,0,4
1130240,41,21,1972,2,male,587,34,25,1,54,1,32,0,22
2037242,42,16,1971,4,male,374,35,13,1,19,1,9,0,10
1142204,45,1,1968,7,female,311,34,27,1,6,1,5,0,1
1615907,48,16,1965,5,male,1455,34,16,1,4,1,3,0,1
1938185,48,13,1965,5,male,530,34,10,1,2,1,2,0,0
1090478,50,16,1963,12,female,1029,35,16,1,2,1,2,0,0
1547811,53,24,1960,11,male,190,35,2,1,5,1,5,0,0
1785876,53,25,1960,4,female,537,34,9,1,6,1,1,0,5
1112190,57,18,1956,5,female,10,34,28,1,6,1,3,0,3
2073215,58,16,1955,10,female,321,35,11,1,4,1,3,0,1
2060071,101,1,1912,1,male,977,35,25,1,12,1,6,0,6
1374230,17,22,1996,11,male,407,34,27,2,0,0,0,2,0
1175315,29,16,1984,12,male,725,35,25,2,0,0,0,2,0
1035041,44,16,1969,11,male,886,35,27,2,0,0,0,2,0
1540429,55,2,1958,11,male,302,34,32,2,0,0,0,2,0
1523634,101,2,1912,10,male,1565,34,10,2,0,0,0,2,0
1474870,51,13,1962,5,male,1253,35,16,2,1,0,1,2,0
1600967,58,6,1955,9,female,301,34,29,2,1,0,1,2,0
1330628,61,23,1952,12,female,724,35,20,2,1,0,0,2,1
1251662,65,30,1948,1,female,285,35,19,2,1,0,1,2,0
1959671,28,21,1985,8,male,614,34,16,2,2,0,0,2,2
2038159,56,22,1957,1,male,440,35,28,2,2,0,0,2,2
1601845,57,1,1956,7,male,1239,34,19,2,2,0,1,2,1
1191233,74,22,1939,7,male,275,35,19,2,2,0,0,2,2
1740881,76,17,1937,7,male,2289,34,16,2,2,0,0,2,2
1282387,22,31,1991,8,male,761,35,32,2,8,0,1,2,7
1473908,23,7,1990,2,female,361,34,29,2,6,0,4,2,2
1200224,40,16,1973,8,male,363,35,27,2,3,0,1,2,2
1122186,47,23,1966,12,male,222,34,27,2,6,0,0,2,6
1427575,62,9,1951,3,male,827,34,23,2,9,0,2,2,7
1702342,70,31,1943,7,female,420,34,27,2,4,0,1,2,3
2042761,78,21,1935,9,male,372,34,14,2,3,0,0,2,3
2107333,28,9,1985,12,female,339,35,34,2,0,1,0,1,0
1845633,53,21,1960,2,male,438,35,5,2,39,1,32,1,7
1303916,17,4,1996,12,female,176,34,20,2,0,2,0,0,0
1254421,19,19,1994,2,female,58,34,25,2,0,2,0,0,0
2140857,20,2,1993,8,male,214,34,19,2,0,2,0,0,0
1030978,27,30,1986,3,male,419,34,7,2,0,2,0,0,0
1709302,29,23,1984,7,male,254,35,28,2,0,2,0,0,0
1625716,30,29,1983,3,male,741,35,27,2,0,2,0,0,0
2100599,30,23,1983,4,female,332,35,23,2,0,2,0,0,0
1127288,30,8,1983,7,male,289,35,21,2,0,2,0,0,0
1052549,30,10,1983,8,female,344,34,17,2,0,2,0,0,0
1216706,34,11,1979,2,female,820,35,8,2,0,2,0,0,0
1174310,39,16,1974,8,male,228,34,28,2,0,2,0,0,0
1462533,41,11,1972,2,female,15,34,1,2,0,2,0,0,0
1108801,42,30,1971,6,male,174,34,31,2,0,2,0,0,0
1104462,43,14,1970,1,male,137,35,28,2,0,2,0,0,0
1403780,13,7,2000,3,male,28,34,25,2,1,2,1,0,0
1396132,18,10,1995,2,male,171,35,15,2,1,2,1,0,0
2007255,20,24,1993,5,male,447,34,6,2,1,2,1,0,0
1474840,22,18,1991,8,male,209,35,26,2,1,2,1,0,0
1643666,33,1,1980,11,male,16,34,20,2,1,2,1,0,0
1361222,34,18,1979,2,male,113,35,29,2,1,2,1,0,0
1055422,35,12,1978,9,male,252,34,20,2,1,2,0,0,1
1832718,37,5,1976,11,male,193,35,24,2,1,2,1,0,0
1073241,37,6,1976,2,male,463,34,17,2,1,2,1,0,0
2028134,71,2,1942,2,female,538,34,23,2,1,2,1,0,0
1958145,21,11,1992,1,male,231,35,4,2,2,2,1,0,1
1374100,28,5,1985,7,female,121,34,15,2,2,2,2,0,0
1198248,33,22,1980,2,male,194,34,17,2,2,2,1,0,1
1077246,34,1,1979,8,male,572,35,11,2,2,2,2,0,0
1496111,39,28,1974,2,male,286,34,29,2,2,2,1,0,1
1612075,16,5,1997,1,male,3,34,14,2,5,2,2,0,3
1651117,17,5,1996,5,female,17,35,32,2,10,2,6,0,4
1419175,18,23,1995,2,female,403,34,20,2,3,2,3,0,0
2115682,20,16,1993,11,female,10,35,25,2,7,2,5,0,2
1143541,20,26,1993,10,male,81,34,27,2,10,2,1,0,9
2111048,21,29,1992,4,female,35,35,20,2,5,2,5,0,0
1781447,23,3,1990,1,female,169,34,12,2,8,2,6,0,2
1487374,23,17,1990,8,male,1075,35,18,2,6,2,6,0,0
1743213,24,6,1989,3,male,745,34,8,2,4,2,4,0,0
2052649,26,7,1987,5,male,237,35,29,2,18,2,17,0,1
1085766,26,24,1987,9,female,59,35,30,2,3,2,0,0,3
1424903,28,2,1985,1,male,673,35,29,2,4,2,3,0,1
1185861,28,18,1985,6,male,69,34,29,2,4,2,4,0,0
1271002,28,7,1985,8,male,886,35,20,2,4,2,4,0,0
1620693,28,18,1985,10,male,77,34,29,2,18,2,16,0,2
1135266,32,19,1981,9,male,240,34,18,2,14,2,9,0,5
1242382,36,14,1977,9,female,19,35,11,2,3,2,2,0,1
1824133,41,25,1972,3,male,245,34,26,2,16,2,7,0,9
1127653,42,25,1971,10,male,29,35,10,2,19,2,10,0,9
2008324,43,11,1970,9,male,165,34,29,2,3,2,3,0,0
1232834,49,19,1964,11,female,62,34,24,2,5,2,1,0,4
1790119,52,18,1961,10,male,63,34,31,2,3,2,2,0,1
1449453,58,15,1955,5,male,1401,35,18,2,59,2,54,0,5
1437981,58,13,1955,8,male,843,34,20,2,4,2,4,0,0
1712148,68,18,1945,8,male,97,34,29,2,17,2,12,0,5
1004174,71,23,1942,7,female,665,35,18,2,7,2,0,0,7
1703245,74,30,1939,1,male,119,35,30,2,8,2,1,0,7
2025049,13,27,2000,4,male,161,35,10,3,0,0,0,3,0
1999163,15,3,1998,11,male,592,34,27,3,0,0,0,3,0
1782513,75,9,1938,1,female,189,34,26,3,0,0,0,3,0
2125743,103,4,1910,1,female,940,35,18,3,0,0,0,3,0
2154718,44,17,1969,12,male,485,34,25,3,1,0,0,3,1
1144852,57,8,1956,9,male,1459,34,13,3,1,0,1,3,0
1866952,65,26,1948,10,male,1569,34,13,3,1,0,0,3,1
1777310,103,9,1910,12,female,1370,35,10,3,1,0,0,3,1
1464428,63,1,1950,4,female,1557,35,5,3,3,0,1,3,2
1757808,18,21,1995,10,female,474,35,24,3,33,0,10,3,23
2144427,27,16,1986,8,male,128,35,29,3,20,0,10,3,10
1686277,57,26,1956,3,male,130,34,21,3,26,0,23,3,3
1108621,85,21,1928,12,female,617,34,22,3,17,0,1,3,16
2092964,21,22,1992,9,female,461,34,29,3,0,1,0,2,0
2070035,49,14,1964,1,male,816,35,11,3,1,2,1,1,0
1008556,23,15,1990,1,male,699,34,25,3,2,2,1,1,1
1460716,18,2,1995,2,male,146,35,30,3,24,1,14,2,10
1475762,25,1,1988,1,female,591,35,26,3,5,2,2,1,3
1335613,40,29,1973,6,male,1379,34,20,3,10,1,5,2,5
1543046,58,16,1955,7,male,1184,35,23,3,5,1,5,2,0
1440459,19,14,1994,4,male,61,34,29,3,0,3,0,0,0
1987758,21,27,1992,9,male,265,35,34,3,0,3,0,0,0
1007362,25,29,1988,1,male,75,35,31,3,0,3,0,0,0
1789898,35,1,1978,7,male,221,34,27,3,0,3,0,0,0
1824530,40,20,1973,2,male,131,35,30,3,0,3,0,0,0
1573175,46,7,1967,8,male,101,34,5,3,0,3,0,0,0
1296392,20,5,1993,11,male,326,34,15,3,1,3,0,0,1
1802031,21,21,1992,12,male,94,34,27,3,1,3,1,0,0
2025881,42,9,1971,5,male,155,34,16,3,1,3,0,0,1
2067784,43,5,1970,5,male,674,34,18,3,1,3,1,0,0
1465743,16,5,1997,11,male,322,34,23,3,2,3,2,0,0
1064054,16,3,1997,9,male,339,34,25,3,4,3,3,0,1
1917708,21,24,1992,1,male,150,34,30,3,2,3,1,0,1
2067499,22,15,1991,4,female,323,35,33,3,2,3,1,0,1
1206890,24,7,1989,2,male,265,35,27,3,2,3,2,0,0
1714743,59,28,1954,6,male,1071,34,17,3,2,3,2,0,0
1350100,17,29,1996,7,female,50,35,23,3,6,3,2,0,4
1450483,23,15,1990,11,female,358,35,14,3,6,3,4,0,2
1828251,29,17,1984,9,female,554,35,14,3,5,3,3,0,2
1005568,30,21,1983,9,female,354,35,23,3,50,3,43,0,7
1812605,61,15,1952,8,male,1232,35,13,3,15,3,9,0,6
1119805,65,10,1948,2,male,962,34,20,3,7,3,7,0,0
1776072,67,12,1946,11,male,897,35,8,3,5,3,3,0,2
1862429,80,16,1933,8,female,1023,35,13,3,5,3,3,0,2
1820545,21,20,1992,9,male,601,35,21,4,0,0,0,4,0
2050571,58,8,1955,3,male,257,34,24,4,0,0,0,4,0
1031761,25,8,1988,6,male,305,35,32,4,1,0,1,4,0
1819740,60,12,1953,9,female,1249,34,14,4,1,0,0,4,1
1103191,61,19,1952,8,female,472,34,28,4,2,0,1,4,1
1487884,61,18,1952,10,female,623,35,31,4,2,0,0,4,2
1455805,66,9,1947,6,female,1199,34,17,4,1,0,0,4,1
1380277,108,30,1905,1,male,106,34,25,4,2,0,1,4,1
2000591,14,26,1999,5,male,339,35,26,4,3,0,3,4,0
1785138,16,19,1997,7,male,20,35,24,4,13,0,5,4,8
1291931,26,6,1987,3,female,442,35,17,4,17,0,6,4,11
1138950,29,23,1984,6,female,160,35,19,4,12,0,3,4,9
1507182,52,13,1961,11,male,339,35,30,4,22,0,7,4,15
1310430,71,11,1942,11,female,13,34,32,4,7,0,5,4,2
1645154,80,8,1933,8,female,884,35,20,4,26,0,14,4,12
1624740,25,16,1988,11,male,422,35,11,4,0,1,0,3,0
1725399,64,6,1949,6,female,1687,34,3,4,1,1,1,3,0
1854946,18,11,1995,11,male,540,34,23,4,0,3,0,1,0
1420735,66,22,1947,4,female,265,34,18,4,1,3,0,1,1
2098612,15,16,1998,4,female,190,35,23,4,0,4,0,0,0
1788574,19,14,1994,9,female,265,34,29,4,0,4,0,0,0
1636506,47,21,1966,1,male,208,35,31,4,0,4,0,0,0
1808581,14,18,1999,10,male,140,34,20,4,1,4,1,0,0
2080147,16,7,1997,3,male,19,35,24,4,1,4,1,0,0
1535188,19,21,1994,9,male,315,34,16,4,2,4,0,0,2
1476962,25,1,1988,1,male,222,35,29,4,1,4,1,0,0
1702078,44,22,1969,12,male,626,34,21,4,2,4,1,0,1
1132524,56,26,1957,4,male,731,35,31,4,2,4,0,0,2
1777158,20,23,1993,2,male,209,35,22,4,4,4,1,0,3
1796576,54,25,1959,3,male,2261,35,18,4,4,4,4,0,0
1708379,15,26,1998,5,male,79,34,25,4,20,4,13,0,7
1416959,16,4,1997,8,female,433,34,17,4,11,4,10,0,1
1861385,29,11,1984,4,male,24,34,24,4,11,4,4,0,7
1100407,41,27,1972,11,male,456,34,14,4,6,4,4,0,2
1418481,64,21,1949,8,female,92,34,32,4,8,4,4,0,4
1437936,75,11,1938,11,female,30,34,21,4,25,4,18,0,7
1648677,23,4,1990,7,male,496,35,27,5,0,0,0,5,0
2124384,31,18,1982,9,male,832,34,21,5,2,0,1,5,1
2163069,63,17,1950,2,female,194,34,25,5,2,0,1,5,1
1310127,67,15,1946,9,male,1503,35,17,5,2,0,1,5,1
1137949,19,5,1994,6,female,155,35,25,5,18,0,2,5,16
1152827,24,6,1989,12,male,414,35,24,5,20,0,5,5,15
1622737,23,13,1990,7,male,86,35,19,5,11,0,0,5,11
1173966,44,22,1969,10,female,486,34,11,5,11,0,4,5,7
1709742,56,27,1957,3,female,151,35,23,5,10,0,2,5,8
1738412,62,1,1951,2,male,1306,34,9,5,9,0,1,5,8
1120937,69,20,1944,3,female,1426,34,16,5,9,0,2,5,7
1079530,74,30,1939,10,female,1338,34,24,5,14,0,8,5,6
1616708,24,14,1989,7,male,507,34,13,5,6,2,0,3,6
1482037,38,11,1975,6,male,420,35,30,5,26,2,3,3,23
1842334,70,19,1943,11,female,765,35,29,5,8,2,7,3,1
1199083,48,23,1965,12,male,62,35,23,5,1,4,1,1,0
1635923,15,12,1998,7,male,39,35,21,5,4,4,1,1,3
1806467,57,19,1956,11,female,1347,34,21,5,7,4,6,1,1
1865177,25,1,1988,1,male,173,34,22,5,0,5,0,0,0
2192126,26,11,1987,2,male,170,34,33,5,0,5,0,0,0
1925300,34,13,1979,8,female,321,34,5,5,0,5,0,0,0
1342418,41,8,1972,7,male,294,34,27,5,0,5,0,0,0
1103056,15,14,1998,5,male,577,35,20,5,2,5,2,0,0
1066975,26,21,1987,11,male,436,35,15,5,2,5,2,0,0
2057214,30,8,1983,8,female,706,35,18,5,1,5,1,0,0
1247174,54,5,1959,10,male,768,35,22,5,3,5,3,0,0
1197619,61,10,1952,3,female,214,34,20,5,2,5,2,0,0
1935362,26,12,1987,8,male,114,35,26,5,6,5,6,0,0
1093290,49,1,1964,1,male,209,34,15,5,5,5,1,0,4
1513120,22,22,1991,9,female,41,35,28,5,12,5,11,0,1
1078027,32,16,1981,6,male,382,35,11,5,24,5,14,0,10
2069867,64,30,1949,10,female,848,34,15,5,11,5,11,0,0
2123259,23,1,1990,1,male,164,35,27,6,0,0,0,6,0
1618927,55,16,1958,6,male,503,35,8,6,0,0,0,6,0
1120948,56,9,1957,5,female,375,34,29,6,2,0,0,6,2
1547577,61,19,1952,3,female,231,34,21,6,2,0,1,6,1
1243494,70,11,1943,2,male,1269,34,18,6,1,0,0,6,1
1681204,62,12,1951,11,female,746,35,9,6,6,0,1,6,5
1556286,66,21,1947,10,female,1280,34,13,6,4,0,0,6,4
1012947,60,20,1953,7,female,121,34,15,6,18,0,7,6,11
1667447,62,20,1951,7,male,656,35,25,6,9,0,5,6,4
2149528,66,13,1947,12,female,416,35,17,6,9,0,3,6,6
2096188,109,16,1904,10,male,1666,35,16,6,23,1,8,5,15
1250026,51,5,1962,10,female,436,35,22,6,3,4,3,2,0
1569646,20,12,1993,2,male,486,35,18,6,7,5,3,1,4
1466448,16,5,1997,10,male,46,34,29,6,10,5,7,1,3
1366891,22,26,1991,10,male,387,35,22,6,0,6,0,0,0
1213897,27,5,1986,5,male,446,35,32,6,0,6,0,0,0
1220897,38,10,1975,8,male,221,34,25,6,0,6,0,0,0
1925648,39,3,1974,6,male,51,34,34,6,0,6,0,0,0
1863435,22,27,1991,12,male,138,34,28,6,2,6,1,0,1
2030384,31,2,1982,9,female,380,34,19,6,3,6,1,0,2
1899883,35,1,1978,1,male,22,35,30,6,1,6,1,0,0
1046127,40,11,1973,2,male,880,34,13,6,2,6,0,0,2
1240636,50,16,1963,4,male,218,35,22,6,3,6,2,0,1
1502346,23,29,1990,11,female,63,35,18,6,6,6,6,0,0
1554713,27,11,1986,11,male,18,34,26,6,4,6,1,0,3
2066954,25,1,1988,1,male,162,35,24,6,18,6,13,0,5
1179014,36,23,1977,11,female,30,34,20,6,61,6,57,0,4
1258513,84,1,1929,1,female,1713,35,21,6,9,6,4,0,5
1069922,13,21,2000,7,male,103,35,18,7,1,0,0,7,1
1047323,18,1,1995,4,male,106,35,10,7,0,1,0,6,0
1505112,27,9,1986,8,male,440,34,26,7,0,0,0,7,0
1318721,27,29,1986,6,female,374,35,28,7,3,0,0,7,3
1513577,86,2,1927,2,female,228,34,32,7,2,0,1,7,1
1218035,26,26,1987,2,female,961,35,20,7,6,0,3,7,3
2180938,16,17,1997,1,male,584,35,16,7,39,0,12,7,27
1794896,36,15,1977,9,male,519,35,34,7,23,0,8,7,15
1391710,51,10,1962,2,male,378,34,12,7,15,0,2,7,13
1243800,19,1,1994,2,male,45,35,28,7,1,2,1,5,0
1782188,51,1,1962,1,female,306,34,30,7,1,4,1,3,0
1865393,56,7,1957,4,male,452,35,32,7,3,2,2,5,1
1654549,57,18,1956,10,male,1581,35,14,7,5,5,3,2,2
1780332,41,25,1972,1,male,180,35,29,7,20,4,15,3,5
1525685,52,27,1961,9,male,2052,34,20,7,12,5,1,2,11
1650672,26,17,1987,3,male,147,35,23,7,3,6,0,1,3
1126688,17,1,1996,1,male,24,34,33,7,1,7,0,0,1
1968535,25,1,1988,1,male,213,35,14,7,1,7,1,0,0
1973738,26,1,1987,1,male,338,34,26,7,0,7,0,0,0
1013367,26,14,1987,4,male,432,35,35,7,1,7,1,0,0
1088245,42,20,1971,2,male,492,35,10,7,0,7,0,0,0
1911332,48,7,1965,10,female,187,35,19,7,0,7,0,0,0
1174274,51,2,1962,8,male,659,34,19,7,1,7,1,0,0
1961741,68,17,1945,8,male,98,34,29,7,0,7,0,0,0
1117371,25,6,1988,12,female,407,34,32,7,3,7,3,0,0
1777250,43,26,1970,9,female,417,34,12,7,2,7,0,0,2
1532324,51,3,1962,11,female,292,34,22,7,2,7,0,0,2
1102730,53,29,1960,3,female,280,34,18,7,3,7,2,0,1
1749824,61,20,1952,9,male,123,35,30,7,2,7,2,0,0
2149221,24,16,1989,2,male,232,35,16,7,7,7,6,0,1
1756102,25,6,1988,1,male,67,35,11,7,7,7,7,0,0
1356489,31,11,1982,12,male,531,34,23,7,7,7,2,0,5
1661635,16,27,1997,4,male,756,35,21,7,13,7,7,0,6
1707520,25,30,1988,1,female,167,34,21,7,24,7,14,0,10
2143914,56,15,1957,1,male,1019,34,22,7,13,7,11,0,2
1155578,67,14,1946,5,female,108,34,28,7,27,7,26,0,1
1183230,62,13,1951,12,female,1178,34,13,8,0,0,0,8,0
2095285,29,7,1984,8,male,417,35,17,8,2,0,1,8,1
1166325,40,6,1973,1,male,1002,34,23,8,4,0,4,8,0
1930569,53,18,1960,10,male,1203,35,11,8,5,0,2,8,3
1053545,79,19,1934,7,male,543,34,21,8,6,0,1,8,5
2130855,31,21,1982,4,female,466,35,23,8,40,0,4,8,36
1601352,65,1,1948,10,male,269,35,21,8,15,0,3,8,12
2073295,74,19,1939,11,female,364,35,25,8,24,0,12,8,12
1673640,18,29,1995,10,male,3,35,35,8,1,3,1,5,0
1547150,34,3,1979,3,male,399,35,22,8,1,3,1,5,0
1501096,65,11,1948,9,male,1391,34,6,8,3,7,2,1,1
1363690,19,15,1994,1,male,27,35,32,8,0,8,0,0,0
1874454,25,10,1988,9,female,203,34,34,8,1,8,0,0,1
1336961,35,8,1978,6,male,325,35,16,8,0,8,0,0,0
1795525,23,22,1990,8,male,511,34,19,8,2,8,2,0,0
1553608,14,17,1999,6,male,673,35,16,8,10,8,4,0,6
1865856,26,7,1987,6,male,24,34,7,8,7,8,5,0,2
1598685,38,4,1975,10,male,518,34,21,8,6,8,6,0,0
1382091,51,7,1962,9,male,363,34,21,8,9,8,7,0,2
1025235,27,27,1986,1,male,156,34,10,8,21,8,21,0,0
1235418,48,11,1965,2,male,582,35,21,8,185,8,113,0,72
1345535,55,1,1958,6,female,217,34,14,9,0,0,0,9,0
1029334,29,14,1984,9,male,809,35,25,9,2,0,0,9,2
1750493,51,16,1962,6,female,339,35,30,9,2,0,2,9,0
1349179,68,31,1945,5,female,1213,35,15,9,4,0,4,9,0
1707840,76,24,1937,2,female,1366,35,13,9,3,0,0,9,3
1285114,93,1,1920,1,female,1636,35,18,9,2,0,0,9,2
1674815,43,25,1970,10,male,152,35,19,9,10,1,3,8,7
1361497,49,14,1964,5,female,165,34,24,9,17,0,14,9,3
1754206,55,28,1958,3,female,874,34,28,9,14,0,10,9,4
1565213,55,10,1958,5,female,486,34,24,9,19,0,0,9,19
1874625,81,8,1932,10,female,1561,34,6,9,32,0,23,9,9
1546295,18,14,1995,1,male,290,34,7,9,0,9,0,0,0
2092625,28,14,1985,8,female,348,35,28,9,1,9,0,0,1
1264381,30,11,1983,1,male,1418,35,10,9,0,9,0,0,0
2073415,70,22,1943,7,female,1395,35,10,9,0,9,0,0,0
1021097,13,3,2000,1,male,30,34,13,9,2,9,1,0,1
1613166,30,25,1983,7,male,183,34,24,9,2,9,2,0,0
2102770,104,1,1909,10,female,13,35,15,9,2,9,2,0,0
1854048,20,26,1993,5,male,19,35,32,9,10,9,7,0,3
2063824,39,2,1974,5,female,477,34,21,9,10,9,9,0,1
1713954,19,16,1994,10,female,48,35,9,9,32,9,16,0,16
2028531,29,21,1984,5,female,157,35,21,9,16,9,15,0,1
1216039,36,26,1977,6,female,702,35,14,9,62,9,36,0,26
1391955,37,17,1976,5,female,204,34,29,9,17,9,12,0,5
1692057,43,23,1970,1,male,528,35,26,9,43,9,22,0,21
1386345,72,11,1941,5,female,751,35,12,10,0,0,0,10,0
1907679,44,26,1969,3,male,566,34,16,10,2,0,0,10,2
1362815,57,26,1956,7,male,1823,34,7,10,19,0,2,10,17
1176491,60,16,1953,1,female,668,34,13,10,132,1,52,9,80
1722383,66,1,1947,6,female,1258,34,14,10,24,6,18,4,6
1056633,66,17,1947,1,male,1639,35,11,10,5,8,2,2,3
2164147,19,24,1994,1,female,174,35,28,10,0,10,0,0,0
1840485,23,1,1990,1,male,219,34,32,10,0,10,0,0,0
1365530,35,23,1978,12,female,310,35,28,10,3,10,3,0,0
1561318,36,10,1977,11,male,259,35,24,10,6,10,5,0,1
1881687,48,7,1965,8,male,716,34,10,10,6,10,6,0,0
1906342,38,26,1975,9,female,415,35,17,10,8,10,4,0,4
1656875,43,27,1970,3,female,122,35,19,10,13,10,12,0,1
1822004,50,25,1963,8,male,337,35,10,10,89,10,81,0,8
2047279,30,21,1983,7,male,612,34,31,11,1,2,0,9,1
1928149,27,8,1986,6,male,289,35,19,11,4,0,1,11,3
1687366,77,28,1936,10,female,22,34,22,11,20,0,4,11,16
1645953,78,28,1935,2,male,392,35,17,11,25,0,8,11,17
1346762,22,1,1991,1,male,163,34,31,11,0,7,0,4,0
1865413,26,2,1987,3,male,345,35,32,11,3,7,3,4,0
1488677,63,20,1950,12,female,1359,35,6,11,24,4,9,7,15
1199218,24,21,1989,3,male,376,34,9,11,1,11,0,0,1
1327313,26,17,1987,2,male,72,35,34,11,0,11,0,0,0
1973772,35,7,1978,3,male,475,34,20,11,0,11,0,0,0
1734107,29,12,1984,4,female,258,34,7,11,3,11,3,0,0
1322915,50,15,1963,12,male,294,35,27,11,4,11,4,0,0
1590247,52,25,1961,4,female,47,35,9,11,3,11,3,0,0
1430390,66,18,1947,5,female,230,35,13,11,5,11,3,0,2
2079689,29,19,1984,5,male,216,35,13,11,7,11,7,0,0
1206310,37,24,1976,2,male,389,34,17,11,14,11,11,0,3
1864303,46,10,1967,9,male,242,34,24,11,11,11,6,0,5
1178302,51,24,1962,3,female,174,34,30,11,15,11,13,0,2
2057026,54,11,1959,12,female,452,35,19,11,8,11,2,0,6
1959886,54,3,1959,1,male,526,34,14,11,7,11,7,0,0
1351369,65,13,1948,2,male,900,34,18,11,12,11,6,0,6
2151521,26,14,1987,4,male,441,35,20,11,22,11,16,0,6
2128120,23,11,1990,2,male,532,34,6,12,0,0,0,12,0
1618375,38,12,1975,11,male,661,34,15,12,1,0,1,12,0
1549190,108,1,1905,1,male,19,34,26,12,3,0,3,12,0
1172345,51,28,1962,9,female,27,35,28,12,15,0,7,12,8
1300295,77,6,1936,4,male,1317,34,14,12,12,0,3,12,9
1316558,62,19,1951,8,male,158,34,14,12,38,0,24,12,14
1927221,58,25,1955,1,female,297,34,26,12,3,3,1,9,2
1685387,22,27,1991,6,male,164,35,26,12,0,12,0,0,0
1499582,25,1,1988,1,male,46,34,32,12,5,12,3,0,2
1037291,100,1,1913,1,male,887,34,16,12,3,12,3,0,0
1321629,25,21,1988,3,male,549,35,22,12,16,12,12,0,4
1746014,42,13,1971,2,male,152,34,19,12,15,12,11,0,4
1981545,49,5,1964,12,male,181,34,20,12,8,12,8,0,0
1223882,19,8,1994,4,male,419,34,29,13,0,0,0,13,0
1745557,53,15,1960,7,male,655,34,13,13,6,2,1,11,5
2177547,43,23,1970,8,male,92,34,31,13,9,0,4,13,5
2165967,59,11,1954,11,female,629,34,24,13,13,0,0,13,13
1402333,93,1,1920,1,female,1703,35,18,13,34,0,17,13,17
1839656,28,6,1985,1,male,539,35,23,13,0,8,0,5,0
1799804,17,4,1996,9,male,40,35,21,13,22,12,8,1,14
1373267,51,29,1962,5,female,14,35,34,13,15,13,15,0,0
1771050,22,10,1991,12,male,50,35,25,13,45,13,42,0,3
1866540,24,30,1989,10,female,22,34,15,13,22,13,13,0,9
1620172,27,10,1986,3,male,641,35,18,14,86,5,53,9,33
2060538,19,9,1994,2,male,101,34,34,14,0,14,0,0,0
1869851,27,6,1986,12,male,67,34,13,14,0,14,0,0,0
1033865,37,1,1976,1,female,126,35,28,14,4,14,1,0,3
2119888,31,1,1982,12,female,165,35,14,14,17,14,9,0,8
1969753,25,2,1988,1,female,46,35,33,14,55,14,51,0,4
1177024,20,15,1993,7,male,262,35,15,15,7,0,1,15,6
1444247,56,19,1957,7,female,362,35,20,15,9,0,0,15,9
1854565,21,15,1992,4,female,322,35,13,15,32,0,4,15,28
1342141,24,24,1989,1,male,685,34,21,15,13,9,12,6,1
1695295,27,6,1986,6,male,150,35,33,15,0,15,0,0,0
1249096,28,1,1985,1,male,98,34,33,15,2,15,2,0,0
1000867,18,5,1995,5,male,84,34,26,15,8,15,7,0,1
1774350,26,1,1987,1,male,176,35,33,15,6,15,6,0,0
1341081,22,14,1991,1,female,294,34,18,15,20,15,15,0,5
1727403,61,10,1952,8,female,126,34,25,15,41,15,28,0,13
2010032,77,1,1936,9,male,1691,34,14,16,2,0,2,16,0
2081409,104,9,1909,8,female,1205,35,28,16,1,0,0,16,1
1375713,58,20,1955,5,male,287,35,29,16,4,0,1,16,3
1222359,69,30,1944,8,female,421,34,22,16,4,0,0,16,4
1064883,54,20,1959,1,female,277,34,25,16,23,0,13,16,10
1079128,27,12,1986,4,female,529,35,20,16,27,1,18,15,9
1534811,73,9,1940,12,male,980,34,16,16,3,10,1,6,2
1899777,25,8,1988,8,male,63,35,20,16,0,16,0,0,0
1975147,60,30,1953,11,male,1403,35,10,16,1,16,0,0,1
1022465,69,6,1944,7,female,1236,34,18,17,2,15,2,2,0
1514653,13,12,2000,2,female,244,35,23,17,1,17,0,0,1
1147287,31,28,1982,8,male,813,35,12,17,0,17,0,0,0
1078387,55,19,1958,9,male,350,34,30,17,0,17,0,0,0
1362883,79,7,1934,2,male,1785,34,15,17,0,17,0,0,0
1423108,32,15,1981,7,female,541,34,16,17,10,17,7,0,3
1784464,56,11,1957,12,female,720,35,15,17,8,17,5,0,3
1349739,85,16,1928,10,female,137,35,25,17,35,17,22,0,13
1843287,28,1,1985,1,female,120,34,27,18,1,0,0,18,1
1550931,39,14,1974,2,female,425,35,17,18,4,0,0,18,4
1995158,70,9,1943,12,female,1590,35,23,18,13,0,8,18,5
2183398,18,24,1995,3,female,82,35,27,18,2,18,2,0,0
2134882,24,25,1989,9,female,66,34,30,18,1,18,1,0,0
1936680,63,18,1950,6,male,135,35,20,18,6,18,2,0,4
1559683,24,24,1989,9,female,175,34,20,18,22,18,12,0,10
2179144,28,13,1985,4,female,622,35,22,18,26,18,17,0,9
1146342,48,4,1965,4,male,33,34,32,18,13,18,13,0,0
1433153,66,29,1947,8,male,1400,35,11,18,22,18,20,0,2
1116883,94,2,1919,10,male,66,35,23,18,25,18,24,0,1
1380972,51,19,1962,5,male,242,34,27,18,33,18,14,0,19
2027819,35,25,1978,9,male,414,35,25,19,4,0,1,19,3
1522993,74,21,1939,11,male,63,34,22,19,8,0,7,19,1
2055305,20,28,1993,5,female,397,35,19,19,13,0,3,19,10
1076076,39,15,1974,1,male,485,35,22,19,5,8,2,11,3
2186418,19,27,1994,2,male,162,34,28,19,5,16,5,3,0
1783880,34,26,1979,7,female,771,35,20,19,3,19,2,0,1
1195833,24,27,1989,4,male,387,35,19,19,24,19,20,0,4
2177048,35,1,1978,3,male,513,34,11,19,12,19,12,0,0
1855245,22,24,1991,8,male,72,34,9,20,0,2,0,18,0
1429170,84,18,1929,3,female,620,34,20,20,4,0,2,20,2
1883373,24,6,1989,9,male,550,34,28,20,52,0,8,20,44
1661687,54,4,1959,1,male,607,35,26,20,46,0,14,20,32
1398066,56,13,1957,6,female,1343,35,13,20,57,0,4,20,53
1801360,40,19,1973,10,female,473,35,15,20,0,20,0,0,0
1589461,30,23,1983,12,female,301,35,18,20,10,20,8,0,2
1023337,52,24,1961,11,female,319,34,23,20,15,20,3,0,12
1202244,18,12,1995,4,male,10,34,26,20,35,20,35,0,0
1396539,55,1,1958,8,female,1272,35,15,20,59,20,52,0,7
1298435,66,23,1947,4,female,1062,34,8,21,24,0,3,21,21
1134782,19,5,1994,3,male,550,35,12,21,4,6,2,15,2
1839282,40,3,1973,8,male,170,34,29,21,3,21,0,0,3
1038193,54,29,1959,11,female,264,34,27,21,1,21,0,0,1
1885619,30,10,1983,9,male,822,35,10,21,61,21,60,0,1
1378198,38,15,1975,4,female,584,34,18,21,58,21,58,0,0
1347614,61,1,1952,12,male,896,35,17,22,6,17,2,5,4
1285563,50,11,1963,9,female,296,34,9,22,2,22,0,0,2
1297920,34,13,1979,5,male,248,34,26,23,0,0,0,23,0
1508494,67,27,1946,5,male,1898,34,4,23,0,0,0,23,0
1523909,32,9,1981,9,male,110,34,30,23,1,23,1,0,0
1206750,42,3,1971,4,male,428,35,18,23,1,23,1,0,0
1829041,68,13,1945,8,male,840,35,18,23,0,23,0,0,0
1613572,21,6,1992,5,female,299,34,8,23,16,23,15,0,1
1795134,60,20,1953,10,female,292,35,24,24,6,0,0,24,6
2012909,36,3,1977,2,male,224,35,29,24,9,11,9,13,0
1356871,54,14,1959,9,female,544,34,21,24,3,19,2,5,1
2174330,23,1,1990,1,female,162,35,23,24,21,24,20,0,1
2133058,35,31,1978,8,male,416,34,13,24,19,24,15,0,4
1210875,61,24,1952,1,male,1402,34,19,24,40,24,26,0,14
1044664,24,30,1989,8,male,262,34,24,25,153,20,92,5,61
1703917,45,27,1968,2,male,643,35,21,25,9,25,4,0,5
1373122,55,17,1958,2,female,512,35,28,25,9,25,7,0,2
1593199,23,10,1990,10,male,135,35,24,25,17,25,16,0,1
1167173,64,10,1949,9,male,930,35,20,26,0,0,0,26,0
1612721,27,13,1986,2,female,306,35,15,26,11,0,1,26,10
2120361,74,19,1939,11,female,1047,34,28,26,8,0,2,26,6
1968199,52,10,1961,1,male,1658,34,17,26,89,0,78,26,11
1517538,31,17,1982,6,male,294,34,24,26,71,23,37,3,34
1103752,14,25,1999,2,male,197,35,31,26,12,26,12,0,0
2169361,58,26,1955,3,male,671,34,24,27,3,27,3,0,0
1449827,49,16,1964,7,female,889,34,13,27,12,27,12,0,0
1431620,54,1,1959,11,female,95,35,25,27,5,27,3,0,2
1321418,13,20,2000,1,female,98,34,28,27,39,27,21,0,18
1139702,64,26,1949,7,male,1753,35,17,27,60,27,43,0,17
1234776,53,24,1960,11,male,38,35,21,28,22,0,3,28,19
1676716,63,4,1950,9,female,1845,34,14,28,43,1,26,27,17
1687985,24,14,1989,6,male,257,35,22,28,42,23,23,5,19
1553883,66,20,1947,3,female,2292,34,11,29,11,0,6,29,5
1859538,54,6,1959,10,male,1402,34,14,29,19,0,1,29,18
2063479,56,16,1957,1,female,64,34,24,29,28,1,10,28,18
1818977,61,9,1952,6,male,156,34,14,29,42,0,12,29,30
1210283,61,2,1952,3,male,1364,35,30,29,62,3,50,26,12
1885547,70,18,1943,12,female,508,34,26,29,31,22,20,7,11
1630198,49,27,1964,8,female,307,35,31,29,18,29,11,0,7
1084007,50,21,1963,7,male,1057,35,10,29,55,29,41,0,14
1483272,68,14,1945,1,male,618,34,30,31,0,1,0,30,0
1933658,24,25,1989,11,male,391,34,27,31,8,0,2,31,6
1387225,28,1,1985,1,male,126,35,31,31,8,3,0,28,8
1210699,57,24,1956,11,female,329,34,29,31,8,0,0,31,8
1456736,15,20,1998,9,male,224,35,20,31,25,20,20,11,5
1516068,22,25,1991,11,male,197,34,26,31,2,29,2,2,0
2117390,27,5,1986,8,male,627,35,11,30,13,30,13,0,0
1206059,39,8,1974,7,female,497,35,28,30,14,30,13,0,1
1241455,51,29,1962,6,male,175,35,32,31,6,31,5,0,1
2089269,21,20,1992,4,male,25,35,24,30,30,30,29,0,1
1062877,50,12,1963,3,female,768,34,12,31,26,31,16,0,10
1883309,33,17,1980,7,female,502,34,22,31,47,31,10,0,37
1950215,63,23,1950,11,male,1119,34,17,32,5,0,3,32,2
1536081,60,25,1953,6,male,635,35,16,32,9,0,4,32,5
1588265,77,17,1936,9,male,19,34,27,32,1,20,0,12,1
1369035,28,27,1985,10,male,290,35,29,32,34,29,18,3,16
2042436,41,1,1972,11,female,426,34,14,33,10,0,3,33,7
1330591,25,19,1988,5,male,343,35,14,33,2,33,2,0,0
1653962,19,1,1994,4,male,293,34,24,33,9,33,7,0,2
1662572,31,22,1982,6,male,454,34,19,33,11,33,4,0,7
1625570,61,10,1952,12,male,415,34,27,34,15,4,11,30,4
1511755,55,17,1958,1,male,75,34,27,34,0,34,0,0,0
2120780,63,7,1950,2,female,1245,34,17,34,3,34,3,0,0
1089677,27,2,1986,3,male,23,34,27,34,13,34,11,0,2
2130006,56,29,1957,12,female,843,34,28,35,5,0,1,35,4
1146411,67,18,1946,10,male,202,35,14,36,34,0,18,36,16
1897848,33,4,1980,12,female,248,34,30,36,8,15,3,21,5
1046766,22,4,1991,4,male,429,35,19,35,34,16,16,19,18
1153043,30,14,1983,10,male,509,35,30,35,25,25,17,10,8
1616724,20,20,1993,7,female,173,35,27,35,7,35,2,0,5
1915441,39,13,1974,7,male,30,34,28,35,8,35,6,0,2
1515508,21,12,1992,8,male,449,35,28,37,13,0,5,37,8
1133616,61,9,1952,2,male,196,34,28,37,22,0,3,37,19
1975464,59,1,1954,12,female,387,35,25,37,25,37,16,0,9
1856624,22,19,1991,2,female,556,34,21,39,3,3,1,36,2
1207218,23,25,1990,3,male,253,35,25,39,14,0,11,39,3
1362571,27,10,1986,10,male,835,35,27,39,77,15,21,24,56
1214858,25,5,1988,3,male,267,34,19,39,4,39,2,0,2
1428440,49,24,1964,8,female,672,35,5,39,5,39,5,0,0
1076258,30,16,1983,6,male,135,34,28,38,8,38,7,0,1
1981130,33,10,1980,4,female,627,34,12,39,26,39,25,0,1
2177318,70,22,1943,10,female,904,35,17,40,27,3,18,37,9
1357719,33,4,1980,3,male,562,35,27,40,1,40,1,0,0
1249490,35,22,1978,12,male,949,35,12,40,22,40,17,0,5
2016682,18,29,1995,1,male,21,35,11,40,49,40,47,0,2
1178065,39,10,1974,3,female,129,34,26,40,37,40,23,0,14
1454275,35,8,1978,7,female,486,35,9,41,19,1,7,40,12
1078468,70,28,1943,9,female,905,34,21,42,24,0,11,42,13
1873909,35,25,1978,12,female,80,34,34,41,39,25,21,16,18
1895797,55,23,1958,10,female,325,35,30,41,9,39,8,2,1
1486921,32,17,1981,8,female,763,35,31,42,39,33,31,9,8
1906282,50,4,1963,8,female,461,35,16,42,93,35,68,7,25
1680303,16,2,1997,2,male,47,35,31,41,15,41,15,0,0
1447409,28,24,1985,9,male,45,34,23,42,8,42,8,0,0
2147259,47,13,1966,1,male,471,35,21,41,11,41,10,0,1
2163036,52,3,1961,8,female,208,34,25,42,7,42,7,0,0
2032569,35,2,1978,4,male,567,34,14,41,40,41,36,0,4
1824818,44,3,1969,3,male,288,34,16,41,42,41,15,0,27
1418304,52,20,1961,7,female,23,35,22,41,43,41,38,0,5
1095678,57,7,1956,9,female,806,35,14,42,75,42,33,0,42
1584246,27,29,1986,6,male,186,34,22,43,0,0,0,43,0
2175762,79,29,1934,1,male,1767,35,17,43,1,0,1,43,0
1638905,73,13,1940,2,female,999,34,20,43,19,42,5,1,14
2104657,108,17,1905,6,male,140,35,21,43,127,34,47,9,80
1391660,31,16,1982,10,male,553,35,29,44,6,44,6,0,0
1768974,23,6,1990,1,female,363,34,10,43,18,43,14,0,4
1755661,44,19,1969,4,female,446,34,22,44,25,44,24,0,1
1004103,30,2,1983,2,male,114,34,21,44,40,44,33,0,7
1604036,23,1,1990,1,male,184,34,27,43,71,43,61,0,10
1408731,28,19,1985,12,female,339,34,29,45,9,1,0,44,9
1901871,21,2,1992,6,male,236,34,26,45,82,25,45,20,37
2064850,67,21,1946,8,female,1254,35,32,46,2,0,0,46,2
1518216,63,2,1950,6,male,323,34,30,46,48,0,12,46,36
1668411,76,13,1937,4,male,1297,35,8,46,1,35,1,11,0
1019752,100,12,1913,8,female,940,35,13,46,6,46,4,0,2
1335273,26,28,1987,2,female,273,35,18,47,36,47,16,0,20
1286448,61,24,1952,11,male,613,35,16,48,0,1,0,47,0
1957723,57,16,1956,2,female,341,34,17,48,21,0,15,48,6
1653053,46,16,1967,10,female,270,34,18,49,35,0,1,49,34
1432049,62,20,1951,4,male,817,34,25,49,61,0,26,49,35
1242019,66,30,1947,7,female,89,34,14,49,2,49,1,0,1
1655874,35,25,1978,5,male,532,35,22,48,31,48,13,0,18
1463530,40,21,1973,2,male,311,35,26,48,80,48,68,0,12
1170304,88,30,1925,6,female,158,34,27,50,14,0,10,50,4
1677506,68,28,1945,5,male,279,34,14,50,8,50,7,0,1
1441124,14,12,1999,10,female,61,34,13,51,19,51,8,0,11
2138307,60,10,1953,3,male,395,34,17,51,9,51,7,0,2
2075693,68,5,1945,9,male,1477,34,8,51,18,51,17,0,1
2002252,68,10,1945,5,male,546,34,27,52,30,0,18,52,12
1455610,46,28,1967,2,male,619,34,26,52,66,0,5,52,61
1683274,26,1,1987,1,male,253,35,23,53,27,53,14,0,13
1233636,55,13,1958,10,NA,2145,35,13,52,28,52,9,0,19
1244969,28,10,1985,11,male,779,34,23,53,52,53,45,0,7
1069434,39,18,1974,12,male,394,34,15,52,39,52,21,0,18
1189754,61,16,1952,10,male,16,35,35,54,22,0,9,54,13
1365459,67,14,1946,2,female,782,35,21,54,11,2,9,52,2
2173728,23,2,1990,10,male,418,35,31,54,24,53,19,1,5
2058179,45,24,1968,10,male,543,34,22,55,12,51,12,4,0
2167855,54,25,1959,8,female,94,34,28,54,10,42,6,12,4
1742209,33,20,1980,5,female,384,35,27,54,4,54,4,0,0
1870468,34,12,1979,5,male,95,34,24,55,26,55,21,0,5
1000443,20,30,1993,6,male,28,34,15,54,58,54,23,0,35
2109931,39,18,1974,1,female,380,35,26,57,25,1,2,56,23
1046992,69,19,1944,5,female,479,35,21,57,35,1,1,56,34
1641756,29,15,1984,4,male,439,35,16,57,39,34,37,23,2
1512971,35,16,1978,2,female,386,34,24,58,0,58,0,0,0
1998437,39,28,1974,9,female,942,34,20,58,22,58,16,0,6
1205636,21,9,1992,5,male,799,34,24,59,9,1,1,58,8
2000143,29,2,1984,1,male,381,34,25,59,106,8,18,51,88
1106393,18,9,1995,10,male,170,34,29,60,13,60,13,0,0
1023086,31,6,1982,2,male,369,34,23,63,10,0,0,63,10
1729126,74,1,1939,1,female,559,35,27,61,32,0,24,61,8
1505156,61,20,1952,5,female,712,35,29,62,55,2,28,60,27
1428378,23,17,1990,4,female,114,35,23,62,30,21,19,41,11
1848756,20,1,1993,12,female,141,34,16,63,34,63,29,0,5
1196885,25,27,1988,6,female,176,35,20,63,43,63,33,0,10
1908016,14,10,1999,10,female,106,34,24,64,0,64,0,0,0
1123167,49,14,1964,4,female,84,34,27,66,64,33,51,33,13
1003270,31,6,1982,8,female,504,35,24,67,7,50,6,17,1
1593745,29,14,1984,5,female,202,35,23,67,35,56,12,11,23
1031946,30,10,1983,8,female,168,34,25,68,0,68,0,0,0
1490262,33,30,1980,4,female,571,35,26,68,8,68,8,0,0
1814529,40,25,1973,10,female,61,35,21,66,26,66,17,0,9
1158588,69,20,1944,4,female,209,34,9,68,52,68,48,0,4
1836300,58,5,1955,8,male,1519,34,11,69,2,0,0,69,2
1526963,59,23,1954,6,male,626,34,26,71,31,0,2,71,29
1687131,45,3,1968,9,female,311,34,15,69,168,0,35,69,133
1504663,33,22,1980,5,female,63,35,24,69,11,68,7,1,4
1403950,22,14,1991,8,female,238,35,7,69,41,69,35,0,6
1936378,25,8,1988,6,female,505,35,22,70,69,70,51,0,18
1337962,23,20,1990,2,female,195,35,35,73,82,4,35,69,47
1761869,45,18,1968,5,male,700,34,0,73,4,73,3,0,1
1379702,53,5,1960,12,male,381,34,11,73,1,73,1,0,0
2107937,38,2,1975,2,female,300,34,16,72,88,72,54,0,34
1597321,23,1,1990,1,male,414,34,26,77,23,0,10,77,13
1608288,50,4,1963,8,female,222,34,14,75,39,0,19,75,20
1444477,64,9,1949,9,female,1028,34,16,75,31,59,21,16,10
1428478,43,20,1970,1,male,746,35,16,75,10,75,6,0,4
1151585,61,4,1952,6,female,730,34,10,75,10,75,10,0,0
1948942,33,5,1980,3,female,393,34,17,77,29,77,11,0,18
2093584,67,19,1946,8,female,1028,34,13,79,22,0,13,79,9
2044099,25,29,1988,10,female,496,35,22,79,155,17,73,62,82
1933551,28,13,1985,11,male,382,34,19,80,70,71,50,9,20
1409992,68,17,1945,8,female,23,34,19,79,17,79,16,0,1
1858405,75,18,1938,11,female,1142,34,18,84,12,0,4,84,8
1086715,50,25,1963,4,female,1046,34,24,81,13,80,5,1,8
2003764,18,24,1995,2,male,307,35,29,83,26,83,26,0,0
1219475,53,29,1960,7,female,445,34,24,86,32,0,4,86,28
2006422,64,28,1949,6,female,89,34,12,85,49,29,31,56,18
1739431,24,30,1989,10,female,161,34,31,86,51,86,39,0,12
2169245,33,14,1980,12,female,856,34,15,86,98,86,45,0,53
1675576,29,26,1984,2,female,641,34,29,91,92,10,32,81,60
1035990,29,18,1984,12,male,34,35,34,90,8,90,8,0,0
1374079,44,3,1969,7,female,869,35,18,88,4,88,4,0,0
2099821,47,6,1966,9,female,416,35,26,92,26,5,17,87,9
1051052,67,13,1946,10,female,1703,34,23,95,25,92,14,3,11
1429916,60,22,1953,4,female,1340,35,31,95,34,95,34,0,0
1413337,52,23,1961,10,female,224,35,26,94,85,94,75,0,10
1338705,31,17,1982,11,female,280,34,33,99,54,0,12,99,42
1748235,70,23,1943,10,female,1215,34,16,97,81,82,55,15,26
1434571,61,27,1952,7,female,688,34,22,96,32,96,20,0,12
1716172,53,15,1960,3,male,439,35,8,103,71,13,64,90,7
1826761,36,29,1977,9,female,629,34,25,104,56,36,31,68,25
1015953,61,18,1952,7,female,105,34,27,101,16,101,16,0,0
2019608,64,25,1949,6,female,246,35,21,100,7,100,7,0,0
2081262,27,26,1986,6,male,820,34,13,101,22,101,20,0,2
1560687,22,1,1991,1,male,295,35,18,102,82,102,70,0,12
1854857,53,19,1960,3,male,434,35,25,109,66,34,42,75,24
1795013,19,15,1994,4,male,1078,35,18,105,11,82,3,23,8
2041751,27,7,1986,4,male,195,34,26,106,15,106,2,0,13
1185129,29,30,1984,7,male,762,35,13,109,0,109,0,0,0
1597888,56,29,1957,7,female,626,35,22,109,2,109,2,0,0
1187313,69,27,1944,4,female,809,34,19,105,8,105,6,0,2
1287419,41,9,1972,8,male,186,35,28,109,31,109,13,0,18
1869865,55,20,1958,9,female,614,34,18,108,74,108,52,0,22
1023759,68,25,1945,10,female,1972,34,12,110,36,98,23,12,13
1886744,51,28,1962,7,male,808,34,17,110,40,110,32,0,8
1118574,48,4,1965,9,female,415,35,22,110,95,110,43,0,52
2099233,59,26,1954,12,female,1752,35,6,114,87,0,49,114,38
1543475,66,12,1947,4,female,99,35,29,118,7,93,1,25,6
1228525,24,17,1989,12,female,212,34,13,117,1,117,1,0,0
1823945,28,24,1985,2,male,48,34,24,118,14,118,9,0,5
1652529,62,5,1951,1,female,93,35,26,117,21,117,14,0,7
1832723,45,17,1968,6,female,245,34,19,115,82,115,50,0,32
2143283,45,15,1968,2,female,309,34,27,120,16,0,8,120,8
2049198,59,28,1954,5,female,201,34,16,120,32,10,27,110,5
1757683,27,11,1986,6,female,564,34,28,122,112,105,48,17,64
1127111,21,14,1992,12,female,351,35,21,120,85,120,40,0,45
1295961,62,14,1951,9,female,354,35,19,128,18,128,4,0,14
2145305,47,9,1966,1,female,403,34,20,126,72,126,55,0,17
1472046,53,28,1960,2,male,292,34,26,132,2,0,0,132,2
1160614,46,21,1967,2,male,342,34,25,136,24,0,18,136,6
1337200,66,28,1947,3,female,661,34,26,135,291,0,70,135,221
1694850,33,4,1980,1,female,689,35,8,131,35,72,27,59,8
2113401,41,16,1972,6,male,50,35,31,132,16,132,8,0,8
2109453,51,29,1962,11,male,420,35,6,136,48,136,45,0,3
2092647,22,11,1991,8,female,444,34,29,138,208,3,52,135,156
1517962,64,20,1949,10,male,433,34,24,141,56,141,50,0,6
1717486,17,14,1996,5,female,266,35,7,139,179,139,129,0,50
1576068,38,28,1975,8,female,277,35,25,145,35,0,2,145,33
1470527,64,21,1949,2,female,876,34,7,148,27,148,19,0,8
1978693,41,3,1972,11,female,318,35,7,145,96,145,83,0,13
1799794,76,16,1937,10,female,849,34,7,152,3,0,2,152,1
1528438,27,20,1986,9,female,517,35,33,155,27,0,4,155,23
2143248,32,22,1981,9,male,147,35,28,151,24,151,5,0,19
1319592,65,12,1948,1,female,1253,34,29,158,64,0,6,158,58
1081904,18,2,1995,6,female,442,35,21,163,50,163,34,0,16
1121634,56,27,1957,1,male,1041,35,25,161,171,161,102,0,69
1049228,22,25,1991,12,female,243,34,23,165,162,165,114,0,48
1027886,58,2,1955,10,male,662,34,19,181,23,0,3,181,20
2167383,72,1,1941,4,female,370,35,23,176,26,0,17,176,9
2166591,70,10,1943,2,female,1347,35,10,180,74,2,23,178,51
1434385,65,10,1948,9,female,10,35,34,179,17,176,12,3,5
1930804,41,22,1972,1,female,782,35,14,176,159,174,142,0,17
1970361,65,17,1948,7,male,678,34,19,184,125,0,2,184,123
2042071,25,20,1988,5,male,147,34,31,184,4,184,3,0,1
1294593,26,5,1987,1,male,254,35,29,182,76,182,45,0,31
1253577,33,24,1980,12,female,283,34,7,189,92,189,79,0,13
1998604,15,20,1998,9,female,513,35,11,199,11,0,5,199,6
1204230,51,8,1962,12,female,571,35,21,199,474,0,146,199,328
1779619,24,8,1989,4,female,410,35,22,199,64,199,54,0,10
1810011,54,15,1959,4,female,67,35,30,193,230,193,69,0,161
2082471,46,3,1967,3,female,571,35,20,205,120,179,50,26,70
1049167,54,16,1959,12,male,490,35,22,213,0,210,0,3,0
1846058,27,3,1986,8,male,102,35,29,216,2,216,1,0,1
1633293,54,16,1959,4,female,236,35,11,216,131,216,85,0,46
2072044,32,10,1981,6,male,26,34,32,214,204,214,204,0,0
1712267,25,24,1988,10,male,41,34,31,231,124,227,57,4,67
1909999,26,1,1987,1,male,418,34,18,231,16,231,15,0,1
1737847,42,12,1971,4,female,221,35,22,224,6,224,1,0,5
1803642,49,7,1964,6,female,390,34,16,232,1,232,1,0,0
1717272,52,28,1961,8,female,60,35,23,222,64,222,29,0,35
1283008,28,24,1985,7,female,661,34,26,244,39,244,33,0,6
1355677,37,4,1976,9,male,182,34,22,239,326,239,283,0,43
1021078,14,22,1999,3,female,326,34,16,257,2,250,1,7,1
1602328,24,14,1989,7,female,94,34,19,253,51,253,20,0,31
1537089,54,5,1959,7,female,305,34,23,259,142,259,80,0,62
1091010,40,2,1973,6,male,557,34,29,255,157,255,102,0,55
2064318,51,4,1962,4,female,808,35,19,273,192,0,23,273,169
2112204,54,15,1959,3,female,208,34,25,291,33,0,7,291,26
1714897,21,13,1992,11,female,29,34,29,282,23,266,11,16,12
2169491,29,30,1984,10,female,269,34,21,291,109,291,82,0,27
1479971,41,15,1972,9,female,243,34,24,279,48,279,36,0,12
1051398,100,19,1913,8,female,314,35,11,281,133,281,128,0,5
1912621,23,22,1990,1,male,82,35,14,300,0,289,0,11,0
1369513,30,23,1983,2,male,110,35,19,300,26,300,26,0,0
1508720,44,24,1969,12,female,227,35,13,322,189,303,41,19,148
1153899,56,27,1957,5,male,296,35,23,335,128,324,32,11,96
1953971,26,17,1987,12,female,252,35,22,336,271,336,191,0,80
1179392,52,12,1961,4,female,157,35,23,354,329,0,151,354,178
1087900,18,1,1995,1,female,63,34,28,352,30,352,28,0,2
1439893,35,6,1978,1,male,86,34,33,369,15,369,5,0,10
1324012,22,4,1991,7,male,71,34,10,360,70,360,50,0,20
2136168,25,10,1988,1,female,55,35,34,358,114,358,69,0,45
1562828,38,13,1975,6,female,159,34,21,368,111,368,102,0,9
1772121,18,1,1995,3,female,9,34,33,360,289,360,281,0,8
1516672,33,6,1980,8,female,607,34,18,379,110,8,19,371,91
1358553,52,7,1961,5,female,556,35,8,404,510,404,322,0,188
1364786,58,27,1955,4,male,215,34,31,434,43,0,1,434,42
1592284,29,24,1984,8,female,230,35,27,442,121,417,50,25,71
1113149,16,13,1997,11,male,198,34,27,448,65,448,29,0,36
1515173,26,9,1987,6,female,459,35,27,443,0,443,0,0,0
1616170,48,3,1965,7,female,300,34,29,428,96,428,67,0,29
1891762,63,14,1950,3,female,501,35,15,463,2,463,2,0,0
2034819,65,2,1948,1,female,309,35,30,496,15,493,12,3,3
1479725,52,15,1961,2,female,438,35,13,505,27,505,20,0,7
1572067,91,13,1922,9,male,1401,35,12,542,6,0,2,542,4
1745054,48,8,1965,8,male,218,35,28,531,565,357,432,174,133
1815263,17,2,1996,8,female,66,34,10,560,139,482,49,78,90
1161807,65,3,1948,1,female,174,34,27,547,290,510,230,37,60
1310794,22,2,1991,4,female,573,34,29,535,596,527,497,8,99
1457366,23,15,1990,6,male,411,34,31,535,0,535,0,0,0
1921932,66,5,1947,9,female,1962,35,6,585,176,577,74,8,102
2120533,19,19,1994,2,male,553,35,16,622,40,558,7,64,33
1919607,30,5,1983,7,female,55,35,20,647,134,471,47,176,87
1547362,51,22,1962,9,female,413,35,25,644,71,644,40,0,31
1347931,33,3,1980,9,female,189,35,25,631,309,631,165,0,144
1399644,41,20,1972,3,female,503,34,12,689,506,588,166,101,340
1388504,20,23,1993,1,female,120,35,11,713,2333,713,1724,0,609
1665621,42,18,1971,10,male,475,35,31,791,226,791,188,0,38
1664983,71,1,1942,7,male,104,35,31,969,119,969,82,0,37
1556581,52,22,1961,9,male,260,34,29,1011,61,0,29,1011,32
1380464,57,2,1956,10,female,993,34,23,1009,8,191,8,818,0
1090429,62,18,1951,3,male,163,35,12,1031,69,1027,24,4,45
1927982,68,6,1945,12,female,283,34,32,1142,981,1,101,1141,880
2085934,18,15,1995,10,female,21,35,23,1165,241,1165,142,0,99
1973612,15,6,1998,10,female,280,35,9,1485,1912,1413,681,72,1231
1317374,23,3,1990,5,male,141,35,20,1405,7,1405,6,0,1
1287359,31,26,1982,9,female,76,34,24,1410,115,1410,58,0,57
2148318,14,30,1999,3,female,325,34,29,1587,838,561,160,1026,678
1438200,63,16,1950,4,female,283,35,17,1581,349,1581,236,0,113
1858603,40,10,1973,10,male,304,35,13,2094,125,2094,76,0,49
1680495,55,16,1958,8,female,1751,35,15,2461,1105,0,379,2461,726
1736275,35,8,1978,1,female,482,34,24,2996,4,2994,3,2,1
1092976,36,10,1977,3,female,157,35,24,3259,157,3259,68,0,89
1652271,44,11,1969,10,female,770,35,18,3517,164,3517,87,0,77
1351456,52,16,1961,7,female,280,35,24,2644,432,2644,326,0,106
1953611,65,6,1948,9,female,886,34,14,3697,108,3515,65,182,43
1371651,14,29,1999,11,male,242,36,20,0,0,0,0,0,0
2069487,13,11,2000,4,male,222,36,20,0,0,0,0,0,0
1198072,14,28,1999,5,male,326,36,19,0,5,0,5,0,0
1661529,14,10,1999,6,male,36,36,31,0,1,0,1,0,0
2150822,14,25,1999,9,male,139,36,12,0,6,0,4,0,2
1276219,14,20,1999,10,male,13,36,23,0,1,0,1,0,0
1129322,15,4,1998,1,female,198,36,21,0,2,0,0,0,2
1995954,15,27,1998,2,male,232,36,34,0,3,0,1,0,2
1009795,15,17,1998,8,male,56,36,29,0,0,0,0,0,0
1930266,15,27,1998,9,male,303,36,27,0,0,0,0,0,0
2176363,17,12,1996,11,male,231,36,20,0,0,0,0,0,0
1233358,16,1,1997,1,male,13,36,29,0,5,0,5,0,0
1834108,16,4,1997,8,female,318,36,13,0,0,0,0,0,0
1763193,16,26,1997,9,male,357,36,36,0,0,0,0,0,0
1771454,17,15,1996,2,female,804,36,20,0,25,0,15,0,10
2162676,17,15,1996,3,male,538,36,6,0,1,0,1,0,0
2034696,17,13,1996,3,male,235,36,26,0,0,0,0,0,0
1935191,17,17,1996,3,male,214,36,35,0,5,0,5,0,0
1560601,17,17,1996,9,male,63,36,35,0,0,0,0,0,0
1150551,19,27,1994,12,male,340,36,29,0,0,0,0,0,0
1180492,18,10,1995,1,female,143,36,26,0,3,0,2,0,1
1561136,18,8,1995,6,male,258,36,26,0,1,0,1,0,0
1115270,18,21,1995,8,male,592,36,24,0,0,0,0,0,0
1685931,18,6,1995,10,male,88,36,33,0,0,0,0,0,0
1658197,20,24,1993,12,male,366,36,7,0,2,0,2,0,0
1711624,20,27,1993,12,male,87,36,24,0,0,0,0,0,0
1366576,19,3,1994,1,male,220,36,35,0,5,0,3,0,2
1417552,19,17,1994,5,male,554,36,27,0,0,0,0,0,0
1741687,19,20,1994,8,male,479,36,30,0,0,0,0,0,0
1918474,19,17,1994,8,male,318,36,20,0,2,0,0,0,2
1189743,19,17,1994,9,male,165,36,35,0,0,0,0,0,0
2147542,19,11,1994,10,male,105,36,26,0,2,0,1,0,1
2029839,21,5,1992,11,female,589,36,3,0,0,0,0,0,0
2031205,20,1,1993,1,male,136,36,28,0,5,0,4,0,1
1970384,20,1,1993,1,male,129,36,34,0,0,0,0,0,0
2121152,20,24,1993,3,male,682,36,30,0,0,0,0,0,0
1034515,20,3,1993,3,female,636,36,12,0,1,0,1,0,0
1617825,20,15,1993,8,male,106,36,26,0,0,0,0,0,0
1029666,21,4,1992,1,male,147,36,25,0,0,0,0,0,0
1768964,21,9,1992,4,male,229,36,27,0,0,0,0,0,0
1995370,21,6,1992,6,female,484,36,20,0,0,0,0,0,0
1170174,22,4,1991,1,male,123,36,30,0,2,0,0,0,2
1523474,22,12,1991,1,male,27,36,36,0,1,0,1,0,0
2019166,22,1,1991,1,male,68,36,35,0,0,0,0,0,0
1122265,24,22,1989,11,male,450,36,18,0,0,0,0,0,0
2086387,23,11,1990,1,male,1007,36,27,0,1,0,0,0,1
1595807,23,17,1990,2,male,429,36,17,0,8,0,2,0,6
2125907,23,19,1990,5,male,585,36,10,0,1,0,0,0,1
1514805,23,26,1990,10,female,42,36,32,0,257,0,1,0,256
1614809,25,25,1988,12,female,63,36,13,0,0,0,0,0,0
1516463,24,6,1989,6,male,1051,36,33,0,0,0,0,0,0
1439229,24,16,1989,6,male,469,36,23,0,0,0,0,0,0
1256658,24,11,1989,8,male,370,36,7,0,0,0,0,0,0
1408493,24,1,1989,10,male,263,36,21,0,0,0,0,0,0
1082330,25,14,1988,5,male,340,36,30,0,0,0,0,0,0
1660095,25,1,1988,5,male,34,36,23,0,0,0,0,0,0
1798751,25,11,1988,8,male,627,36,28,0,0,0,0,0,0
1953131,27,14,1986,12,male,494,36,28,0,1,0,0,0,1
1658169,28,21,1985,11,male,77,36,35,0,0,0,0,0,0
1898819,28,31,1985,12,male,653,36,21,0,1,0,1,0,0
1116528,27,25,1986,1,female,487,36,23,0,0,0,0,0,0
2193175,27,24,1986,4,male,696,36,28,0,0,0,0,0,0
1349457,27,22,1986,5,female,1470,36,22,0,1,0,0,0,1
2131838,27,18,1986,9,male,209,36,30,0,0,0,0,0,0
1207639,28,15,1985,3,male,15,36,7,0,2,0,1,0,1
1718921,28,25,1985,5,male,408,36,33,0,0,0,0,0,0
1457489,28,28,1985,8,male,206,36,19,0,0,0,0,0,0
1973153,28,10,1985,9,male,474,36,25,0,0,0,0,0,0
2189982,30,7,1983,11,male,438,36,16,0,0,0,0,0,0
1745249,29,18,1984,3,male,595,36,24,0,1,0,1,0,0
1258298,29,13,1984,3,male,266,36,27,0,0,0,0,0,0
1851284,29,4,1984,5,male,138,36,25,0,0,0,0,0,0
1555793,30,9,1983,1,male,498,36,25,0,0,0,0,0,0
2159439,31,9,1982,1,male,137,36,18,0,1,0,1,0,0
1501327,31,21,1982,2,male,447,36,25,0,5,0,5,0,0
1197601,33,12,1980,12,male,720,36,14,0,3,0,3,0,0
1611518,32,4,1981,10,female,350,36,23,0,0,0,0,0,0
1376175,33,13,1980,5,male,525,36,10,0,9,0,8,0,1
2038473,33,2,1980,7,male,293,36,34,0,0,0,0,0,0
1773485,33,29,1980,8,male,230,36,23,0,0,0,0,0,0
1723969,34,22,1979,2,male,142,36,16,0,0,0,0,0,0
2073435,34,5,1979,6,male,1278,36,24,0,0,0,0,0,0
1488520,34,18,1979,6,male,428,36,4,0,1,0,1,0,0
1937738,34,29,1979,8,male,196,36,24,0,0,0,0,0,0
1321679,34,23,1979,9,male,233,36,28,0,2,0,2,0,0
1339003,35,8,1978,1,male,296,36,18,0,1,0,1,0,0
2158325,35,16,1978,7,male,855,36,9,0,1,0,1,0,0
1124142,37,1,1976,1,male,270,36,23,0,0,0,0,0,0
1354091,37,6,1976,4,male,549,36,13,0,0,0,0,0,0
1251266,37,5,1976,9,female,406,36,23,0,0,0,0,0,0
1940318,37,6,1976,9,male,117,36,22,0,2,0,2,0,0
1932743,40,4,1973,11,female,316,36,21,0,1,0,1,0,0
2181063,39,17,1974,1,male,547,36,4,0,1,0,1,0,0
2175992,40,23,1973,3,male,83,36,32,0,0,0,0,0,0
1428223,40,11,1973,5,male,587,36,17,0,0,0,0,0,0
1512048,41,1,1972,1,male,269,36,33,0,0,0,0,0,0
1025343,41,5,1972,2,male,110,36,33,0,0,0,0,0,0
1500278,41,11,1972,7,male,384,36,19,0,1,0,0,0,1
1541991,41,17,1972,9,male,767,36,32,0,2,0,1,0,1
2183927,42,15,1971,10,female,73,36,4,0,0,0,0,0,0
1941317,43,7,1970,4,male,598,36,16,0,1,0,0,0,1
1349420,43,29,1970,6,male,924,36,20,0,0,0,0,0,0
1548168,43,24,1970,8,male,635,36,21,0,0,0,0,0,0
1243643,45,1,1968,1,male,306,36,35,0,0,0,0,0,0
2193131,45,10,1968,7,male,145,36,34,0,4,0,1,0,3
1119895,47,21,1966,11,female,473,36,19,0,0,0,0,0,0
2018462,46,9,1967,4,male,200,36,18,0,0,0,0,0,0
1361353,46,16,1967,9,male,337,36,12,0,1,0,1,0,0
1890562,47,17,1966,1,male,57,36,23,0,0,0,0,0,0
1774849,47,27,1966,2,female,486,36,13,0,1,0,1,0,0
1349663,49,4,1964,12,female,783,36,31,0,1,0,1,0,0
1691787,49,27,1964,12,male,611,36,8,0,24,0,9,0,15
1629003,48,15,1965,3,male,526,36,11,0,1,0,1,0,0
2060409,49,1,1964,1,male,347,36,18,0,4,0,3,0,1
1455459,49,18,1964,5,female,86,36,33,0,1,0,1,0,0
1941373,50,20,1963,5,female,236,36,22,0,0,0,0,0,0
1996326,50,2,1963,9,male,162,36,28,0,6,0,3,0,3
1314831,51,6,1962,6,male,47,36,26,0,0,0,0,0,0
2117584,52,24,1961,1,female,643,36,19,0,0,0,0,0,0
1128565,54,31,1959,3,male,1287,36,23,0,0,0,0,0,0
1915354,59,21,1954,7,male,1077,36,12,0,0,0,0,0,0
1439552,62,30,1951,1,female,478,36,28,0,0,0,0,0,0
2132326,62,1,1951,6,female,94,36,10,0,7,0,7,0,0
1695575,62,1,1951,9,male,403,36,26,0,1,0,1,0,0
1423646,63,15,1950,2,female,35,36,11,0,0,0,0,0,0
1427564,63,18,1950,7,female,1688,36,21,0,1,0,1,0,0
1551112,63,17,1950,10,female,530,36,24,0,0,0,0,0,0
1122183,67,14,1946,7,female,284,36,27,0,1,0,1,0,0
1736633,69,21,1944,9,female,274,36,22,0,3,0,3,0,0
1601212,71,29,1942,5,female,831,36,24,0,0,0,0,0,0
1839994,71,2,1942,9,male,151,36,16,0,46,0,41,0,5
2113689,75,15,1938,7,male,1405,36,15,0,0,0,0,0,0
1461341,76,9,1937,10,male,1538,36,6,0,0,0,0,0,0
1352217,82,15,1931,11,male,158,36,30,0,0,0,0,0,0
1641004,86,19,1927,7,male,607,36,27,0,0,0,0,0,0
1680379,103,1,1910,1,male,504,36,13,0,0,0,0,0,0
1905542,16,10,1997,4,male,23,36,36,1,0,0,0,1,0
1175212,18,1,1995,1,male,291,36,27,1,0,0,0,1,0
2070275,19,25,1994,1,male,561,36,30,1,0,0,0,1,0
1474947,22,28,1991,1,male,26,36,25,1,0,0,0,1,0
1938464,22,29,1991,4,male,212,36,27,1,0,0,0,1,0
1047110,44,1,1969,8,male,485,36,19,1,0,0,0,1,0
1894936,18,10,1995,10,female,92,36,24,1,1,0,0,1,1
2023589,22,11,1991,10,female,763,36,26,1,1,0,1,1,0
1537602,60,4,1953,12,male,646,36,24,1,1,0,0,1,1
1987482,66,11,1947,7,male,1656,36,8,1,1,0,0,1,1
2013876,26,6,1987,11,male,358,36,16,1,264,0,61,1,203
1423574,30,4,1983,4,male,495,36,33,1,11,0,1,1,10
1941433,31,7,1982,5,male,533,36,35,1,127,0,23,1,104
1140295,47,15,1966,1,male,145,36,16,1,2,0,0,1,2
1857000,53,31,1960,3,female,404,36,27,1,11,0,2,1,9
1830342,80,23,1933,12,female,1346,36,19,1,20,0,10,1,10
1975636,16,10,1997,2,female,177,36,34,1,0,1,0,0,0
1500696,16,7,1997,7,female,64,36,12,1,0,1,0,0,0
1130465,17,3,1996,10,male,178,36,14,1,0,1,0,0,0
1408556,24,12,1989,6,male,252,36,32,1,0,1,0,0,0
1683407,25,15,1988,1,male,57,36,22,1,0,1,0,0,0
1535391,25,1,1988,2,male,518,36,17,1,0,1,0,0,0
2122729,25,5,1988,4,male,131,36,28,1,0,1,0,0,0
1972694,33,30,1980,12,male,349,36,12,1,0,1,0,0,0
1194020,33,5,1980,8,male,131,36,27,1,0,1,0,0,0
2188820,34,25,1979,9,male,319,36,28,1,0,1,0,0,0
2054258,36,30,1977,11,female,232,36,27,1,0,1,0,0,0
1115812,41,14,1972,10,male,58,36,32,1,0,1,0,0,0
1892964,43,17,1970,11,male,268,36,32,1,0,1,0,0,0
1972104,48,24,1965,9,female,1700,36,12,1,0,1,0,0,0
2158841,72,20,1941,1,female,1148,36,11,1,0,1,0,0,0
1742223,18,22,1995,7,male,20,36,33,1,1,1,1,0,0
1260013,18,1,1995,8,male,43,36,36,1,1,1,1,0,0
1513092,19,21,1994,1,male,86,36,23,1,1,1,1,0,0
2088139,30,17,1983,10,male,44,36,27,1,1,1,1,0,0
1256033,31,9,1982,2,female,43,36,32,1,1,1,1,0,0
1981801,32,7,1981,6,male,505,36,21,1,1,1,1,0,0
1538914,41,3,1972,6,male,745,36,14,1,1,1,1,0,0
1360713,60,1,1953,12,male,326,36,28,1,1,1,1,0,0
1148303,60,21,1953,3,female,251,36,36,1,1,1,1,0,0
1965497,103,15,1910,2,male,1476,36,11,1,1,1,1,0,0
1782177,14,11,1999,11,male,20,36,16,1,4,1,4,0,0
1972632,15,25,1998,8,male,72,36,19,1,3,1,0,0,3
1987404,22,30,1991,11,male,297,36,25,1,2,1,2,0,0
1335341,22,5,1991,5,male,48,36,25,1,4,1,2,0,2
1844246,22,25,1991,8,female,337,36,24,1,2,1,2,0,0
1865593,23,8,1990,3,male,8,36,36,1,3,1,2,0,1
2100522,25,1,1988,1,male,269,36,22,1,6,1,6,0,0
1288273,25,28,1988,9,male,479,36,9,1,7,1,2,0,5
1317424,28,25,1985,12,male,290,36,25,1,3,1,2,0,1
1063258,27,2,1986,6,male,490,36,11,1,3,1,1,0,2
1780307,27,7,1986,8,female,63,36,16,1,13,1,7,0,6
1538061,28,17,1985,5,male,637,36,22,1,6,1,1,0,5
1183618,31,15,1982,8,male,568,36,24,1,4,1,2,0,2
1771174,33,26,1980,8,male,82,36,34,1,35,1,35,0,0
1881388,40,10,1973,10,male,215,36,26,1,16,1,12,0,4
1453348,51,1,1962,1,male,109,36,34,1,6,1,6,0,0
1969830,52,8,1961,8,male,614,36,20,1,3,1,0,0,3
1498595,54,29,1959,5,male,1886,36,19,1,42,1,30,0,12
1291354,62,3,1951,4,male,983,36,19,1,2,1,0,0,2
1283597,67,16,1946,9,female,462,36,20,1,2,1,2,0,0
1904079,68,17,1945,10,female,537,36,27,1,4,1,4,0,0
2178550,73,3,1940,11,male,53,36,31,1,8,1,4,0,4
1911612,15,16,1998,2,male,663,36,25,2,0,0,0,2,0
1809312,16,10,1997,3,male,182,36,33,2,0,0,0,2,0
1456300,33,6,1980,8,female,559,36,15,2,0,0,0,2,0
1961803,35,28,1978,6,female,257,36,33,2,0,0,0,2,0
2099384,39,27,1974,11,female,959,36,20,2,0,0,0,2,0
1901800,46,12,1967,3,male,745,36,31,2,0,0,0,2,0
1713879,77,15,1936,1,female,1784,36,16,2,0,0,0,2,0
1987137,23,2,1990,7,male,548,36,22,2,1,0,0,2,1
1721901,33,11,1980,12,male,188,36,29,2,1,0,0,2,1
1403224,67,14,1946,8,male,2035,36,2,2,1,0,1,2,0
1622782,39,28,1974,10,male,232,36,22,2,32,0,4,2,28
1323308,60,30,1953,6,female,1347,36,20,2,5,0,1,2,4
1887853,61,6,1952,5,male,154,36,20,2,10,0,1,2,9
2089021,66,25,1947,2,female,509,36,28,2,3,0,1,2,2
2188854,19,25,1994,7,male,688,36,31,2,0,2,0,0,0
1268294,26,22,1987,11,male,88,36,30,2,0,2,0,0,0
1309398,25,1,1988,1,male,201,36,36,2,0,2,0,0,0
2039469,26,2,1987,2,male,540,36,21,2,0,2,0,0,0
2137314,57,6,1956,1,male,444,36,19,2,0,2,0,0,0
1803146,60,5,1953,8,male,1884,36,23,2,0,2,0,0,0
1328268,67,30,1946,8,female,446,36,15,2,0,2,0,0,0
2032261,102,7,1911,10,male,381,36,30,2,0,2,0,0,0
1392996,19,1,1994,1,male,470,36,33,2,1,2,1,0,0
1804417,24,16,1989,5,male,565,36,24,2,1,2,0,0,1
1884575,48,14,1965,2,female,531,36,9,2,1,2,1,0,0
1560170,51,7,1962,10,male,394,36,23,2,1,2,1,0,0
1858005,16,27,1997,10,male,240,36,21,2,2,2,2,0,0
2003765,26,31,1987,5,male,620,36,29,2,2,2,1,0,1
1142216,18,28,1995,2,female,268,36,27,2,7,2,4,0,3
1115071,22,20,1991,11,male,258,36,26,2,9,2,0,0,9
1069673,21,30,1992,4,male,60,36,25,2,25,2,25,0,0
1453682,22,19,1991,5,female,596,36,32,2,12,2,10,0,2
1470489,26,9,1987,5,male,159,36,33,2,4,2,4,0,0
1582939,26,20,1987,10,female,18,36,33,2,4,2,1,0,3
1975126,38,21,1975,1,male,337,36,29,2,6,2,5,0,1
1690056,48,18,1965,11,male,528,36,20,2,6,2,6,0,0
2058253,49,8,1964,3,male,318,36,25,2,12,2,8,0,4
2007672,54,17,1959,9,male,735,36,18,2,6,2,3,0,3
2157372,62,12,1951,12,female,1093,36,16,2,3,2,3,0,0
1056488,61,17,1952,4,male,756,36,21,2,14,2,11,0,3
1819334,21,1,1992,1,male,394,36,34,3,0,0,0,3,0
1779359,24,17,1989,5,male,384,36,28,3,0,0,0,3,0
1032229,48,11,1965,1,male,16,36,31,3,1,0,0,3,1
1701117,60,27,1953,4,male,309,36,20,3,1,0,0,3,1
2087079,16,28,1997,4,male,414,36,32,3,2,0,1,3,1
1727229,52,8,1961,10,female,248,36,8,3,6,0,0,3,6
2102387,53,28,1960,10,female,1604,36,7,3,5,0,4,3,1
1424860,17,6,1996,6,male,340,36,21,3,14,2,2,1,12
1947864,25,1,1988,1,male,141,36,35,3,0,3,0,0,0
1791266,31,10,1982,2,male,586,36,32,3,0,3,0,0,0
2093541,23,19,1990,7,male,805,36,30,3,1,3,1,0,0
1518522,27,21,1986,6,male,136,36,34,3,1,3,1,0,0
1973864,16,27,1997,9,female,272,36,21,3,2,3,2,0,0
1353471,22,30,1991,8,male,578,36,12,3,2,3,1,0,1
2186020,24,18,1989,9,female,40,36,30,3,2,3,2,0,0
2056081,32,11,1981,8,female,543,36,23,3,13,3,12,0,1
1418747,58,29,1955,7,male,999,36,29,3,13,3,10,0,3
1224580,91,2,1922,1,NA,2319,36,12,3,5,3,3,0,2
1510785,24,11,1989,6,male,142,36,9,4,0,0,0,4,0
1029943,28,2,1985,2,male,492,36,14,4,16,0,2,4,14
1928537,54,23,1959,2,male,423,36,7,4,42,2,32,2,10
1139393,32,31,1981,7,male,311,36,16,4,12,3,1,1,11
1164537,16,23,1997,3,male,160,36,36,4,0,4,0,0,0
1594628,38,5,1975,12,male,323,36,9,4,0,4,0,0,0
1127108,58,15,1955,8,female,1347,36,10,4,2,4,2,0,0
2173385,60,24,1953,12,female,1538,36,7,4,1,4,1,0,0
1049625,14,8,1999,10,male,121,36,18,4,4,4,4,0,0
1343635,16,23,1997,3,male,881,36,19,4,3,4,0,0,3
1504932,21,17,1992,3,male,277,36,23,4,13,4,12,0,1
1029355,27,17,1986,7,female,234,36,28,4,8,4,6,0,2
1569670,63,4,1950,5,male,1034,36,18,4,11,4,6,0,5
1134481,55,13,1958,3,female,239,36,35,5,1,0,0,5,1
2039901,29,23,1984,3,male,141,36,30,5,4,0,1,5,3
1278436,39,30,1974,6,male,394,36,25,5,11,0,2,5,9
1718379,65,8,1948,5,male,1822,36,24,5,1,1,0,4,1
1829601,26,16,1987,6,female,335,36,29,5,23,4,10,1,13
1917540,65,24,1948,6,female,641,36,28,5,8,4,3,1,5
1859008,28,21,1985,2,male,417,36,32,5,0,5,0,0,0
1194634,45,20,1968,9,male,1749,36,6,5,0,5,0,0,0
1089641,15,28,1998,9,male,135,36,35,5,2,5,0,0,2
1262346,31,26,1982,2,male,136,36,31,5,3,5,3,0,0
1978935,40,15,1973,5,female,298,36,27,5,1,5,0,0,1
1916329,60,1,1953,1,female,263,36,26,5,3,5,2,0,1
1611492,49,6,1964,4,male,171,36,25,5,4,5,4,0,0
1481804,19,12,1994,5,male,24,36,21,5,9,5,9,0,0
1365782,45,1,1968,4,female,397,36,24,5,10,5,4,0,6
1813019,76,3,1937,9,female,1104,36,23,5,8,5,6,0,2
1373691,15,23,1998,12,female,440,36,14,6,0,0,0,6,0
2048577,22,7,1991,8,male,257,36,4,6,0,0,0,6,0
1241611,37,10,1976,4,male,135,36,27,6,1,0,1,6,0
1368677,52,28,1961,6,female,599,36,18,6,2,0,2,6,0
2151302,14,21,1999,2,female,558,36,19,6,7,0,1,6,6
1905639,38,9,1975,10,male,1688,36,22,6,14,0,0,6,14
1287260,33,8,1980,2,male,13,36,27,6,0,4,0,2,0
1796877,18,12,1995,12,male,49,36,27,6,8,2,4,4,4
2158989,48,31,1965,3,female,403,36,20,6,4,2,4,4,0
1303011,33,30,1980,4,male,111,36,23,6,10,4,3,2,7
1819031,37,14,1976,4,male,398,36,26,6,0,6,0,0,0
1790800,18,8,1995,3,male,15,36,31,6,2,6,0,0,2
1402358,25,1,1988,2,male,42,36,33,6,2,6,2,0,0
1517627,28,19,1985,1,female,570,36,11,6,2,6,2,0,0
1019338,60,19,1953,2,male,257,36,28,6,1,6,0,0,1
1749231,66,10,1947,4,female,633,36,25,6,1,6,1,0,0
1067792,26,11,1987,12,male,45,36,29,6,4,6,3,0,1
1169445,27,26,1986,6,female,390,36,30,6,4,6,4,0,0
2102504,17,25,1996,8,male,56,36,20,6,16,6,7,0,9
2138894,29,21,1984,7,male,450,36,13,6,11,6,10,0,1
1415411,52,2,1961,11,female,625,36,26,6,12,6,10,0,2
2044852,19,23,1994,4,male,657,36,15,7,1,0,0,7,1
1559253,71,26,1942,6,male,101,36,23,7,2,0,0,7,2
1276746,45,2,1968,3,male,53,36,24,7,33,0,1,7,32
1189655,33,16,1980,8,male,333,36,13,7,2,2,2,5,0
2185748,50,15,1963,2,female,302,36,22,7,3,5,3,2,0
1311952,59,26,1954,11,female,853,36,29,7,1,6,1,1,0
1346185,25,27,1988,10,female,145,36,29,7,4,6,3,1,1
2107074,24,10,1989,4,male,347,36,27,7,25,6,1,1,24
2099720,29,25,1984,10,male,172,36,25,7,0,7,0,0,0
1352239,16,1,1997,11,female,559,36,14,7,2,7,2,0,0
2087620,25,9,1988,11,female,332,36,21,7,3,7,3,0,0
1081253,38,8,1975,12,female,447,36,22,7,3,7,2,0,1
1434048,53,14,1960,7,female,78,36,23,7,3,7,2,0,1
1321973,69,12,1944,8,female,11,36,34,7,9,7,6,0,3
1570085,17,16,1996,4,male,42,36,29,7,13,7,7,0,6
1487861,18,6,1995,6,male,106,36,27,8,0,0,0,8,0
1395453,70,14,1943,7,male,157,36,26,8,8,0,4,8,4
1617704,28,30,1985,9,female,652,36,19,8,30,4,11,4,19
1087738,34,9,1979,1,male,591,36,12,8,16,4,15,4,1
1645206,38,6,1975,7,male,643,36,25,8,0,8,0,0,0
1483711,22,1,1991,1,female,534,36,28,8,4,8,3,0,1
2105547,56,20,1957,2,female,406,36,32,8,4,8,3,0,1
1070038,71,30,1942,4,female,546,36,26,8,2,8,2,0,0
2165013,21,1,1992,1,male,151,36,25,9,7,0,6,9,1
2096634,19,15,1994,8,male,543,36,21,9,0,9,0,0,0
2026930,25,5,1988,6,male,179,36,32,9,0,9,0,0,0
2120862,28,1,1985,6,male,314,36,35,9,0,9,0,0,0
1088239,36,15,1977,6,female,438,36,15,9,0,9,0,0,0
1970008,24,21,1989,4,male,185,36,11,9,5,9,4,0,1
2132409,60,3,1953,8,female,566,36,18,9,5,9,2,0,3
2155684,22,23,1991,12,male,168,36,32,9,11,9,11,0,0
2049310,49,9,1964,7,male,541,36,13,9,8,9,7,0,1
1564142,29,11,1984,10,female,439,36,21,9,54,9,44,0,10
2020844,52,25,1961,7,male,222,36,22,9,25,9,21,0,4
1993884,14,20,1999,1,male,22,36,33,10,2,0,1,10,1
1062683,61,19,1952,9,female,737,36,27,10,13,0,5,10,8
1287155,53,31,1960,10,female,117,36,25,10,5,7,2,3,3
1116429,14,27,1999,9,male,112,36,23,10,23,9,9,1,14
2189094,47,28,1966,2,female,292,36,26,10,34,10,33,0,1
2048893,68,27,1945,5,female,285,36,26,11,1,0,1,11,0
1311312,49,30,1964,12,male,343,36,10,11,4,0,0,11,4
1267280,29,17,1984,11,female,159,36,16,11,18,7,2,4,16
1225599,26,6,1987,4,male,306,36,18,11,1,8,1,3,0
1873807,65,12,1948,6,female,1494,36,15,11,3,11,1,0,2
1567917,19,19,1994,7,male,245,36,30,11,7,11,3,0,4
1589774,56,7,1957,5,female,620,36,17,11,9,11,9,0,0
1905647,66,17,1947,7,male,346,36,22,12,1,0,0,12,1
1849721,14,17,1999,8,male,42,36,23,12,3,0,0,12,3
1366733,65,20,1948,2,female,839,36,20,12,6,0,1,12,5
2099292,45,2,1968,9,female,138,36,26,12,4,11,4,1,0
1185442,71,10,1942,4,male,845,36,21,12,10,10,9,2,1
1509757,46,23,1967,3,female,402,36,33,12,1,12,1,0,0
1518366,23,31,1990,3,female,362,36,22,12,7,12,6,0,1
1541075,32,28,1981,12,male,215,36,24,12,9,12,5,0,4
1048996,67,24,1946,4,female,2318,36,9,12,9,12,4,0,5
1832283,71,12,1942,6,female,1638,36,16,12,11,12,9,0,2
1999322,43,18,1970,6,female,255,36,9,12,20,12,10,0,10
1484956,52,30,1961,4,female,211,36,30,13,9,5,1,8,8
2184880,17,21,1996,5,male,30,36,35,13,19,13,18,0,1
1982513,38,15,1975,6,male,309,36,29,13,16,13,16,0,0
2009412,29,18,1984,1,male,745,36,19,13,81,13,55,0,26
1480692,76,25,1937,1,female,983,36,25,14,8,0,5,14,3
2082764,43,14,1970,10,male,937,36,18,14,91,0,25,14,66
1733607,50,3,1963,9,female,64,36,34,14,23,0,1,14,22
1710282,50,16,1963,1,male,133,36,28,14,84,13,41,1,43
1378762,66,3,1947,11,male,64,36,27,14,1,14,1,0,0
1076387,58,29,1955,8,male,524,36,33,14,12,14,2,0,10
1059113,69,23,1944,7,female,296,36,28,15,5,0,2,15,3
2126959,79,17,1934,1,female,972,36,13,15,4,0,2,15,2
1063649,17,8,1996,2,female,94,36,27,15,1,15,0,0,1
1315564,14,20,1999,7,male,87,36,28,15,3,15,2,0,1
2187115,49,20,1964,8,male,748,36,27,15,4,15,2,0,2
1538094,26,1,1987,1,male,38,36,20,15,20,15,14,0,6
2175019,30,29,1983,7,male,652,36,7,15,16,15,15,0,1
1786805,51,21,1962,3,female,390,36,32,15,25,15,6,0,19
1584577,66,19,1947,2,female,1574,36,18,16,6,0,2,16,4
1663880,20,4,1993,11,male,130,36,23,16,3,16,1,0,2
1006214,20,6,1993,12,male,180,36,25,16,7,16,7,0,0
1775099,60,12,1953,11,female,265,36,15,16,4,16,4,0,0
1054830,38,2,1975,4,male,26,36,28,16,19,16,14,0,5
1862331,20,6,1993,1,male,943,36,26,17,0,0,0,17,0
1592748,27,9,1986,9,male,130,36,25,17,10,6,3,11,7
1959035,34,2,1979,9,male,885,36,25,17,15,17,2,0,13
1054873,52,15,1961,12,male,1405,36,15,18,8,0,5,18,3
2122825,37,7,1976,10,male,565,36,32,18,3,17,3,1,0
1201832,48,21,1965,6,female,71,36,29,18,0,18,0,0,0
1544261,19,30,1994,11,male,555,36,31,18,15,18,4,0,11
1464264,66,3,1947,7,NA,2219,36,11,19,1,5,1,14,0
1378983,70,20,1943,5,female,395,36,18,19,3,18,3,1,0
1110284,103,31,1910,8,male,855,36,15,19,3,14,3,5,0
1870564,23,3,1990,6,male,120,36,15,19,12,19,11,0,1
1385031,34,6,1979,3,male,122,36,12,19,28,19,9,0,19
1910811,22,17,1991,10,male,152,36,29,19,72,19,66,0,6
1062821,60,24,1953,9,female,1339,36,19,19,31,19,29,0,2
1847655,35,1,1978,12,male,656,36,30,20,0,0,0,20,0
1543719,14,15,1999,2,male,3,36,36,20,38,0,7,20,31
1551013,21,19,1992,9,female,117,36,3,20,92,20,63,0,29
1693620,25,6,1988,1,female,406,36,23,21,17,17,13,4,4
1012459,25,11,1988,1,female,474,36,19,21,37,20,15,1,22
1393462,37,9,1976,11,male,440,36,26,21,15,21,12,0,3
1714669,20,22,1993,7,female,418,36,29,22,6,21,1,1,5
1140274,15,8,1998,3,male,342,36,22,22,0,22,0,0,0
2150276,69,13,1944,2,male,810,36,26,22,1,22,1,0,0
1098597,46,11,1967,10,female,209,36,21,22,16,22,14,0,2
2079323,31,19,1982,5,male,157,36,24,23,7,0,5,23,2
1275173,43,24,1970,1,male,696,36,22,23,101,21,83,2,18
1484471,28,6,1985,6,male,180,36,25,23,10,23,3,0,7
2050665,63,8,1950,10,female,308,36,26,23,6,23,6,0,0
1340880,56,31,1957,8,female,153,36,29,24,1,24,0,0,1
1762567,30,18,1983,8,male,165,36,36,24,11,24,10,0,1
1015303,15,16,1998,1,female,95,36,18,24,49,24,23,0,26
1929037,63,20,1950,12,female,1048,36,20,25,10,0,4,25,6
1727108,51,14,1962,10,male,1079,36,16,25,45,23,27,2,18
1622585,35,5,1978,4,female,603,36,17,25,7,25,7,0,0
1854489,58,1,1955,7,male,165,36,28,27,28,0,1,27,27
1297825,53,4,1960,12,female,137,36,23,28,22,0,1,28,21
1195163,53,30,1960,8,female,307,36,16,29,16,3,13,26,3
1254950,21,13,1992,4,male,45,36,14,29,53,2,3,27,50
1644247,74,1,1939,9,female,1085,36,21,29,5,12,4,17,1
2170427,42,30,1971,12,male,71,36,32,29,9,29,7,0,2
1200231,20,10,1993,9,female,851,36,15,29,46,29,32,0,14
1423032,21,10,1992,5,male,483,36,7,30,28,0,14,30,14
1724666,21,1,1992,1,female,132,36,24,30,11,18,9,12,2
1096032,33,18,1980,6,male,224,36,22,30,30,24,3,6,27
1523992,38,28,1975,2,female,721,36,11,30,51,24,2,6,49
1850490,22,21,1991,9,female,192,36,28,31,7,31,7,0,0
1482956,25,7,1988,1,female,270,36,3,31,11,31,11,0,0
1773930,22,22,1991,10,female,151,36,23,30,26,30,19,0,7
1754610,61,11,1952,6,male,149,36,29,31,20,31,18,0,2
1466776,43,7,1970,7,male,281,36,23,32,1,0,0,32,1
1299983,44,6,1969,3,female,559,36,21,33,17,0,0,33,17
1745824,39,10,1974,7,male,534,36,31,33,30,32,24,1,6
1923734,24,20,1989,2,male,154,36,28,33,32,33,18,0,14
2139091,50,5,1963,10,female,608,36,13,33,22,33,9,0,13
1083137,32,8,1981,8,female,310,36,0,33,52,33,46,0,6
1219398,63,18,1950,12,female,1713,36,23,34,3,0,1,34,2
1919257,75,11,1938,2,male,398,36,26,34,7,34,6,0,1
1839270,96,16,1917,9,female,1856,36,13,35,10,0,5,35,5
1881511,61,6,1952,5,female,1478,36,11,36,36,0,14,36,22
1730639,44,9,1969,6,female,328,36,11,36,0,36,0,0,0
1070124,25,10,1988,6,female,263,36,26,37,3,0,0,37,3
1284746,34,16,1979,1,female,462,36,8,37,13,36,12,1,1
2112402,14,17,1999,8,male,393,36,33,37,14,37,14,0,0
2099177,42,9,1971,3,female,443,36,26,37,23,37,19,0,4
1863180,20,15,1993,8,female,196,36,14,40,23,40,0,0,23
2004013,54,20,1959,7,female,128,36,34,40,27,40,22,0,5
1401291,23,12,1990,4,female,599,36,13,40,207,40,207,0,0
1888164,58,14,1955,2,female,1079,36,9,44,5,34,5,10,0
1474025,33,31,1980,5,female,422,36,22,44,0,44,0,0,0
2135517,32,28,1981,12,female,148,36,19,44,24,44,15,0,9
1183299,32,29,1981,7,male,276,36,27,43,15,43,13,0,2
1458237,16,26,1997,8,male,309,36,34,44,29,44,19,0,10
1513750,59,25,1954,4,female,1766,36,18,44,46,44,41,0,5
2157102,16,1,1997,1,male,505,36,18,45,0,10,0,35,0
1447621,21,14,1992,4,male,314,36,26,45,17,42,6,3,11
1739659,56,3,1957,7,female,1272,36,10,45,7,45,5,0,2
1284771,67,8,1946,10,male,709,36,26,46,19,0,2,46,17
2013530,23,1,1990,9,female,331,36,20,46,2,44,2,2,0
2189611,23,14,1990,2,male,128,36,24,47,39,37,37,10,2
1576988,25,1,1988,5,male,270,36,19,49,16,27,4,22,12
2107052,67,5,1946,1,female,93,36,27,48,29,48,7,0,22
1409437,38,31,1975,12,female,666,36,19,49,76,49,53,0,23
1107731,45,21,1968,1,female,744,36,8,48,84,48,71,0,13
1170903,42,3,1971,12,female,458,36,23,51,27,0,15,51,12
1038663,30,23,1983,4,female,93,36,26,51,35,0,11,51,24
2042808,53,7,1960,8,female,429,36,25,50,45,0,22,50,23
2000350,18,30,1995,7,male,175,36,25,50,25,24,17,26,8
1899937,108,3,1905,1,male,30,36,35,50,14,17,9,33,5
1778236,29,2,1984,7,male,549,36,20,50,1,50,1,0,0
2033944,47,23,1966,6,female,251,36,25,52,3,52,2,0,1
1161535,53,24,1960,4,female,529,36,16,52,68,52,53,0,15
1134398,20,14,1993,12,male,298,36,32,55,1,51,1,4,0
2132175,16,12,1997,1,male,193,36,30,54,18,54,17,0,1
1460600,33,1,1980,1,male,146,36,16,54,16,54,11,0,5
1337319,29,15,1984,6,male,117,36,35,58,8,0,7,58,1
1650570,63,13,1950,4,male,234,36,21,57,6,0,0,57,6
2042152,76,17,1937,1,male,1944,36,20,57,27,0,12,57,15
1202462,28,12,1985,8,male,12,36,25,57,54,50,51,7,3
1867258,68,24,1945,3,male,1092,36,11,58,3,58,0,0,3
1705661,26,2,1987,11,female,542,36,20,56,133,56,125,0,8
1440225,47,21,1966,10,male,635,36,23,60,18,60,8,0,10
1603372,40,7,1973,8,female,480,36,18,60,50,60,39,0,11
1249100,16,12,1997,11,male,306,36,30,63,0,0,0,63,0
1575968,51,3,1962,12,female,618,36,19,61,8,7,7,54,1
1943902,50,2,1963,12,female,399,36,25,61,5,61,2,0,3
1307850,66,27,1947,1,female,1598,36,19,65,72,15,15,50,57
1609214,36,21,1977,6,female,213,36,30,64,19,57,8,7,11
2137726,15,24,1998,5,male,86,36,22,65,15,65,15,0,0
1453678,22,10,1991,6,female,231,36,24,65,58,65,33,0,25
1666235,43,6,1970,7,female,570,36,12,64,90,64,67,0,23
1911634,21,8,1992,7,male,366,36,13,68,74,18,45,50,29
1593048,25,12,1988,3,male,303,36,26,68,23,53,0,15,23
1616208,59,2,1954,8,female,460,36,13,70,16,0,1,70,15
1796669,18,27,1995,5,female,184,36,22,70,38,19,29,51,9
1202569,21,7,1992,10,female,302,36,11,70,48,47,34,23,14
1797830,13,10,2000,3,female,128,36,28,71,40,62,30,9,10
1780926,59,1,1954,10,female,774,36,31,69,42,64,27,5,15
1866992,27,5,1986,5,female,125,36,18,72,50,46,4,26,46
1776847,22,15,1991,6,male,181,36,26,74,28,74,22,0,6
1731658,28,1,1985,11,female,131,36,10,74,173,74,146,0,27
2085914,108,1,1905,6,NA,2265,36,17,75,122,53,42,22,80
1765471,42,4,1971,3,female,280,36,25,75,26,73,11,2,15
1668120,72,3,1941,1,female,636,36,7,76,13,76,11,0,2
1214647,40,19,1973,5,male,305,36,27,79,27,1,19,78,8
1036774,48,9,1965,12,female,255,36,23,80,186,80,50,0,136
1848288,64,31,1949,8,female,1386,36,23,81,40,80,32,1,8
2064192,58,25,1955,2,female,870,36,21,83,92,83,83,0,9
2114080,40,2,1973,7,female,585,36,24,87,13,5,8,82,5
1484708,63,6,1950,7,female,700,36,21,85,21,0,1,85,20
2073211,40,8,1973,3,male,323,36,18,86,74,86,51,0,23
1109859,59,20,1954,7,female,216,36,29,90,41,0,28,90,13
1491900,13,9,2000,4,male,601,36,7,91,1,91,1,0,0
1301443,32,28,1981,1,female,693,36,20,88,16,88,16,0,0
2035601,33,6,1980,2,male,414,36,16,94,51,0,7,94,44
1298080,68,15,1945,12,female,245,36,3,92,41,0,10,92,31
1660470,67,21,1946,9,female,255,36,28,95,30,7,8,88,22
1443687,54,1,1959,4,female,228,36,31,93,36,62,14,31,22
1334792,30,27,1983,12,female,851,36,17,92,18,76,14,16,4
1695129,39,24,1974,6,male,271,36,15,92,15,92,14,0,1
1880742,53,17,1960,3,male,49,36,29,95,40,95,29,0,11
1580526,38,7,1975,7,female,154,36,18,96,5,0,2,96,3
1719647,56,8,1957,10,female,110,36,23,98,27,0,0,98,27
2041084,47,5,1966,6,female,933,36,18,96,37,95,14,1,23
2016333,59,7,1954,5,female,206,36,10,96,8,96,3,0,5
1784417,16,6,1997,3,female,27,36,26,96,45,96,33,0,12
1592604,29,22,1984,10,female,374,36,22,96,94,96,84,0,10
1632639,38,12,1975,4,female,631,36,28,100,60,17,4,83,56
2000304,96,1,1917,12,female,563,36,7,104,46,0,9,104,37
1337309,38,24,1975,7,female,238,36,19,102,53,88,31,14,22
1421090,26,30,1987,3,female,236,36,20,100,81,100,47,0,34
1736034,48,13,1965,4,female,244,36,18,108,12,0,7,108,5
1728415,13,13,2000,5,female,22,36,15,106,29,92,14,14,15
1843558,18,20,1995,9,male,109,36,27,108,34,108,21,0,13
1940262,37,18,1976,9,female,219,36,19,113,38,113,33,0,5
1689311,46,3,1967,10,female,242,36,25,117,18,75,10,42,8
1003406,47,15,1966,2,female,663,36,24,115,56,115,24,0,32
1949594,41,31,1972,3,female,109,36,19,121,77,121,54,0,23
1141193,50,3,1963,8,male,305,36,18,125,61,0,8,125,53
1279941,40,6,1973,1,female,215,36,16,127,29,127,19,0,10
1756843,27,20,1986,7,female,1264,36,21,130,223,130,122,0,101
1771569,58,1,1955,3,male,738,36,27,133,85,131,53,2,32
1573677,20,2,1993,9,female,49,36,21,132,158,132,111,0,47
1603473,32,1,1981,12,male,390,36,27,138,21,138,18,0,3
1785405,25,16,1988,10,male,58,36,34,139,44,139,44,0,0
1760772,49,10,1964,1,female,221,36,23,149,51,0,4,149,47
1620809,28,9,1985,11,male,440,36,29,144,18,144,16,0,2
1277414,30,27,1983,7,male,747,36,34,146,15,146,14,0,1
1824962,35,18,1978,11,male,544,36,23,149,22,149,10,0,12
1589526,51,17,1962,2,female,57,36,33,151,64,151,43,0,21
1233581,64,16,1949,10,male,428,36,26,171,56,4,26,167,30
1059375,23,25,1990,12,female,390,36,20,165,1,85,1,80,0
2113919,45,27,1968,7,female,28,36,21,169,16,60,12,109,4
1468932,17,23,1996,3,female,67,36,26,168,293,155,127,13,166
1666780,30,22,1983,12,female,336,36,33,165,28,165,14,0,14
1544359,56,29,1957,9,female,350,36,17,168,196,168,160,0,36
2013791,18,4,1995,6,male,15,36,28,179,39,179,19,0,20
1539506,55,6,1958,3,female,1403,36,28,197,24,197,11,0,13
2046360,34,21,1979,10,male,104,36,30,191,55,191,51,0,4
1659352,23,1,1990,1,female,465,36,22,206,20,206,14,0,6
1488226,34,26,1979,7,female,600,36,26,204,40,204,33,0,7
2125452,52,20,1961,11,male,634,36,10,220,241,218,137,2,104
1727665,52,3,1961,3,male,369,36,10,227,0,11,0,216,0
1520248,60,14,1953,3,female,363,36,23,226,81,0,57,226,24
1326921,40,17,1973,7,female,520,36,15,227,54,151,52,76,2
2076809,57,26,1956,7,female,464,36,26,257,123,0,72,257,51
1519603,20,22,1993,12,female,81,36,31,250,71,232,44,18,27
1863587,48,11,1965,6,female,698,36,24,248,18,248,14,0,4
1789455,49,1,1964,1,female,177,36,18,258,55,258,38,0,17
1669541,17,28,1996,3,male,203,36,30,265,36,265,19,0,17
1606078,25,24,1988,5,male,433,36,13,274,112,274,109,0,3
1564344,28,2,1985,9,female,286,36,24,261,175,261,159,0,16
1953325,62,27,1951,3,female,645,36,29,279,27,1,9,278,18
1591195,19,23,1994,9,female,286,36,30,279,75,273,47,6,28
1439799,59,14,1954,7,female,869,36,23,293,67,293,30,0,37
1483996,55,8,1958,4,female,15,36,28,315,47,305,22,10,25
1571410,66,20,1947,1,female,251,36,30,317,12,317,12,0,0
2133595,18,15,1995,6,female,70,36,27,315,123,315,59,0,64
2029360,20,22,1993,9,female,460,36,18,314,169,314,114,0,55
1277463,55,5,1958,1,female,243,36,18,335,139,0,18,335,121
1472315,35,21,1978,6,female,1373,36,14,336,170,336,108,0,62
2166746,58,13,1955,4,female,411,36,22,337,75,337,20,0,55
1286343,18,12,1995,11,male,396,36,31,361,3,361,3,0,0
1870090,50,16,1963,10,female,61,36,32,373,81,2,27,371,54
2079274,63,27,1950,1,male,1817,36,22,393,188,0,30,393,158
2138250,72,26,1941,4,female,1721,36,15,417,54,45,26,372,28
1644496,40,6,1973,8,female,231,36,27,415,319,415,237,0,82
1336324,50,24,1963,3,male,371,36,28,435,80,0,14,435,66
1081795,72,8,1941,10,male,1084,36,16,434,80,0,62,434,18
2046515,55,9,1958,1,female,195,36,20,432,93,432,69,0,24
1231704,33,21,1980,10,female,291,36,15,517,229,448,117,69,112
2180406,36,24,1977,1,female,360,36,28,492,150,461,41,31,109
1343661,28,8,1985,11,female,454,36,19,561,37,561,35,0,2
1698688,27,26,1986,1,female,129,36,33,560,12,560,10,0,2
1284590,47,30,1966,8,female,76,36,35,590,52,0,5,590,47
1293688,40,6,1973,10,female,125,36,12,662,380,639,91,23,289
1337580,14,11,1999,7,female,15,36,6,759,102,759,74,0,28
1099323,41,9,1972,11,male,468,36,29,768,13,768,11,0,2
1858259,43,8,1970,5,male,621,36,20,919,28,836,11,83,17
1901930,71,2,1942,5,female,218,36,34,1212,31,1212,24,0,7
1186319,53,25,1960,11,female,690,36,23,1314,52,1314,52,0,0
1294930,24,16,1989,5,female,175,36,20,1455,424,1455,187,0,237
1705034,63,7,1950,11,female,1406,36,13,1689,58,7,25,1682,33
2038330,20,9,1993,8,female,468,36,23,1798,199,1283,128,515,71
1637188,73,16,1940,9,female,1593,36,14,2215,46,445,20,1770,26
1663763,64,23,1949,6,male,1714,37,18,6,4,6,0,0,4
1917554,65,29,1948,5,male,1713,38,20,6,6,6,2,0,4
1142865,27,25,1986,2,female,143,37,32,6,55,6,49,0,6
1704291,38,20,1975,4,male,112,38,13,6,35,6,24,0,11
1506699,44,7,1969,7,female,24,37,24,6,56,6,51,0,5
1717035,53,24,1960,3,male,54,37,27,6,27,6,6,0,21
1442765,33,12,1980,5,female,346,38,9,7,0,0,0,7,0
2014825,54,12,1959,8,male,420,37,19,7,2,0,2,7,0
1897274,64,1,1949,9,male,1601,37,14,7,2,0,2,7,0
1976286,17,24,1996,5,male,195,37,27,7,5,0,0,7,5
1943192,18,4,1995,6,female,268,37,18,7,7,1,6,6,1
1477162,23,3,1990,1,male,421,37,20,7,27,0,3,7,24
1317529,47,17,1966,9,female,179,37,31,7,13,0,6,7,7
1701047,71,1,1942,3,female,188,37,25,7,36,0,31,7,5
1280869,100,10,1913,10,female,120,38,31,7,12,0,7,7,5
1834064,19,4,1994,2,male,232,38,26,7,4,4,2,3,2
2188848,29,24,1984,11,male,81,37,28,7,6,5,3,2,3
2165457,44,8,1969,11,male,131,38,9,7,26,5,6,2,20
1081768,50,6,1963,12,female,462,37,33,7,16,5,7,2,9
1497822,18,8,1995,6,male,86,38,30,7,1,7,1,0,0
1307650,30,27,1983,7,female,317,38,21,7,1,7,1,0,0
1093517,54,22,1959,7,female,505,37,19,7,1,7,1,0,0
1476860,63,29,1950,4,male,918,38,26,7,0,7,0,0,0
1042114,26,1,1987,8,male,482,37,17,7,2,7,2,0,0
1500576,55,26,1958,8,male,101,38,34,7,4,7,0,0,4
1288346,25,1,1988,1,male,182,37,12,7,6,7,6,0,0
1585524,30,2,1983,1,male,195,38,31,7,7,7,7,0,0
2121989,16,29,1997,8,male,28,38,33,7,24,7,8,0,16
1743107,60,27,1953,6,female,336,38,34,7,14,7,10,0,4
1516937,59,11,1954,5,male,893,37,24,8,0,0,0,8,0
1516004,69,15,1944,10,male,1743,38,14,8,0,0,0,8,0
1799076,32,9,1981,6,female,145,38,27,8,3,1,0,7,3
1155384,48,6,1965,3,male,526,38,22,8,4,0,0,8,4
2133674,63,11,1950,11,female,660,37,23,8,4,0,2,8,2
1495697,69,8,1944,12,male,103,37,15,8,27,0,6,8,21
1583563,50,2,1963,11,female,509,38,24,8,2,4,1,4,1
2167147,28,9,1985,7,male,653,38,22,8,8,4,5,4,3
1312371,14,18,1999,4,male,428,37,31,8,0,6,0,2,0
1821777,64,14,1949,2,female,662,37,25,8,4,6,4,2,0
1966694,19,2,1994,4,male,276,38,38,8,1,8,1,0,0
1061411,22,31,1991,8,male,280,38,38,8,0,8,0,0,0
1771102,27,20,1986,10,male,330,38,27,8,0,8,0,0,0
1393633,31,5,1982,11,male,116,37,30,8,1,8,0,0,1
1991069,47,7,1966,11,female,177,38,25,8,0,8,0,0,0
2164894,72,30,1941,12,male,628,37,21,8,1,8,1,0,0
1445558,35,2,1978,2,male,262,38,27,8,4,8,4,0,0
2081306,63,21,1950,12,male,1580,38,19,8,3,8,2,0,1
1674178,23,5,1990,12,male,647,38,28,8,5,8,3,0,2
1414289,30,24,1983,4,female,261,37,25,8,7,8,6,0,1
1327383,57,17,1956,7,male,7,37,32,8,8,8,5,0,3
1728823,25,9,1988,10,female,270,37,21,8,88,8,47,0,41
1023817,29,7,1984,9,male,322,38,32,8,14,8,10,0,4
1242609,49,10,1964,4,male,517,37,21,8,102,8,90,0,12
2052347,68,15,1945,7,female,499,37,26,9,0,1,0,8,0
1048076,74,11,1939,11,male,739,38,33,9,1,0,0,9,1
1360979,22,30,1991,11,male,4,37,37,9,10,0,4,9,6
1039019,38,12,1975,12,male,473,38,26,9,15,0,1,9,14
1881321,18,8,1995,6,male,34,38,37,9,1,3,1,6,0
2153506,34,22,1979,8,male,535,37,37,9,3,5,3,4,0
1095870,63,8,1950,8,female,54,38,17,9,7,2,5,7,2
2010285,62,15,1951,7,male,75,38,30,9,0,7,0,2,0
1410104,18,15,1995,7,male,84,37,24,9,0,9,0,0,0
1957947,19,1,1994,1,male,30,37,35,9,0,9,0,0,0
1443866,22,25,1991,1,male,1444,37,14,9,1,9,0,0,1
1044060,28,21,1985,12,female,599,38,17,9,1,9,0,0,1
2152069,30,14,1983,12,male,528,38,8,9,1,9,0,0,1
1968903,57,28,1956,2,female,687,38,20,9,0,9,0,0,0
1008103,16,14,1997,9,female,455,37,19,9,3,9,0,0,3
1418215,24,3,1989,1,female,171,37,24,9,4,9,3,0,1
1582093,50,3,1963,8,male,265,38,23,9,2,9,2,0,0
2154725,18,8,1995,6,female,424,38,12,9,6,9,1,0,5
1627026,64,2,1949,8,female,1695,38,11,9,8,9,5,0,3
1962764,40,16,1973,2,male,118,37,25,9,60,9,50,0,10
1037258,50,18,1963,2,male,358,38,21,9,29,9,21,0,8
1693074,55,24,1958,7,female,705,37,26,9,17,9,15,0,2
1794492,59,10,1954,4,female,323,37,17,9,15,9,13,0,2
1945686,18,2,1995,4,female,280,37,21,10,1,0,0,10,1
1671671,19,10,1994,4,male,420,38,26,10,0,0,0,10,0
2078400,26,26,1987,11,male,532,37,24,10,0,0,0,10,0
2056481,102,22,1911,9,male,1814,38,13,10,1,0,1,10,0
1143354,64,4,1949,11,female,401,38,18,10,6,0,4,10,2
1800266,68,12,1945,12,female,629,38,17,10,9,0,0,10,9
1492964,55,1,1958,5,male,12,37,22,10,23,0,4,10,19
1545816,62,10,1951,8,female,1215,38,2,10,30,0,6,10,24
2086111,70,11,1943,5,female,1614,37,20,10,23,0,5,10,18
1578892,71,22,1942,9,female,20,38,21,10,20,0,6,10,14
1733574,19,19,1994,11,male,197,38,21,10,2,2,2,8,0
1919912,30,1,1983,4,male,15,37,19,10,4,3,2,7,2
1893291,59,25,1954,4,female,1164,37,9,10,2,5,2,5,0
1103997,65,7,1948,8,male,1577,37,8,10,18,2,4,8,14
1701666,20,3,1993,4,male,389,38,26,10,5,9,4,1,1
1184705,25,18,1988,9,male,596,37,17,10,3,9,2,1,1
1333623,24,7,1989,12,female,394,37,10,10,33,8,24,2,9
1789688,38,6,1975,5,male,349,38,14,10,0,10,0,0,0
1528060,63,30,1950,1,female,69,37,32,10,1,10,1,0,0
1533847,75,11,1938,1,male,1522,37,23,10,1,10,1,0,0
1903787,38,20,1975,2,female,175,37,27,10,4,10,4,0,0
1833898,43,30,1970,4,male,538,38,17,10,2,10,2,0,0
1736170,43,16,1970,8,male,181,38,13,10,4,10,4,0,0
2144484,35,11,1978,1,female,95,38,29,10,7,10,5,0,2
1510632,25,16,1988,11,female,149,38,30,10,27,10,19,0,8
1518861,65,13,1948,10,male,59,38,35,11,1,0,0,11,1
1158633,27,30,1986,9,male,353,38,35,11,6,0,5,11,1
1630418,62,24,1951,10,female,1472,38,22,11,4,0,4,11,0
1135403,63,8,1950,5,female,310,38,34,11,11,0,2,11,9
2158025,24,2,1989,8,male,14,37,37,11,4,7,3,4,1
1929091,79,14,1934,6,female,890,38,31,11,2,3,1,8,1
1401124,38,24,1975,5,male,451,37,22,11,37,3,28,8,9
2087314,53,17,1960,9,female,959,38,27,11,5,8,2,3,3
1918534,71,13,1942,2,male,1781,38,4,11,0,11,0,0,0
1199900,23,23,1990,3,female,285,38,29,11,3,11,0,0,3
1699235,28,15,1985,11,male,120,37,7,11,4,11,3,0,1
1418136,30,29,1983,9,male,223,37,30,11,5,11,5,0,0
2169890,60,2,1953,10,male,1496,37,11,11,4,11,4,0,0
2024424,63,9,1950,4,male,1060,37,27,11,4,11,4,0,0
1375970,19,27,1994,4,male,647,37,18,11,8,11,8,0,0
1601832,25,4,1988,4,female,212,37,21,11,15,11,14,0,1
1438284,52,4,1961,9,male,555,38,18,11,15,11,11,0,4
1009182,54,11,1959,11,female,756,37,21,11,11,11,7,0,4
1797504,70,1,1943,6,female,1764,38,10,11,9,11,7,0,2
1963142,33,20,1980,1,female,593,37,12,11,61,11,58,0,3
1460167,67,17,1946,8,female,467,38,30,12,8,0,4,12,4
1162190,64,17,1949,12,female,344,37,10,12,19,0,9,12,10
1045639,48,6,1965,5,male,301,38,24,12,9,11,7,1,2
1636075,64,14,1949,4,female,215,37,27,12,0,12,0,0,0
2156736,18,7,1995,7,male,333,37,21,12,5,12,5,0,0
1695086,36,19,1977,2,female,642,38,24,12,18,12,14,0,4
2122107,21,1,1992,12,male,555,38,23,13,1,0,1,13,0
1113454,25,1,1988,1,male,127,38,33,13,29,5,11,8,18
1868479,56,1,1957,7,female,682,38,30,13,4,13,2,0,2
1098103,76,27,1937,10,female,511,38,29,13,4,13,3,0,1
1550433,100,1,1913,1,male,210,38,16,13,7,13,4,0,3
2153507,25,16,1988,2,female,21,38,23,13,10,13,9,0,1
1820568,20,15,1993,7,female,372,38,3,13,41,13,39,0,2
1340541,25,1,1988,1,female,128,38,9,13,46,13,42,0,4
1990784,29,14,1984,5,male,8,37,23,13,21,13,5,0,16
1398768,34,17,1979,6,male,480,38,17,14,1,5,0,9,1
1253666,21,28,1992,8,female,171,38,16,14,9,3,6,11,3
1629980,23,22,1990,1,male,111,38,23,14,6,12,5,2,1
1041563,56,5,1957,5,male,337,37,8,14,1,14,1,0,0
1467578,21,12,1992,8,male,46,38,36,14,3,14,2,0,1
1627805,42,16,1971,6,male,259,37,12,14,5,14,5,0,0
1582558,53,3,1960,3,male,899,38,17,14,3,14,2,0,1
1891696,31,16,1982,8,male,308,37,12,14,68,14,45,0,23
1126496,20,14,1993,8,male,557,37,22,15,2,6,1,9,1
1083034,23,19,1990,12,male,167,38,31,15,2,14,1,1,1
1191310,19,24,1994,12,male,243,37,28,15,1,15,1,0,0
1899205,40,7,1973,3,male,602,38,29,15,0,15,0,0,0
2018890,45,17,1968,9,female,104,38,25,15,0,15,0,0,0
2066796,17,14,1996,12,male,368,38,27,15,3,15,3,0,0
1406053,52,21,1961,9,male,141,37,32,15,4,15,1,0,3
1416306,63,10,1950,7,female,1881,37,19,15,6,15,3,0,3
2132606,69,16,1944,10,male,1081,37,21,15,9,15,7,0,2
1082489,25,16,1988,6,male,543,38,34,15,17,15,6,0,11
1918007,26,1,1987,6,male,517,38,22,15,17,15,17,0,0
1671857,25,15,1988,11,female,34,37,12,15,64,15,56,0,8
1837544,19,30,1994,3,male,526,37,18,16,3,3,1,13,2
1010544,55,5,1958,2,female,328,37,27,16,5,0,3,16,2
1965123,18,30,1995,6,male,222,38,35,16,0,16,0,0,0
1847488,47,30,1966,7,male,927,37,17,16,3,16,3,0,0
1917907,58,4,1955,2,male,1197,38,27,16,3,16,0,0,3
1069288,36,30,1977,6,male,304,38,19,16,19,16,18,0,1
1859394,44,12,1969,10,female,621,38,11,16,25,16,21,0,4
2032252,13,4,2000,5,male,40,37,26,17,2,0,0,17,2
1214627,59,27,1954,8,female,294,38,37,17,0,0,0,17,0
1179180,23,10,1990,10,male,141,38,28,17,2,17,1,0,1
1331366,23,1,1990,1,male,48,37,33,17,10,17,9,0,1
1353814,42,1,1971,12,female,273,37,23,17,9,17,2,0,7
1364690,18,17,1995,5,male,436,38,24,17,12,17,12,0,0
2124223,41,27,1972,3,male,140,38,29,18,12,3,7,15,5
2136648,29,1,1984,10,male,362,37,27,18,0,12,0,6,0
1379683,18,26,1995,9,female,449,37,22,18,35,7,17,11,18
1047580,58,27,1955,11,female,549,37,11,18,51,8,22,10,29
1551346,31,24,1982,2,male,75,37,35,18,1,16,1,2,0
1766211,36,26,1977,10,male,276,37,21,18,2,16,0,2,2
1458427,60,27,1953,1,female,2276,38,27,18,1,18,0,0,1
2040051,25,9,1988,10,female,184,38,32,18,17,18,13,0,4
1421176,38,24,1975,1,female,191,37,33,18,11,18,11,0,0
2127099,57,27,1956,12,male,1188,38,16,19,4,2,2,17,2
2137813,65,19,1948,10,male,1733,38,12,19,9,0,8,19,1
1174299,27,16,1986,9,female,229,37,6,19,0,19,0,0,0
1044029,26,12,1987,12,male,99,37,34,19,4,19,4,0,0
1738007,52,1,1961,4,male,219,37,36,19,10,19,8,0,2
2058591,25,24,1988,11,male,184,37,32,19,22,19,19,0,3
1529872,17,26,1996,8,male,36,37,30,19,55,19,55,0,0
1454670,38,1,1975,7,male,820,38,21,19,30,19,30,0,0
1484548,61,7,1952,9,male,1071,37,17,20,2,0,1,20,1
1858840,17,15,1996,10,female,424,37,26,20,5,0,3,20,2
1694711,75,26,1938,1,NA,1469,38,14,20,1,18,0,2,1
1300053,23,1,1990,3,male,44,38,28,20,4,20,4,0,0
1160036,31,22,1982,4,male,752,37,20,20,10,20,9,0,1
1491292,38,1,1975,1,female,379,38,32,20,7,20,4,0,3
2144892,43,5,1970,7,female,185,38,27,20,7,20,1,0,6
1391532,49,3,1964,11,male,306,37,18,20,6,20,5,0,1
1407707,57,10,1956,5,female,258,37,31,20,5,20,4,0,1
1484711,94,25,1919,7,female,254,37,28,20,15,20,12,0,3
2162644,36,16,1977,7,male,104,37,14,20,130,20,110,0,20
1921676,48,2,1965,1,female,6,37,17,20,88,20,69,0,19
2091050,80,14,1933,3,female,780,37,27,21,2,0,1,21,1
2148925,81,13,1932,7,female,1509,37,18,21,3,2,1,19,2
1273149,18,6,1995,1,male,20,38,34,21,15,2,1,19,14
2097210,31,13,1982,6,female,184,38,23,21,19,7,8,14,11
1861359,60,3,1953,3,male,159,38,11,21,1,21,1,0,0
1706070,19,6,1994,6,female,250,37,14,21,13,21,8,0,5
1789424,47,16,1966,1,female,359,37,19,21,28,21,9,0,19
1666981,49,12,1964,10,female,637,38,11,21,38,21,24,0,14
1906039,22,18,1991,4,female,527,38,7,22,15,13,10,9,5
1106561,35,28,1978,12,male,700,38,24,22,0,22,0,0,0
1856761,48,23,1965,11,male,273,38,22,22,2,22,0,0,2
1165711,26,2,1987,7,male,215,37,24,22,6,22,5,0,1
1143010,38,22,1975,6,male,1310,37,21,22,7,22,7,0,0
1431462,18,2,1995,6,female,269,38,22,23,2,0,0,23,2
1891538,19,1,1994,7,male,25,38,36,23,5,12,4,11,1
2097248,37,4,1976,4,male,167,38,11,23,2,23,2,0,0
1536228,24,5,1989,5,female,24,38,31,23,27,23,14,0,13
1833885,28,10,1985,12,female,568,38,21,23,15,23,15,0,0
1343075,31,4,1982,8,male,192,38,13,23,23,23,14,0,9
1069226,42,20,1971,5,female,299,38,36,23,32,23,31,0,1
1618335,81,4,1932,5,female,607,38,35,24,10,0,8,24,2
1471704,104,23,1909,3,female,1496,38,1,24,43,14,12,10,31
2156138,35,1,1978,6,male,154,38,32,24,14,24,7,0,7
1503892,45,10,1968,2,male,293,37,24,25,3,0,1,25,2
1976185,45,13,1968,5,female,291,38,26,25,41,0,19,25,22
2032983,65,14,1948,7,female,214,37,33,25,3,24,2,1,1
1765666,18,22,1995,2,male,10,37,28,25,4,25,4,0,0
1345696,25,12,1988,12,male,377,37,14,25,0,25,0,0,0
1245658,19,21,1994,9,female,196,38,3,25,13,25,13,0,0
2097690,24,29,1989,8,female,144,37,15,25,170,25,40,0,130
1963028,28,1,1985,11,male,492,38,33,25,56,25,36,0,20
1772234,51,8,1962,2,female,195,38,21,26,2,0,0,26,2
2108830,24,2,1989,3,female,29,38,16,26,37,1,13,25,24
1480731,50,23,1963,9,female,304,37,25,26,16,0,8,26,8
1304934,107,11,1906,10,male,1193,38,14,26,16,2,13,24,3
1689486,45,21,1968,5,female,438,37,25,26,63,0,3,26,60
1987089,13,10,2000,6,female,109,38,22,26,0,14,0,12,0
1254102,14,4,1999,7,female,234,37,20,26,2,23,1,3,1
1982703,30,2,1983,2,male,1265,37,13,26,15,22,6,4,9
1294194,34,14,1979,3,female,245,37,30,26,5,25,4,1,1
1513611,53,30,1960,4,male,987,38,19,26,18,24,8,2,10
1238635,54,9,1959,9,female,406,37,11,26,17,19,3,7,14
1323933,43,9,1970,1,male,264,37,27,26,36,26,23,0,13
1580957,52,9,1961,1,female,41,37,17,26,36,26,31,0,5
1092298,54,30,1959,9,female,1009,38,19,27,2,3,1,24,1
1910704,69,5,1944,3,female,753,37,36,27,3,0,0,27,3
2061449,72,8,1941,10,female,1168,37,15,27,16,0,10,27,6
1623389,24,1,1989,7,female,298,37,26,27,4,10,2,17,2
1880363,28,7,1985,8,female,409,38,24,27,2,27,2,0,0
1135867,38,11,1975,6,male,244,38,22,27,13,27,8,0,5
1324075,60,23,1953,8,female,608,38,25,27,22,27,22,0,0
1423181,36,1,1977,4,male,455,38,12,27,56,27,37,0,19
1977368,59,12,1954,8,male,1283,38,22,28,12,0,9,28,3
1456672,64,13,1949,5,female,1343,37,22,28,7,5,4,23,3
1209185,22,1,1991,8,male,203,37,24,28,2,28,1,0,1
1730016,24,23,1989,2,male,198,38,13,28,3,28,3,0,0
1292922,57,28,1956,5,female,465,38,18,28,5,28,3,0,2
1178493,28,30,1985,6,male,117,38,33,29,0,13,0,16,0
2173141,66,17,1947,12,female,724,37,13,29,7,22,4,7,3
1509405,21,12,1992,6,female,586,37,22,29,24,27,20,2,4
1068656,25,20,1988,2,male,38,38,20,29,4,29,3,0,1
1954686,48,29,1965,12,male,1673,38,27,29,17,29,11,0,6
1983413,69,5,1944,6,female,346,38,27,29,11,29,8,0,3
1287794,66,30,1947,7,male,1753,38,12,29,29,29,29,0,0
1311606,61,31,1952,3,female,312,38,21,30,4,0,2,30,2
1012253,53,4,1960,9,female,532,37,28,31,13,0,9,31,4
1210128,42,5,1971,4,female,623,38,28,31,20,16,10,15,10
1954090,32,14,1981,12,female,273,37,7,31,21,29,11,2,10
1449870,35,24,1978,7,female,320,38,23,30,73,23,26,7,47
1194726,46,11,1967,11,male,447,38,29,31,3,31,3,0,0
1824612,47,31,1966,3,male,214,37,27,31,2,31,2,0,0
1423156,57,13,1956,3,female,364,37,21,30,4,30,4,0,0
1894385,69,27,1944,3,female,1267,38,25,30,4,30,0,0,4
1142015,111,1,1902,1,female,2142,37,19,30,1,30,1,0,0
1003316,22,9,1991,2,female,254,38,29,30,36,30,12,0,24
1982261,24,21,1989,7,male,174,37,34,31,30,31,26,0,4
1196938,54,15,1959,1,female,169,37,22,31,33,31,22,0,11
1997307,66,17,1947,1,male,249,37,28,30,24,30,23,0,1
2093335,73,25,1940,10,male,245,37,26,30,21,30,17,0,4
1736795,64,10,1949,1,female,1435,37,18,32,4,0,1,32,3
1381309,29,31,1984,1,male,118,37,22,32,22,9,16,23,6
1465778,18,7,1995,7,male,52,38,26,32,20,32,17,0,3
1640447,57,11,1956,8,male,784,38,28,32,47,32,46,0,1
2150784,65,14,1948,10,female,394,38,25,34,4,0,0,34,4
2049392,72,21,1941,11,female,1983,37,20,34,7,6,4,28,3
1613389,20,24,1993,7,male,147,38,15,34,13,24,3,10,10
1157076,108,20,1905,3,female,52,38,21,34,13,12,12,22,1
1683790,64,11,1949,9,male,1532,38,18,34,33,14,13,20,20
1349294,56,28,1957,3,female,982,37,10,34,5,34,4,0,1
1783935,47,24,1966,10,female,1416,38,14,36,17,0,13,36,4
1812864,52,25,1961,9,female,788,38,22,36,17,3,11,33,6
1608454,64,21,1949,7,female,1363,38,19,35,19,0,6,35,13
1242635,64,2,1949,9,male,646,38,24,36,28,0,23,36,5
2073473,50,21,1963,10,female,391,38,26,36,56,3,23,33,33
1608082,73,11,1940,8,male,1122,38,24,35,84,17,70,18,14
1975298,32,23,1981,10,female,457,37,15,35,2,35,1,0,1
1750622,54,13,1959,10,female,161,38,25,36,8,36,3,0,5
1839522,51,10,1962,6,male,27,37,31,36,41,36,33,0,8
1793024,72,16,1941,6,female,684,38,15,37,20,0,1,37,19
1579877,31,6,1982,8,male,441,38,18,37,9,37,9,0,0
1021117,56,7,1957,2,male,363,38,19,38,4,0,2,38,2
1382643,70,26,1943,1,female,838,37,26,39,3,0,0,39,3
1734248,62,2,1951,3,male,424,37,20,38,2,15,0,23,2
1476159,34,29,1979,9,female,1238,38,22,39,152,36,130,3,22
1712080,17,13,1996,8,female,174,37,18,38,7,38,3,0,4
1742408,25,1,1988,1,male,39,38,31,39,27,39,27,0,0
2066227,53,15,1960,10,female,161,37,23,39,36,39,34,0,2
1889852,44,15,1969,2,male,82,37,16,39,79,39,65,0,14
1605753,30,13,1983,12,female,436,37,21,40,4,40,3,0,1
1504678,55,18,1958,4,female,724,37,15,41,7,0,5,41,2
1093986,58,10,1955,11,male,396,37,14,42,10,0,4,42,6
2011873,68,10,1945,4,female,508,38,23,41,14,0,2,41,12
2172611,26,18,1987,9,male,399,38,32,41,61,33,22,8,39
1562559,34,23,1979,12,male,339,38,34,42,44,42,40,0,4
2143097,41,26,1972,3,female,340,37,18,42,74,42,55,0,19
1173561,44,2,1969,9,female,419,37,27,44,7,0,3,44,4
2068086,59,16,1954,6,female,1609,37,17,44,2,0,0,44,2
1211120,63,1,1950,11,female,1769,37,16,44,72,0,24,44,48
1679816,58,7,1955,8,female,863,38,17,43,36,16,26,27,10
2059121,42,4,1971,4,male,986,38,21,43,19,35,19,8,0
1379182,22,19,1991,8,male,654,38,26,44,32,44,25,0,7
2142171,26,11,1987,9,male,27,38,27,45,10,43,0,2,10
1466680,61,5,1952,8,female,1477,38,31,45,11,41,7,4,4
2130842,65,22,1948,11,male,187,38,25,46,2,0,1,46,1
1646027,84,22,1929,11,male,815,37,24,46,2,7,2,39,0
1061274,38,23,1975,9,male,798,37,27,47,23,0,15,47,8
1480450,44,5,1969,11,male,556,37,17,46,12,4,7,42,5
1869203,83,2,1930,3,female,799,38,34,46,121,0,48,46,73
2104109,57,15,1956,11,male,507,38,13,47,23,13,15,34,8
2192560,22,10,1991,3,male,439,37,14,46,31,46,26,0,5
1681108,24,23,1989,9,male,356,38,21,46,47,46,25,0,22
1786995,75,13,1938,1,female,421,38,32,49,8,0,4,49,4
1751500,27,23,1986,4,male,268,38,34,49,54,0,17,49,37
1236258,53,13,1960,1,female,1713,38,23,49,18,44,10,5,8
1479941,25,8,1988,3,male,161,37,25,49,3,49,3,0,0
2091533,33,29,1980,3,female,490,38,9,49,1,49,1,0,0
1033885,36,13,1977,4,female,467,37,25,49,2,49,2,0,0
1402613,28,1,1985,3,male,332,38,21,48,22,48,16,0,6
1040532,52,27,1961,7,female,242,37,30,49,42,49,30,0,12
1532646,20,19,1993,2,female,165,37,31,50,17,0,10,50,7
1980445,45,28,1968,5,female,334,38,25,51,31,2,14,49,17
1506810,44,22,1969,12,male,32,38,29,50,54,49,43,1,11
1095098,52,26,1961,12,female,227,38,35,51,58,44,28,7,30
1298395,79,29,1934,4,female,1438,38,15,51,16,51,12,0,4
1698504,13,15,2000,9,male,214,37,8,51,39,51,30,0,9
1076986,108,7,1905,11,male,2485,37,8,52,47,0,32,52,15
1106978,16,26,1997,10,female,272,37,28,53,51,24,16,29,35
1821025,44,8,1969,9,female,26,37,34,53,1,52,1,1,0
2154833,38,14,1975,8,female,394,38,30,52,13,52,4,0,9
1871573,58,9,1955,11,female,448,38,31,53,99,53,80,0,19
1499314,18,7,1995,12,male,65,37,35,55,8,6,3,49,5
1783386,14,19,1999,4,female,98,37,33,55,86,0,8,55,78
2042118,23,9,1990,1,male,113,38,23,55,17,31,6,24,11
1234606,26,2,1987,6,male,94,37,29,55,23,46,16,9,7
2045123,48,22,1965,10,female,647,37,26,54,34,54,31,0,3
2031641,35,11,1978,4,female,435,37,18,58,15,2,1,56,14
1137455,50,15,1963,8,female,665,38,22,58,28,2,13,56,15
1879135,29,22,1984,2,male,337,38,23,58,63,7,34,51,29
1019923,62,24,1951,9,female,1129,38,21,58,47,0,23,58,24
1642323,32,8,1981,11,male,287,37,25,57,34,31,10,26,24
1570913,39,23,1974,4,female,652,37,18,58,1,58,0,0,1
1012739,26,28,1987,4,female,200,38,11,58,42,58,42,0,0
1310063,41,1,1972,4,male,610,38,29,60,8,34,2,26,6
1841448,36,19,1977,8,male,625,38,32,60,5,60,5,0,0
1657796,41,12,1972,3,female,516,37,23,63,14,63,14,0,0
1764125,63,13,1950,4,female,1087,37,13,62,57,62,51,0,6
1573614,46,27,1967,3,female,106,37,29,61,149,61,134,0,15
1374826,73,24,1940,9,female,846,38,12,64,9,0,3,64,6
2144371,24,12,1989,6,male,218,37,19,65,1,65,0,0,1
1253599,61,11,1952,8,female,64,37,35,64,2,64,0,0,2
1999094,62,3,1951,6,female,547,38,25,64,14,64,8,0,6
1138099,51,28,1962,5,male,485,37,19,65,72,65,58,0,14
1906364,63,7,1950,7,female,776,38,23,64,42,64,26,0,16
2093980,19,27,1994,3,male,30,37,20,67,24,3,6,64,18
2025627,22,13,1991,9,male,324,38,31,66,15,60,11,6,4
1122577,46,21,1967,6,male,552,37,27,67,15,63,5,4,10
1977829,23,20,1990,5,male,254,38,18,66,8,66,4,0,4
1512409,38,23,1975,11,male,318,38,27,66,4,66,4,0,0
1762357,24,9,1989,3,female,64,38,9,66,28,66,17,0,11
1566150,25,1,1988,1,male,163,38,29,67,19,67,18,0,1
1440266,30,1,1983,1,male,29,37,34,66,36,66,24,0,12
1604140,61,2,1952,1,male,733,37,28,68,23,68,12,0,11
1186644,55,21,1958,3,female,1012,37,16,71,1,0,1,71,0
2174729,58,26,1955,9,female,1532,37,12,70,43,4,12,66,31
2176260,43,25,1970,6,female,403,37,13,71,8,53,8,18,0
2167906,50,30,1963,5,female,401,37,14,71,13,70,12,1,1
1303504,19,4,1994,10,male,236,37,29,70,30,70,14,0,16
1431381,51,4,1962,6,male,415,37,30,72,1,0,0,72,1
1915991,65,16,1948,3,female,1382,38,20,73,28,30,17,43,11
1914180,67,14,1946,1,female,1021,38,24,76,6,0,2,76,4
2095164,34,26,1979,1,female,102,37,27,75,41,73,19,2,22
1631288,70,28,1943,4,female,1471,38,15,75,90,73,29,2,61
2016468,55,5,1958,5,female,1568,38,22,77,74,77,49,0,25
2157467,28,1,1985,1,female,216,38,28,79,156,54,87,25,69
1849465,24,13,1989,4,female,247,38,20,78,54,78,41,0,13
2000134,29,25,1984,9,male,110,38,20,82,30,14,15,68,15
1473784,60,10,1953,4,female,711,38,16,84,34,43,10,41,24
1686495,17,13,1996,9,male,228,38,33,81,4,78,4,3,0
1255048,40,1,1973,3,male,304,38,25,84,38,75,10,9,28
1357835,31,17,1982,1,male,359,37,21,84,14,84,13,0,1
1838362,34,2,1979,2,female,184,37,25,84,22,84,4,0,18
1288723,69,16,1944,10,female,1141,37,25,85,2,0,1,85,1
1085218,17,11,1996,6,male,379,37,20,85,24,0,10,85,14
1073177,29,24,1984,1,female,528,38,25,86,34,84,29,2,5
2073890,57,11,1956,4,male,473,37,16,87,22,84,22,3,0
2155647,64,6,1949,10,male,584,37,31,86,52,85,51,1,1
1502619,62,27,1951,10,female,49,38,22,91,189,15,126,76,63
1916676,28,7,1985,3,female,178,37,30,88,137,23,107,65,30
1419614,44,8,1969,3,female,1140,38,32,88,42,70,19,18,23
1790689,21,1,1992,7,male,177,37,24,88,1,88,1,0,0
1868426,58,15,1955,2,female,561,37,29,95,86,66,57,29,29
1705547,66,1,1947,7,female,599,37,16,94,21,81,15,13,6
1430354,18,1,1995,7,male,494,37,22,92,2,92,1,0,1
1643326,40,19,1973,2,male,504,37,12,95,0,95,0,0,0
1736025,35,16,1978,10,male,447,37,30,94,46,94,26,0,20
1452857,46,25,1967,2,female,1793,38,13,93,122,93,103,0,19
2086029,67,6,1946,6,male,1688,38,16,94,81,94,39,0,42
1863629,25,25,1988,3,male,13,37,25,99,56,0,19,99,37
1670623,54,8,1959,1,female,463,37,30,96,44,0,12,96,32
2101273,44,9,1969,9,female,502,37,25,99,94,7,59,92,35
1254452,25,7,1988,6,male,373,37,25,96,14,85,10,11,4
1081463,41,17,1972,11,female,206,38,32,98,5,98,5,0,0
1658732,42,27,1971,10,male,662,38,28,97,39,97,34,0,5
1430694,56,22,1957,11,female,264,37,14,97,79,97,63,0,16
1845488,19,17,1994,2,male,281,37,34,101,43,101,34,0,9
1774054,66,9,1947,4,male,779,38,20,108,3,0,1,108,2
1543656,50,12,1963,2,male,289,37,29,107,60,0,16,107,44
1338014,53,11,1960,6,female,62,37,27,109,147,103,65,6,82
1102957,41,13,1972,7,male,327,38,14,109,12,109,11,0,1
1246340,45,9,1968,2,female,884,37,21,108,106,108,83,0,23
1651809,20,7,1993,12,female,255,37,20,112,8,3,1,109,7
1831423,29,7,1984,3,male,328,37,19,112,75,13,25,99,50
2166016,75,24,1938,5,female,34,37,19,113,31,113,22,0,9
1547986,39,24,1974,7,female,223,38,25,118,14,118,9,0,5
1528936,24,1,1989,1,male,63,37,24,114,54,114,27,0,27
2084417,52,17,1961,12,female,487,37,23,117,42,117,35,0,7
1939112,54,9,1959,11,female,75,37,28,118,29,118,19,0,10
1546712,25,25,1988,12,female,546,37,25,115,134,115,84,0,50
1956740,56,29,1957,8,female,198,38,28,121,5,121,5,0,0
2103217,37,25,1976,3,male,386,38,19,123,113,123,64,0,49
2006175,48,27,1965,9,female,754,37,23,121,74,121,41,0,33
1495732,18,30,1995,7,male,48,38,25,123,328,123,323,0,5
1800537,43,6,1970,2,female,319,37,19,129,20,3,1,126,19
1647377,68,18,1945,2,female,269,37,31,129,74,0,37,129,37
2139907,70,26,1943,7,male,1356,37,20,125,30,35,14,90,16
1495495,59,22,1954,3,female,1451,37,24,130,94,59,76,71,18
1874154,63,4,1950,12,female,1997,37,17,129,107,70,67,59,40
2061818,58,7,1955,3,male,408,37,30,125,1,115,1,10,0
1141849,27,16,1986,4,female,209,38,31,129,37,128,31,1,6
1606446,19,6,1994,1,female,423,37,27,130,210,130,184,0,26
1972831,31,15,1982,1,male,379,37,31,136,6,0,0,136,6
1710028,63,1,1950,1,female,401,38,27,132,34,45,22,87,12
1567857,28,5,1985,1,female,544,37,23,134,76,128,59,6,17
1054169,21,30,1992,11,female,541,38,20,131,26,131,7,0,19
1812545,28,1,1985,1,male,239,38,22,135,27,135,26,0,1
1539501,61,3,1952,3,male,30,38,22,131,22,131,15,0,7
1313770,45,22,1968,5,male,324,37,34,139,65,0,47,139,18
1481413,27,25,1986,3,male,396,37,10,140,2,140,1,0,1
1224130,28,20,1985,4,male,232,37,34,139,12,139,8,0,4
2023771,68,28,1945,5,female,29,38,29,143,113,143,91,0,22
1423052,58,18,1955,4,female,224,38,31,145,46,0,28,145,18
1133587,45,15,1968,8,female,238,38,21,144,115,18,102,126,13
1104638,44,24,1969,2,female,429,37,15,148,107,141,93,7,14
1910336,71,21,1942,8,male,1061,37,28,144,19,144,12,0,7
1727174,58,25,1955,10,female,883,38,19,148,39,148,33,0,6
1344807,59,7,1954,7,female,211,38,32,157,0,143,0,14,0
1794276,30,25,1983,6,male,741,38,22,157,11,157,10,0,1
1389539,25,6,1988,4,male,249,38,29,155,67,155,60,0,7
1598095,19,25,1994,10,male,828,37,23,162,61,2,17,160,44
1680960,43,27,1970,8,female,143,37,14,163,38,51,29,112,9
1323920,43,22,1970,12,male,251,38,15,159,136,132,129,27,7
1727605,62,1,1951,12,female,1381,38,22,161,21,161,12,0,9
1655784,54,5,1959,7,female,439,37,25,167,136,154,116,13,20
1967308,96,18,1917,9,female,535,38,23,168,14,167,9,1,5
1336782,16,23,1997,11,male,598,38,27,175,12,0,2,175,10
1128510,74,1,1939,11,male,1325,38,13,176,79,0,14,176,65
1330300,64,7,1949,2,female,171,38,23,176,6,175,4,1,2
1477376,19,15,1994,2,female,161,38,23,174,87,174,74,0,13
1814093,17,5,1996,4,female,192,38,21,184,65,15,6,169,59
1229548,21,13,1992,1,male,100,38,33,188,0,188,0,0,0
2008238,16,29,1997,3,female,206,38,35,200,27,0,12,200,15
1004848,47,16,1966,12,female,191,37,17,194,22,0,3,194,19
1489166,72,22,1941,11,female,1837,38,17,196,166,1,9,195,157
1005392,36,24,1977,10,male,259,37,28,193,97,187,50,6,47
1458575,46,28,1967,12,female,292,37,15,193,40,193,19,0,21
2170592,25,29,1988,1,male,483,37,30,205,85,205,60,0,25
1322117,32,18,1981,10,female,93,38,28,216,92,216,71,0,21
2187395,36,20,1977,12,female,83,37,23,216,51,216,38,0,13
1281865,54,9,1959,8,female,524,38,26,220,41,220,28,0,13
1886659,45,27,1968,3,female,492,37,27,212,192,212,145,0,47
1211285,51,19,1962,8,female,423,38,22,230,101,180,17,50,84
1720786,56,10,1957,1,male,1797,37,5,224,43,219,34,5,9
1302317,65,27,1948,11,female,58,37,27,229,7,229,2,0,5
1310417,77,26,1936,4,female,978,38,27,225,12,225,7,0,5
1909474,57,24,1956,1,male,377,38,22,239,32,0,21,239,11
1247160,51,12,1962,9,female,554,38,20,236,54,140,34,96,20
1271215,55,29,1958,4,male,694,38,30,247,48,172,39,75,9
1532990,47,1,1966,5,female,194,37,12,252,25,248,24,4,1
2042381,41,18,1972,3,female,264,38,33,265,13,265,7,0,6
1432601,41,9,1972,5,female,888,37,27,263,38,263,30,0,8
1033903,103,27,1910,10,female,1609,37,11,279,145,11,89,268,56
2159385,43,19,1970,9,male,61,38,27,279,73,279,66,0,7
1048729,55,23,1958,3,female,40,38,30,298,218,0,55,298,163
1602137,56,17,1957,11,NA,2011,38,16,296,198,210,76,86,122
2048532,33,16,1980,7,female,41,38,21,301,133,297,80,4,53
1660603,25,1,1988,1,male,70,37,19,306,111,306,83,0,28
1232556,22,20,1991,10,male,84,37,31,297,198,297,121,0,77
1637577,28,6,1985,8,female,168,37,28,312,180,237,61,75,119
1071964,32,1,1981,1,female,87,38,25,321,154,255,34,66,120
1608596,28,1,1985,1,male,183,38,32,320,271,305,72,15,199
1338834,25,5,1988,3,male,255,38,33,315,30,312,27,3,3
1211568,25,8,1988,7,male,331,38,24,321,17,321,9,0,8
1770995,15,5,1998,5,female,24,38,32,322,144,322,63,0,81
1033297,13,29,2000,4,male,33,38,32,336,50,0,26,336,24
1362562,77,23,1936,4,female,255,37,32,337,7,3,1,334,6
2103504,56,29,1957,6,female,274,38,25,341,50,333,25,8,25
1887586,46,25,1967,3,female,118,38,16,345,8,345,5,0,3
1097823,29,16,1984,6,male,191,37,32,331,65,331,28,0,37
1024324,65,18,1948,11,female,799,38,14,359,123,0,24,359,99
1902177,34,21,1979,12,female,229,37,13,364,92,364,35,0,57
1406890,54,10,1959,10,female,991,38,26,367,100,367,52,0,48
1999334,61,6,1952,12,female,420,37,17,394,134,383,90,11,44
1627431,50,1,1963,12,female,91,37,15,372,101,372,95,0,6
1546014,49,28,1964,11,male,492,38,30,418,15,0,13,418,2
1906958,53,30,1960,11,female,520,37,26,400,23,8,5,392,18
1123415,14,5,1999,8,male,103,37,14,402,30,318,5,84,25
1420445,65,26,1948,3,female,641,37,35,430,181,4,38,426,143
2158367,66,4,1947,11,male,1699,38,15,425,499,67,142,358,357
2116131,50,27,1963,11,female,494,37,12,430,197,407,151,23,46
1045499,53,17,1960,11,male,707,37,28,461,83,97,67,364,16
1863604,57,11,1956,10,female,531,37,20,483,56,483,35,0,21
1487927,56,10,1957,7,female,1600,37,15,508,177,375,116,133,61
1528480,41,15,1972,9,female,494,38,20,505,444,500,345,5,99
1871672,61,28,1952,7,female,967,38,27,509,100,509,77,0,23
1230982,23,5,1990,5,male,193,38,17,560,7,560,7,0,0
1700108,23,20,1990,11,female,340,37,32,603,77,602,74,1,3
1517449,26,28,1987,1,female,232,37,22,585,360,585,214,0,146
1439278,56,13,1957,12,female,232,38,28,569,359,569,115,0,244
1786811,60,23,1953,9,female,1852,37,27,635,41,0,31,635,10
1845004,70,25,1943,1,female,910,38,24,627,37,0,6,627,31
1401011,33,26,1980,10,female,258,38,18,638,119,572,100,66,19
2025994,49,14,1964,2,female,537,38,32,625,299,617,140,8,159
1528570,67,11,1946,10,female,337,38,33,626,19,626,16,0,3
1769572,30,1,1983,1,female,97,38,5,729,697,125,275,604,422
2042360,23,24,1990,8,female,843,38,29,781,293,778,203,3,90
1401464,33,1,1980,1,female,39,37,26,811,1626,709,828,102,798
1451333,42,5,1971,3,female,282,37,30,829,117,829,73,0,44
1145596,39,6,1974,5,female,270,37,19,1117,341,637,130,480,211
1562454,50,23,1963,2,female,455,37,26,996,233,232,59,764,174
1761909,29,1,1984,8,female,121,38,18,1270,27,1270,20,0,7
1026464,52,12,1961,3,female,212,37,22,1153,77,1153,60,0,17
1845679,24,27,1989,1,female,72,38,29,1393,1271,15,422,1378,849
1656892,54,11,1959,2,female,1464,38,26,1465,326,724,138,741,188
1589493,70,19,1943,10,female,923,37,24,1358,10,1358,9,0,1
1855682,16,10,1997,2,female,110,37,30,1728,4,1728,2,0,2
2177736,67,17,1946,10,female,249,37,21,3212,144,0,71,3212,73
1258809,50,11,1963,2,female,188,37,16,3316,1764,3316,1594,0,170
1405946,20,1,1993,7,male,307,37,33,13569,37,666,15,12903,22
1260778,13,30,2000,1,male,131,39,28,0,0,0,0,0,0
1002607,13,7,2000,8,male,70,39,18,0,0,0,0,0,0
1811917,15,14,1998,3,male,286,39,28,0,0,0,0,0,0
1476779,15,15,1998,4,male,592,39,15,0,0,0,0,0,0
1532937,15,5,1998,4,male,233,39,30,0,0,0,0,0,0
1286923,15,16,1998,7,male,32,39,37,0,2,0,2,0,0
1477925,17,26,1996,12,male,376,39,37,0,6,0,0,0,6
1507975,16,25,1997,4,male,296,39,33,0,45,0,38,0,7
1425208,16,20,1997,7,male,335,39,21,0,2,0,1,0,1
1605406,16,6,1997,8,male,382,39,35,0,21,0,14,0,7
1104105,16,23,1997,8,male,243,39,39,0,0,0,0,0,0
1447127,16,30,1997,10,male,158,39,34,0,0,0,0,0,0
1217036,16,6,1997,10,male,74,39,25,0,0,0,0,0,0
1467639,17,17,1996,5,female,110,39,26,0,0,0,0,0,0
1399181,17,14,1996,9,male,415,39,31,0,0,0,0,0,0
1973841,18,5,1995,1,male,326,39,9,0,3,0,3,0,0
1189418,18,17,1995,1,male,131,39,28,0,0,0,0,0,0
1499670,18,15,1995,1,female,126,39,20,0,0,0,0,0,0
1859556,18,15,1995,2,male,209,39,30,0,0,0,0,0,0
1825338,18,13,1995,3,male,240,39,30,0,7,0,1,0,6
2042156,18,9,1995,3,female,208,39,27,0,0,0,0,0,0
1575008,18,6,1995,3,male,190,39,13,0,0,0,0,0,0
2048291,18,21,1995,7,male,385,39,29,0,0,0,0,0,0
1547623,18,4,1995,8,male,299,39,33,0,0,0,0,0,0
1500321,18,8,1995,8,male,179,39,32,0,1,0,1,0,0
1070551,18,1,1995,8,male,122,39,26,0,0,0,0,0,0
1435533,19,1,1994,1,male,41,39,29,0,0,0,0,0,0
2036185,19,16,1994,8,male,426,39,28,0,0,0,0,0,0
1612459,20,25,1993,3,male,219,39,20,0,0,0,0,0,0
1419281,20,14,1993,4,male,168,39,33,0,0,0,0,0,0
1097170,20,4,1993,5,male,423,39,23,0,2,0,0,0,2
1820584,20,10,1993,8,female,586,39,13,0,4,0,0,0,4
2150508,20,1,1993,9,male,454,39,20,0,0,0,0,0,0
1314099,21,16,1992,3,male,200,39,28,0,0,0,0,0,0
1503678,21,25,1992,6,female,161,39,17,0,0,0,0,0,0
1968357,21,2,1992,8,male,307,39,14,0,0,0,0,0,0
1340347,21,23,1992,10,male,8,39,38,0,1,0,0,0,1
1125423,23,9,1990,11,male,1111,39,1,0,2,0,0,0,2
1689780,62,18,1951,8,male,727,39,29,10,3,10,3,0,0
2110001,25,1,1988,1,female,45,39,30,10,63,10,51,0,12
1338499,69,22,1944,6,female,580,39,24,11,0,0,0,11,0
1881288,55,22,1958,11,male,865,39,17,11,2,0,2,11,0
1667189,52,20,1961,4,female,787,39,32,11,10,0,3,11,7
1783852,113,1,1900,1,NA,1822,39,17,11,12,0,3,11,9
1324538,36,18,1977,1,male,594,39,31,11,23,6,11,5,12
1086021,61,1,1952,1,female,404,39,28,11,0,11,0,0,0
1711323,23,6,1990,7,female,218,39,19,11,8,11,7,0,1
1176992,25,22,1988,1,male,94,39,38,11,10,11,8,0,2
1620213,21,26,1992,8,male,24,39,37,11,25,11,14,0,11
1054805,27,19,1986,10,male,253,39,23,11,44,11,28,0,16
1450712,56,23,1957,8,female,1177,39,20,11,29,11,12,0,17
1810813,54,1,1959,7,female,496,39,23,12,11,0,4,12,7
1605036,59,12,1954,11,male,1022,39,19,12,100,0,7,12,93
1627526,21,3,1992,5,female,361,39,31,12,10,5,2,7,8
1453872,44,9,1969,1,male,258,39,27,12,3,12,2,0,1
1644368,62,21,1951,1,female,300,39,22,12,6,12,6,0,0
1445517,24,22,1989,9,male,441,39,25,12,12,12,6,0,6
1861976,17,1,1996,1,female,102,39,15,13,9,0,5,13,4
1757442,22,17,1991,10,male,215,39,30,13,8,0,3,13,5
1104513,48,6,1965,5,male,200,39,30,13,16,1,3,12,13
1584698,19,2,1994,3,male,568,39,15,13,4,8,4,5,0
1128189,26,24,1987,7,male,30,39,19,13,17,11,7,2,10
1763047,44,6,1969,9,male,130,39,25,13,23,12,19,1,4
2177272,60,6,1953,5,female,1411,39,24,14,6,0,4,14,2
1824080,24,2,1989,2,male,75,39,31,14,13,7,8,7,5
1604536,26,29,1987,12,male,325,39,19,14,0,14,0,0,0
2180268,70,4,1943,10,female,1792,39,16,14,11,14,7,0,4
1765284,29,7,1984,3,female,273,39,18,15,3,0,1,15,2
1600288,65,16,1948,7,female,862,39,26,15,6,0,2,15,4
1653320,55,27,1958,2,male,1192,39,30,15,7,6,6,9,1
1774019,29,19,1984,12,male,206,39,28,15,13,15,8,0,5
1669384,70,16,1943,7,male,1185,39,28,15,16,15,12,0,4
1206835,27,9,1986,1,female,182,39,25,15,25,15,22,0,3
1887256,42,1,1971,9,female,524,39,21,15,23,15,9,0,14
1949300,43,7,1970,1,female,77,39,28,15,26,15,20,0,6
1006349,39,14,1974,12,female,401,39,26,16,6,11,1,5,5
1326968,22,22,1991,3,female,444,39,22,16,7,16,6,0,1
1900951,108,31,1905,12,male,1401,39,26,16,19,16,16,0,3
1686827,25,12,1988,12,male,829,39,30,16,43,16,42,0,1
1822237,86,3,1927,4,male,821,39,18,17,2,4,2,13,0
2013248,22,10,1991,9,female,296,39,32,17,19,15,7,2,12
1713735,31,14,1982,12,female,308,39,14,17,17,17,12,0,5
2161755,23,26,1990,1,male,97,39,29,17,43,17,34,0,9
1581695,18,10,1995,3,male,460,39,25,18,2,18,2,0,0
1098305,23,8,1990,2,male,575,39,30,18,0,18,0,0,0
1797456,27,29,1986,12,male,47,39,36,18,12,18,7,0,5
1168429,47,25,1966,12,male,581,39,38,19,0,0,0,19,0
1593285,101,26,1912,5,female,132,39,18,19,4,0,1,19,3
1371974,62,17,1951,8,female,833,39,22,19,15,0,11,19,4
1089207,28,6,1985,2,female,492,39,2,19,0,19,0,0,0
1894858,23,2,1990,10,male,250,39,21,19,26,19,17,0,9
1089067,47,23,1966,9,female,470,39,22,20,12,0,0,20,12
1283626,19,19,1994,9,female,392,39,19,20,23,20,14,0,9
1534981,26,1,1987,1,female,437,39,19,21,9,0,3,21,6
1903566,64,5,1949,1,female,448,39,20,21,6,0,4,21,2
2128178,17,28,1996,10,male,479,39,5,21,7,21,7,0,0
1243742,69,8,1944,3,female,1304,39,14,22,2,0,1,22,1
1505317,26,10,1987,3,male,427,39,33,22,20,16,20,6,0
1180754,25,1,1988,1,male,303,39,38,22,3,22,2,0,1
1591507,27,4,1986,3,female,284,39,24,22,3,22,0,0,3
1514953,24,11,1989,10,male,131,39,30,22,12,22,6,0,6
1231577,21,14,1992,4,female,21,39,32,22,31,22,26,0,5
1356703,71,23,1942,9,female,1946,39,16,23,2,20,2,3,0
1025622,64,4,1949,9,female,1743,39,13,23,31,20,7,3,24
1611586,39,1,1974,1,female,35,39,30,24,14,23,6,1,8
1545565,30,10,1983,11,male,190,39,37,24,1,24,1,0,0
1692995,58,1,1955,8,male,300,39,27,24,1,24,1,0,0
1577329,103,10,1910,10,male,622,39,34,24,6,24,6,0,0
1269518,55,15,1958,5,female,971,39,26,24,46,24,9,0,37
1010611,50,1,1963,1,male,483,39,37,25,4,15,0,10,4
1357515,43,28,1970,8,male,458,39,16,25,5,25,1,0,4
1080562,60,10,1953,9,male,406,39,27,25,12,25,8,0,4
1155942,23,12,1990,1,male,22,39,34,26,32,23,17,3,15
1904625,53,29,1960,7,female,554,39,28,26,18,23,18,3,0
2033646,35,19,1978,7,female,262,39,6,27,7,10,6,17,1
1167120,48,26,1965,2,female,623,39,27,27,3,27,2,0,1
1776246,23,19,1990,6,female,270,39,29,27,13,27,11,0,2
1441531,44,27,1969,12,female,282,39,36,27,11,27,10,0,1
1335723,100,29,1913,12,male,1216,39,15,27,39,27,34,0,5
1887342,28,20,1985,3,female,109,39,27,27,45,27,36,0,9
1621981,61,13,1952,12,male,1678,39,22,28,6,28,4,0,2
1374282,106,25,1907,7,male,70,39,38,29,1,25,1,4,0
1122751,52,5,1961,8,female,1024,39,24,29,52,26,36,3,16
1471778,27,17,1986,1,male,60,39,38,29,5,29,5,0,0
1769220,53,1,1960,2,male,929,39,28,31,18,9,10,22,8
1321588,41,13,1972,2,male,34,39,35,32,16,0,8,32,8
1868242,69,28,1944,6,female,1043,39,28,32,13,32,13,0,0
1675788,23,1,1990,1,male,408,39,17,33,1,3,1,30,0
1944762,71,18,1942,12,female,532,39,16,33,27,3,7,30,20
1604705,50,7,1963,2,male,971,39,3,33,44,26,9,7,35
1152931,32,23,1981,2,male,574,39,15,33,9,33,4,0,5
1910971,66,4,1947,4,female,1790,39,7,34,3,2,3,32,0
1637705,41,29,1972,2,female,52,39,33,35,31,0,15,35,16
1453695,51,4,1962,4,female,262,39,28,35,24,20,5,15,19
1449001,50,21,1963,8,female,1053,39,17,35,12,35,12,0,0
2148524,51,15,1962,9,female,180,39,32,36,54,36,27,0,27
1388512,61,17,1952,5,female,102,39,29,35,68,35,52,0,16
1498181,62,14,1951,1,male,2239,39,30,36,154,36,119,0,35
1216275,44,19,1969,2,male,557,39,13,37,5,0,2,37,3
2153141,47,11,1966,12,female,170,39,11,37,23,0,16,37,7
1511397,70,7,1943,6,male,1258,39,14,37,2,37,1,0,1
2080505,36,12,1977,2,female,647,39,16,37,21,37,17,0,4
1083294,35,21,1978,3,male,45,39,33,39,18,22,9,17,9
1488699,52,24,1961,12,male,414,39,20,39,8,38,7,1,1
1226236,25,1,1988,1,female,220,39,32,39,1,39,1,0,0
2112952,43,18,1970,6,male,144,39,14,39,4,39,1,0,3
2157038,53,2,1960,2,male,305,39,39,38,9,38,9,0,0
1877346,23,18,1990,9,female,170,39,23,39,50,39,15,0,35
1737015,64,15,1949,2,male,779,39,27,40,0,0,0,40,0
1753052,16,21,1997,6,male,16,39,38,40,28,0,7,40,21
1890745,49,17,1964,5,male,1083,39,21,40,10,40,3,0,7
1220976,62,13,1951,3,female,1205,39,18,40,14,40,5,0,9
1749893,64,15,1949,12,female,1086,39,18,42,32,39,16,3,16
1317288,29,16,1984,11,male,695,39,25,42,17,42,16,0,1
1161885,57,28,1956,12,female,375,39,33,41,10,41,7,0,3
2102914,23,15,1990,9,female,404,39,23,44,21,44,17,0,4
1442008,30,28,1983,9,female,428,39,14,43,24,43,18,0,6
1557295,23,16,1990,7,male,297,39,36,46,17,0,12,46,5
1905943,31,4,1982,2,female,281,39,16,47,21,46,19,1,2
1571579,72,22,1941,10,female,1543,39,26,49,38,0,9,49,29
1836167,51,15,1962,2,female,2144,39,23,49,55,33,36,16,19
1270678,40,29,1973,9,female,176,39,19,48,345,47,246,1,99
1066833,101,30,1912,4,female,658,39,27,51,21,19,9,32,12
1350111,25,1,1988,1,female,94,39,24,50,23,50,16,0,7
2121797,33,26,1980,10,male,437,39,26,51,64,51,45,0,19
2011605,76,22,1937,3,male,1283,39,12,52,5,0,5,52,0
1094697,71,3,1942,5,female,2039,39,31,52,100,0,52,52,48
1361964,51,9,1962,6,male,1624,39,34,53,1,53,1,0,0
1360157,27,19,1986,7,female,263,39,27,52,14,52,9,0,5
1752380,61,10,1952,12,female,559,39,10,53,25,53,24,0,1
1515530,23,31,1990,10,male,40,39,19,54,25,9,15,45,10
1500308,67,4,1946,1,female,1095,39,26,54,32,11,8,43,24
1843723,69,4,1944,4,NA,2349,39,20,54,5,53,4,1,1
1772129,34,1,1979,1,female,180,39,30,54,5,54,5,0,0
1611852,66,23,1947,1,male,605,39,28,55,107,55,87,0,20
2192252,55,26,1958,7,male,916,39,19,57,10,0,4,57,6
2043082,18,2,1995,1,male,46,39,36,58,6,34,3,24,3
2113331,64,15,1949,10,male,86,39,21,58,41,48,20,10,21
1804184,37,25,1976,12,female,391,39,19,56,26,56,4,0,22
1002701,63,6,1950,12,female,410,39,27,60,25,0,11,60,14
2036821,58,30,1955,6,NA,2090,39,17,60,62,60,43,0,19
1796445,31,3,1982,1,male,138,39,34,63,21,0,4,63,17
1435268,26,16,1987,12,female,351,39,20,62,11,25,10,37,1
2045002,35,9,1978,5,male,255,39,25,63,38,51,31,12,7
1215096,46,12,1967,3,female,401,39,32,62,2,62,2,0,0
1104833,30,10,1983,12,female,49,39,18,63,15,63,14,0,1
1285206,67,17,1946,7,female,808,39,28,65,1,65,1,0,0
1670674,71,1,1942,2,male,925,39,20,68,17,0,4,68,13
2036926,66,17,1947,6,male,1048,39,23,67,11,66,4,1,7
1567899,28,9,1985,9,male,954,39,28,66,37,64,30,2,7
1062006,53,25,1960,6,female,882,39,23,68,17,62,11,6,6
2129646,29,18,1984,11,female,190,39,30,67,11,67,3,0,8
1610254,30,25,1983,9,female,157,39,16,66,3,66,3,0,0
1183762,59,14,1954,8,female,2200,39,16,67,14,67,13,0,1
1920709,83,1,1930,1,male,25,39,30,66,19,66,13,0,6
1826588,61,1,1952,7,female,1230,39,20,70,65,0,39,70,26
1500122,19,29,1994,7,male,437,39,33,71,45,34,30,37,15
1679617,76,22,1937,7,male,428,39,23,72,27,0,11,72,16
2107212,28,4,1985,4,male,481,39,25,72,51,0,38,72,13
1163363,21,9,1992,6,female,153,39,19,74,44,74,35,0,9
1836467,56,27,1957,12,female,261,39,19,76,13,0,2,76,11
1429384,41,25,1972,3,male,445,39,31,76,97,74,74,2,23
1843867,46,12,1967,1,female,154,39,30,80,38,0,12,80,26
1848001,31,14,1982,5,female,261,39,29,79,101,0,30,79,71
1273323,69,15,1944,3,male,1152,39,19,79,85,0,41,79,44
1229997,108,28,1905,11,female,1756,39,17,78,79,38,27,40,52
2152267,27,22,1986,11,female,222,39,18,79,23,79,12,0,11
1311436,20,17,1993,2,female,58,39,38,80,79,80,76,0,3
2127365,68,4,1945,3,male,1737,39,10,81,9,0,3,81,6
1435546,33,11,1980,9,male,254,39,28,84,29,0,12,84,17
1985863,65,3,1948,2,male,2164,39,7,82,17,0,5,82,12
1630891,76,20,1937,12,female,1311,39,27,83,66,0,9,83,57
1422555,53,5,1960,4,male,1317,39,16,84,209,84,142,0,67
1098001,28,11,1985,9,male,67,39,35,86,53,82,41,4,12
1252994,18,15,1995,12,male,68,39,32,90,18,82,7,8,11
1150316,40,20,1973,5,male,360,39,13,89,39,84,24,5,15
1167338,30,26,1983,11,female,72,39,26,90,49,90,41,0,8
1903371,50,9,1963,5,female,343,39,24,95,36,0,22,95,14
1836260,39,23,1974,1,female,172,39,24,95,36,34,12,61,24
2165148,49,23,1964,2,male,676,39,37,92,26,88,24,4,2
1157853,39,24,1974,1,female,154,39,32,95,120,95,60,0,60
1807694,42,27,1971,7,male,265,39,32,98,47,24,25,74,22
1514597,77,20,1936,5,female,264,39,19,97,20,25,18,72,2
1610290,96,15,1917,1,female,1354,39,21,97,19,71,3,26,16
2040613,73,17,1940,7,male,1652,39,13,96,60,91,33,5,27
2160716,47,1,1966,1,female,381,39,33,97,6,97,4,0,2
1538566,47,19,1966,6,female,375,39,31,98,0,98,0,0,0
1351214,55,6,1958,2,female,1544,39,10,101,5,15,5,86,0
2151381,54,15,1959,4,female,341,39,27,104,93,101,55,3,38
1334151,42,6,1971,8,male,17,39,32,104,16,104,12,0,4
1138931,31,25,1982,7,female,148,39,28,109,129,103,61,6,68
1717407,71,4,1942,12,female,698,39,23,112,2,0,2,112,0
1656168,23,17,1990,2,female,471,39,27,112,26,1,5,111,21
2152481,19,9,1994,9,male,1123,39,24,123,197,31,176,92,21
1554403,22,23,1991,10,male,13,39,33,129,4,59,0,70,4
1759331,70,5,1943,3,female,1901,39,11,125,268,124,171,1,97
2126477,68,16,1945,11,female,1052,39,18,126,8,126,4,0,4
1574002,44,1,1969,10,male,16,39,35,128,140,128,116,0,24
1900211,33,26,1980,8,female,167,39,27,126,211,126,210,0,1
1088129,47,4,1966,10,male,515,39,5,137,9,0,1,137,8
1342545,14,5,1999,2,female,22,39,29,137,41,91,26,46,15
1701335,51,29,1962,3,male,496,39,13,143,24,88,14,55,10
1756963,15,17,1998,11,female,23,39,28,140,134,140,12,0,122
1486561,29,14,1984,4,female,311,39,27,147,34,39,23,108,11
1853560,50,25,1963,3,male,453,39,21,145,31,54,1,91,30
1324282,36,5,1977,3,female,405,39,20,147,22,147,21,0,1
1801266,13,1,2000,5,female,175,39,25,149,39,149,28,0,11
1454970,28,4,1985,2,female,250,39,28,144,122,144,98,0,24
1822794,56,22,1957,5,female,271,39,24,152,12,148,6,4,6
1365635,60,19,1953,2,male,1336,39,29,164,47,0,11,164,36
2173634,88,7,1925,1,female,2351,39,15,158,13,45,12,113,1
1267945,66,17,1947,8,male,1302,39,26,159,70,109,33,50,37
1581035,20,26,1993,5,female,518,39,27,158,8,158,3,0,5
1114040,46,1,1967,3,female,1454,39,16,168,20,168,19,0,1
1199181,43,10,1970,8,female,485,39,22,180,65,132,58,48,7
1233826,19,19,1994,4,female,1653,39,25,177,432,148,130,29,302
1271962,33,30,1980,7,male,430,39,30,174,56,174,29,0,27
1426906,43,17,1970,11,female,431,39,18,180,36,180,36,0,0
2191105,18,15,1995,9,male,61,39,23,176,169,176,164,0,5
1685500,21,10,1992,6,male,54,39,35,188,26,188,20,0,6
1397716,49,8,1964,8,female,824,39,29,191,69,0,3,191,66
1745753,58,27,1955,10,female,244,39,20,193,57,1,20,192,37
1422756,67,20,1946,6,female,278,39,29,191,109,189,80,2,29
1984481,60,16,1953,9,female,1693,39,20,196,5,196,4,0,1
1585777,55,25,1958,7,female,257,39,20,191,88,191,39,0,49
1255691,61,1,1952,11,male,693,39,15,204,62,22,41,182,21
1299057,57,28,1956,8,male,425,39,19,209,261,30,209,179,52
1619781,16,15,1997,6,male,156,39,30,204,57,204,48,0,9
1167249,74,29,1939,9,female,505,39,26,217,30,0,5,217,25
2142960,46,1,1967,1,male,466,39,33,212,189,149,147,63,42
1893702,18,25,1995,1,female,137,39,36,212,14,205,4,7,10
2069137,72,9,1941,3,female,1625,39,22,217,25,179,23,38,2
1875551,46,14,1967,1,male,608,39,15,216,214,216,17,0,197
2062363,16,29,1997,5,female,90,39,15,237,396,19,45,218,351
1518604,20,29,1993,6,male,199,39,26,239,352,77,107,162,245
1222324,41,16,1972,2,male,439,39,13,242,211,241,196,1,15
1885156,52,5,1961,6,female,135,39,27,250,99,158,59,92,40
2171197,30,9,1983,11,male,30,39,26,284,197,282,153,2,44
1822246,15,28,1998,8,male,70,39,26,280,48,280,47,0,1
1555314,28,7,1985,9,female,357,39,24,294,90,0,9,294,81
1758078,52,28,1961,8,female,1392,39,25,303,94,204,82,99,12
1691890,27,23,1986,10,female,593,39,19,293,600,289,370,4,230
1091167,42,20,1971,7,female,675,39,16,304,28,304,25,0,3
1982579,20,1,1993,3,female,239,39,24,317,197,317,159,0,38
1864112,31,14,1982,3,female,280,39,26,329,28,86,1,243,27
2036960,55,7,1958,6,female,741,39,15,344,150,339,51,5,99
1447741,45,6,1968,12,male,511,39,22,361,55,361,24,0,31
1350913,62,28,1951,8,female,468,39,22,372,89,372,65,0,24
1675834,30,6,1983,1,female,229,39,25,415,39,415,38,0,1
1296206,51,20,1962,8,female,629,39,18,415,44,415,32,0,12
1049321,23,21,1990,3,female,618,39,28,432,48,432,34,0,14
1989624,41,21,1972,6,female,734,39,31,464,577,462,507,2,70
1921972,48,20,1965,8,male,222,39,33,504,97,504,77,0,20
1158022,54,18,1959,6,male,132,39,29,562,356,555,262,7,94
1894379,63,1,1950,1,male,129,39,32,659,421,1,221,658,200
1493198,43,7,1970,5,female,496,39,36,681,64,679,46,2,18
1848210,38,19,1975,5,male,82,39,32,670,142,670,88,0,54
1845402,100,10,1913,10,female,1729,39,19,703,163,703,111,0,52
1591277,47,7,1966,6,female,369,39,28,827,288,0,62,827,226
1109928,64,2,1949,6,female,1255,39,29,858,97,791,76,67,21
2171157,59,1,1954,4,female,257,39,19,857,58,857,45,0,13
2114558,36,11,1977,7,female,556,39,14,1097,140,1094,84,3,56
2077587,53,17,1960,5,female,404,39,38,1424,145,1424,68,0,77
1179837,77,10,1936,7,female,344,39,21,2340,243,2340,158,0,85
1895741,20,26,1993,3,female,417,39,24,4117,169,10,42,4107,127
1620887,42,15,1971,12,male,119,41,21,3,3,3,3,0,0
2002678,52,22,1961,9,female,485,40,11,3,2,3,1,0,1
1163033,56,6,1957,1,male,222,40,30,3,3,3,3,0,0
1688408,27,26,1986,5,male,404,41,29,3,35,3,24,0,11
1411782,29,1,1984,1,male,92,40,31,3,8,3,8,0,0
1754309,32,17,1981,11,male,213,41,17,3,6,3,6,0,0
1990541,31,14,1982,7,male,75,41,38,3,8,3,8,0,0
1432080,39,15,1974,4,male,604,41,26,3,7,3,7,0,0
1287501,45,9,1968,11,female,577,41,37,3,83,3,71,0,12
1399217,46,8,1967,5,male,302,41,37,3,23,3,20,0,3
1074243,48,26,1965,2,male,280,41,20,3,5,3,5,0,0
1339694,51,26,1962,3,male,467,40,24,3,8,3,4,0,4
1938895,62,12,1951,7,male,257,41,21,3,11,3,10,0,1
1037656,66,31,1947,3,female,126,40,25,3,29,3,25,0,4
1166416,21,11,1992,6,female,386,40,3,4,0,0,0,4,0
2029125,16,2,1997,3,female,299,40,20,4,1,0,0,4,1
1012903,57,19,1956,8,female,847,41,39,4,2,0,0,4,2
1098315,19,19,1994,4,male,363,40,23,4,4,0,0,4,4
1051645,52,1,1961,6,female,415,41,25,4,4,0,1,4,3
1910731,20,11,1993,11,male,23,40,29,4,8,0,2,4,6
1050785,64,14,1949,5,female,1543,41,23,4,6,0,3,4,3
1774768,65,2,1948,10,female,686,40,23,4,32,0,20,4,12
1347098,66,15,1947,8,male,769,40,11,4,10,0,7,4,3
1727457,78,14,1935,8,male,2182,41,18,4,6,0,4,4,2
1787776,93,7,1920,6,female,1668,41,15,4,35,0,18,4,17
1946844,29,26,1984,10,male,488,41,32,4,0,1,0,3,0
1153444,59,30,1954,3,female,54,40,8,4,0,1,0,3,0
1832712,44,30,1969,10,female,379,40,17,4,2,2,0,2,2
1357733,18,25,1995,3,male,314,40,18,4,13,1,12,3,1
1506418,15,10,1998,6,male,493,40,24,4,0,4,0,0,0
1858241,15,1,1998,8,male,148,41,37,4,0,4,0,0,0
1256620,20,26,1993,12,male,49,41,35,4,0,4,0,0,0
1193528,19,15,1994,7,male,142,41,28,4,0,4,0,0,0
2121106,26,1,1987,1,male,98,41,34,4,0,4,0,0,0
1005481,27,3,1986,4,male,1055,40,8,4,0,4,0,0,0
1620018,34,5,1979,8,male,419,40,25,4,0,4,0,0,0
1167733,45,20,1968,9,male,350,41,33,4,0,4,0,0,0
1537485,93,20,1920,6,male,1231,40,15,4,0,4,0,0,0
1947687,26,1,1987,1,male,139,41,33,4,2,4,2,0,0
1261575,34,17,1979,10,male,113,40,33,4,1,4,1,0,0
1912478,50,26,1963,9,male,597,41,18,4,2,4,2,0,0
1976180,16,8,1997,12,male,85,40,26,4,3,4,2,0,1
1632067,23,15,1990,4,male,310,40,30,4,3,4,1,0,2
1040281,18,17,1995,12,female,59,41,26,4,8,4,5,0,3
2097767,17,11,1996,6,male,140,41,41,4,12,4,10,0,2
1133743,19,26,1994,1,male,62,41,19,4,39,4,16,0,23
2167968,21,8,1992,6,male,502,41,20,4,22,4,21,0,1
1671197,22,9,1991,9,male,18,41,38,4,6,4,2,0,4
1372931,24,23,1989,3,female,157,40,5,4,6,4,5,0,1
1115176,26,23,1987,8,female,313,41,30,4,16,4,8,0,8
1752301,33,1,1980,1,male,42,40,35,4,9,4,8,0,1
1581217,44,19,1969,11,male,227,40,19,4,8,4,3,0,5
1812044,55,1,1958,7,female,79,41,18,4,23,4,17,0,6
2039849,63,28,1950,2,female,25,40,29,4,9,4,9,0,0
1713194,66,22,1947,8,female,1524,41,24,4,21,4,17,0,4
2184504,17,10,1996,12,female,144,41,22,5,0,0,0,5,0
2116649,36,23,1977,9,male,38,40,35,5,0,0,0,5,0
1133763,52,4,1961,2,female,538,40,39,5,0,0,0,5,0
1903001,63,21,1950,12,male,931,41,15,5,0,0,0,5,0
1803495,21,25,1992,6,male,833,41,19,5,1,0,0,5,1
1264662,34,10,1979,10,male,142,40,30,5,2,0,1,5,1
1124248,45,7,1968,8,female,1550,41,14,5,2,0,1,5,1
1074957,46,1,1967,10,female,469,40,26,5,1,0,1,5,0
1607598,61,27,1952,10,male,595,41,29,5,7,0,6,5,1
1660892,56,13,1957,4,female,250,40,17,5,20,0,5,5,15
1778247,59,26,1954,6,male,452,40,37,5,13,0,3,5,10
1688269,75,29,1938,8,male,627,41,28,5,8,0,6,5,2
1739379,25,19,1988,8,male,196,40,40,5,0,3,0,2,0
1696806,20,30,1993,11,male,246,40,14,5,49,4,40,1,9
1922193,25,1,1988,1,male,216,40,27,5,0,5,0,0,0
2040218,45,27,1968,10,male,134,41,29,5,0,5,0,0,0
1557713,64,17,1949,9,male,1060,41,7,5,0,5,0,0,0
1677844,19,1,1994,12,male,185,41,38,5,1,5,1,0,0
1110336,19,2,1994,1,male,121,40,13,5,3,5,0,0,3
1633670,28,1,1985,1,male,331,41,27,5,3,5,3,0,0
1257149,32,14,1981,6,male,490,40,27,5,3,5,3,0,0
2054613,49,6,1964,9,female,475,41,23,5,2,5,2,0,0
1082752,23,10,1990,7,male,58,40,29,5,5,5,4,0,1
1190858,29,11,1984,12,male,31,41,39,5,4,5,4,0,0
1045727,33,22,1980,2,male,490,41,14,5,7,5,7,0,0
1101636,49,22,1964,6,male,769,41,11,5,5,5,5,0,0
1159312,56,16,1957,9,male,916,40,18,5,4,5,2,0,2
2045195,17,17,1996,1,male,1617,41,23,5,16,5,14,0,2
1364179,21,14,1992,2,male,164,40,20,5,34,5,31,0,3
1640245,22,21,1991,9,female,67,41,31,5,10,5,4,0,6
1317855,32,1,1981,5,male,140,40,37,5,8,5,6,0,2
1163089,55,23,1958,10,female,94,40,25,5,30,5,12,0,18
1346110,72,19,1941,1,female,1664,41,14,5,14,5,14,0,0
1788927,21,12,1992,7,female,620,41,6,6,0,0,0,6,0
2100137,41,24,1972,6,female,548,41,22,6,3,1,1,5,2
1237110,49,4,1964,9,female,1857,41,24,6,1,0,0,6,1
2092835,13,17,2000,4,male,121,41,21,6,4,1,3,5,1
2118054,33,10,1980,12,male,139,41,38,6,0,4,0,2,0
2030035,66,15,1947,9,male,1675,41,4,6,0,4,0,2,0
1135364,67,4,1946,1,female,1317,41,19,6,5,4,2,2,3
1934944,40,13,1973,8,male,1457,41,16,6,3,5,2,1,1
2132357,27,16,1986,7,male,113,41,35,6,0,6,0,0,0
1737483,51,5,1962,8,male,965,41,34,6,0,6,0,0,0
1165341,16,20,1997,1,male,10,40,38,6,1,6,1,0,0
1221969,18,4,1995,10,female,661,41,12,6,1,6,0,0,1
1440110,19,5,1994,3,male,91,41,38,6,1,6,1,0,0
1326304,37,11,1976,8,male,197,40,27,6,2,6,1,0,1
1358523,52,14,1961,11,male,503,40,24,6,1,6,0,0,1
1560947,57,16,1956,5,female,515,40,26,6,3,6,3,0,0
1142834,65,21,1948,12,male,2051,40,7,6,1,6,1,0,0
1584900,70,16,1943,11,female,1866,41,15,6,2,6,2,0,0
1936832,30,25,1983,4,male,522,40,31,6,6,6,6,0,0
2137303,54,7,1959,11,male,777,41,15,6,7,6,7,0,0
1286222,18,10,1995,3,male,215,40,24,6,23,6,7,0,16
1694584,32,23,1981,5,male,360,40,15,6,13,6,10,0,3
1501561,54,8,1959,4,male,212,41,21,6,24,6,18,0,6
1588355,65,11,1948,8,male,1400,40,14,6,34,6,6,0,28
1827134,108,23,1905,1,female,66,41,30,7,1,0,1,7,0
1355967,72,22,1941,2,male,1284,41,21,7,13,0,11,7,2
1848437,17,16,1996,11,female,323,41,20,7,18,4,10,3,8
1395727,38,12,1975,6,male,58,40,32,7,1,6,1,1,0
1576841,31,30,1982,9,female,113,41,25,7,10,6,4,1,6
1309329,52,28,1961,2,male,1935,41,10,7,29,6,24,1,5
1511608,62,30,1951,1,male,422,40,21,7,46,6,22,1,24
1527055,23,20,1990,6,male,116,41,20,7,1,7,1,0,0
2166139,25,28,1988,11,female,589,41,12,7,1,7,1,0,0
1589311,44,12,1969,1,male,173,40,31,7,0,7,0,0,0
2109730,52,27,1961,11,male,1110,40,23,7,0,7,0,0,0
1343444,20,1,1993,1,male,133,41,37,7,3,7,1,0,2
1726842,27,12,1986,4,female,107,40,16,7,4,7,3,0,1
1742793,31,8,1982,11,male,275,40,30,7,3,7,3,0,0
1828745,46,5,1967,5,male,270,41,27,7,2,7,1,0,1
2028326,65,8,1948,12,female,694,41,16,7,4,7,4,0,0
1698423,16,16,1997,3,male,127,40,35,7,32,7,26,0,6
1047530,23,8,1990,8,female,699,40,34,7,18,7,17,0,1
1423809,26,14,1987,8,male,532,40,11,7,12,7,12,0,0
1614466,25,17,1988,1,male,595,41,27,8,1,0,0,8,1
1407978,57,7,1956,8,male,784,40,29,8,1,0,1,8,0
1647969,41,16,1972,4,male,164,40,39,8,3,0,2,8,1
1872750,51,13,1962,3,male,483,41,27,8,5,0,2,8,3
1652713,51,11,1962,9,male,258,40,36,8,5,0,4,8,1
1154180,60,24,1953,3,female,625,41,27,8,7,0,4,8,3
1940527,57,13,1956,1,female,353,41,33,8,12,0,4,8,8
1428051,53,12,1960,2,male,1489,41,21,8,1,2,0,6,1
1865027,40,3,1973,4,male,644,40,19,8,43,6,33,2,10
1352955,40,20,1973,4,female,172,41,26,8,25,6,16,2,9
1340536,14,6,1999,7,male,0,41,40,8,0,8,0,0,0
1784503,32,9,1981,11,male,629,40,8,8,1,8,1,0,0
1745202,33,3,1980,3,male,73,40,33,8,1,8,1,0,0
1394275,79,28,1934,12,female,1532,41,15,8,1,8,0,0,1
1360054,23,1,1990,1,male,70,40,24,8,2,8,2,0,0
1526116,27,28,1986,2,female,345,41,20,8,2,8,1,0,1
1907070,36,24,1977,6,male,70,41,32,8,2,8,2,0,0
1243274,54,28,1959,8,female,232,41,25,8,3,8,3,0,0
1841470,20,2,1993,8,male,91,40,33,8,11,8,10,0,1
1560316,30,11,1983,4,male,156,40,16,8,80,8,41,0,39
1142503,32,16,1981,10,male,464,40,30,8,14,8,1,0,13
2147079,37,25,1976,12,female,438,41,32,9,0,0,0,9,0
1341509,40,29,1973,4,male,596,41,30,9,1,0,0,9,1
1071278,67,19,1946,9,female,1440,41,9,9,0,0,0,9,0
2126413,18,23,1995,11,male,81,40,36,9,2,0,2,9,0
1796557,33,19,1980,6,male,4,41,40,9,5,0,1,9,4
1566726,62,4,1951,1,female,440,41,24,9,2,0,1,9,1
1248413,85,14,1928,11,female,848,41,23,9,12,0,1,9,11
1554280,53,1,1960,2,female,162,41,19,9,24,0,18,9,6
1414437,53,15,1960,8,female,227,41,30,9,19,0,12,9,7
1700779,69,5,1944,11,male,541,41,26,9,19,0,2,9,17
1354031,48,26,1965,5,male,439,41,19,9,4,3,3,6,1
1605917,17,7,1996,12,male,4,41,41,9,0,9,0,0,0
1764442,42,19,1971,12,male,423,41,31,9,0,9,0,0,0
1005229,19,27,1994,4,female,5,41,40,9,2,9,2,0,0
1347719,20,1,1993,3,male,510,41,26,9,3,9,3,0,0
2120503,23,5,1990,8,male,216,41,34,9,4,9,4,0,0
2086593,25,4,1988,1,male,169,40,29,9,7,9,7,0,0
1086735,22,12,1991,9,female,137,40,30,9,125,9,44,0,81
2002473,31,18,1982,3,female,560,41,27,9,168,9,120,0,48
1658853,31,15,1982,4,female,647,40,28,9,22,9,14,0,8
1134095,34,29,1979,12,female,280,40,21,9,24,9,15,0,9
1502906,39,3,1974,3,female,163,40,21,9,46,9,21,0,25
2192123,49,26,1964,11,female,1777,41,17,9,25,9,12,0,13
1779979,48,15,1965,1,female,76,41,22,9,28,9,7,0,21
1267160,77,22,1936,12,male,793,41,24,10,0,0,0,10,0
1226110,58,13,1955,5,female,1215,41,22,10,11,0,2,10,9
1827602,32,11,1981,11,male,176,41,38,10,15,0,14,10,1
1903817,64,7,1949,1,female,549,40,17,10,18,1,2,9,16
1981328,43,11,1970,2,male,62,41,35,10,3,3,2,7,1
2128405,52,13,1961,2,male,143,40,34,10,12,2,8,8,4
2133920,59,28,1954,10,male,741,40,21,10,9,3,4,7,5
1094385,60,11,1953,9,male,1596,40,22,10,8,6,6,4,2
2015709,33,12,1980,10,female,424,41,28,10,5,8,5,2,0
1817043,23,21,1990,9,female,176,40,26,10,87,8,64,2,23
1151688,49,2,1964,5,female,2044,41,22,10,35,9,25,1,10
1135071,14,15,1999,2,male,98,41,37,10,5,10,0,0,5
2170499,30,15,1983,8,male,225,40,30,10,2,10,2,0,0
1072840,31,2,1982,7,male,604,41,28,10,5,10,5,0,0
1976309,34,18,1979,10,male,136,40,28,10,4,10,4,0,0
1598103,24,26,1989,10,female,282,40,27,10,11,10,5,0,6
1203385,29,22,1984,5,male,411,41,21,10,8,10,7,0,1
1295060,37,22,1976,1,male,536,40,19,10,18,10,18,0,0
1330165,64,28,1949,8,female,31,41,24,10,15,10,13,0,2
1211891,24,10,1989,3,male,594,40,24,11,2,0,1,11,1
1639509,31,27,1982,4,male,408,40,23,11,2,0,0,11,2
1702665,53,10,1960,4,male,192,41,22,11,13,0,8,11,5
1493939,14,25,1999,7,male,62,40,33,11,0,7,0,4,0
1334663,17,1,1996,2,male,640,41,8,11,2,6,0,5,2
1618234,26,25,1987,8,male,417,41,40,11,0,11,0,0,0
1254995,30,28,1983,5,male,1544,41,25,11,1,11,1,0,0
1928708,20,29,1993,3,male,40,40,38,11,2,11,2,0,0
1563320,63,27,1950,12,female,243,41,33,11,6,11,5,0,1
2159743,21,14,1992,2,male,30,40,35,11,13,11,9,0,4
1930770,19,16,1994,7,male,93,40,30,11,27,11,24,0,3
2069680,67,23,1946,11,male,1266,41,17,12,1,0,1,12,0
1172751,74,15,1939,12,female,1756,40,21,12,7,0,0,12,7
1008503,53,9,1960,6,female,726,41,22,12,71,0,53,12,18
1084079,31,1,1982,1,male,135,41,25,12,13,7,3,5,10
1087410,23,1,1990,11,male,242,40,17,12,2,12,2,0,0
1877511,47,17,1966,7,male,686,41,14,12,2,12,0,0,2
2114515,64,16,1949,4,female,1208,40,23,12,5,12,3,0,2
2153513,23,9,1990,3,male,6,40,33,12,15,12,13,0,2
1862808,25,1,1988,5,male,147,41,35,12,10,12,9,0,1
1878304,30,1,1983,1,male,19,41,31,12,15,12,15,0,0
1406519,36,10,1977,6,male,664,40,36,12,22,12,19,0,3
1516918,45,2,1968,2,female,519,40,23,12,21,12,2,0,19
1948631,46,10,1967,6,female,275,41,29,12,61,12,55,0,6
1670869,30,20,1983,9,female,107,40,23,13,5,1,2,12,3
1562856,58,16,1955,10,female,922,40,24,13,15,0,11,13,4
1372475,39,25,1974,3,female,708,40,14,13,4,10,4,3,0
1443605,14,12,1999,3,female,258,40,28,13,0,13,0,0,0
1600562,18,8,1995,1,male,529,40,28,13,1,13,0,0,1
1736659,24,12,1989,2,male,143,40,36,13,0,13,0,0,0
1892523,49,21,1964,5,male,145,41,28,13,1,13,1,0,0
1181490,41,27,1972,1,male,711,41,14,13,3,13,3,0,0
1145425,16,26,1997,2,male,438,40,26,13,9,13,8,0,1
1371922,43,23,1970,8,female,287,41,24,13,10,13,9,0,1
1578813,22,8,1991,7,male,373,40,25,14,18,1,11,13,7
1620132,57,6,1956,12,female,133,40,36,14,13,1,5,13,8
1416574,19,10,1994,7,male,774,40,31,14,6,10,4,4,2
1900113,59,28,1954,4,female,1939,40,15,14,8,3,5,11,3
2059317,15,25,1998,5,male,127,41,28,14,4,14,0,0,4
1208092,17,8,1996,11,female,589,40,29,14,3,14,3,0,0
1813096,20,6,1993,12,male,791,40,28,14,4,14,3,0,1
1270064,39,8,1974,7,female,456,40,16,14,4,14,0,0,4
1479675,26,15,1987,5,female,135,41,34,14,20,14,19,0,1
1082801,46,16,1967,7,male,548,40,35,14,24,14,14,0,10
2025818,32,13,1981,12,female,155,41,36,15,2,0,1,15,1
1997802,50,5,1963,3,male,455,41,26,15,0,0,0,15,0
1845059,54,17,1959,2,male,478,40,34,15,3,0,0,15,3
1804804,44,1,1969,12,male,1351,41,27,15,1,15,1,0,0
1914258,13,19,2000,3,male,144,40,32,15,4,15,3,0,1
1882092,23,21,1990,9,male,348,40,26,15,5,15,4,0,1
1767925,25,1,1988,1,female,179,40,30,15,8,15,6,0,2
1961523,47,27,1966,12,male,163,40,27,15,5,15,5,0,0
1744171,23,8,1990,8,male,29,41,24,15,10,15,9,0,1
1016932,40,14,1973,8,male,226,41,16,15,25,15,10,0,15
1431312,59,19,1954,8,female,1610,40,24,15,27,15,22,0,5
2015495,23,19,1990,6,male,250,41,26,16,7,1,4,15,3
1443996,69,8,1944,1,male,1683,41,12,16,17,0,8,16,9
1615321,107,18,1906,9,female,5,41,33,16,16,0,9,16,7
1262946,35,1,1978,9,female,158,41,27,16,36,0,20,16,16
1681132,42,1,1971,4,male,140,40,32,16,31,1,28,15,3
2044860,47,2,1966,12,female,52,40,27,16,31,0,3,16,28
1441872,48,18,1965,9,female,70,40,32,16,3,14,2,2,1
1567432,22,19,1991,4,female,79,40,16,16,13,15,10,1,3
1392774,22,5,1991,10,male,610,41,20,16,12,14,7,2,5
1778283,16,4,1997,8,male,226,41,25,16,1,16,0,0,1
1643082,57,13,1956,7,female,39,40,30,16,0,16,0,0,0
1118007,47,22,1966,6,male,254,40,30,16,9,16,6,0,3
2102360,49,29,1964,7,female,1313,41,15,16,8,16,6,0,2
1821093,43,1,1970,1,female,253,41,22,16,33,16,19,0,14
1529142,38,8,1975,1,male,286,41,21,17,21,3,12,14,9
1788908,60,17,1953,2,male,1732,40,15,17,12,1,6,16,6
1149248,71,22,1942,12,female,453,40,30,17,15,0,6,17,9
1333498,57,11,1956,9,male,111,41,33,17,91,1,60,16,31
1858243,16,10,1997,8,female,400,41,10,17,1,8,0,9,1
1376513,13,4,2000,1,female,126,40,30,17,1,17,1,0,0
1320226,16,4,1997,11,male,241,41,9,17,1,17,1,0,0
1257843,42,17,1971,8,female,82,40,34,17,21,17,19,0,2
1983775,18,29,1995,5,female,720,40,40,18,7,6,2,12,5
1177300,30,8,1983,8,male,377,41,30,18,23,7,18,11,5
1221529,30,1,1983,10,male,395,41,21,18,14,15,7,3,7
1479895,14,23,1999,4,male,133,40,26,18,0,18,0,0,0
1260390,33,27,1980,9,female,558,40,8,18,1,18,0,0,1
1668785,47,4,1966,10,male,483,40,27,18,7,18,6,0,1
1192814,18,24,1995,11,female,69,40,24,18,31,18,27,0,4
1525942,61,19,1952,3,male,478,41,23,19,1,0,1,19,0
1709398,52,21,1961,6,female,165,40,22,19,9,0,3,19,6
1970241,59,30,1954,4,female,357,40,35,19,9,0,7,19,2
1001772,48,3,1965,5,female,641,41,22,19,16,13,15,6,1
1439315,26,1,1987,8,male,329,40,20,19,10,15,1,4,9
2077810,22,14,1991,2,male,35,41,40,19,0,19,0,0,0
1859570,52,16,1961,8,female,493,40,29,19,2,19,2,0,0
1565044,31,16,1982,2,female,386,40,26,19,8,19,4,0,4
1759769,38,1,1975,4,male,174,40,25,19,11,19,3,0,8
1738658,33,3,1980,11,male,184,41,32,20,12,1,2,19,10
1288711,26,22,1987,9,male,534,41,22,20,51,3,27,17,24
2132634,62,6,1951,4,female,1592,40,21,20,15,13,8,7,7
1170143,49,10,1964,9,male,100,41,10,20,24,19,15,1,9
1391822,48,7,1965,8,female,428,40,12,20,1,20,1,0,0
1685626,17,28,1996,1,male,486,40,19,21,1,0,0,21,1
2137568,18,24,1995,5,male,11,41,32,21,6,8,5,13,1
1714532,15,9,1998,5,male,310,40,31,21,0,21,0,0,0
1379291,23,19,1990,10,male,11,40,37,21,6,21,2,0,4
1276254,28,20,1985,2,female,211,41,27,21,4,21,1,0,3
1649947,42,2,1971,10,female,879,41,34,21,4,21,4,0,0
1575187,16,23,1997,7,female,211,40,18,21,28,21,3,0,25
1105935,42,1,1971,1,female,330,41,25,21,15,21,12,0,3
2013976,46,21,1967,10,female,459,40,21,22,15,3,7,19,8
1883708,85,2,1928,2,female,75,40,29,22,78,0,42,22,36
1435129,20,28,1993,3,male,253,41,31,22,1,21,0,1,1
1297641,29,8,1984,12,male,23,40,35,22,3,22,3,0,0
1449852,63,3,1950,2,female,629,41,25,22,1,22,1,0,0
1254247,38,21,1975,9,male,754,41,10,22,5,22,4,0,1
1640651,23,7,1990,10,female,290,41,12,22,125,22,99,0,26
1207048,45,10,1968,8,female,441,41,26,22,82,22,82,0,0
1876110,22,24,1991,10,male,226,41,27,23,32,0,13,23,19
1332078,56,18,1957,9,female,80,40,37,23,22,2,6,21,16
1761988,50,31,1963,1,male,690,41,8,23,5,9,4,14,1
1733614,26,15,1987,6,male,675,41,29,23,9,22,6,1,3
1574059,31,4,1982,10,female,295,40,22,23,10,20,9,3,1
1621219,18,17,1995,10,male,84,41,30,23,14,23,12,0,2
1958941,47,13,1966,10,female,141,41,18,24,6,0,1,24,5
1971755,24,8,1989,1,female,282,40,11,24,1,5,0,19,1
1153671,58,26,1955,10,female,1592,40,10,24,67,14,39,10,28
1502240,38,1,1975,1,male,78,41,33,24,3,23,3,1,0
1708964,41,20,1972,7,female,224,41,37,24,5,18,4,6,1
1753775,28,11,1985,9,male,316,41,18,24,0,24,0,0,0
1361313,27,8,1986,8,male,194,40,31,24,10,24,6,0,4
1009808,94,26,1919,3,male,585,40,24,24,11,24,10,0,1
1172706,26,9,1987,5,male,189,40,21,24,32,24,17,0,15
1385062,67,8,1946,8,female,1467,41,20,25,9,0,4,25,5
1389144,66,28,1947,7,female,1346,40,21,25,21,0,9,25,12
2035848,53,29,1960,10,female,117,40,29,25,44,0,9,25,35
1892644,21,23,1992,11,female,459,40,22,25,0,20,0,5,0
1455510,17,11,1996,9,female,466,40,27,25,5,24,4,1,1
1377360,25,20,1988,2,male,630,40,34,25,2,25,1,0,1
1941723,29,9,1984,9,male,148,40,37,25,0,25,0,0,0
2091304,19,12,1994,6,female,381,41,15,25,18,25,3,0,15
1783082,69,21,1944,3,male,1143,40,28,26,33,0,6,26,27
1612524,52,10,1961,12,female,1513,40,24,26,43,0,24,26,19
1538406,53,15,1960,2,male,102,41,13,26,27,7,22,19,5
1434634,67,9,1946,8,male,996,40,18,26,63,18,20,8,43
1684110,21,15,1992,12,male,336,40,24,26,14,26,14,0,0
1218226,22,13,1991,8,female,99,41,25,26,44,26,30,0,14
1201600,33,3,1980,3,male,749,40,12,26,41,26,36,0,5
1971804,65,14,1948,7,female,1580,41,15,26,75,26,58,0,17
1822139,43,8,1970,1,male,162,41,23,27,8,1,2,26,6
1513331,65,12,1948,6,female,1105,40,24,27,15,0,9,27,6
1299182,22,3,1991,10,male,96,40,17,27,12,17,8,10,4
1907081,25,1,1988,1,male,224,40,26,27,14,27,13,0,1
1746414,28,1,1985,1,male,116,40,31,27,15,27,15,0,0
1966439,38,10,1975,10,male,201,41,23,27,9,27,8,0,1
1030810,68,29,1945,4,male,36,40,26,27,12,27,12,0,0
1222611,49,11,1964,8,male,540,41,18,27,30,27,28,0,2
1123361,30,3,1983,12,female,469,40,30,27,47,27,43,0,4
1868326,45,31,1968,8,male,99,40,5,27,46,27,45,0,1
2010397,67,29,1946,3,male,2215,40,25,28,0,0,0,28,0
1227755,30,18,1983,6,male,585,41,25,28,8,7,7,21,1
2105118,78,22,1935,6,female,1930,40,6,28,1,28,0,0,1
1954782,26,25,1987,8,female,510,41,21,28,13,28,13,0,0
1193375,28,24,1985,8,female,226,40,28,28,8,28,8,0,0
1252190,35,18,1978,10,male,530,40,22,28,22,28,15,0,7
1566138,69,24,1944,2,female,159,40,15,29,33,0,22,29,11
1737676,108,14,1905,10,female,269,41,30,29,23,0,2,29,21
2049294,23,21,1990,9,male,675,41,29,29,2,28,1,1,1
1178305,43,1,1970,4,male,198,41,13,29,42,29,38,0,4
1299770,56,18,1957,10,female,675,40,34,30,18,0,5,30,13
1075803,71,20,1942,9,male,33,40,31,30,9,0,4,30,5
1068277,62,28,1951,3,female,840,40,26,30,17,14,15,16,2
1037223,81,29,1932,11,male,1620,40,1,30,11,28,4,2,7
1704574,18,12,1995,12,male,249,41,29,31,38,29,24,2,14
1636065,47,12,1966,9,male,521,40,15,30,2,30,1,0,1
1474422,21,5,1992,4,male,316,41,34,30,9,30,6,0,3
1412548,26,7,1987,3,male,263,40,40,31,12,31,8,0,4
2021567,36,13,1977,4,male,446,40,33,30,22,30,11,0,11
2189440,45,2,1968,11,female,488,40,25,30,43,30,23,0,20
1933703,28,8,1985,10,female,445,41,32,30,53,30,35,0,18
1896974,31,18,1982,7,male,318,41,38,32,0,0,0,32,0
1721179,80,2,1933,8,female,243,41,28,32,8,0,5,32,3
1131586,64,30,1949,3,male,112,40,27,32,22,2,3,30,19
2075742,30,13,1983,12,male,481,40,17,32,66,20,21,12,45
1599153,46,26,1967,3,male,596,40,28,32,2,31,2,1,0
2028877,31,25,1982,12,male,442,41,29,32,8,30,5,2,3
1960389,38,11,1975,8,male,15,41,38,32,9,29,7,3,2
1608566,59,6,1954,2,female,259,41,25,32,19,27,11,5,8
1723340,14,7,1999,8,male,264,40,4,32,4,32,2,0,2
1143961,19,21,1994,1,female,283,40,15,32,1,32,1,0,0
1047725,52,7,1961,5,male,226,40,35,32,27,32,18,0,9
1163048,40,9,1973,3,male,317,41,24,32,103,32,47,0,56
2106477,59,14,1954,11,female,873,41,33,33,7,0,0,33,7
1761115,20,1,1993,9,male,849,41,16,33,15,12,8,21,7
2005321,27,15,1986,4,female,11,40,37,33,80,30,67,3,13
1191445,26,25,1987,12,female,357,40,13,33,28,33,20,0,8
1774525,59,1,1954,5,male,970,41,10,33,31,33,8,0,23
1969844,54,13,1959,3,male,769,40,27,34,63,28,43,6,20
1730529,25,30,1988,10,male,413,40,20,34,13,34,13,0,0
1536587,39,18,1974,12,male,1051,40,25,34,8,34,6,0,2
1089807,14,18,1999,2,male,495,40,16,36,0,0,0,36,0
2117140,57,18,1956,1,female,647,41,27,35,122,1,78,34,44
2023667,38,26,1975,12,female,447,41,20,35,22,10,12,25,10
2169955,20,2,1993,12,male,76,40,28,35,5,35,4,0,1
1360604,51,22,1962,4,female,244,40,16,36,1,36,1,0,0
1460665,51,13,1962,7,female,1195,40,16,36,1,36,1,0,0
1579982,22,16,1991,7,male,406,41,22,37,0,34,0,3,0
1348361,48,4,1965,4,male,672,41,36,37,5,35,4,2,1
1723603,20,11,1993,5,male,309,40,32,37,4,37,4,0,0
2143879,71,8,1942,7,male,918,41,28,37,3,37,1,0,2
1246969,41,3,1972,5,male,242,41,14,37,16,37,13,0,3
2019989,18,1,1995,1,male,88,40,34,39,8,0,3,39,5
2047479,19,31,1994,1,male,87,41,37,38,22,7,1,31,21
1415312,28,27,1985,2,female,482,41,18,38,7,0,3,38,4
1849575,40,11,1973,7,female,379,41,26,38,1,13,0,25,1
1506348,17,27,1996,4,male,420,40,15,39,5,31,1,8,4
1871938,39,5,1974,6,female,241,40,25,38,1,38,1,0,0
1680742,45,25,1968,11,female,475,40,26,38,5,38,3,0,2
1701008,21,17,1992,2,male,438,41,24,39,53,39,40,0,13
1340651,45,28,1968,7,male,545,41,11,39,47,39,38,0,9
2055962,56,4,1957,9,male,622,40,29,40,5,33,5,7,0
1943922,50,26,1963,2,male,384,41,33,40,4,40,4,0,0
1483991,66,15,1947,12,female,1199,40,20,40,6,40,4,0,2
1934824,54,12,1959,5,male,435,41,28,41,15,0,0,41,15
1070759,23,12,1990,1,female,119,41,16,42,57,0,12,42,45
1470685,33,28,1980,10,female,551,41,22,41,16,38,13,3,3
1125186,67,1,1946,9,female,2313,41,15,41,38,36,15,5,23
1816624,23,13,1990,7,male,194,40,39,41,9,41,9,0,0
1707256,28,19,1985,5,female,321,40,14,42,90,42,45,0,45
1591863,57,9,1956,4,male,551,40,25,43,4,0,3,43,1
1795867,25,10,1988,6,male,71,41,35,44,13,7,0,37,13
1282727,26,8,1987,7,female,201,40,17,44,5,13,4,31,1
2028064,28,30,1985,6,female,68,41,31,43,10,39,9,4,1
1252750,23,22,1990,1,male,119,41,23,43,6,43,6,0,0
2105886,39,13,1974,5,male,132,40,36,43,2,43,2,0,0
1095683,14,25,1999,1,female,68,40,24,44,54,44,9,0,45
2097423,47,24,1966,2,female,125,41,40,44,28,44,15,0,13
1968895,62,23,1951,6,female,594,40,21,45,13,0,4,45,9
1384953,53,24,1960,10,female,69,41,30,46,8,1,1,45,7
1482411,93,30,1920,4,female,175,41,34,46,23,6,18,40,5
1083171,18,9,1995,3,male,74,40,29,46,6,43,4,3,2
2189549,44,12,1969,10,female,511,41,20,46,12,43,8,3,4
1062940,61,7,1952,3,female,464,41,22,47,16,43,10,4,6
1408497,24,2,1989,10,male,325,40,26,47,36,40,20,7,16
1567907,32,8,1981,12,female,186,41,20,46,49,40,24,6,25
1887278,69,13,1944,6,female,487,41,26,46,7,46,2,0,5
1322424,61,19,1952,10,female,136,41,11,46,41,46,20,0,21
1555171,19,24,1994,9,female,122,41,30,48,1,0,0,48,1
2025208,62,25,1951,3,male,227,41,24,49,6,0,1,49,5
1192996,46,9,1967,7,female,123,40,19,48,19,0,3,48,16
2158296,55,18,1958,6,male,153,40,32,49,10,0,3,49,7
1664458,66,23,1947,9,female,643,41,20,48,28,0,25,48,3
1919904,27,1,1986,1,male,365,40,32,48,25,31,24,17,1
1315909,18,2,1995,7,male,12,41,36,48,22,48,22,0,0
2157539,35,28,1978,1,female,347,41,37,49,11,49,11,0,0
2116082,51,14,1962,9,female,483,40,27,49,42,49,38,0,4
1745589,42,30,1971,3,male,95,40,19,49,88,49,69,0,19
2017498,65,21,1948,6,male,980,41,24,51,6,2,1,49,5
2139506,17,17,1996,2,male,70,40,32,51,25,31,11,20,14
1715337,36,25,1977,7,female,44,41,20,50,49,14,28,36,21
2090842,16,11,1997,10,female,124,40,30,51,15,44,7,7,8
1560418,27,2,1986,7,female,153,40,33,50,6,50,3,0,3
2063162,39,8,1974,7,male,129,41,22,50,12,50,7,0,5
1913175,28,1,1985,1,male,283,40,32,53,19,1,9,52,10
1255837,50,26,1963,6,female,239,41,38,53,11,0,8,53,3
1600678,57,14,1956,3,male,397,40,27,52,13,0,7,52,6
2012724,50,26,1963,5,female,771,40,20,53,41,0,28,53,13
1397688,66,15,1947,8,female,1288,41,22,53,14,50,10,3,4
2019205,23,4,1990,1,female,24,41,31,52,2,52,2,0,0
1320177,27,5,1986,1,female,502,40,19,52,19,52,19,0,0
1065767,66,11,1947,4,female,740,40,21,53,15,53,10,0,5
1223327,19,11,1994,12,female,97,40,18,53,34,53,34,0,0
1763969,58,3,1955,5,female,152,40,5,55,38,9,28,46,10
1394151,22,1,1991,1,female,253,41,27,55,214,0,28,55,186
1621655,20,24,1993,6,male,61,40,19,55,33,55,13,0,20
1648624,27,23,1986,3,male,444,40,26,55,39,55,33,0,6
1087288,50,19,1963,4,male,341,40,38,57,5,11,0,46,5
2047593,15,1,1998,8,male,123,41,31,56,22,0,7,56,15
1241400,62,4,1951,11,female,408,41,17,58,13,10,7,48,6
1394322,73,24,1940,8,female,1433,41,18,57,10,6,1,51,9
1773512,102,11,1911,11,male,554,41,26,57,27,0,11,57,16
1357209,29,9,1984,6,male,93,41,29,57,63,8,3,49,60
1986388,18,31,1995,8,male,282,41,27,57,6,55,2,2,4
1584501,50,15,1963,12,male,732,40,23,57,10,50,9,7,1
1497345,24,29,1989,6,male,41,41,21,56,38,41,25,15,13
1017281,51,11,1962,6,female,328,41,25,57,1,57,1,0,0
1960154,29,27,1984,7,female,110,41,25,57,15,57,11,0,4
1004470,28,22,1985,7,male,56,41,33,57,51,57,45,0,6
1994755,54,18,1959,9,male,78,40,23,58,36,58,34,0,2
1074318,60,17,1953,3,female,1128,41,19,59,52,0,12,59,40
1901557,69,21,1944,3,male,1139,40,17,60,26,55,10,5,16
1522690,38,4,1975,12,female,60,40,40,59,48,59,47,0,1
1194196,103,22,1910,10,female,81,41,34,63,21,0,9,63,12
1482362,25,31,1988,3,male,118,40,30,63,66,1,39,62,27
1888772,45,28,1968,5,male,294,41,34,61,46,16,0,45,46
2073732,18,20,1995,6,male,313,40,11,62,0,52,0,10,0
1120548,29,5,1984,5,female,299,40,23,61,27,60,22,1,5
1778732,29,16,1984,3,male,462,41,20,61,18,61,16,0,2
1723419,44,22,1969,2,male,1425,41,31,61,98,61,67,0,31
1497491,34,19,1979,7,female,395,40,25,64,7,64,7,0,0
2172422,36,26,1977,8,female,510,41,21,65,73,65,53,0,20
1141652,65,3,1948,9,female,275,41,20,66,12,0,5,66,7
1750831,39,1,1974,4,male,549,41,35,68,1,31,1,37,0
1905367,22,26,1991,11,female,788,40,6,68,13,68,8,0,5
1310421,33,13,1980,5,male,313,40,10,66,74,66,15,0,59
1906232,66,17,1947,4,female,1874,40,14,69,22,0,19,69,3
1965357,23,10,1990,8,female,534,41,18,70,35,44,23,26,12
1960730,42,14,1971,5,female,116,40,27,69,89,14,21,55,68
1227405,39,26,1974,7,female,400,41,27,71,11,68,7,3,4
2047026,20,25,1993,6,male,22,40,24,71,1,71,1,0,0
1891331,36,30,1977,10,male,101,40,29,70,0,70,0,0,0
1587259,59,24,1954,10,female,113,41,23,70,15,70,8,0,7
1391100,30,8,1983,8,female,454,41,21,70,50,70,49,0,1
1997414,108,18,1905,4,female,81,41,29,70,133,70,62,0,71
1162601,52,12,1961,3,male,292,40,27,73,6,0,2,73,4
1020203,44,3,1969,8,female,341,41,20,74,29,2,8,72,21
2189090,31,1,1982,1,male,75,40,22,73,2,72,2,1,0
1051385,71,26,1942,7,female,1678,40,2,73,7,68,5,5,2
1988825,18,6,1995,9,female,492,41,32,73,114,65,67,8,47
1843908,32,24,1981,7,male,163,40,37,72,1,72,1,0,0
1732589,56,1,1957,1,female,754,41,22,72,20,72,11,0,9
1143627,20,1,1993,8,female,303,41,14,72,111,72,40,0,71
1529766,33,19,1980,1,male,1376,41,30,77,0,47,0,30,0
1153383,29,22,1984,6,male,261,40,32,77,30,77,15,0,15
1240196,41,29,1972,7,female,162,41,37,76,36,76,15,0,21
1799081,56,5,1957,3,male,936,40,26,76,53,76,46,0,7
1552885,22,3,1991,10,female,291,40,17,79,55,69,35,10,20
1902097,38,3,1975,4,male,556,40,17,78,380,65,348,13,32
1959351,21,11,1992,2,male,54,40,26,80,8,80,8,0,0
1486675,38,5,1975,6,female,504,40,31,78,134,78,95,0,39
1941149,49,18,1964,7,male,1001,40,6,83,22,46,16,37,6
1638114,39,15,1974,5,male,26,40,22,82,170,80,155,2,15
1530442,67,24,1946,8,female,205,40,20,81,10,81,9,0,1
1177401,25,1,1988,6,female,326,40,23,81,40,81,30,0,10
2093284,52,13,1961,3,female,739,40,28,87,31,23,16,64,15
1811106,18,14,1995,9,male,45,40,38,86,5,86,5,0,0
1478060,35,19,1978,5,male,155,41,22,85,37,85,31,0,6
1952082,56,17,1957,3,male,29,40,34,85,37,85,32,0,5
1558689,79,14,1934,11,female,631,41,33,91,8,0,2,91,6
1910384,48,19,1965,2,female,171,41,26,89,47,0,19,89,28
1832009,51,11,1962,9,female,640,41,34,91,34,4,5,87,29
2103256,82,7,1931,5,female,1115,40,20,91,87,90,84,1,3
1515398,23,1,1990,6,male,39,40,26,91,3,91,2,0,1
1892240,47,8,1966,5,female,95,40,31,89,3,89,3,0,0
1371798,33,5,1980,1,female,717,41,23,88,40,88,33,0,7
1420618,19,12,1994,12,male,15,41,21,95,81,91,61,4,20
1142139,59,3,1954,11,male,377,41,16,95,174,95,133,0,41
1012525,46,25,1967,9,male,1234,40,22,99,6,77,3,22,3
1421292,33,7,1980,10,female,132,40,25,97,84,92,64,5,20
1405263,60,12,1953,7,male,225,41,40,98,4,98,2,0,2
1870412,20,5,1993,5,male,50,41,31,96,17,96,4,0,13
1454094,37,18,1976,11,female,139,40,33,97,36,97,36,0,0
1142422,53,17,1960,6,female,677,41,23,96,37,96,31,0,6
1043271,63,12,1950,10,female,436,41,35,102,99,0,55,102,44
2016266,37,28,1976,12,male,1433,40,5,103,143,42,97,61,46
1712097,19,4,1994,9,male,36,40,38,103,58,80,46,23,12
1115394,40,29,1973,5,male,427,41,24,100,15,100,12,0,3
1266412,50,11,1963,4,male,316,41,29,104,2,104,2,0,0
2061164,24,7,1989,6,male,460,41,27,102,40,102,31,0,9
1470642,66,24,1947,12,male,1369,41,8,102,32,102,21,0,11
1550541,21,16,1992,9,male,46,41,41,108,23,97,17,11,6
1425496,59,27,1954,12,female,636,41,29,106,26,77,24,29,2
1326339,58,9,1955,12,male,321,40,35,107,14,107,13,0,1
1948217,41,2,1972,8,female,351,41,19,108,53,108,49,0,4
1124461,14,27,1999,4,female,17,41,35,109,144,109,96,0,48
1562980,43,12,1970,1,female,403,41,27,105,122,105,113,0,9
1785811,31,29,1982,9,female,98,41,19,107,171,107,134,0,37
1459334,51,1,1962,8,female,759,40,22,112,44,22,4,90,40
1409612,48,10,1965,12,female,638,40,27,113,67,113,57,0,10
1939911,49,7,1964,9,female,261,41,26,112,65,112,53,0,12
2157989,24,15,1989,4,male,22,40,25,112,130,112,58,0,72
1310017,55,17,1958,4,female,1745,41,18,113,77,113,55,0,22
2129901,65,21,1948,9,female,968,40,27,116,12,0,5,116,7
1763679,30,1,1983,11,female,119,40,34,116,30,110,12,6,18
1473039,63,2,1950,11,female,1071,41,11,118,16,118,11,0,5
1622977,80,25,1933,4,male,1541,40,18,115,19,115,12,0,7
1147475,84,17,1929,2,female,210,40,26,124,28,0,1,124,27
1225914,67,29,1946,5,female,478,40,23,122,16,122,12,0,4
1166661,37,11,1976,4,female,593,40,29,120,33,120,16,0,17
1855036,65,22,1948,5,male,373,40,31,121,24,121,12,0,12
1026396,67,1,1946,1,male,651,40,13,121,85,121,72,0,13
1025220,51,30,1962,6,male,492,40,15,128,4,0,0,128,4
1725395,34,6,1979,4,female,119,41,22,126,26,126,20,0,6
1135797,23,5,1990,11,male,34,41,27,125,120,125,116,0,4
1188945,93,15,1920,4,male,1291,40,6,135,1,0,1,135,0
1804241,49,17,1964,6,male,575,40,31,134,109,0,3,134,106
1196225,30,10,1983,5,male,624,40,22,134,30,89,6,45,24
1396874,34,19,1979,7,female,349,41,29,132,89,132,84,0,5
1163748,79,24,1934,11,female,1100,41,16,138,27,0,9,138,18
1673597,28,18,1985,6,male,274,40,25,141,0,116,0,25,0
1359722,19,27,1994,8,male,256,41,13,141,6,141,6,0,0
1144397,49,25,1964,8,male,465,40,19,138,31,138,13,0,18
1777163,27,17,1986,6,female,415,40,18,148,14,0,4,148,10
1548397,54,26,1959,3,female,422,41,28,150,12,22,9,128,3
1215333,28,13,1985,5,male,77,40,24,146,202,146,63,0,139
1418756,73,2,1940,8,female,1448,41,15,155,14,0,14,155,0
1252282,26,29,1987,7,female,310,41,17,157,17,157,0,0,17
2163900,39,8,1974,12,female,152,40,34,154,9,154,6,0,3
1887970,58,9,1955,3,male,216,40,30,151,19,151,12,0,7
1726238,36,3,1977,7,male,37,41,25,160,97,53,14,107,83
1702586,28,6,1985,12,male,84,41,37,170,32,62,11,108,21
1273352,33,20,1980,4,male,241,40,21,168,36,166,13,2,23
1009462,63,18,1950,5,female,285,41,29,168,33,163,12,5,21
2079783,31,12,1982,1,female,81,41,26,178,85,178,78,0,7
1663920,68,13,1945,11,female,12,41,39,185,32,0,14,185,18
1108973,69,6,1944,1,female,310,41,20,188,99,0,9,188,90
1503085,20,2,1993,5,female,272,41,19,188,77,172,54,16,23
1103601,56,2,1957,4,female,569,40,34,183,92,166,56,17,36
1359869,52,16,1961,9,female,306,40,31,190,23,190,18,0,5
2029149,28,21,1985,5,male,772,41,21,185,71,185,66,0,5
1862079,51,19,1962,1,female,102,40,16,198,60,11,15,187,45
1877477,63,19,1950,7,female,96,40,28,195,131,0,53,195,78
1898401,74,9,1939,2,female,302,41,16,192,113,192,86,0,27
1780009,23,21,1990,7,male,133,41,17,201,238,168,88,33,150
2191040,50,2,1963,10,female,1141,40,28,221,70,30,9,191,61
1196012,69,2,1944,6,male,1417,41,19,216,47,55,8,161,39
1461418,34,27,1979,8,female,529,40,13,221,267,204,168,17,99
1248253,35,23,1978,10,female,946,41,34,212,200,172,161,40,39
2116857,47,22,1966,5,female,481,40,22,214,35,214,33,0,2
1654130,52,6,1961,7,female,152,41,25,223,82,0,23,223,59
1296417,67,8,1946,4,female,1045,41,27,228,78,36,12,192,66
2189180,36,1,1977,10,male,368,40,35,232,112,232,93,0,19
1725948,37,21,1976,4,male,326,40,30,229,179,229,130,0,49
1928736,23,11,1990,2,female,240,40,11,241,265,0,112,241,153
2119582,33,19,1980,11,female,71,40,26,239,127,207,127,32,0
1521472,21,16,1992,9,male,273,40,33,243,5,243,5,0,0
1047046,76,26,1937,1,female,675,40,24,244,16,244,11,0,5
1452903,42,26,1971,5,male,519,41,23,237,72,237,62,0,10
1816523,50,29,1963,12,female,757,41,31,244,167,244,48,0,119
1082775,25,6,1988,10,female,491,41,21,237,437,237,319,0,118
1714321,20,5,1993,9,female,84,41,38,248,94,43,21,205,73
1222863,57,16,1956,5,female,42,41,7,253,47,13,0,240,47
1804367,41,1,1972,1,male,272,40,21,260,93,104,35,156,58
1838020,32,20,1981,4,female,278,40,35,260,193,234,174,26,19
1006768,41,27,1972,9,female,303,40,29,260,327,252,168,8,159
1280163,43,7,1970,3,female,408,40,26,258,25,258,10,0,15
1858966,52,25,1961,9,female,1419,40,30,248,142,248,74,0,68
2095981,30,1,1983,1,female,147,40,17,256,301,256,244,0,57
1691988,27,11,1986,11,female,53,40,20,260,447,260,134,0,313
1045021,32,10,1981,11,female,1000,40,33,270,66,224,38,46,28
2125862,18,1,1995,1,female,188,40,23,271,429,246,259,25,170
1198760,30,7,1983,1,male,352,41,15,270,0,270,0,0,0
2065722,34,5,1979,7,male,314,41,28,266,133,266,131,0,2
2038777,53,24,1960,6,female,1137,40,19,292,137,0,84,292,53
1486846,24,20,1989,1,female,159,41,23,291,128,291,22,0,106
1166360,43,1,1970,12,female,274,40,22,300,6,46,1,254,5
2163881,13,27,2000,2,female,119,40,12,294,107,294,86,0,21
1367979,23,8,1990,11,male,158,40,10,296,92,296,67,0,25
1572689,47,9,1966,11,female,142,41,21,305,161,305,136,0,25
1264051,67,4,1946,2,female,251,41,28,328,372,0,21,328,351
1331643,19,5,1994,3,female,588,40,31,336,206,151,157,185,49
1188376,60,17,1953,4,female,529,40,24,333,53,333,42,0,11
1525844,18,22,1995,4,female,260,41,27,361,21,361,17,0,4
1725739,25,15,1988,3,male,15,40,34,349,224,349,73,0,151
1846819,75,27,1938,9,male,677,40,19,385,64,0,21,385,43
2153131,50,27,1963,1,male,921,41,23,382,134,0,16,382,118
1140912,32,12,1981,12,female,197,41,16,385,102,385,49,0,53
1026492,58,8,1955,5,female,654,41,30,402,64,22,11,380,53
1406585,22,9,1991,6,male,394,41,35,410,89,401,78,9,11
1483285,21,21,1992,2,female,322,41,26,409,207,405,140,4,67
1039332,45,5,1968,10,male,72,40,35,421,215,421,143,0,72
1449008,39,4,1974,10,female,243,41,14,444,26,248,17,196,9
1044176,75,11,1938,1,female,805,41,27,466,13,0,2,466,11
1493249,21,31,1992,8,female,900,41,23,478,156,363,69,115,87
1170947,15,23,1998,9,male,652,40,28,463,60,463,31,0,29
1384085,68,26,1945,9,male,1729,41,14,503,163,499,96,4,67
1756488,13,28,2000,9,female,40,41,30,488,105,488,90,0,15
1524340,25,1,1988,2,male,62,40,27,519,353,519,190,0,163
2170396,20,2,1993,3,male,172,41,34,529,47,529,32,0,15
1169243,16,1,1997,2,female,293,40,33,608,26,527,14,81,12
1892977,26,16,1987,8,male,321,41,21,606,90,606,24,0,66
1014433,58,26,1955,9,male,212,41,20,601,71,601,42,0,29
1858622,61,17,1952,2,female,426,40,23,647,373,647,144,0,229
1983857,81,1,1932,1,female,921,40,24,669,133,7,39,662,94
1696094,36,11,1977,7,male,272,40,29,666,506,128,285,538,221
1477927,62,1,1951,6,female,379,41,34,747,61,39,35,708,26
1852774,20,16,1993,3,female,65,40,31,794,262,764,170,30,92
1562397,51,18,1962,3,male,1744,40,26,916,563,901,461,15,102
2072719,50,27,1963,4,female,670,40,23,1107,396,1029,118,78,278
1484944,54,12,1959,5,female,964,40,13,1223,145,0,27,1223,118
1569844,63,10,1950,4,female,1075,40,11,1192,52,87,38,1105,14
1250962,53,20,1960,4,female,1037,41,22,1189,1013,0,192,1189,821
2074916,56,19,1957,9,female,845,41,15,1188,180,1188,135,0,45
2125868,66,26,1947,8,female,1810,40,20,1219,340,1219,133,0,207
1543714,65,9,1948,6,male,232,41,24,1363,815,0,121,1363,694
2193465,19,1,1994,6,female,139,40,8,1459,691,1459,465,0,226
1060842,38,14,1975,5,male,1494,40,12,1441,1329,1441,999,0,330
2115002,34,13,1979,11,male,666,40,23,1412,3220,1412,1798,0,1422
1468018,33,29,1980,6,female,215,40,4,1707,199,1707,93,0,106
1018228,49,26,1964,7,female,516,40,27,1548,0,1548,0,0,0
1220422,43,1,1970,1,male,235,41,16,2199,149,3,51,2196,98
1024947,18,29,1995,8,female,319,40,29,1917,97,1911,62,6,35
1182112,63,29,1950,7,female,1366,41,15,3528,715,3484,286,44,429
1978826,27,3,1986,4,female,123,40,35,3379,2468,3379,364,0,2104
2020958,47,22,1966,6,female,848,40,32,3865,5733,1,61,3864,5672
1506792,21,1,1992,3,male,124,40,27,5628,230,3467,123,2161,107
1460080,34,23,1979,6,male,131,43,25,2,10,2,7,0,3
2010444,38,5,1975,5,male,168,43,39,2,7,2,6,0,1
1880810,44,16,1969,9,male,46,43,32,2,6,2,6,0,0
1845536,45,24,1968,4,male,559,42,28,2,10,2,9,0,1
1992084,48,28,1965,6,male,600,43,25,2,16,2,13,0,3
1238187,49,2,1964,4,male,409,43,17,2,22,2,5,0,17
1820384,49,16,1964,4,male,100,43,41,2,7,2,6,0,1
1254195,53,22,1960,1,male,235,42,32,2,25,2,12,0,13
2125236,56,22,1957,8,female,265,42,21,2,19,2,5,0,14
2163659,65,10,1948,12,male,2211,42,13,2,6,2,5,0,1
1370507,66,5,1947,9,female,825,43,22,2,4,2,4,0,0
1980502,68,19,1945,5,male,571,43,12,2,11,2,6,0,5
1450247,17,17,1996,2,male,197,43,30,3,0,0,0,3,0
1541592,47,17,1966,7,male,310,43,34,3,0,0,0,3,0
1434594,14,17,1999,8,male,286,43,36,3,1,0,1,3,0
1618486,17,9,1996,7,female,367,42,29,3,1,0,0,3,1
2053966,49,4,1964,4,male,974,43,27,3,1,0,1,3,0
1808071,64,1,1949,4,male,1067,43,28,3,1,0,0,3,1
1881349,68,14,1945,10,male,1345,42,9,3,1,0,0,3,1
1053118,73,16,1940,5,female,894,42,17,3,1,0,0,3,1
1082070,50,1,1963,9,female,512,43,27,3,2,0,2,3,0
1803506,61,21,1952,11,male,318,42,22,3,2,0,0,3,2
1046705,16,10,1997,10,male,279,43,29,3,42,0,21,3,21
1079424,47,18,1966,2,male,502,42,19,3,40,0,17,3,23
1636444,55,5,1958,9,female,1625,43,25,3,9,0,2,3,7
1170401,69,1,1944,1,male,277,42,35,3,6,0,3,3,3
1276564,78,27,1935,5,female,817,43,19,3,8,0,2,3,6
1173235,15,30,1998,10,male,292,42,32,3,0,2,0,1,0
1429597,44,16,1969,9,male,509,42,8,3,0,1,0,2,0
1300219,57,17,1956,3,male,355,42,24,3,1,2,1,1,0
1875280,26,10,1987,2,male,73,43,33,3,3,1,0,2,3
1144762,20,17,1993,11,male,66,43,36,3,0,3,0,0,0
1264509,20,5,1993,3,male,109,42,36,3,0,3,0,0,0
1266918,20,25,1993,9,female,251,42,36,3,0,3,0,0,0
1199603,21,30,1992,7,male,146,42,37,3,0,3,0,0,0
1966990,24,13,1989,9,female,452,42,34,3,0,3,0,0,0
1727208,27,10,1986,6,male,424,42,24,3,0,3,0,0,0
1814872,33,18,1980,1,male,266,42,32,3,0,3,0,0,0
1321274,48,1,1965,1,male,816,43,10,3,0,3,0,0,0
1258620,50,25,1963,7,male,242,43,11,3,0,3,0,0,0
1223447,51,24,1962,9,female,98,43,38,3,0,3,0,0,0
1429353,68,24,1945,2,female,268,42,32,3,0,3,0,0,0
1382855,31,19,1982,7,female,215,42,31,3,1,3,0,0,1
1554967,37,26,1976,3,male,192,43,26,3,1,3,1,0,0
1365265,38,1,1975,6,male,418,43,42,3,1,3,0,0,1
1185525,42,12,1971,8,female,256,42,31,3,1,3,1,0,0
1423732,44,7,1969,4,male,319,43,35,3,1,3,0,0,1
1655860,56,17,1957,6,male,1806,42,18,3,1,3,0,0,1
1479727,59,25,1954,11,female,215,42,27,3,1,3,1,0,0
1654366,61,17,1952,4,male,464,42,30,3,1,3,1,0,0
1569808,68,14,1945,5,male,55,43,28,3,1,3,0,0,1
1021933,23,12,1990,6,male,419,43,27,3,4,3,4,0,0
1817024,25,8,1988,8,male,53,43,29,3,2,3,2,0,0
1869357,29,7,1984,6,male,489,42,31,3,3,3,3,0,0
2009876,34,6,1979,6,male,297,43,32,3,3,3,3,0,0
1583366,36,3,1977,10,male,294,43,31,3,2,3,0,0,2
1235054,45,14,1968,8,male,710,42,18,3,3,3,2,0,1
1724004,16,4,1997,3,male,428,43,25,3,40,3,23,0,17
2041350,18,11,1995,1,female,157,42,22,3,42,3,10,0,32
1641657,22,19,1991,1,male,637,42,28,3,15,3,13,0,2
1213707,23,20,1990,7,female,314,43,34,3,25,3,7,0,18
1423506,28,1,1985,1,male,181,42,22,3,8,3,2,0,6
2050524,29,3,1984,1,female,274,43,38,3,19,3,8,0,11
2019505,29,10,1984,10,female,377,43,15,3,7,3,4,0,3
1914448,31,22,1982,11,male,155,43,34,3,45,3,45,0,0
2146406,31,4,1982,9,female,701,42,20,3,17,3,17,0,0
1730211,34,9,1979,5,male,809,43,17,3,11,3,10,0,1
2116978,45,23,1968,11,male,456,42,15,3,5,3,5,0,0
1144987,53,16,1960,3,male,649,42,13,3,18,3,15,0,3
1529514,55,6,1958,2,male,221,42,36,3,15,3,14,0,1
1031499,57,19,1956,3,male,144,42,27,3,7,3,3,0,4
1322077,59,6,1954,4,male,616,43,31,3,32,3,25,0,7
1827654,64,22,1949,9,male,111,42,37,3,77,3,49,0,28
1636129,21,19,1992,10,male,419,43,34,4,0,0,0,4,0
2001214,56,9,1957,5,male,1567,43,34,4,2,0,1,4,1
1190605,49,30,1964,5,male,378,43,34,4,4,0,0,4,4
2183751,22,3,1991,12,male,400,43,19,4,20,0,12,4,8
1788359,54,16,1959,10,male,308,42,32,4,11,0,5,4,6
1418935,64,15,1949,2,female,1337,43,22,4,6,0,3,4,3
1284661,67,3,1946,4,female,94,43,31,4,11,0,0,4,11
1887764,69,19,1944,12,male,1109,43,21,4,7,0,5,4,2
1481940,108,1,1905,1,male,2088,42,27,4,15,0,7,4,8
1608171,48,10,1965,7,male,1351,42,15,4,0,2,0,2,0
1538450,53,2,1960,5,male,867,42,23,4,0,3,0,1,0
2098431,61,2,1952,10,male,820,42,27,4,0,3,0,1,0
1366698,58,23,1955,4,female,506,42,10,4,2,3,1,1,1
1253692,66,11,1947,8,female,1111,42,33,4,1,3,0,1,1
1313013,45,30,1968,5,male,280,43,27,4,6,3,4,1,2
2067474,24,1,1989,1,male,158,43,41,4,0,4,0,0,0
1189821,24,21,1989,9,male,62,42,36,4,0,4,0,0,0
1369656,25,5,1988,2,male,53,43,31,4,0,4,0,0,0
1664540,30,17,1983,10,male,519,43,16,4,0,4,0,0,0
1753972,46,1,1967,7,male,455,42,36,4,0,4,0,0,0
2190767,29,12,1984,1,male,410,43,42,4,2,4,2,0,0
1474383,66,4,1947,5,male,1295,42,5,4,1,4,0,0,1
1436193,21,3,1992,9,female,437,43,27,4,5,4,1,0,4
1181838,28,28,1985,4,male,488,43,40,4,4,4,4,0,0
1944657,44,6,1969,4,male,97,42,27,4,3,4,1,0,2
1156585,54,20,1959,5,female,1342,42,10,4,4,4,4,0,0
1416166,64,2,1949,10,male,1025,42,26,4,3,4,3,0,0
1263678,19,30,1994,10,male,334,43,26,4,56,4,42,0,14
1139591,22,2,1991,11,female,501,43,7,4,28,4,12,0,16
1635614,23,30,1990,9,male,354,43,22,4,10,4,0,0,10
2185247,31,24,1982,11,female,530,42,24,4,6,4,1,0,5
1999220,30,16,1983,5,male,1488,43,14,4,16,4,16,0,0
1851414,20,28,1993,9,male,279,42,21,5,2,0,0,5,2
1236288,26,13,1987,2,male,410,43,29,5,3,0,1,5,2
1555648,58,4,1955,7,female,421,42,26,5,1,0,0,5,1
1870013,61,1,1952,1,male,1064,43,21,5,3,0,1,5,2
1527920,55,17,1958,2,female,597,42,6,5,7,0,7,5,0
1823439,55,17,1958,4,female,133,42,36,5,4,0,1,5,3
2048292,68,7,1945,8,male,742,42,25,5,5,0,0,5,5
1180442,18,7,1995,11,male,146,43,23,5,23,0,8,5,15
2161669,73,4,1940,8,male,1108,42,6,5,1,2,1,3,0
2035077,26,10,1987,10,male,328,43,7,5,8,1,6,4,2
1743241,56,4,1957,3,female,1534,43,26,5,21,1,5,4,16
2028258,18,25,1995,10,male,288,42,40,5,0,5,0,0,0
1351465,20,21,1993,1,male,1465,42,27,5,0,5,0,0,0
1666023,48,20,1965,6,male,528,43,21,5,0,5,0,0,0
1998428,52,1,1961,7,male,456,43,15,5,0,5,0,0,0
1398603,18,20,1995,8,female,839,43,5,5,2,5,2,0,0
1065332,24,23,1989,8,male,64,43,9,5,1,5,0,0,1
2178519,32,29,1981,6,male,562,42,40,5,3,5,3,0,0
1131489,34,15,1979,1,male,353,42,37,5,3,5,1,0,2
1159236,19,12,1994,9,male,114,42,40,5,4,5,3,0,1
1938775,21,27,1992,3,male,673,42,28,5,7,5,4,0,3
1438738,21,13,1992,7,male,193,42,22,5,4,5,0,0,4
1095605,28,1,1985,1,male,290,43,20,5,5,5,4,0,1
1269956,28,10,1985,2,male,104,43,25,5,4,5,0,0,4
1630530,28,10,1985,6,male,180,43,30,5,22,5,21,0,1
1318512,32,13,1981,11,male,500,42,20,5,12,5,9,0,3
1181613,37,19,1976,10,male,45,43,37,5,13,5,8,0,5
2061378,42,6,1971,2,male,1633,43,23,5,20,5,18,0,2
1479731,70,15,1943,6,male,1850,43,31,6,0,0,0,6,0
1221898,75,20,1938,8,female,792,42,17,6,0,0,0,6,0
1031497,21,8,1992,4,male,529,43,21,6,1,0,0,6,1
1384204,55,22,1958,5,male,256,42,32,6,3,0,0,6,3
2049658,17,8,1996,4,male,166,43,16,6,4,0,1,6,3
1420346,48,4,1965,11,male,263,43,36,6,4,1,0,5,4
1994475,55,8,1958,2,male,215,42,38,6,0,3,0,3,0
1401515,21,1,1992,1,male,245,43,36,6,1,2,1,4,0
2025028,41,18,1972,3,female,489,43,34,6,6,4,1,2,5
1140605,35,18,1978,11,female,564,43,28,6,6,5,2,1,4
2005871,39,3,1974,5,male,90,42,35,6,0,6,0,0,0
1766782,51,15,1962,2,female,555,42,11,6,0,6,0,0,0
1087953,62,6,1951,10,female,765,43,25,6,0,6,0,0,0
1838836,22,18,1991,3,female,75,43,28,6,2,6,1,0,1
1450150,42,31,1971,1,male,343,43,24,6,1,6,1,0,0
1249397,21,19,1992,10,male,25,43,22,6,4,6,4,0,0
1489991,50,9,1963,9,male,768,42,21,6,5,6,4,0,1
2106178,55,23,1958,9,male,390,43,25,6,6,6,5,0,1
1442955,17,27,1996,10,female,251,42,13,6,14,6,3,0,11
2085474,22,23,1991,6,male,252,42,20,6,9,6,7,0,2
1477881,33,1,1980,1,male,94,43,36,6,38,6,9,0,29
1449744,40,25,1973,5,female,501,42,25,7,1,0,0,7,1
1085504,56,25,1957,11,male,617,42,22,7,0,0,0,7,0
1819317,64,19,1949,9,male,1067,42,11,7,1,0,1,7,0
1936302,42,13,1971,6,male,439,43,36,7,8,0,8,7,0
1064540,54,3,1959,6,female,364,43,21,7,7,0,1,7,6
1561621,23,22,1990,7,male,285,43,37,7,6,3,6,4,0
1339719,68,15,1945,2,male,243,42,29,7,5,2,0,5,5
1657123,26,15,1987,12,male,280,43,35,7,4,6,2,1,2
2155590,31,5,1982,9,female,477,43,27,7,43,6,26,1,17
1712292,14,8,1999,7,male,139,43,41,7,1,7,1,0,0
1923966,16,4,1997,6,male,400,43,29,7,0,7,0,0,0
1077646,25,6,1988,4,male,133,42,41,7,0,7,0,0,0
1259853,32,1,1981,1,male,605,42,32,7,0,7,0,0,0
1372843,40,14,1973,11,female,479,43,31,7,0,7,0,0,0
1502682,59,19,1954,12,female,892,43,18,7,0,7,0,0,0
1403541,20,22,1993,2,male,426,43,17,7,3,7,1,0,2
2059508,28,15,1985,8,male,694,42,32,7,2,7,0,0,2
2138348,32,22,1981,10,female,201,42,27,7,4,7,2,0,2
1166951,34,19,1979,9,male,137,42,24,7,2,7,1,0,1
1868136,36,5,1977,8,male,202,43,25,7,2,7,1,0,1
1508700,68,3,1945,6,male,679,43,27,7,2,7,2,0,0
2145291,20,2,1993,1,male,213,43,15,7,7,7,2,0,5
1251598,30,3,1983,10,female,506,42,24,7,9,7,8,0,1
1466024,47,8,1966,2,male,304,42,26,7,6,7,2,0,4
1003606,18,27,1995,4,male,218,42,35,7,25,7,11,0,14
1260742,27,25,1986,8,male,755,43,21,7,16,7,11,0,5
1446700,53,27,1960,9,female,25,43,36,7,14,7,3,0,11
2039306,61,21,1952,4,male,1519,43,16,7,31,7,17,0,14
1672761,64,15,1949,5,male,239,43,40,7,44,7,26,0,18
1801522,105,9,1908,7,female,137,42,25,7,18,7,13,0,5
1444082,24,22,1989,2,male,543,42,39,8,0,0,0,8,0
1076071,23,4,1990,7,male,915,43,22,8,4,0,4,8,0
1683243,25,4,1988,12,male,555,42,15,8,2,0,0,8,2
1877302,44,2,1969,8,male,1781,43,15,8,3,0,2,8,1
1691017,65,27,1948,5,female,869,43,20,8,2,0,0,8,2
1180486,15,5,1998,4,male,332,43,29,8,8,1,0,7,8
1684654,72,12,1941,10,male,979,43,23,8,5,0,3,8,2
1584883,57,27,1956,5,female,128,43,30,8,140,0,47,8,93
1534334,30,3,1983,1,male,887,42,34,8,4,2,4,6,0
1987582,25,7,1988,1,female,480,43,27,8,0,8,0,0,0
1620051,26,31,1987,7,male,553,42,27,8,0,8,0,0,0
1702113,30,11,1983,3,male,75,43,29,8,0,8,0,0,0
2169861,40,13,1973,5,male,276,42,12,8,2,8,2,0,0
1498577,22,15,1991,1,male,9,43,35,8,7,8,7,0,0
1367027,29,1,1984,6,male,713,43,25,8,5,8,5,0,0
1121633,40,26,1973,8,male,1201,43,22,8,8,8,6,0,2
1088589,57,20,1956,10,male,929,42,18,8,7,8,5,0,2
2153588,61,2,1952,2,female,900,42,11,8,10,8,8,0,2
1784952,90,4,1923,7,male,16,43,41,8,8,8,2,0,6
1942667,33,16,1980,9,male,101,42,26,8,29,8,8,0,21
1767338,56,10,1957,10,female,776,43,7,8,27,8,27,0,0
1947711,20,12,1993,4,male,271,43,41,9,0,0,0,9,0
1504555,32,12,1981,10,male,659,43,31,9,1,0,0,9,1
1572694,35,14,1978,3,male,325,42,28,9,1,0,0,9,1
1234182,67,17,1946,7,male,1150,42,24,9,1,0,0,9,1
1502770,62,11,1951,6,male,225,42,28,9,2,0,0,9,2
1386537,23,17,1990,2,female,120,42,38,9,10,0,1,9,9
1226677,48,22,1965,7,female,325,42,30,9,16,0,2,9,14
1024060,65,18,1948,9,female,513,42,22,9,24,0,10,9,14
1281160,53,3,1960,6,female,348,43,22,9,3,3,3,6,0
1030030,36,14,1977,2,male,128,42,31,9,6,5,4,4,2
1124259,49,8,1964,7,female,1192,42,14,9,10,2,9,7,1
2024461,58,3,1955,12,female,556,43,24,9,1,8,1,1,0
1715315,62,14,1951,2,female,500,42,30,9,7,7,2,2,5
2035110,33,10,1980,8,male,179,42,26,9,0,9,0,0,0
1444874,30,19,1983,11,female,337,43,25,9,12,9,8,0,4
1299027,25,1,1988,7,male,157,42,33,9,32,9,29,0,3
1128015,45,30,1968,9,female,143,43,36,9,14,9,12,0,2
2118754,41,17,1972,5,female,179,42,33,10,6,0,1,10,5
1893400,55,8,1958,6,male,343,43,35,10,2,0,1,10,1
1153694,63,18,1950,3,female,1392,42,25,10,6,0,3,10,3
2043486,69,24,1944,7,male,1024,42,9,10,4,0,0,10,4
1544031,45,16,1968,9,female,442,42,35,10,20,0,13,10,7
1674694,60,21,1953,4,female,271,42,24,10,17,0,6,10,11
1237786,47,10,1966,3,female,912,43,28,10,5,4,4,6,1
2149853,32,3,1981,6,male,366,43,34,10,16,2,14,8,2
1105899,50,9,1963,3,female,1370,42,21,10,15,3,1,7,14
1356745,71,22,1942,9,female,1580,42,17,10,7,9,3,1,4
1087334,25,1,1988,1,female,144,42,38,10,1,10,0,0,1
1044422,37,28,1976,11,male,885,43,15,10,0,10,0,0,0
1240845,60,14,1953,10,male,471,43,30,10,0,10,0,0,0
1072001,61,28,1952,10,male,668,43,31,10,0,10,0,0,0
2092004,21,11,1992,8,male,456,43,28,10,4,10,2,0,2
1448396,25,14,1988,3,female,139,43,30,10,13,10,11,0,2
1887216,20,5,1993,11,female,40,42,9,10,19,10,19,0,0
1925483,29,22,1984,6,male,519,42,20,10,35,10,14,0,21
1852282,32,1,1981,1,male,229,43,35,10,61,10,43,0,18
1096047,33,15,1980,10,female,421,42,9,10,15,10,14,0,1
1164281,18,1,1995,5,male,87,43,41,11,0,1,0,10,0
1527788,55,23,1958,6,female,628,42,13,11,0,0,0,11,0
1627085,17,27,1996,12,male,303,42,37,11,4,0,1,11,3
1492931,51,1,1962,6,female,351,42,24,11,10,0,5,11,5
1972681,64,19,1949,6,female,812,43,29,11,9,0,5,11,4
1376293,65,29,1948,8,male,1681,43,20,11,7,0,2,11,5
2080891,59,1,1954,12,male,739,42,28,11,28,0,5,11,23
1953066,72,2,1941,8,female,805,43,30,11,53,0,32,11,21
1347847,34,7,1979,2,male,264,42,38,11,2,10,0,1,2
1437750,19,25,1994,5,male,416,42,30,11,23,8,2,3,21
1168408,47,16,1966,5,male,420,42,9,11,0,11,0,0,0
1395990,54,4,1959,6,male,2235,43,29,11,1,11,1,0,0
1207432,59,26,1954,11,male,772,42,19,11,1,11,1,0,0
1907806,67,10,1946,3,male,647,42,15,11,0,11,0,0,0
1571877,94,27,1919,5,male,169,42,37,11,1,11,0,0,1
1380835,47,5,1966,2,male,1957,43,20,11,2,11,2,0,0
1411408,23,7,1990,12,male,39,42,32,11,9,11,6,0,3
2103754,22,15,1991,6,female,486,43,20,11,16,11,10,0,6
1652434,60,17,1953,1,male,618,42,27,11,13,11,9,0,4
1821458,63,1,1950,1,female,359,43,33,11,7,11,4,0,3
1896763,45,26,1968,2,male,1958,43,30,11,29,11,27,0,2
1211954,48,21,1965,10,male,521,42,10,11,45,11,22,0,23
1685163,24,25,1989,2,male,395,42,28,12,19,0,10,12,9
2064297,17,16,1996,6,female,19,42,35,12,0,8,0,4,0
2040216,27,23,1986,11,female,411,43,34,12,23,9,7,3,16
2143320,23,7,1990,8,male,404,42,25,12,1,12,0,0,1
1887396,27,11,1986,7,male,85,43,39,12,1,12,0,0,1
1875922,26,1,1987,12,male,347,43,4,12,10,12,7,0,3
1520387,37,18,1976,12,male,635,42,8,12,12,12,11,0,1
1658586,46,4,1967,8,female,1332,42,14,12,23,12,18,0,5
2185509,70,2,1943,12,female,1429,42,24,13,2,0,0,13,2
1717498,69,9,1944,3,male,1891,43,13,13,4,2,1,11,3
1778515,65,17,1948,3,female,947,42,18,13,0,5,0,8,0
2060966,47,7,1966,7,female,1356,42,24,13,37,8,32,5,5
2000939,22,14,1991,12,male,22,43,41,13,17,12,3,1,14
1119812,21,22,1992,8,male,204,43,36,13,39,12,28,1,11
1534221,25,16,1988,7,female,468,43,18,13,2,13,2,0,0
1830433,30,15,1983,1,male,220,43,36,13,0,13,0,0,0
2000324,22,14,1991,10,male,507,43,31,13,3,13,3,0,0
1157166,25,2,1988,8,female,302,42,23,13,14,13,13,0,1
1256906,38,13,1975,2,male,883,43,16,13,33,13,22,0,11
1137627,20,13,1993,8,male,606,42,27,14,2,0,0,14,2
2004407,25,18,1988,8,male,438,42,28,14,4,1,2,13,2
1411886,55,3,1958,6,female,83,42,19,14,11,1,0,13,11
1987673,43,10,1970,10,male,261,42,23,14,38,0,9,14,29
1649475,17,30,1996,3,male,504,42,21,14,3,5,0,9,3
1188361,22,2,1991,2,male,153,42,27,14,2,14,2,0,0
1642562,32,16,1981,12,male,598,43,39,14,0,14,0,0,0
1999162,33,18,1980,1,male,180,42,39,14,14,14,13,0,1
1354594,74,10,1939,8,female,784,43,25,15,7,0,5,15,2
1825831,26,15,1987,7,female,169,42,16,15,0,10,0,5,0
1042260,50,24,1963,1,male,49,43,23,15,17,7,4,8,13
1268385,40,11,1973,4,female,300,43,28,15,1,11,1,4,0
1219812,32,20,1981,2,male,22,42,37,15,12,14,2,1,10
1518231,39,14,1974,5,male,214,42,25,15,44,11,28,4,16
1382144,50,22,1963,6,female,2398,42,15,15,2,15,1,0,1
1480673,71,22,1942,10,female,1716,43,14,15,7,15,7,0,0
1879962,24,5,1989,4,female,381,43,34,15,15,15,7,0,8
1955697,32,31,1981,8,male,162,43,31,16,5,0,4,16,1
1533051,75,8,1938,5,female,1498,43,9,16,25,0,8,16,17
1130055,17,4,1996,11,male,595,42,17,16,22,4,12,12,10
1323690,23,1,1990,1,male,948,42,32,16,9,12,5,4,4
2011524,16,19,1997,7,male,267,43,25,16,0,16,0,0,0
1411371,30,26,1983,7,male,496,43,29,16,0,16,0,0,0
1065930,57,26,1956,11,male,525,42,33,16,5,16,0,0,5
2058531,60,1,1953,8,female,1027,42,18,16,5,16,3,0,2
1386088,18,15,1995,11,female,153,42,29,16,24,16,14,0,10
1231235,23,27,1990,2,female,105,42,33,16,44,16,18,0,26
1658873,58,4,1955,9,female,548,42,26,16,25,16,14,0,11
1603402,31,28,1982,5,male,753,43,28,17,6,0,4,17,2
1207600,61,1,1952,2,NA,2051,43,19,17,23,6,9,11,14
1575352,50,4,1963,11,male,505,43,34,17,0,17,0,0,0
2070744,36,12,1977,1,male,411,43,17,17,5,17,5,0,0
1909264,49,6,1964,3,male,1089,43,22,17,7,17,3,0,4
2040078,57,17,1956,10,female,482,43,17,17,10,17,7,0,3
1921082,27,23,1986,12,female,269,42,25,17,25,17,19,0,6
1211383,34,20,1979,10,male,620,43,18,17,54,17,39,0,15
2157965,64,5,1949,3,female,216,42,31,18,1,0,0,18,1
1739520,51,27,1962,1,male,463,42,24,18,10,11,8,7,2
2116462,36,15,1977,12,female,15,42,41,18,4,16,4,2,0
1558356,56,7,1957,5,female,1809,43,15,18,28,17,6,1,22
2143571,18,22,1995,3,male,363,42,35,18,0,18,0,0,0
2185971,24,7,1989,1,male,65,42,31,18,3,18,3,0,0
1993538,36,19,1977,1,male,464,42,28,18,5,18,3,0,2
2038965,32,17,1981,11,female,371,43,29,18,19,18,6,0,13
1156728,39,12,1974,2,female,612,42,32,18,17,18,11,0,6
1804922,54,28,1959,5,female,852,43,17,18,19,18,16,0,3
1533870,28,14,1985,4,male,219,43,21,18,36,18,29,0,7
1481876,44,5,1969,5,female,2230,42,25,18,50,18,47,0,3
1488888,55,9,1958,9,male,573,43,19,18,31,18,13,0,18
1007243,33,7,1980,7,female,639,43,16,19,9,0,5,19,4
2012042,63,24,1950,8,female,673,42,13,19,12,0,2,19,10
1270674,73,16,1940,9,male,1121,43,13,19,16,18,13,1,3
1469660,39,12,1974,10,male,381,42,39,19,2,19,2,0,0
2007598,18,22,1995,5,male,268,42,25,19,20,19,13,0,7
2110907,23,2,1990,2,male,242,43,32,20,1,0,0,20,1
1598878,90,15,1923,4,female,104,42,35,20,0,0,0,20,0
1172838,33,28,1980,11,male,550,42,25,20,12,0,2,20,10
1036729,54,19,1959,9,female,1084,43,29,20,8,1,0,19,8
1506196,16,13,1997,10,female,298,43,22,20,6,14,2,6,4
2163360,39,1,1974,5,male,173,42,35,20,2,20,1,0,1
1051810,53,20,1960,6,male,278,42,18,20,1,20,1,0,0
1852423,24,16,1989,10,male,397,43,0,20,13,20,2,0,11
1565593,57,29,1956,3,male,437,43,33,21,10,0,1,21,9
1786297,70,6,1943,1,female,850,43,7,21,5,0,2,21,3
1256382,81,14,1932,6,female,460,42,25,21,16,0,5,21,11
1314554,18,6,1995,1,male,595,43,24,21,12,18,9,3,3
1956025,50,3,1963,4,male,1937,42,11,21,56,20,51,1,5
1618225,24,7,1989,7,male,32,42,28,21,2,21,1,0,1
1128969,35,8,1978,9,male,543,43,32,21,8,21,8,0,0
1112155,62,24,1951,8,female,794,42,37,21,18,21,5,0,13
1827069,58,8,1955,1,female,146,42,26,21,57,21,34,0,23
1833641,21,19,1992,6,male,668,43,22,22,2,0,0,22,2
1429471,34,14,1979,6,male,169,43,41,22,30,13,20,9,10
1528681,64,13,1949,9,female,1876,43,21,22,20,5,9,17,11
1118386,46,10,1967,8,male,371,43,32,22,81,22,38,0,43
1047020,68,2,1945,12,female,1187,43,23,23,10,22,6,1,4
1472339,30,15,1983,6,male,171,43,28,23,1,23,1,0,0
1995774,45,14,1968,5,female,219,42,30,23,12,23,3,0,9
1802208,45,17,1968,6,male,68,43,17,23,5,23,5,0,0
1471810,108,1,1905,1,male,1120,43,12,24,5,0,2,24,3
2022402,44,11,1969,3,male,3,43,36,24,73,2,43,22,30
1761650,26,3,1987,9,male,792,43,21,24,4,12,0,12,4
1760243,45,20,1968,2,male,785,42,32,24,18,16,15,8,3
1898870,13,10,2000,5,male,78,42,30,24,7,19,5,5,2
1189204,18,19,1995,8,male,124,42,31,24,6,22,6,2,0
1027814,49,11,1964,9,male,328,42,31,24,3,24,1,0,2
1976635,44,26,1969,10,male,625,43,27,24,9,24,9,0,0
1922723,40,8,1973,10,male,127,42,27,24,65,24,63,0,2
1875515,27,8,1986,6,female,65,43,23,25,5,24,5,1,0
2187591,25,17,1988,5,male,10,42,37,25,0,25,0,0,0
1789016,31,25,1982,11,male,241,42,15,25,2,25,1,0,1
2173290,66,13,1947,6,male,2067,43,15,25,2,25,1,0,1
1741179,31,30,1982,10,male,30,42,39,25,13,25,13,0,0
1289486,13,1,2000,8,male,18,42,35,25,16,25,10,0,6
1861393,18,15,1995,8,male,112,43,39,26,11,3,1,23,10
1328216,111,24,1902,11,male,2291,43,17,26,23,0,8,26,15
1709920,27,30,1986,10,male,468,42,26,26,48,15,26,11,22
1607921,20,21,1993,5,male,9,42,31,26,28,26,16,0,12
1004029,22,10,1991,3,male,253,43,32,26,16,26,13,0,3
1155662,37,4,1976,5,male,1726,43,19,26,33,26,21,0,12
1026689,42,1,1971,1,male,37,42,36,26,23,26,20,0,3
2001952,73,6,1940,9,female,1145,42,25,27,4,0,0,27,4
1645711,48,2,1965,5,male,955,43,29,27,16,0,5,27,11
1899758,56,10,1957,7,male,1460,43,26,27,29,0,16,27,13
1601996,58,13,1955,9,female,862,42,22,27,30,12,20,15,10
1870872,16,4,1997,7,male,153,43,35,27,0,27,0,0,0
2057746,26,28,1987,7,male,88,43,37,27,2,27,0,0,2
1409645,27,1,1986,7,male,1144,43,26,27,0,27,0,0,0
1720268,34,22,1979,6,female,433,42,20,27,2,27,2,0,0
1888768,41,25,1972,1,female,1007,43,4,27,0,27,0,0,0
1128259,19,22,1994,6,male,208,43,38,27,35,27,22,0,13
1562849,27,12,1986,3,female,651,42,38,27,23,27,13,0,10
2181065,20,11,1993,11,female,45,42,27,27,57,27,35,0,22
2150882,35,13,1978,3,male,819,43,22,28,77,16,36,12,41
2142442,44,12,1969,2,male,187,43,29,28,1,28,1,0,0
2166506,28,4,1985,10,female,123,43,38,28,37,28,37,0,0
1747384,41,25,1972,3,male,545,42,41,29,2,0,0,29,2
1296113,74,22,1939,1,female,1625,43,25,29,2,29,1,0,1
1323848,36,25,1977,7,male,518,43,15,31,1,2,1,29,0
1482304,23,19,1990,5,male,894,43,8,30,17,0,0,30,17
1794099,59,5,1954,4,female,10,43,13,31,249,0,135,31,114
1443691,18,1,1995,1,male,414,43,23,31,1,13,1,18,0
1182047,62,14,1951,9,female,909,43,6,31,8,9,3,22,5
2044121,25,27,1988,2,male,546,43,23,30,33,21,23,9,10
2166986,27,9,1986,4,male,78,43,37,31,31,30,17,1,14
2185474,23,20,1990,8,female,378,43,1,30,3,30,1,0,2
1574398,21,1,1992,9,male,98,42,41,30,11,30,11,0,0
1909018,26,1,1987,1,female,624,42,39,30,10,30,7,0,3
1465800,45,1,1968,9,male,46,43,41,30,9,30,5,0,4
1671342,87,22,1926,4,female,550,42,17,30,12,30,2,0,10
1356254,28,1,1985,2,male,22,42,27,31,24,31,23,0,1
1236526,33,18,1980,11,female,695,42,25,32,11,0,3,32,8
1027734,23,10,1990,5,male,804,42,9,32,14,32,2,0,12
1772468,50,30,1963,12,male,578,43,28,32,12,32,8,0,4
1849904,49,1,1964,12,female,662,42,27,33,4,0,3,33,1
1630741,67,25,1946,5,female,36,42,11,33,31,32,23,1,8
1065915,20,14,1993,3,male,473,43,18,33,10,33,2,0,8
2119575,66,8,1947,1,female,146,43,36,34,6,0,1,34,5
1676392,31,16,1982,3,female,78,42,38,34,2,34,2,0,0
1256456,45,24,1968,5,male,289,42,16,35,27,0,21,35,6
1686074,29,28,1984,11,male,604,43,23,36,0,23,0,13,0
2178884,53,26,1960,6,female,787,43,11,36,5,21,5,15,0
1875052,44,31,1969,12,female,413,42,32,35,15,34,13,1,2
1646995,24,22,1989,6,male,187,42,21,35,39,28,34,7,5
1864322,32,23,1981,4,male,553,43,25,36,49,31,34,5,15
1665453,25,3,1988,3,male,184,43,28,35,2,35,2,0,0
2142739,25,4,1988,5,male,356,43,32,36,1,36,1,0,0
1077920,23,28,1990,12,female,75,42,41,36,12,36,12,0,0
1739338,22,1,1991,1,male,31,43,38,36,10,36,10,0,0
1319782,47,15,1966,12,male,237,43,9,35,56,35,51,0,5
1353981,23,11,1990,3,male,138,42,38,37,9,4,8,33,1
1900393,70,9,1943,4,female,1360,42,33,37,10,0,1,37,9
1094466,70,1,1943,1,female,1036,42,25,37,119,0,56,37,63
1259682,15,6,1998,4,male,31,43,33,37,10,10,4,27,6
1498789,34,24,1979,6,female,424,43,39,37,11,37,10,0,1
1622171,45,15,1968,10,male,49,43,39,37,22,37,20,0,2
1096852,21,23,1992,2,female,141,42,33,39,45,7,25,32,20
1071116,62,17,1951,7,male,532,43,24,38,8,9,6,29,2
1006168,16,9,1997,9,male,602,42,30,39,0,39,0,0,0
2104132,37,5,1976,2,male,219,42,32,39,1,39,1,0,0
1372023,19,19,1994,1,male,513,43,9,39,22,39,4,0,18
1775164,51,22,1962,11,male,101,42,30,40,1,40,1,0,0
1250978,53,30,1960,11,female,541,42,30,41,1,0,0,41,1
1957750,42,21,1971,2,male,280,42,28,41,18,0,6,41,12
1380685,62,26,1951,12,female,641,43,35,42,18,1,8,41,10
1940791,25,30,1988,10,male,404,43,37,42,5,42,5,0,0
1573493,47,24,1966,4,male,620,42,28,41,10,41,2,0,8
1704660,57,8,1956,7,male,559,43,30,43,20,0,18,43,2
1134102,52,22,1961,9,male,203,42,36,43,3,26,3,17,0
1783118,35,4,1978,6,female,590,42,29,43,125,41,90,2,35
1515346,40,1,1973,1,male,96,43,39,43,14,43,12,0,2
1240836,58,12,1955,5,female,84,43,25,45,32,0,18,45,14
1875332,33,14,1980,12,male,522,43,18,45,43,36,24,9,19
1102567,17,13,1996,3,male,39,42,39,45,22,45,15,0,7
1826249,35,7,1978,4,male,578,42,10,45,125,45,96,0,29
1814335,72,7,1941,2,male,214,42,27,47,2,9,2,38,0
1686372,54,14,1959,11,female,445,43,28,47,52,38,30,9,22
1098375,30,9,1983,12,male,251,43,22,47,35,47,16,0,19
1818718,29,4,1984,5,female,150,43,18,46,39,46,33,0,6
2191743,46,28,1967,8,male,646,43,33,47,37,47,32,0,5
2190704,58,13,1955,2,female,917,43,31,48,0,0,0,48,0
1872117,75,24,1938,12,female,858,43,28,49,0,9,0,40,0
1993740,29,14,1984,4,male,303,43,36,48,18,0,6,48,12
2052826,34,1,1979,6,female,207,42,22,49,10,2,10,47,0
1126839,54,4,1959,7,female,544,43,11,48,16,1,10,47,6
1296941,46,28,1967,2,female,177,43,22,48,62,31,16,17,46
1607062,57,20,1956,7,female,739,42,32,50,0,0,0,50,0
1390381,57,22,1956,9,female,1013,43,17,50,2,0,1,50,1
2124346,69,10,1944,12,male,230,43,31,50,4,0,1,50,3
1976882,45,12,1968,4,male,350,42,30,50,13,20,4,30,9
2170099,24,24,1989,3,male,827,42,30,50,13,49,12,1,1
1394301,98,5,1915,4,male,206,42,24,51,5,51,5,0,0
1229532,43,14,1970,1,female,78,43,31,50,10,50,7,0,3
1368423,53,8,1960,8,female,348,42,36,50,10,50,10,0,0
1607262,30,17,1983,1,female,320,42,36,51,62,51,36,0,26
1485106,35,4,1978,9,female,458,42,32,50,65,50,60,0,5
1539697,71,31,1942,10,female,41,43,16,53,14,0,8,53,6
1209895,28,8,1985,1,male,10,42,19,52,45,3,15,49,30
1620022,30,20,1983,3,female,475,42,25,53,40,48,8,5,32
1157781,26,1,1987,1,female,56,42,16,52,4,52,4,0,0
1626157,18,20,1995,6,female,184,43,24,53,23,53,7,0,16
1216575,37,1,1976,6,male,1043,43,30,53,30,53,17,0,13
1482135,76,17,1937,8,female,599,43,28,52,30,52,20,0,10
2012324,43,26,1970,8,male,530,42,32,54,0,17,0,37,0
1660293,30,9,1983,5,male,1706,43,16,55,479,48,304,7,175
1333702,100,7,1913,3,female,1613,42,19,55,133,48,44,7,89
1981879,42,19,1971,5,male,291,42,30,54,15,54,10,0,5
1292747,60,22,1953,9,female,1643,43,36,54,12,54,10,0,2
1756646,47,22,1966,8,male,64,42,15,55,48,55,38,0,10
1412104,31,16,1982,5,male,490,43,40,58,61,55,49,3,12
2102483,39,28,1974,3,female,341,42,23,58,58,58,57,0,1
1000931,50,26,1963,2,male,171,42,23,56,83,56,50,0,33
1027447,64,11,1949,8,female,589,42,22,59,0,0,0,59,0
1584513,100,3,1913,6,male,5,42,42,60,5,0,2,60,3
1192564,14,2,1999,9,male,65,42,39,59,17,3,6,56,11
1330819,21,7,1992,1,female,26,42,36,59,45,12,7,47,38
1473689,26,14,1987,4,male,277,43,37,60,17,47,5,13,12
1315331,59,17,1954,1,male,1839,42,12,59,37,58,12,1,25
1820188,50,8,1963,7,female,412,43,35,60,1,60,1,0,0
1170155,55,15,1958,9,female,41,43,32,60,41,60,25,0,16
1995482,62,29,1951,12,male,1683,42,14,59,54,59,51,0,3
1668139,59,19,1954,12,male,609,42,30,61,8,0,0,61,8
1363063,23,9,1990,8,female,71,42,38,61,43,41,29,20,14
1360273,21,12,1992,11,female,232,42,29,63,2,62,2,1,0
2021857,54,9,1959,6,female,1325,43,23,62,31,61,18,1,13
1754330,29,1,1984,1,male,384,43,42,61,3,61,3,0,0
1322319,18,29,1995,1,female,516,43,13,64,3,22,3,42,0
1529758,20,6,1993,1,male,93,42,29,64,22,47,13,17,9
2124826,101,13,1912,6,female,2058,42,25,65,28,64,23,1,5
1889493,33,2,1980,2,male,80,43,10,64,11,64,11,0,0
1327720,46,3,1967,12,male,167,42,35,64,33,64,12,0,21
1020024,69,27,1944,12,female,431,42,25,65,86,65,78,0,8
1135396,52,28,1961,7,male,347,42,18,68,3,1,2,67,1
2044436,22,5,1991,5,male,767,43,34,66,13,1,9,65,4
1028473,52,25,1961,2,female,271,42,32,67,96,55,57,12,39
1683880,15,17,1998,11,male,289,43,31,66,0,66,0,0,0
1343761,67,29,1946,4,female,404,43,33,68,3,68,2,0,1
1405072,46,3,1967,3,female,438,42,31,66,19,66,17,0,2
1831021,65,6,1948,2,male,310,42,13,66,55,66,48,0,7
1210212,22,7,1991,1,female,382,42,27,66,108,66,92,0,16
1220044,59,20,1954,3,female,1456,43,17,71,80,40,43,31,37
1478516,25,2,1988,1,male,79,43,36,71,3,71,3,0,0
1574951,15,12,1998,7,female,285,43,28,69,12,69,12,0,0
1161326,37,25,1976,4,female,267,43,35,71,163,71,144,0,19
1461367,56,8,1957,1,female,1317,43,13,74,179,27,55,47,124
1617203,16,16,1997,9,male,237,42,33,74,8,61,5,13,3
1503273,37,22,1976,10,male,845,42,39,72,25,72,10,0,15
1662991,55,5,1958,11,female,433,43,20,73,36,73,35,0,1
1455785,59,6,1954,1,female,264,42,26,72,30,72,22,0,8
1277126,51,2,1962,6,female,130,43,13,74,212,74,166,0,46
1855962,35,6,1978,1,female,526,43,22,75,30,19,10,56,20
2161113,65,23,1948,6,female,456,42,23,77,86,62,64,15,22
1058333,38,13,1975,5,female,460,43,21,77,42,77,36,0,6
1054509,56,16,1957,5,female,578,43,17,79,45,1,25,78,20
1733986,55,14,1958,10,female,1393,43,24,79,47,28,16,51,31
1751672,18,3,1995,5,female,645,43,26,79,10,79,10,0,0
2047636,31,23,1982,11,male,369,42,31,80,3,80,3,0,0
1590772,38,20,1975,10,male,89,43,41,79,27,79,21,0,6
2088175,21,3,1992,6,female,228,43,27,78,105,78,67,0,38
1386590,48,30,1965,4,male,769,42,42,82,2,0,1,82,1
1808328,62,26,1951,5,female,247,43,10,82,12,0,1,82,11
1383441,20,2,1993,7,female,161,42,19,81,54,46,24,35,30
1730047,21,24,1992,9,male,623,43,29,84,189,42,39,42,150
1725282,27,24,1986,6,female,51,42,12,84,16,74,15,10,1
1990461,56,25,1957,5,male,327,42,12,83,54,74,36,9,18
2121117,15,4,1998,1,female,74,42,24,81,41,81,41,0,0
1848094,51,25,1962,11,female,727,43,30,82,144,82,109,0,35
1967480,21,28,1992,7,female,938,42,26,86,7,0,0,86,7
1646636,25,1,1988,1,female,68,43,32,86,66,22,37,64,29
1085416,51,23,1962,4,male,739,42,36,86,49,76,32,10,17
1250166,21,12,1992,10,male,282,42,25,85,153,85,131,0,22
1852108,54,11,1959,11,female,396,43,33,88,36,30,16,58,20
1348545,15,12,1998,1,male,339,42,8,91,6,91,1,0,5
1024509,20,12,1993,12,male,287,43,33,88,0,88,0,0,0
1250727,33,11,1980,3,female,298,42,14,89,94,89,56,0,38
1407681,45,4,1968,1,male,380,42,27,92,52,19,5,73,47
2142231,33,17,1980,11,female,538,43,16,92,130,92,129,0,1
2042633,50,16,1963,5,female,711,43,34,96,14,40,1,56,13
1385537,49,14,1964,1,female,254,42,27,98,35,96,25,2,10
1336749,39,15,1974,3,female,337,43,8,98,0,98,0,0,0
1511931,36,17,1977,11,female,266,43,20,96,40,96,18,0,22
1193790,53,26,1960,1,female,103,42,39,104,15,104,13,0,2
1305806,36,13,1977,12,female,378,42,16,102,20,102,11,0,9
2112170,53,24,1960,2,female,436,43,42,101,60,101,59,0,1
1176884,30,14,1983,4,female,372,43,26,106,141,63,139,43,2
1620129,18,10,1995,2,female,60,43,37,105,231,35,111,70,120
1772776,22,12,1991,8,male,214,43,38,105,21,105,17,0,4
1104829,25,28,1988,10,male,262,43,26,109,57,109,51,0,6
1589247,33,30,1980,7,male,52,42,18,106,75,106,40,0,35
1402368,44,20,1969,5,female,498,42,13,112,5,83,0,29,5
1579731,23,10,1990,1,male,870,43,29,112,12,112,6,0,6
1515050,28,15,1985,5,female,60,42,19,112,41,112,21,0,20
1716498,37,5,1976,12,female,249,43,31,113,56,113,34,0,22
1311532,42,28,1971,3,male,693,43,22,113,51,113,23,0,28
1838521,61,9,1952,1,female,145,42,28,118,28,0,11,118,17
1426743,66,4,1947,9,female,1107,42,31,118,65,0,20,118,45
1937573,29,19,1984,9,female,518,43,30,115,77,0,5,115,72
1181306,50,5,1963,6,male,677,43,22,119,86,7,30,112,56
1436848,28,12,1985,12,female,1687,43,35,119,121,110,95,9,26
1085856,37,4,1976,5,female,457,43,30,119,151,92,135,27,16
1161070,15,13,1998,7,male,463,42,21,117,17,116,14,1,3
1259778,57,1,1956,9,male,62,42,38,116,13,116,10,0,3
1964344,58,10,1955,5,male,307,43,25,122,36,3,22,119,14
2160135,102,21,1911,9,female,1628,43,36,122,124,84,44,38,80
1783357,19,14,1994,12,male,12,43,35,124,35,102,30,22,5
1303035,32,9,1981,5,male,177,42,25,121,58,113,53,8,5
1771244,48,17,1965,1,NA,1820,43,19,123,9,123,7,0,2
1573395,27,13,1986,3,male,74,42,25,120,37,120,24,0,13
1222706,31,25,1982,12,male,363,42,27,121,36,121,29,0,7
1541340,31,23,1982,9,female,553,43,10,121,219,121,210,0,9
1944564,53,11,1960,8,female,561,43,14,125,6,27,4,98,2
1003446,53,5,1960,3,male,1418,42,19,126,44,95,15,31,29
1015205,25,1,1988,1,female,147,43,32,128,16,128,15,0,1
1916308,31,16,1982,7,male,207,42,33,130,2,130,1,0,1
1678534,60,21,1953,9,female,1851,43,13,132,48,6,19,126,29
1223761,44,28,1969,6,female,223,42,25,132,7,41,6,91,1
1382596,25,4,1988,7,male,40,43,29,134,15,134,14,0,1
2081137,42,24,1971,4,female,538,43,26,134,14,134,12,0,2
1914634,63,23,1950,2,male,126,43,41,132,14,132,11,0,3
1714053,16,26,1997,5,male,925,42,24,131,60,131,51,0,9
2039340,29,24,1984,4,female,391,43,14,131,76,131,70,0,6
1833497,46,22,1967,10,male,145,43,35,143,65,0,11,143,54
1710903,58,25,1955,6,male,733,42,40,139,208,0,61,139,147
2191441,43,6,1970,5,male,265,43,26,138,77,135,46,3,31
1572911,18,21,1995,3,female,537,43,30,140,89,103,68,37,21
1553830,58,12,1955,5,female,822,43,24,141,118,141,73,0,45
1701060,26,20,1987,5,male,151,43,39,150,8,26,6,124,2
2046135,47,25,1966,12,female,509,43,27,149,1,0,0,149,1
1134805,50,8,1963,8,female,193,42,35,149,1,4,0,145,1
1633422,57,7,1956,5,male,314,42,31,148,35,148,8,0,27
1114312,54,12,1959,1,female,250,42,25,157,127,0,20,157,107
1253500,60,28,1953,11,female,1093,42,15,152,41,40,13,112,28
1237867,52,4,1961,1,NA,1806,43,29,152,52,127,35,25,17
1105520,17,10,1996,6,female,672,43,8,152,85,152,82,0,3
1153040,39,9,1974,1,male,68,43,39,153,122,153,122,0,0
1945414,61,23,1952,7,female,1000,42,6,159,93,0,52,159,41
1058607,50,3,1963,10,male,369,42,25,161,21,161,19,0,2
1285773,53,8,1960,3,female,266,43,30,160,0,160,0,0,0
2144486,45,31,1968,8,female,159,43,24,158,53,158,49,0,4
1779293,42,10,1971,1,male,937,42,21,170,188,126,163,44,25
1458099,30,24,1983,7,male,354,42,23,167,1,167,0,0,1
1319808,21,1,1992,5,female,14,42,21,171,83,171,72,0,11
1903378,63,28,1950,5,female,963,42,21,177,17,0,0,177,17
1117323,80,22,1933,1,female,1048,42,32,176,127,158,51,18,76
1902356,25,21,1988,7,male,630,43,32,175,11,175,11,0,0
1332307,57,27,1956,3,female,75,43,30,180,18,180,18,0,0
1773499,50,13,1963,7,female,626,42,25,180,42,180,35,0,7
2135160,54,20,1959,2,male,202,42,18,177,279,177,124,0,155
1893967,78,10,1935,3,male,1388,43,16,186,23,0,20,186,3
1815405,81,24,1932,6,female,1747,43,14,182,17,0,7,182,10
1089582,25,27,1988,6,female,191,42,30,184,78,37,8,147,70
1038151,22,7,1991,8,male,138,42,34,189,5,186,4,3,1
1559540,26,12,1987,2,female,318,43,14,182,71,182,59,0,12
2124562,17,10,1996,6,female,152,43,36,200,108,0,43,200,65
2059941,63,16,1950,4,male,515,42,30,192,112,30,7,162,105
1725933,33,11,1980,6,female,188,43,36,199,39,198,24,1,15
1671443,27,15,1986,8,male,333,43,32,197,2,197,1,0,1
1451027,72,30,1941,12,female,792,42,34,197,28,197,25,0,3
1298705,72,31,1941,12,female,116,43,26,197,49,197,40,0,9
1671166,35,16,1978,11,female,627,43,20,204,66,76,23,128,43
1082832,60,14,1953,7,female,672,43,22,205,101,118,83,87,18
1696889,32,11,1981,3,male,19,43,42,208,42,208,31,0,11
1214144,56,25,1957,12,female,554,43,34,212,46,0,3,212,43
1060219,62,29,1951,8,male,171,43,29,217,281,0,61,217,220
1066845,44,24,1969,3,male,500,43,30,215,115,215,41,0,74
1096009,50,6,1963,10,female,330,42,21,230,64,0,10,230,54
1130696,28,19,1985,1,male,650,43,28,231,48,231,23,0,25
1058989,33,18,1980,7,female,608,42,20,235,123,235,70,0,53
1126639,67,24,1946,1,female,933,42,26,250,7,0,5,250,2
1189523,64,9,1949,8,female,1454,42,15,247,223,228,145,19,78
2064487,38,4,1975,3,male,514,43,35,254,41,254,37,0,4
1755855,42,30,1971,1,male,522,42,26,250,188,250,148,0,40
1038944,63,23,1950,6,male,252,42,35,260,859,260,371,0,488
1020945,19,17,1994,7,female,759,42,20,273,340,0,9,273,331
1587517,29,31,1984,12,male,312,42,29,271,114,174,70,97,44
1020447,55,25,1958,1,female,554,43,38,267,141,241,93,26,48
1250582,21,20,1992,5,male,407,43,29,263,240,263,103,0,137
1529770,77,18,1936,10,female,337,42,18,276,230,276,139,0,91
1073600,86,25,1927,5,female,1517,42,29,282,67,0,14,282,53
2033948,35,7,1978,5,female,538,43,15,277,167,200,60,77,107
1851832,36,20,1977,6,female,701,42,30,288,134,142,95,146,39
1636558,49,10,1964,10,female,362,42,26,290,53,276,37,14,16
1757453,22,31,1991,5,female,438,42,31,290,45,290,41,0,4
1532018,23,19,1990,5,male,127,43,38,281,147,281,135,0,12
1357828,30,16,1983,1,female,234,43,30,280,194,280,124,0,70
2158148,16,22,1997,3,male,310,42,22,293,44,277,18,16,26
1348466,27,15,1986,5,female,481,43,25,308,17,282,17,26,0
1388709,32,31,1981,5,female,160,43,28,295,96,226,9,69,87
1550414,48,30,1965,10,male,199,42,28,300,295,299,230,1,65
1454246,15,12,1998,8,male,23,43,38,307,23,307,21,0,2
1640345,32,26,1981,8,female,369,42,26,293,117,293,104,0,13
1883645,44,29,1969,7,female,373,42,30,325,372,249,114,76,258
1879901,22,24,1991,11,female,351,43,27,333,169,220,108,113,61
2107897,28,27,1985,6,male,933,43,28,331,335,329,273,2,62
2095876,28,23,1985,8,female,685,42,18,336,212,334,121,2,91
1240092,33,20,1980,1,male,35,43,36,337,24,337,17,0,7
1361037,30,24,1983,5,female,275,42,22,329,93,329,76,0,17
1522091,54,24,1959,6,female,268,43,33,337,59,337,41,0,18
2189278,61,6,1952,7,female,743,42,36,378,129,0,100,378,29
1961264,53,17,1960,7,male,176,43,30,379,1,379,1,0,0
1515690,55,22,1958,2,male,127,43,34,382,93,382,74,0,19
1197337,42,21,1971,12,female,87,43,8,379,306,379,293,0,13
2127829,33,25,1980,2,female,455,43,21,411,435,354,157,57,278
2080728,64,8,1949,7,female,1601,42,20,473,146,0,35,473,111
2119942,26,1,1987,1,male,207,43,22,476,45,476,35,0,10
1977605,18,18,1995,5,female,60,42,15,486,526,0,122,486,404
1044385,47,25,1966,12,male,377,42,23,516,96,516,79,0,17
2184318,17,19,1996,8,male,483,43,39,533,43,406,27,127,16
1125462,47,23,1966,10,female,219,43,34,558,48,545,47,13,1
1534575,36,9,1977,7,female,170,43,37,530,292,459,238,71,54
1870952,49,30,1964,3,male,1591,42,27,524,281,504,110,20,171
1572966,26,11,1987,11,female,237,42,32,546,737,487,691,59,46
1593687,51,4,1962,10,female,466,43,30,545,172,540,89,5,83
1250445,25,7,1988,8,male,272,42,36,561,34,561,26,0,8
2085506,29,7,1984,8,female,28,42,17,594,221,474,89,120,132
1733853,58,13,1955,5,female,821,43,8,591,12,588,8,3,4
1667239,18,29,1995,4,female,95,43,36,600,95,600,42,0,53
1279446,55,13,1958,2,male,237,43,43,574,365,574,180,0,185
1994846,18,27,1995,1,female,333,42,14,709,669,509,528,200,141
1588025,26,4,1987,11,female,438,43,32,664,0,664,0,0,0
1549597,52,20,1961,2,female,375,43,34,760,87,408,34,352,53
1253690,25,5,1988,5,female,465,42,31,867,726,337,399,530,327
1557401,57,21,1956,3,female,421,43,21,848,192,651,140,197,52
1429215,46,6,1967,12,male,288,42,32,983,31,983,23,0,8
1301601,58,6,1955,12,female,1603,43,36,1063,349,618,195,445,154
1972580,52,8,1961,3,female,137,42,40,1162,494,18,121,1144,373
2001432,61,23,1952,4,female,586,43,22,1167,439,0,13,1167,426
1885882,69,15,1944,9,female,1429,43,26,1343,63,0,34,1343,29
1349942,18,3,1995,10,female,282,43,22,1524,1284,0,81,1524,1203
1279458,19,23,1994,12,female,300,42,22,1299,164,1299,98,0,66
1955265,43,20,1970,10,female,97,43,31,1334,254,1334,182,0,72
1305026,40,11,1973,5,female,1328,43,19,1858,206,1588,122,270,84
1314164,66,14,1947,12,male,1254,43,20,1730,280,1641,135,89,145
1086966,28,2,1985,10,female,495,42,4,2329,1436,1640,691,689,745
1996699,18,21,1995,12,male,354,42,23,2747,5,28,0,2719,5
1771046,18,6,1995,2,female,370,43,19,3457,521,3457,452,0,69
1270836,23,9,1990,4,male,288,44,40,7,5,7,4,0,1
1569957,30,11,1983,10,female,402,45,21,7,5,7,3,0,2
1102091,21,17,1992,6,female,257,45,17,7,13,7,11,0,2
1426875,40,8,1973,10,male,27,45,37,7,14,7,12,0,2
1542187,45,17,1968,5,female,545,44,32,7,18,7,9,0,9
1955926,64,16,1949,12,female,1704,44,19,7,15,7,8,0,7
1577248,44,25,1969,7,male,339,45,34,8,1,0,0,8,1
2031607,66,6,1947,3,female,1177,45,15,8,1,0,0,8,1
1608821,65,17,1948,3,male,477,44,3,8,36,0,30,8,6
2141031,58,3,1955,4,female,1707,45,28,8,2,2,2,6,0
2143930,23,28,1990,2,female,186,44,30,8,18,5,0,3,18
1519441,56,16,1957,10,male,11,45,40,8,1,7,0,1,1
1677977,14,13,1999,7,male,582,44,38,8,4,6,1,2,3
1079937,65,12,1948,5,female,470,45,17,8,1,8,0,0,1
1164870,16,2,1997,4,male,350,44,35,8,2,8,0,0,2
2054657,30,1,1983,1,male,357,45,42,8,2,8,2,0,0
1112482,63,27,1950,10,male,135,44,31,8,4,8,4,0,0
2151215,73,15,1940,9,female,1165,45,22,8,6,8,4,0,2
1240898,36,3,1977,12,male,392,44,41,9,0,0,0,9,0
1324430,17,12,1996,7,male,412,45,17,9,4,0,2,9,2
1681998,39,22,1974,1,male,224,44,21,9,2,0,0,9,2
1126060,60,5,1953,11,female,544,45,26,9,27,0,9,9,18
1209144,26,28,1987,4,male,470,44,16,9,11,6,9,3,2
1228909,63,20,1950,1,female,250,45,23,9,6,4,6,5,0
1276837,70,10,1943,4,male,1935,45,24,9,88,6,55,3,33
1653357,17,4,1996,11,male,198,45,15,9,1,8,0,1,1
1523657,23,24,1990,4,male,305,45,31,9,0,9,0,0,0
1718233,29,10,1984,2,male,152,45,38,9,1,9,1,0,0
1174843,53,7,1960,3,female,209,44,20,9,0,9,0,0,0
1863783,100,1,1913,12,male,176,45,43,9,0,9,0,0,0
1392875,45,9,1968,7,female,140,45,32,9,4,9,4,0,0
2108256,57,17,1956,11,male,1700,45,29,9,2,9,1,0,1
2116183,93,12,1920,9,female,809,44,20,9,2,9,2,0,0
2022228,17,1,1996,8,male,345,44,20,9,9,9,6,0,3
1536283,18,23,1995,3,female,154,45,22,9,10,9,10,0,0
1056606,40,10,1973,10,male,237,45,16,9,11,9,11,0,0
1014845,52,23,1961,10,female,549,44,17,9,7,9,5,0,2
2187211,65,12,1948,2,male,275,44,17,9,57,9,16,0,41
2057576,68,25,1945,11,female,1023,44,11,9,26,9,9,0,17
1744370,55,10,1958,5,male,1123,45,26,10,1,0,0,10,1
1992721,63,22,1950,6,female,1432,45,14,10,1,0,0,10,1
1890422,74,24,1939,9,male,729,45,33,10,0,0,0,10,0
2176880,37,3,1976,11,male,501,44,30,10,3,0,1,10,2
1969545,61,15,1952,10,male,1826,44,15,10,7,1,6,9,1
2179984,63,2,1950,6,female,312,45,25,10,18,0,8,10,10
1879025,23,16,1990,3,male,606,44,33,10,0,10,0,0,0
1669260,23,30,1990,4,male,352,44,33,10,0,10,0,0,0
1231855,17,2,1996,11,female,384,44,24,10,3,10,2,0,1
2041253,46,24,1967,9,female,57,45,36,10,5,10,3,0,2
2027342,57,8,1956,5,female,140,44,30,10,7,10,6,0,1
1631905,24,11,1989,10,male,243,44,22,10,16,10,13,0,3
1465102,33,20,1980,8,male,178,45,32,10,33,10,28,0,5
1867062,45,15,1968,3,male,72,45,33,10,18,10,6,0,12
1338658,68,3,1945,12,female,1550,45,15,10,32,10,29,0,3
2028168,19,19,1994,7,male,503,45,21,11,1,0,0,11,1
1764837,41,28,1972,3,male,313,44,34,11,0,2,0,9,0
1475982,62,7,1951,7,male,465,45,26,11,10,0,5,11,5
1288995,70,7,1943,11,female,214,44,37,11,13,1,12,10,1
1844580,51,30,1962,1,female,550,45,17,11,24,5,11,6,13
1865505,31,2,1982,2,male,139,45,35,11,1,11,1,0,0
1254415,33,1,1980,11,male,208,45,39,11,0,11,0,0,0
1755229,108,25,1905,2,female,90,45,37,11,4,11,3,0,1
1801548,19,14,1994,8,female,88,45,33,11,8,11,6,0,2
1229433,33,6,1980,11,male,244,44,27,11,7,11,3,0,4
1380712,49,24,1964,10,female,423,45,31,11,26,11,16,0,10
1584312,25,28,1988,4,male,185,44,40,12,3,0,1,12,2
1840572,50,6,1963,3,female,929,44,29,12,4,0,4,12,0
2145627,18,1,1995,11,male,9,44,31,12,29,7,19,5,10
1309606,28,17,1985,2,male,261,45,33,12,2,11,1,1,1
1119644,64,22,1949,11,male,467,45,37,12,5,9,5,3,0
1956595,19,18,1994,8,male,855,44,32,12,1,12,0,0,1
1606517,25,27,1988,11,male,103,45,33,12,0,12,0,0,0
1248235,46,2,1967,9,male,455,44,26,12,0,12,0,0,0
1353186,18,22,1995,10,male,210,44,12,12,2,12,1,0,1
2142529,51,6,1962,1,male,1256,45,13,12,6,12,3,0,3
1639797,28,10,1985,6,female,348,45,34,12,22,12,12,0,10
1940245,53,8,1960,7,male,544,45,28,12,45,12,21,0,24
1274362,61,21,1952,5,male,688,44,23,12,61,12,34,0,27
2124869,19,2,1994,3,male,199,44,25,13,6,0,1,13,5
1100316,53,22,1960,11,male,471,44,38,13,7,1,2,12,5
1253023,76,26,1937,11,female,1268,44,25,13,5,0,4,13,1
1414943,20,12,1993,12,male,182,45,15,13,8,0,0,13,8
1369275,61,21,1952,9,female,906,44,30,13,15,0,10,13,5
1743839,108,15,1905,12,male,88,45,28,13,20,2,9,11,11
1091713,31,23,1982,3,female,360,44,42,13,4,7,4,6,0
1563175,14,10,1999,5,male,250,44,34,13,78,3,7,10,71
2039556,50,2,1963,9,male,393,45,33,13,0,11,0,2,0
1086254,52,9,1961,3,male,560,45,13,13,3,13,2,0,1
2178059,26,6,1987,6,female,334,45,22,13,18,13,16,0,2
1663483,33,24,1980,1,male,32,44,40,13,16,13,15,0,1
2046121,63,25,1950,8,female,1759,44,15,13,38,13,19,0,19
1834428,30,26,1983,5,male,593,45,25,14,5,0,0,14,5
1458250,37,14,1976,7,female,299,44,22,14,6,0,1,14,5
1332792,13,21,2000,6,male,60,44,36,14,12,0,1,14,11
1185526,113,18,1900,10,male,2370,45,20,14,28,1,20,13,8
1829275,23,11,1990,11,female,363,45,23,14,16,7,11,7,5
1233529,72,1,1941,4,female,1426,44,14,14,28,11,22,3,6
1591719,36,21,1977,10,male,958,45,24,14,2,14,2,0,0
1654185,43,13,1970,3,male,66,44,33,14,2,14,0,0,2
1000881,14,31,1999,10,male,163,44,23,14,3,14,1,0,2
1777451,68,27,1945,1,male,1218,45,25,14,6,14,6,0,0
2063696,22,15,1991,5,female,116,44,17,14,16,14,13,0,3
1157760,24,23,1989,3,male,389,45,17,14,71,14,67,0,4
1659046,30,25,1983,4,male,131,44,23,14,21,14,11,0,10
2111585,44,15,1969,1,male,129,45,14,14,62,14,28,0,34
1914905,44,23,1969,4,male,62,45,37,14,26,14,8,0,18
1180682,15,25,1998,7,male,133,44,37,15,2,5,2,10,0
1799990,58,6,1955,9,male,780,44,28,15,17,9,10,6,7
1359107,46,14,1967,11,female,276,45,42,15,2,15,2,0,0
1753432,99,14,1914,2,male,217,45,35,15,1,15,1,0,0
1897246,38,15,1975,6,female,76,44,37,15,59,15,49,0,10
1519478,53,3,1960,4,male,149,44,35,16,2,3,2,13,0
1181083,61,3,1952,4,male,174,44,42,16,3,0,1,16,2
1606885,18,1,1995,1,male,141,44,42,16,26,0,13,16,13
1410646,57,29,1956,4,male,440,45,12,16,18,6,13,10,5
1128432,26,3,1987,1,male,260,44,22,16,2,16,1,0,1
1724864,31,26,1982,1,male,291,45,38,16,1,16,0,0,1
1936177,74,7,1939,3,female,147,45,33,16,0,16,0,0,0
1953217,17,20,1996,9,female,294,44,18,16,5,16,3,0,2
1689207,25,26,1988,10,male,297,44,33,16,7,16,1,0,6
1053443,35,14,1978,12,female,53,45,26,16,9,16,9,0,0
1277969,31,4,1982,8,male,64,45,36,16,114,16,91,0,23
1088205,18,1,1995,2,male,605,45,38,17,0,0,0,17,0
1403025,45,21,1968,10,male,1362,44,9,17,10,12,4,5,6
1260088,19,1,1994,1,male,452,45,21,17,12,16,9,1,3
1597429,56,2,1957,6,male,1935,45,14,17,25,16,16,1,9
1381436,20,19,1993,1,male,34,44,27,17,0,17,0,0,0
2168730,22,30,1991,11,male,380,45,18,17,0,17,0,0,0
1219060,52,12,1961,9,male,166,45,15,17,6,17,4,0,2
1985475,56,4,1957,11,female,377,45,19,17,3,17,2,0,1
1277020,61,4,1952,11,male,112,44,30,17,4,17,4,0,0
1001827,65,3,1948,2,female,281,45,32,17,4,17,4,0,0
1468408,24,2,1989,1,female,135,44,36,17,61,17,29,0,32
2045638,27,3,1986,8,female,113,44,33,17,115,17,104,0,11
1116757,53,5,1960,3,male,308,44,40,18,2,0,0,18,2
1475618,56,12,1957,2,male,1498,44,30,18,2,12,2,6,0
2112014,45,28,1968,6,male,626,44,22,18,12,10,9,8,3
1287784,57,31,1956,10,female,1200,45,31,18,21,15,13,3,8
1791027,30,20,1983,9,male,244,44,18,18,27,18,22,0,5
1614290,69,19,1944,12,female,1396,45,25,19,0,0,0,19,0
1201532,28,10,1985,2,male,276,44,30,19,5,0,1,19,4
1019176,43,17,1970,6,female,121,44,30,19,20,0,4,19,16
1496167,30,31,1983,8,female,554,45,14,19,11,13,5,6,6
1727243,25,6,1988,2,male,652,44,29,19,0,15,0,4,0
1919376,20,28,1993,1,female,229,45,36,19,74,17,27,2,47
1394810,18,23,1995,3,male,408,44,23,19,2,19,2,0,0
1437070,27,2,1986,12,female,638,45,19,19,11,19,1,0,10
1757244,26,27,1987,7,male,328,45,36,19,12,19,10,0,2
1126294,29,22,1984,6,male,257,44,19,19,12,19,8,0,4
1227920,50,18,1963,10,female,159,44,36,19,38,19,30,0,8
1384502,73,16,1940,12,male,1147,45,34,20,3,0,1,20,2
1700773,76,22,1937,7,male,595,45,35,20,3,0,1,20,2
1865289,22,24,1991,2,male,400,45,39,20,10,1,0,19,10
1965013,24,3,1989,3,female,544,45,32,20,11,0,1,20,10
1191086,50,27,1963,12,female,530,45,26,20,63,1,34,19,29
2030819,61,22,1952,5,female,1755,44,23,20,37,0,21,20,16
1636310,14,19,1999,7,male,138,45,25,20,1,20,1,0,0
2136732,25,1,1988,1,male,233,45,31,20,1,20,1,0,0
1856010,25,4,1988,4,male,127,45,25,20,0,20,0,0,0
1335352,32,2,1981,4,male,317,45,42,20,2,20,2,0,0
1386050,30,6,1983,9,male,283,45,39,20,30,20,18,0,12
1800239,50,17,1963,12,male,247,45,21,21,5,0,0,21,5
1698841,73,3,1940,4,male,1734,44,18,21,7,0,4,21,3
1389589,103,21,1910,3,male,801,44,14,21,0,16,0,5,0
1506620,51,17,1962,3,male,243,45,36,21,8,21,5,0,3
1780511,44,10,1969,10,female,238,44,21,21,30,21,28,0,2
1534551,51,27,1962,10,female,251,45,22,21,79,21,69,0,10
1765598,21,14,1992,5,male,997,45,38,22,2,4,2,18,0
1161179,25,20,1988,3,male,355,44,31,22,12,0,5,22,7
2179084,28,5,1985,2,male,148,45,44,22,1,22,1,0,0
1941829,35,12,1978,9,male,294,45,33,22,3,22,3,0,0
1548221,103,27,1910,7,female,347,44,33,22,14,22,13,0,1
1526074,54,14,1959,11,female,758,45,33,22,42,22,27,0,15
1796941,60,7,1953,5,female,294,45,26,23,7,0,4,23,3
1607061,29,4,1984,5,male,50,45,41,23,79,20,35,3,44
2090439,34,26,1979,4,male,921,45,26,23,70,22,56,1,14
1107877,98,24,1915,4,male,380,45,38,23,0,23,0,0,0
2137700,28,1,1985,3,female,461,45,9,23,18,23,18,0,0
1703789,66,5,1947,11,female,289,44,13,24,11,0,8,24,3
2159392,33,11,1980,10,female,564,45,32,24,23,11,17,13,6
1755033,23,14,1990,11,male,232,45,25,24,2,24,2,0,0
1892779,35,9,1978,1,male,462,45,41,24,2,24,2,0,0
1615608,22,20,1991,11,male,325,45,18,24,43,24,28,0,15
1876196,25,6,1988,5,female,341,45,29,24,51,24,45,0,6
1266141,44,30,1969,3,male,120,45,31,24,75,24,64,0,11
1016402,52,15,1961,12,female,1273,45,34,25,4,0,3,25,1
1136472,21,15,1992,10,male,334,45,23,25,8,0,3,25,5
1008303,57,25,1956,10,female,1006,44,29,25,18,0,9,25,9
1903674,40,5,1973,6,female,611,45,11,25,8,23,3,2,5
1268840,38,10,1975,2,male,761,44,38,25,4,25,4,0,0
1169397,22,25,1991,2,male,395,44,32,25,6,25,5,0,1
1482562,103,23,1910,7,male,422,45,34,25,7,25,5,0,2
1091623,43,27,1970,11,female,102,45,29,25,21,25,17,0,4
1928969,26,15,1987,10,female,149,45,14,25,52,25,24,0,28
1769882,17,8,1996,3,female,495,45,33,26,0,0,0,26,0
1938797,57,21,1956,2,male,686,45,30,26,12,0,2,26,10
1727398,18,19,1995,12,male,9,44,39,26,15,26,10,0,5
1967580,42,1,1971,1,male,13,44,36,26,5,26,4,0,1
1352399,28,16,1985,3,female,191,45,24,26,51,26,4,0,47
1270371,33,24,1980,1,female,238,44,22,27,5,0,3,27,2
1081133,41,16,1972,8,male,387,44,10,27,3,6,3,21,0
1411963,24,17,1989,11,male,280,44,31,27,7,14,6,13,1
2042846,59,11,1954,11,female,2259,44,18,28,31,2,16,26,15
1676951,29,24,1984,5,female,664,44,26,28,53,25,30,3,23
2116972,18,6,1995,5,male,48,44,39,28,3,28,0,0,3
1379025,50,18,1963,11,female,317,45,33,28,4,28,3,0,1
1528952,18,15,1995,6,male,43,45,37,28,5,28,1,0,4
1313254,23,2,1990,2,female,58,45,38,28,6,28,0,0,6
1498302,38,16,1975,8,male,435,45,35,28,23,28,1,0,22
1089760,53,24,1960,7,female,142,44,32,29,68,18,49,11,19
1753938,38,29,1975,7,male,582,44,13,29,2,29,2,0,0
1231000,62,25,1951,1,female,1189,44,30,29,2,29,2,0,0
1013775,55,1,1958,3,male,1362,45,30,29,6,29,5,0,1
1722608,42,17,1971,3,female,395,45,23,31,3,0,2,31,1
1373334,54,6,1959,8,male,52,44,42,30,1,0,0,30,1
1925792,13,6,2000,1,male,233,45,25,30,2,17,1,13,1
1670133,21,23,1992,6,male,73,45,41,31,0,28,0,3,0
1918692,108,25,1905,1,female,2055,44,23,30,28,29,27,1,1
1071853,51,21,1962,3,female,1156,45,23,30,3,30,2,0,1
1848471,37,18,1976,8,male,546,45,32,30,8,30,7,0,1
1037520,23,14,1990,11,female,121,44,34,32,30,21,7,11,23
1160108,62,6,1951,1,female,663,44,31,32,5,29,5,3,0
1140849,23,9,1990,4,male,160,45,38,32,1,32,1,0,0
1539941,24,12,1989,9,male,119,45,39,32,1,32,1,0,0
1635166,18,3,1995,12,male,55,45,37,32,30,32,25,0,5
1835794,14,4,1999,5,female,271,45,31,33,17,0,12,33,5
1338949,53,1,1960,9,male,29,45,28,33,10,33,9,0,1
1003680,29,1,1984,1,male,406,44,32,34,1,0,1,34,0
2160580,76,3,1937,9,female,708,45,17,34,1,0,1,34,0
2090467,39,24,1974,8,female,420,44,21,34,13,0,6,34,7
1167102,69,11,1944,5,female,218,45,18,34,63,0,50,34,13
1799897,70,5,1943,4,male,217,44,27,34,51,0,14,34,37
1920402,58,15,1955,8,female,910,45,19,34,13,20,5,14,8
1983124,61,12,1952,3,female,1434,45,15,34,16,32,13,2,3
1351415,27,15,1986,1,male,141,44,23,34,102,34,38,0,64
1992259,35,4,1978,11,female,284,44,34,35,1,0,0,35,1
1676273,55,22,1958,3,male,1764,45,41,35,3,0,1,35,2
2160351,58,6,1955,1,male,279,45,27,35,1,0,0,35,1
2073320,19,30,1994,6,male,378,45,32,35,14,0,6,35,8
2021508,52,8,1961,4,female,297,45,33,35,17,0,12,35,5
1316568,97,24,1916,12,female,892,44,13,36,15,0,1,36,14
2009428,34,5,1979,7,male,103,44,34,36,13,36,13,0,0
1348336,31,19,1982,10,female,297,44,34,36,53,36,50,0,3
1589650,49,8,1964,10,female,583,45,22,37,41,0,12,37,29
1203695,46,12,1967,9,female,299,44,25,37,73,37,9,0,64
1551969,25,6,1988,10,male,310,44,41,39,6,0,3,39,3
1029751,80,3,1933,3,female,154,45,34,38,6,0,0,38,6
1816175,40,2,1973,4,female,302,45,40,39,18,0,16,39,2
1411246,82,24,1931,2,male,576,45,26,38,7,0,6,38,1
1284674,41,2,1972,2,male,647,45,20,38,37,10,23,28,14
1171372,16,7,1997,2,male,182,45,37,38,8,36,5,2,3
1700510,55,8,1958,1,female,163,44,33,39,13,39,7,0,6
1788013,61,2,1952,6,female,2145,45,23,39,21,39,10,0,11
1991646,17,8,1996,2,female,47,44,4,38,26,38,11,0,15
1854550,35,28,1978,10,female,574,45,16,38,71,38,51,0,20
1003658,15,19,1998,10,male,80,45,34,40,6,0,2,40,4
1315836,17,17,1996,10,male,230,44,37,40,0,0,0,40,0
1388857,18,1,1995,1,male,240,45,25,40,2,0,1,40,1
1352247,63,11,1950,7,male,1111,45,21,40,88,22,49,18,39
1494514,49,10,1964,11,female,392,45,43,40,35,35,29,5,6
1030709,19,5,1994,8,male,216,45,32,40,13,40,13,0,0
1303722,23,29,1990,1,male,175,45,35,41,1,41,1,0,0
1100950,26,29,1987,7,male,223,45,21,41,2,41,1,0,1
2094475,29,2,1984,10,male,487,44,36,42,21,42,17,0,4
1668024,61,3,1952,8,female,610,45,31,42,15,42,13,0,2
1548635,30,13,1983,10,male,261,45,23,41,29,41,23,0,6
1879215,48,30,1965,8,female,575,44,20,41,27,41,8,0,19
1760966,27,1,1986,4,male,584,44,15,43,7,43,7,0,0
1769516,29,26,1984,3,male,374,44,37,44,2,44,2,0,0
1139404,51,20,1962,7,female,68,44,43,44,4,44,4,0,0
1272207,73,27,1940,5,female,1518,45,28,43,0,43,0,0,0
1004437,20,2,1993,6,male,79,45,26,44,26,44,18,0,8
1236209,42,27,1971,10,male,150,44,40,44,14,44,14,0,0
1518245,34,17,1979,1,female,614,44,20,43,71,43,18,0,53
2007646,19,8,1994,1,female,303,45,29,45,12,21,6,24,6
1481139,16,27,1997,11,female,571,44,26,45,167,19,34,26,133
1201812,77,27,1936,9,male,1582,45,25,45,1,44,1,1,0
1114451,20,10,1993,12,male,507,44,23,45,44,39,38,6,6
1608462,51,1,1962,10,male,794,45,16,45,2,45,1,0,1
1978050,44,31,1969,1,male,610,44,10,46,0,46,0,0,0
1516605,30,14,1983,12,female,217,44,13,47,9,47,8,0,1
1166332,44,3,1969,10,male,98,45,37,48,10,0,3,48,7
1948776,63,11,1950,11,female,547,45,15,48,12,3,6,45,6
2170973,24,4,1989,3,female,90,44,36,48,77,19,14,29,63
1505563,51,12,1962,11,female,646,45,18,48,131,34,59,14,72
1260068,15,14,1998,8,male,310,44,30,49,20,45,15,4,5
2097564,17,27,1996,9,male,459,44,29,49,40,46,30,3,10
1560060,23,21,1990,9,male,19,44,39,49,0,49,0,0,0
1861986,28,21,1985,9,male,153,44,24,48,21,48,16,0,5
1990228,34,18,1979,10,male,423,44,10,49,14,49,11,0,3
1165506,38,11,1975,7,female,594,44,33,48,21,48,12,0,9
2083050,22,28,1991,3,female,588,44,22,49,38,49,37,0,1
1393311,18,16,1995,11,female,347,44,24,51,0,51,0,0,0
1813182,49,23,1964,6,female,192,45,19,50,30,50,5,0,25
1330341,21,3,1992,5,female,93,45,41,53,25,10,4,43,21
1034829,61,1,1952,12,male,1183,45,25,52,72,0,13,52,59
1895992,15,7,1998,6,male,206,44,33,53,13,46,7,7,6
1648340,15,4,1998,8,male,348,45,4,52,10,49,6,3,4
1099409,47,11,1966,9,female,146,45,33,52,14,41,7,11,7
1960143,59,25,1954,7,female,1619,44,20,52,13,50,10,2,3
1173874,47,28,1966,1,female,1408,44,23,52,34,50,19,2,15
1609688,20,18,1993,4,male,27,44,43,52,0,52,0,0,0
1060268,46,1,1967,1,female,262,44,17,53,14,53,12,0,2
1227440,48,10,1965,4,female,41,45,30,52,22,52,13,0,9
1203894,46,10,1967,6,male,884,45,14,55,138,47,130,8,8
1511534,26,31,1987,12,female,350,44,26,54,27,54,9,0,18
1839349,21,3,1992,3,female,243,45,31,54,33,54,26,0,7
1561987,47,12,1966,4,female,736,44,23,55,54,55,46,0,8
1549537,67,12,1946,9,female,1616,44,23,56,47,22,31,34,16
1817676,57,24,1956,11,male,137,45,27,56,219,25,110,31,109
1293411,28,7,1985,7,female,1181,45,18,56,5,53,3,3,2
1595913,32,29,1981,3,female,398,44,36,56,0,54,0,2,0
1209410,22,27,1991,12,female,206,44,26,58,61,55,46,3,15
1230945,52,14,1961,7,male,107,45,33,58,7,58,3,0,4
1992085,58,3,1955,6,female,1493,45,31,57,4,57,2,0,2
1491761,28,19,1985,6,male,134,44,38,56,29,56,17,0,12
1577554,54,7,1959,11,female,1359,44,22,57,19,57,17,0,2
2080909,23,2,1990,7,female,400,45,30,59,34,0,19,59,15
1671640,52,13,1961,1,male,607,45,31,60,68,1,39,59,29
1621974,68,18,1945,8,female,1525,45,33,59,91,7,30,52,61
1593404,21,20,1992,7,female,905,44,21,59,39,37,6,22,33
1508705,22,13,1991,8,male,104,44,42,59,33,48,13,11,20
1163579,26,3,1987,1,female,356,45,25,59,54,59,10,0,44
1547911,34,26,1979,7,female,314,45,22,60,76,60,72,0,4
1439022,41,16,1972,1,male,216,45,28,61,14,34,11,27,3
1603729,53,12,1960,9,female,485,44,17,61,0,61,0,0,0
1090570,47,20,1966,1,female,569,45,33,61,36,61,28,0,8
1075646,50,27,1963,6,male,98,44,39,63,15,63,14,0,1
1960958,31,7,1982,7,female,128,45,36,63,255,63,239,0,16
1852609,19,7,1994,3,male,99,45,36,64,16,6,3,58,13
1227669,58,12,1955,9,female,476,45,26,64,333,0,123,64,210
1338007,70,30,1943,11,female,1460,44,14,65,32,64,19,1,13
1271736,63,19,1950,9,female,185,44,31,67,6,0,3,67,3
1556304,58,7,1955,5,female,1325,44,15,67,37,0,4,67,33
1725878,108,1,1905,1,male,110,45,33,67,22,0,5,67,17
1324327,61,3,1952,7,female,302,45,33,68,56,42,40,26,16
2000906,44,28,1969,1,female,600,44,14,66,34,66,11,0,23
1584541,108,31,1905,7,female,1157,45,26,71,12,0,0,71,12
1204631,33,8,1980,11,male,416,44,38,71,7,71,7,0,0
1977714,23,2,1990,12,male,42,44,22,69,25,69,18,0,7
2104233,24,24,1989,3,female,300,44,14,69,21,69,21,0,0
1454583,34,8,1979,2,male,67,44,22,69,98,69,84,0,14
2042946,34,17,1979,10,male,21,45,42,70,52,70,46,0,6
1173721,64,26,1949,10,female,2173,45,34,74,24,11,15,63,9
2140876,14,12,1999,6,female,107,45,19,74,5,74,5,0,0
1511603,36,1,1977,9,female,487,45,27,74,22,74,20,0,2
1878366,20,27,1993,2,female,480,45,33,75,5,75,4,0,1
1345433,44,12,1969,10,male,620,44,32,77,1,77,0,0,1
1502907,94,30,1919,3,male,286,44,21,75,8,75,7,0,1
2179598,29,28,1984,8,female,409,45,38,77,26,77,21,0,5
1876578,62,24,1951,3,male,619,45,25,77,14,77,9,0,5
1896669,37,11,1976,5,female,690,44,17,76,60,76,37,0,23
1595713,54,5,1959,5,male,612,45,31,76,48,76,17,0,31
1609064,54,23,1959,9,female,419,45,27,80,1,80,1,0,0
1688546,65,28,1948,8,female,1242,44,21,79,12,79,5,0,7
1226471,49,13,1964,9,female,953,45,27,78,39,78,32,0,7
1311104,45,29,1968,11,male,446,45,38,83,46,80,18,3,28
1329309,34,5,1979,6,female,437,44,18,84,45,84,34,0,11
1303767,59,16,1954,10,male,406,44,39,81,39,81,33,0,6
1795699,47,27,1966,8,female,364,45,21,84,63,84,54,0,9
1348117,51,23,1962,6,female,149,44,29,86,18,0,5,86,13
1109683,65,1,1948,12,female,1782,44,25,86,16,57,16,29,0
1928161,24,28,1989,8,male,574,45,37,87,120,31,55,56,65
1350651,46,19,1967,10,female,12,44,13,85,68,80,21,5,47
1626956,48,3,1965,7,male,612,44,26,86,80,71,56,15,24
2177862,54,3,1959,12,male,378,44,22,85,3,85,0,0,3
1371788,25,1,1988,1,male,286,45,33,85,41,85,24,0,17
1197364,66,16,1947,1,male,504,45,31,89,24,0,6,89,18
1257333,50,9,1963,12,female,726,44,29,89,29,52,21,37,8
1922795,67,15,1946,8,female,1757,44,17,89,5,89,4,0,1
2160582,42,22,1971,5,male,382,45,39,91,18,91,18,0,0
1140407,61,4,1952,1,female,195,45,23,90,81,90,67,0,14
2008580,51,30,1962,6,female,355,45,29,94,36,94,32,0,4
1339630,31,24,1982,2,male,232,45,22,97,0,0,0,97,0
2173205,52,7,1961,10,female,619,44,30,99,173,1,73,98,100
1541336,30,4,1983,5,male,292,45,1,99,28,98,24,1,4
1397389,59,23,1954,9,female,370,45,22,98,25,98,11,0,14
2152858,23,25,1990,10,female,142,45,22,99,65,99,53,0,12
1192438,45,19,1968,2,female,285,45,21,104,31,4,4,100,27
1306320,24,14,1989,8,female,520,44,30,101,152,2,21,99,131
2008229,22,8,1991,7,male,717,44,14,101,50,101,27,0,23
1628141,14,2,1999,10,female,285,45,21,106,14,48,3,58,11
1841349,25,16,1988,9,male,132,44,43,108,4,108,4,0,0
1894046,46,18,1967,5,female,186,45,22,108,11,108,5,0,6
1210266,23,6,1990,3,male,12,44,39,107,25,107,17,0,8
1899023,58,4,1955,4,female,201,44,12,106,26,106,21,0,5
1212595,53,23,1960,4,male,176,44,19,105,79,105,26,0,53
1804583,48,25,1965,1,male,441,45,28,119,3,0,1,119,2
2107914,59,16,1954,3,female,361,45,36,114,0,0,0,114,0
1110083,84,26,1929,10,female,934,44,34,117,24,0,21,117,3
1310015,28,28,1985,12,female,356,45,24,115,85,9,15,106,70
1330527,55,24,1958,9,female,392,45,26,116,138,0,79,116,59
1642168,61,10,1952,12,male,2169,44,17,114,130,52,103,62,27
2190343,18,1,1995,3,male,25,44,13,118,1,106,1,12,0
1047322,25,18,1988,8,male,194,45,43,117,16,112,8,5,8
1881694,24,25,1989,1,male,320,44,40,115,72,87,53,28,19
1656819,25,7,1988,8,male,178,45,44,118,47,118,33,0,14
1094558,38,27,1975,1,male,213,44,36,116,29,116,12,0,17
1376679,41,1,1972,1,male,272,45,34,114,19,114,19,0,0
1773393,39,26,1974,3,female,182,44,18,118,138,118,129,0,9
1482503,20,7,1993,3,female,255,44,42,123,0,123,0,0,0
1979299,40,26,1973,4,male,94,44,29,123,20,123,20,0,0
1684045,47,3,1966,3,female,61,44,37,124,77,124,73,0,4
1888224,49,26,1964,9,female,622,44,8,128,28,0,16,128,12
1457875,90,20,1923,12,female,415,45,31,129,92,50,30,79,62
1266486,48,29,1965,5,female,1073,45,24,127,21,127,16,0,5
1362935,15,20,1998,10,male,337,45,26,127,34,127,26,0,8
1052107,38,5,1975,3,female,50,44,40,129,40,129,39,0,1
1596686,65,9,1948,10,female,1576,44,14,131,28,6,6,125,22
2093970,71,12,1942,6,male,619,44,19,134,64,0,13,134,51
1846173,32,12,1981,5,male,173,44,41,131,1,131,0,0,1
2021466,31,7,1982,5,female,278,45,32,143,37,85,24,58,13
1364873,30,25,1983,7,male,81,44,41,137,12,137,7,0,5
1746717,65,10,1948,11,female,635,44,28,145,36,0,18,145,18
1127563,68,14,1945,9,female,1172,44,28,146,130,0,22,146,108
1006273,33,7,1980,2,male,325,45,38,147,6,147,4,0,2
1497754,46,27,1967,5,male,1111,45,21,153,15,153,8,0,7
2150563,31,27,1982,9,male,28,44,40,155,94,155,84,0,10
1878964,50,13,1963,5,female,1589,45,12,153,153,153,97,0,56
1205533,15,7,1998,3,male,774,44,15,158,4,158,4,0,0
2172895,40,17,1973,12,female,398,45,25,166,134,40,42,126,92
1293370,100,8,1913,10,female,32,44,37,169,228,139,155,30,73
1623674,36,18,1977,7,female,870,44,26,170,28,170,11,0,17
1855335,63,30,1950,5,female,1469,44,18,165,17,165,15,0,2
1826729,48,13,1965,8,female,359,45,35,176,35,0,2,176,33
1665931,48,18,1965,3,male,1265,44,37,178,23,93,15,85,8
1747011,36,11,1977,7,male,136,44,28,173,100,58,82,115,18
1112169,49,16,1964,10,female,223,44,21,175,93,125,66,50,27
1078046,20,15,1993,8,male,131,45,21,175,85,175,77,0,8
1304234,43,11,1970,9,male,142,44,28,174,55,174,49,0,6
1906141,45,26,1968,8,male,363,44,22,178,291,178,237,0,54
1018444,54,16,1959,7,male,1007,44,18,180,318,180,181,0,137
1798045,47,16,1966,6,female,219,44,30,188,102,0,52,188,50
1166305,21,26,1992,11,female,149,44,32,190,97,187,71,3,26
1758790,18,3,1995,11,female,13,45,41,187,259,180,103,7,156
1260856,63,3,1950,3,female,1265,44,33,188,24,188,15,0,9
1165782,66,13,1947,9,female,1267,44,23,182,20,182,15,0,5
1271000,25,4,1988,10,female,45,44,28,190,200,190,174,0,26
1108532,43,31,1970,7,male,327,44,16,186,212,186,191,0,21
1285502,34,24,1979,9,female,284,45,20,194,210,5,25,189,185
1898199,19,25,1994,5,male,223,44,26,194,23,193,16,1,7
1708764,40,11,1973,7,female,340,45,21,203,4,17,3,186,1
2034111,41,3,1972,11,female,45,45,23,214,287,16,211,198,76
1174904,24,13,1989,11,female,279,44,27,212,18,212,16,0,2
2006617,33,15,1980,11,female,259,44,27,217,67,217,47,0,20
1838457,49,13,1964,3,female,1561,44,27,214,79,214,34,0,45
2050803,29,22,1984,5,male,583,44,35,232,17,2,5,230,12
1203460,32,17,1981,10,female,260,45,21,229,39,226,36,3,3
2020004,54,20,1959,8,female,137,44,41,243,40,0,22,243,18
1989290,39,22,1974,3,female,164,45,39,245,235,242,48,3,187
1361829,27,25,1986,5,female,657,45,29,240,16,240,6,0,10
2188798,54,22,1959,2,female,156,44,28,240,39,240,30,0,9
1930395,15,22,1998,7,male,291,45,30,241,127,241,65,0,62
1524104,28,4,1985,7,female,67,45,34,245,111,245,89,0,22
1452239,42,6,1971,1,female,40,45,44,242,302,242,219,0,83
1586899,71,29,1942,11,male,988,45,15,253,40,0,23,253,17
1379366,39,5,1974,4,female,382,45,28,250,131,63,118,187,13
1480243,26,8,1987,4,male,142,45,38,251,384,246,284,5,100
1229250,27,30,1986,1,male,212,45,29,253,97,253,77,0,20
1457395,46,16,1967,9,female,141,45,26,253,90,253,59,0,31
2052706,69,23,1944,2,female,1605,44,19,269,82,0,22,269,60
1567262,19,8,1994,7,female,316,44,19,268,180,0,23,268,157
1548995,48,21,1965,11,female,769,45,10,277,15,5,8,272,7
2121874,30,6,1983,11,male,458,44,14,277,360,58,129,219,231
1975775,50,2,1963,1,female,469,44,27,286,68,286,64,0,4
1141528,62,8,1951,12,female,350,44,37,284,76,284,62,0,14
1291204,21,13,1992,8,male,384,44,30,303,123,0,79,303,44
1861760,23,27,1990,12,male,107,45,22,296,176,291,93,5,83
1611636,27,1,1986,4,female,1191,45,34,294,63,293,23,1,40
2087286,25,15,1988,2,female,576,44,27,296,113,296,107,0,6
1375796,57,19,1956,2,female,2150,44,13,337,99,319,65,18,34
1017519,58,15,1955,4,male,663,45,31,339,100,294,78,45,22
1645519,53,30,1960,12,female,672,44,34,330,98,330,52,0,46
1206087,48,2,1965,4,female,1820,45,22,348,133,338,69,10,64
1186752,39,9,1974,3,female,371,45,29,367,324,367,297,0,27
1574051,67,6,1946,7,male,668,45,18,370,31,0,18,370,13
1138856,16,23,1997,6,female,170,44,13,383,78,29,28,354,50
1392034,63,2,1950,10,female,117,45,28,379,90,0,44,379,46
2166771,63,2,1950,4,female,1565,45,20,400,321,400,133,0,188
2103044,25,18,1988,8,male,515,44,25,435,13,0,0,435,13
1556769,66,29,1947,1,female,443,44,36,427,9,427,6,0,3
1239105,27,27,1986,3,female,36,44,21,450,78,450,26,0,52
1618402,27,20,1986,8,female,224,45,30,481,45,0,20,481,25
2048944,45,30,1968,1,female,532,45,29,455,89,43,59,412,30
1643705,63,1,1950,1,male,990,45,11,459,264,0,40,459,224
1031176,25,1,1988,1,male,118,44,11,469,248,459,142,10,106
2091242,69,24,1944,12,female,496,44,16,460,6,459,2,1,4
1794656,28,1,1985,12,male,307,45,37,481,0,481,0,0,0
1487156,58,18,1955,9,female,642,45,32,464,105,464,98,0,7
1318807,63,15,1950,2,female,127,44,22,481,94,481,72,0,22
1311581,93,13,1920,11,female,126,45,29,454,106,454,73,0,33
2190789,96,1,1917,1,male,969,45,35,504,153,9,104,495,49
1784576,67,12,1946,11,female,1025,45,22,547,59,0,9,547,50
1405640,37,24,1976,8,female,524,45,21,529,86,529,77,0,9
1406339,37,17,1976,1,female,252,45,35,605,162,605,107,0,55
1277365,78,20,1935,11,male,1044,45,9,625,156,6,8,619,148
1820240,18,9,1995,9,female,553,44,32,686,49,622,48,64,1
1171451,50,5,1963,9,female,387,44,26,740,274,740,234,0,40
1615843,18,28,1995,2,male,600,45,22,823,709,4,81,819,628
1986055,59,1,1954,2,female,435,44,22,859,607,832,159,27,448
1137181,37,18,1976,3,female,198,44,31,983,329,0,101,983,228
1572142,106,30,1907,10,male,150,45,18,955,27,885,18,70,9
1411743,32,19,1981,11,female,174,45,43,920,660,920,592,0,68
1286179,28,13,1985,8,male,436,45,24,1049,385,124,158,925,227
1571054,57,19,1956,3,male,1062,44,18,1014,19,1014,13,0,6
1492113,14,7,1999,7,female,168,44,21,1237,393,1127,137,110,256
1608114,61,31,1952,8,female,553,44,24,1338,306,0,112,1338,194
1828443,51,18,1962,12,female,685,44,42,1399,216,931,145,468,71
2121844,23,21,1990,4,female,303,44,30,1981,3213,3,190,1978,3023
2082720,17,18,1996,9,female,410,44,24,1926,509,1881,329,45,180
1249770,23,1,1990,8,female,312,45,31,2046,635,2045,314,1,321
1297076,67,12,1946,9,male,572,47,37,31,14,31,13,0,1
1085759,26,17,1987,2,female,430,46,18,30,60,30,21,0,39
1425932,92,20,1921,10,male,394,46,28,32,6,11,1,21,5
1882853,27,14,1986,5,male,234,47,30,32,5,31,1,1,4
2145482,62,14,1951,2,male,992,47,27,32,5,32,4,0,1
1586037,30,1,1983,1,male,793,46,20,32,8,32,5,0,3
1638584,24,26,1989,12,female,92,46,25,32,37,32,13,0,24
1316685,18,31,1995,1,female,48,46,26,33,72,9,33,24,39
1235336,33,6,1980,3,male,316,46,17,33,19,27,16,6,3
1536835,38,1,1975,1,male,242,47,38,33,6,33,6,0,0
1521456,40,11,1973,9,male,24,47,47,33,9,33,5,0,4
2095042,47,20,1966,10,male,175,47,37,33,6,33,6,0,0
2171909,47,17,1966,6,male,460,47,21,33,24,33,12,0,12
1066632,41,17,1972,5,female,432,47,25,34,2,32,2,2,0
1506811,51,16,1962,4,female,2046,46,29,34,9,33,5,1,4
2032432,16,31,1997,12,male,343,46,34,34,0,34,0,0,0
2153484,51,14,1962,10,female,141,47,41,34,26,34,21,0,5
1378687,72,7,1941,2,female,2194,47,25,35,2,5,1,30,1
1824615,29,27,1984,1,male,365,46,28,36,7,0,5,36,2
2110750,63,23,1950,9,male,333,47,40,36,1,9,1,27,0
2059781,17,24,1996,5,male,321,47,44,35,7,33,5,2,2
1718791,20,2,1993,3,male,191,46,27,36,0,36,0,0,0
1538530,19,9,1994,3,female,311,46,30,35,15,35,13,0,2
2091725,21,11,1992,2,female,452,46,32,36,7,36,6,0,1
2131056,26,26,1987,4,male,261,46,42,35,10,35,9,0,1
1212378,26,7,1987,9,male,221,47,19,36,12,36,12,0,0
1030486,47,8,1966,2,NA,219,46,29,35,9,35,9,0,0
1730897,40,20,1973,5,female,202,47,19,36,125,36,119,0,6
1935599,66,7,1947,4,female,1988,47,8,37,8,35,5,2,3
2006104,32,15,1981,5,female,493,47,20,37,7,37,6,0,1
1950945,50,26,1963,6,male,1309,46,38,37,9,37,9,0,0
1700443,68,19,1945,1,female,968,46,28,38,4,2,3,36,1
1416615,26,6,1987,3,female,177,46,40,38,15,36,11,2,4
1100753,23,4,1990,4,male,174,47,24,38,98,29,30,9,68
1524258,33,19,1980,5,female,607,46,26,39,2,39,2,0,0
2179828,59,12,1954,11,male,1626,46,11,38,4,38,3,0,1
1549421,48,14,1965,2,male,55,47,46,38,17,38,7,0,10
1564377,100,27,1913,7,female,2168,46,16,40,43,40,18,0,25
1466295,23,18,1990,3,male,239,46,34,41,0,0,0,41,0
1284652,53,19,1960,5,female,129,46,40,42,160,0,70,42,90
2013928,38,6,1975,12,female,372,47,35,41,11,27,2,14,9
1712161,23,14,1990,6,male,227,47,26,41,34,12,25,29,9
1436710,31,30,1982,9,female,268,46,32,42,41,23,27,19,14
1238394,48,4,1965,9,male,887,47,23,41,118,13,96,28,22
1103791,16,9,1997,12,female,637,46,18,42,3,42,3,0,0
1414032,67,17,1946,3,female,1357,46,19,43,46,0,23,43,23
1246506,62,18,1951,5,female,103,46,44,43,16,37,3,6,13
1117645,17,14,1996,3,male,10,47,47,43,11,43,10,0,1
2090283,28,1,1985,2,male,118,46,24,44,13,44,7,0,6
1193440,57,3,1956,9,male,918,46,41,44,12,44,8,0,4
1072135,58,13,1955,7,female,541,47,24,45,62,15,18,30,44
1456586,60,9,1953,2,male,1514,46,7,45,19,44,6,1,13
1454827,16,5,1997,3,male,365,47,31,47,2,0,1,47,1
1624176,71,7,1942,7,female,332,47,33,47,15,0,5,47,10
1674997,23,12,1990,10,female,73,47,45,47,9,47,2,0,7
2114339,74,26,1939,11,NA,1949,46,29,46,23,46,21,0,2
1396617,20,8,1993,4,male,146,47,45,47,57,47,27,0,30
1098833,62,9,1951,2,male,657,47,15,49,27,0,15,49,12
2003804,71,21,1942,7,female,972,47,30,49,6,34,4,15,2
2125050,20,5,1993,2,male,479,47,34,48,4,45,3,3,1
1988119,24,16,1989,9,female,335,46,14,49,50,48,27,1,23
1340688,29,18,1984,4,female,214,46,32,49,12,49,10,0,2
1618965,34,14,1979,10,female,212,47,16,48,12,48,8,0,4
2074429,27,23,1986,10,female,313,47,46,49,88,49,54,0,34
2157248,54,1,1959,10,female,397,47,28,49,138,49,104,0,34
1877555,32,31,1981,10,male,83,47,44,50,0,10,0,40,0
1553786,26,23,1987,10,female,779,46,27,50,14,50,10,0,4
1558782,74,3,1939,3,female,1607,46,16,51,16,51,10,0,6
2069348,27,30,1986,9,female,549,46,27,50,124,50,30,0,94
1714645,43,10,1970,9,female,294,46,21,53,27,3,7,50,20
1743776,56,11,1957,6,female,1601,46,28,52,25,8,11,44,14
1773840,41,1,1972,12,male,355,46,14,52,26,31,17,21,9
1836939,64,14,1949,1,female,1519,46,35,52,31,49,23,3,8
2186364,49,22,1964,6,female,348,47,35,52,164,38,76,14,88
1253039,62,21,1951,9,male,884,47,16,55,12,7,3,48,9
2119903,47,12,1966,7,female,773,47,21,54,46,53,34,1,12
1892205,74,5,1939,4,female,826,46,30,55,9,55,5,0,4
1474574,26,2,1987,2,female,101,46,41,54,1070,54,584,0,486
1802826,63,12,1950,1,male,492,46,35,58,27,0,1,58,26
1078410,16,14,1997,11,male,854,47,21,58,18,26,15,32,3
1620487,62,15,1951,8,female,1765,47,31,58,21,57,11,1,10
1665745,58,23,1955,9,male,1314,47,31,58,83,55,60,3,23
2132453,59,9,1954,2,male,1052,46,21,56,76,50,58,6,18
1669035,27,20,1986,6,female,361,47,27,57,10,57,10,0,0
1374650,27,1,1986,6,male,232,46,9,56,18,56,15,0,3
1080855,31,11,1982,11,male,206,46,45,56,45,56,39,0,6
1450992,32,22,1981,9,female,504,46,30,57,106,57,46,0,60
1536216,71,16,1942,4,male,824,46,36,59,16,0,5,59,11
2088675,24,15,1989,10,male,283,47,41,60,32,60,28,0,4
2154907,32,17,1981,4,female,721,47,18,59,12,59,12,0,0
1385577,33,24,1980,4,female,252,47,36,59,49,59,44,0,5
1364823,62,5,1951,6,female,619,46,27,59,42,59,25,0,17
2052105,59,25,1954,12,female,563,47,26,61,13,4,10,57,3
1400380,27,12,1986,9,female,71,46,26,63,37,36,29,27,8
1704524,21,2,1992,4,male,234,47,38,62,34,62,9,0,25
1154220,29,1,1984,1,male,299,47,23,61,20,61,18,0,2
1634578,33,27,1980,10,male,317,46,23,61,20,61,18,0,2
1513554,51,7,1962,10,female,171,47,38,63,12,63,8,0,4
1297893,39,23,1974,3,male,305,47,17,61,42,61,32,0,10
1117558,18,4,1995,1,female,429,46,28,65,76,11,24,54,52
1076907,59,7,1954,10,female,417,47,43,66,20,0,15,66,5
1036031,60,13,1953,10,female,587,46,29,66,25,0,16,66,9
1534561,54,27,1959,8,female,540,46,25,66,92,0,66,66,26
1935042,29,29,1984,4,female,300,46,19,67,7,67,7,0,0
1583534,29,11,1984,4,male,227,46,11,68,1,68,1,0,0
2178705,42,30,1971,6,female,236,46,27,66,37,66,26,0,11
1973193,23,22,1990,7,female,409,47,35,66,50,66,32,0,18
2064099,23,11,1990,11,female,53,46,40,69,129,0,21,69,108
1485367,21,15,1992,1,male,270,46,29,69,7,23,6,46,1
1275352,52,8,1961,1,male,939,46,26,70,40,59,25,11,15
1632349,31,17,1982,8,female,709,46,28,70,1,70,1,0,0
1747504,28,7,1985,6,male,484,47,28,71,43,71,34,0,9
1629829,21,24,1992,4,female,382,46,27,71,217,71,69,0,148
1881393,26,28,1987,10,male,431,46,24,74,43,68,31,6,12
1515922,73,27,1940,12,male,1341,46,32,73,11,73,6,0,5
1109103,16,6,1997,6,male,19,46,40,73,29,73,29,0,0
2151505,39,21,1974,10,female,112,46,36,77,47,3,26,74,21
1115466,57,10,1956,9,female,2135,47,14,75,19,47,14,28,5
1286271,65,4,1948,10,female,1240,46,19,77,39,40,32,37,7
1554581,20,11,1993,11,male,814,46,33,77,80,45,40,32,40
1630673,21,2,1992,1,male,320,47,41,77,0,77,0,0,0
1721006,35,17,1978,10,male,268,47,39,77,5,77,5,0,0
2168798,59,22,1954,2,male,51,46,43,75,9,75,8,0,1
1730035,40,4,1973,3,female,673,46,33,76,43,76,33,0,10
1401759,18,30,1995,4,female,107,46,27,80,30,79,20,1,10
1266154,28,10,1985,1,male,301,46,31,79,113,70,52,9,61
1109083,53,19,1960,12,female,765,46,30,80,63,65,33,15,30
1907335,30,23,1983,11,female,1565,46,18,79,216,60,176,19,40
2156896,26,5,1987,4,female,294,46,23,80,31,80,6,0,25
1931798,29,15,1984,1,female,200,47,27,79,58,79,36,0,22
1876564,71,6,1942,3,female,368,46,40,81,8,0,5,81,3
1076554,56,10,1957,7,male,856,47,23,81,30,0,12,81,18
1951625,64,13,1949,9,female,596,46,38,81,50,0,25,81,25
1262013,18,25,1995,11,male,43,46,23,83,34,82,23,1,11
1403391,68,4,1945,3,female,2268,46,33,84,26,79,22,5,4
1934238,108,15,1905,4,male,1146,47,31,83,15,70,10,13,5
2114430,16,19,1997,9,female,103,46,33,81,101,78,81,3,20
1680548,35,7,1978,8,male,258,46,39,81,11,81,9,0,2
1136131,34,8,1979,9,female,582,46,27,83,135,83,134,0,1
1371058,65,22,1948,12,female,501,46,15,87,20,61,15,26,5
1496479,68,2,1945,8,male,112,47,16,85,11,85,10,0,1
2035619,22,1,1991,1,female,282,46,35,87,45,87,24,0,21
1098912,37,21,1976,5,male,145,47,26,85,133,85,87,0,46
2005288,25,18,1988,7,female,394,46,18,91,67,0,7,91,60
1041221,65,4,1948,10,female,481,46,17,88,86,6,57,82,29
1819022,49,7,1964,8,male,201,46,32,88,34,54,28,34,6
1572540,45,24,1968,7,female,484,46,10,90,68,64,46,26,22
1230878,53,21,1960,9,female,914,47,27,90,173,49,92,41,81
1089742,27,25,1986,4,female,688,46,31,89,28,83,20,6,8
1774104,55,19,1958,9,female,1450,46,31,89,48,81,26,8,22
1035817,33,28,1980,12,female,16,46,20,90,106,82,67,8,39
1342734,46,1,1967,6,male,639,47,8,91,42,91,31,0,11
1978639,23,17,1990,1,female,381,46,28,88,84,88,59,0,25
1968426,58,10,1955,10,female,339,47,31,89,199,89,132,0,67
1207625,61,22,1952,4,female,341,46,21,94,13,0,5,94,8
1740533,26,4,1987,10,female,547,46,16,94,51,86,18,8,33
1340018,27,25,1986,10,female,390,47,34,93,21,68,11,25,10
1326824,57,1,1956,11,female,100,46,38,94,11,94,7,0,4
1330065,45,7,1968,6,male,89,46,29,97,5,0,1,97,4
1417235,17,13,1996,5,female,410,46,40,96,43,0,4,96,39
1857707,83,14,1930,4,female,602,46,15,96,25,2,5,94,20
1134415,38,13,1975,5,male,328,46,31,98,111,10,46,88,65
1250367,38,28,1975,5,female,141,46,35,97,5,97,5,0,0
1756352,57,28,1956,2,female,2124,46,10,97,7,97,4,0,3
2140929,38,25,1975,6,female,78,46,21,97,48,97,40,0,8
2014774,42,3,1971,3,male,373,47,24,97,61,97,56,0,5
2077210,26,5,1987,5,male,154,46,41,97,147,97,128,0,19
2145295,16,9,1997,12,male,282,46,34,104,0,104,0,0,0
1938356,51,10,1962,10,male,43,47,36,103,1,103,1,0,0
2187681,45,10,1968,3,male,23,46,45,109,56,6,8,103,48
1377523,26,14,1987,11,female,341,47,42,105,11,93,9,12,2
1917343,18,2,1995,1,male,225,47,41,105,31,101,25,4,6
2144699,17,16,1996,10,female,51,46,36,108,14,108,14,0,0
1298120,44,3,1969,3,male,314,46,25,106,60,106,45,0,15
2080924,25,16,1988,6,female,208,47,12,108,91,108,55,0,36
1779286,21,30,1992,8,female,232,46,43,112,13,112,4,0,9
2070768,42,29,1971,6,female,406,46,34,112,5,112,4,0,1
2078963,23,12,1990,8,male,190,47,22,110,51,110,45,0,6
1389050,35,17,1978,2,male,466,47,41,118,31,75,8,43,23
1806634,29,1,1984,12,male,368,46,24,119,5,119,4,0,1
2188272,65,24,1948,10,female,489,46,32,118,53,118,41,0,12
1730085,28,6,1985,3,female,95,46,40,118,128,118,82,0,46
1074821,40,5,1973,5,female,212,46,38,118,78,118,67,0,11
2081666,54,26,1959,10,male,550,46,14,119,306,119,243,0,63
1088439,73,14,1940,4,male,501,46,39,124,57,0,41,124,16
1025074,23,18,1990,8,female,215,46,28,120,24,120,23,0,1
1877253,36,2,1977,9,male,280,47,31,121,21,121,3,0,18
1776570,33,19,1980,6,male,482,47,26,126,128,0,104,126,24
2105379,72,15,1941,10,female,554,47,33,129,93,4,47,125,46
1000013,61,26,1952,10,female,1856,47,28,128,55,128,31,0,24
1795301,53,19,1960,1,female,506,46,24,133,37,0,17,133,20
1417474,67,28,1946,9,female,174,47,36,133,96,0,32,133,64
1928818,19,3,1994,7,male,232,47,35,135,148,126,80,9,68
1846324,25,31,1988,12,male,179,47,30,135,1,135,1,0,0
1499187,107,4,1906,3,male,238,46,45,136,5,136,4,0,1
1006846,27,18,1986,10,female,88,46,28,132,76,132,59,0,17
1900680,48,24,1965,6,female,445,47,23,136,159,136,115,0,44
2043003,27,23,1986,2,female,106,46,38,140,32,28,16,112,16
2148237,33,20,1980,1,female,552,46,27,138,122,137,76,1,46
1235315,20,1,1993,5,female,430,47,29,142,13,142,10,0,3
1990056,23,19,1990,9,male,42,46,30,138,51,138,27,0,24
1708895,38,3,1975,9,female,87,47,37,150,53,147,29,3,24
1282095,27,19,1986,11,male,138,47,37,145,13,145,13,0,0
2067552,46,8,1967,7,female,138,47,26,150,47,150,42,0,5
1470432,66,29,1947,4,female,885,46,12,153,26,65,18,88,8
1225240,18,10,1995,6,male,50,46,33,152,12,152,12,0,0
1152324,53,27,1960,3,male,1010,46,14,159,130,36,92,123,38
1777535,36,14,1977,12,female,380,47,33,160,4,153,3,7,1
1482801,60,6,1953,5,female,1746,46,6,165,34,0,9,165,25
2062752,77,11,1936,2,female,691,47,22,166,98,0,3,166,95
1358166,64,13,1949,7,female,1556,47,24,171,59,116,32,55,27
1727817,59,22,1954,7,male,210,46,31,167,70,167,57,0,13
2023714,28,15,1985,2,female,474,46,23,167,135,167,116,0,19
1829781,104,14,1909,3,female,46,47,9,166,106,166,103,0,3
1769193,41,18,1972,3,male,284,47,40,173,9,0,0,173,9
1508362,57,2,1956,1,male,363,46,26,176,82,0,22,176,60
1006429,78,2,1935,5,female,726,47,33,181,87,0,2,181,85
2023430,45,1,1968,11,female,461,46,20,177,89,177,82,0,7
1931378,23,29,1990,8,female,301,46,15,184,69,14,29,170,40
1381127,46,31,1967,3,male,92,47,35,190,132,45,16,145,116
1508314,51,23,1962,10,male,333,46,36,182,67,154,36,28,31
1256412,39,4,1974,3,male,317,46,22,190,23,190,20,0,3
1665309,31,9,1982,10,female,743,46,13,189,51,189,41,0,10
1603643,79,25,1934,1,female,1662,47,20,200,22,0,17,200,5
1365936,54,28,1959,8,female,199,47,32,199,87,191,61,8,26
1929395,41,3,1972,3,female,280,46,26,198,71,198,64,0,7
1909494,61,27,1952,5,female,677,46,23,192,76,192,58,0,18
2044892,64,20,1949,2,female,752,47,32,201,78,0,59,201,19
1726583,64,7,1949,12,male,982,47,24,201,381,29,250,172,131
1644145,21,26,1992,3,female,36,46,42,204,337,61,60,143,277
1923871,63,29,1950,10,female,427,46,25,209,34,177,12,32,22
1761193,23,17,1990,8,female,153,47,38,209,322,193,226,16,96
1310150,108,30,1905,5,female,1444,46,35,217,85,0,44,217,41
2155555,58,25,1955,4,male,1550,47,25,217,205,155,40,62,165
1930650,29,5,1984,9,female,399,46,22,215,77,214,54,1,23
1904536,44,11,1969,3,female,233,47,31,222,32,119,12,103,20
1983920,55,2,1958,5,male,86,47,25,231,10,231,7,0,3
1841945,57,20,1956,1,female,955,47,19,243,28,39,15,204,13
1785123,21,29,1992,12,female,656,47,24,238,92,237,73,1,19
1834694,39,9,1974,12,female,490,46,26,237,22,237,22,0,0
2113216,22,7,1991,7,female,385,47,38,237,109,237,84,0,25
1018719,36,4,1977,5,female,284,46,28,239,319,239,294,0,25
1666245,26,17,1987,11,female,136,46,19,260,96,256,95,4,1
2182095,23,3,1990,3,male,471,46,38,251,98,251,77,0,21
1754273,60,22,1953,2,female,677,46,23,261,101,0,33,261,68
2157438,26,15,1987,2,female,607,47,44,264,468,179,175,85,293
1469352,30,11,1983,11,female,266,47,34,267,391,234,284,33,107
1145224,48,11,1965,2,male,296,46,29,263,335,253,218,10,117
1730097,36,25,1977,7,female,439,46,28,268,112,268,104,0,8
1352747,44,24,1969,3,female,626,47,27,275,176,275,135,0,41
1677936,36,22,1977,11,female,197,46,31,288,1,0,0,288,1
1991605,44,28,1969,5,female,564,46,12,290,88,290,73,0,15
1151152,28,1,1985,1,male,336,46,28,281,265,281,87,0,178
1838159,53,12,1960,9,female,973,46,15,292,309,292,232,0,77
1223166,64,22,1949,3,female,392,46,33,305,25,0,5,305,20
1895299,15,18,1998,2,female,121,47,36,297,51,2,32,295,19
1650389,56,2,1957,7,female,80,46,44,301,81,1,54,300,27
1974258,36,24,1977,5,female,273,46,22,299,187,13,151,286,36
1492198,49,25,1964,10,female,45,46,25,324,49,317,33,7,16
1279904,46,21,1967,4,male,180,47,20,326,10,326,9,0,1
1876684,56,20,1957,8,female,467,47,16,332,263,225,124,107,139
1144294,42,22,1971,10,male,434,47,22,337,181,336,124,1,57
1122230,42,11,1971,10,female,610,47,21,337,140,337,122,0,18
1950624,61,27,1952,6,female,390,47,30,357,132,132,80,225,52
1931705,33,8,1980,12,female,68,46,27,369,213,369,178,0,35
1952235,31,23,1982,9,male,347,47,44,370,13,0,3,370,10
1938407,16,4,1997,12,female,197,47,24,391,111,356,59,35,52
2062854,42,1,1971,6,female,581,46,35,392,57,392,31,0,26
2062543,21,3,1992,2,female,439,46,19,378,145,378,83,0,62
1174978,34,31,1979,7,female,215,46,34,377,94,377,70,0,24
1028407,26,7,1987,11,female,337,47,24,431,85,431,81,0,4
1871156,30,6,1983,4,female,29,46,32,462,326,27,175,435,151
1294698,28,10,1985,1,female,19,46,33,459,111,459,85,0,26
1295345,51,12,1962,3,female,517,47,30,500,348,414,239,86,109
1731991,39,31,1974,1,female,295,47,31,507,19,507,18,0,1
2019633,78,24,1935,11,male,1380,47,19,526,66,32,24,494,42
1626545,72,1,1941,2,male,427,46,30,531,71,334,53,197,18
2012645,48,10,1965,2,male,1194,47,33,558,186,504,141,54,45
1000660,62,18,1951,9,female,160,46,34,572,78,445,61,127,17
1712945,18,29,1995,5,female,248,47,28,612,266,0,30,612,236
2153941,56,13,1957,1,male,325,47,33,623,112,434,73,189,39
1640540,52,3,1961,6,female,1092,46,29,655,97,651,36,4,61
1084563,33,1,1980,3,female,25,46,30,634,185,629,148,5,37
1714259,68,20,1945,3,male,1372,47,13,629,197,629,143,0,54
2166224,32,24,1981,4,female,233,47,24,624,426,624,273,0,153
2001089,31,21,1982,8,female,491,46,31,704,373,704,234,0,139
1913438,28,1,1985,3,female,168,47,42,751,467,0,19,751,448
1878402,21,14,1992,2,male,421,47,16,761,589,208,232,553,357
2185359,41,9,1972,11,female,126,46,32,780,267,780,250,0,17
1506581,56,15,1957,11,male,538,47,26,750,152,750,108,0,44
2134693,20,12,1993,12,female,173,47,37,869,1055,204,386,665,669
1699124,43,16,1970,11,female,564,47,37,798,24,790,13,8,11
2143686,69,18,1944,8,female,210,46,20,856,247,850,92,6,155
1300605,33,30,1980,5,female,474,47,26,861,21,861,20,0,1
2137529,55,26,1958,8,female,311,46,27,867,727,867,278,0,449
1506243,26,13,1987,10,female,295,46,19,980,105,980,73,0,32
1206181,56,28,1957,1,female,645,47,28,1042,185,174,92,868,93
2007966,56,13,1957,6,female,908,47,23,1056,434,14,329,1042,105
1025043,57,28,1956,1,female,226,47,35,1050,371,0,116,1050,255
1608725,21,21,1992,11,female,906,46,21,1156,1194,900,465,256,729
1756032,51,4,1962,10,male,547,46,30,1150,10,1150,5,0,5
1927450,17,29,1996,12,female,462,46,28,1363,1134,97,256,1266,878
1891926,22,7,1991,9,female,236,47,16,1444,1589,1081,746,363,843
1210429,19,18,1994,7,female,136,46,37,2040,1444,1118,636,922,808
1883215,66,21,1947,1,female,1014,47,23,2345,50,2344,30,1,20
1933494,54,8,1959,8,female,176,47,22,1957,41,1957,29,0,12
1276284,29,1,1984,7,male,220,49,28,24,22,24,12,0,10
1177572,32,20,1981,12,male,494,48,23,24,72,24,43,0,29
1267974,24,21,1989,1,female,194,48,24,25,29,3,5,22,24
1268466,32,25,1981,9,male,409,48,32,25,22,0,6,25,16
2154571,76,18,1937,6,female,50,48,32,25,103,0,53,25,50
1752362,25,2,1988,1,male,205,48,27,25,2,25,1,0,1
2111662,30,15,1983,5,female,329,48,42,25,9,25,9,0,0
1918355,35,11,1978,11,female,417,49,17,25,10,25,8,0,2
1755775,98,18,1915,6,male,529,48,31,25,6,25,3,0,3
2002007,22,12,1991,4,male,261,48,28,25,20,25,20,0,0
1061488,30,26,1983,7,male,157,49,32,25,38,25,14,0,24
1811520,23,5,1990,1,male,160,48,43,26,22,14,18,12,4
1455117,13,2,2000,3,male,92,49,34,26,8,20,4,6,4
1956871,15,18,1998,8,male,400,48,38,26,33,20,12,6,21
1651593,25,1,1988,1,female,289,48,19,26,15,26,13,0,2
1149738,18,19,1995,8,male,130,49,38,26,18,26,18,0,0
1188112,47,29,1966,10,male,347,49,28,26,62,26,34,0,28
1637311,20,15,1993,10,male,513,48,38,27,4,27,2,0,2
1259196,35,10,1978,11,male,678,49,36,27,1,27,1,0,0
1698699,39,7,1974,3,male,1546,48,13,28,10,24,10,4,0
1884678,47,10,1966,5,male,1818,48,38,28,23,26,22,2,1
1658453,24,1,1989,4,male,224,49,22,28,11,28,8,0,3
1008904,35,12,1978,6,female,153,49,25,28,44,28,12,0,32
1255323,38,15,1975,2,female,522,49,29,29,26,18,7,11,19
1536792,22,15,1991,3,female,233,48,21,29,17,29,11,0,6
1866427,17,28,1996,6,male,203,48,27,29,30,29,20,0,10
1833614,25,20,1988,10,female,269,49,39,29,19,29,11,0,8
1477142,39,11,1974,8,male,213,48,18,29,138,29,131,0,7
2084154,18,13,1995,5,male,410,49,40,31,5,0,0,31,5
1094656,56,5,1957,12,male,944,48,32,31,2,0,1,31,1
1328830,32,14,1981,4,female,611,49,36,31,63,0,29,31,34
1815509,61,21,1952,1,female,1721,49,29,31,60,17,44,14,16
1940315,19,17,1994,2,male,279,48,15,31,148,28,103,3,45
1203989,33,11,1980,4,male,195,49,46,30,238,30,225,0,13
1922014,47,1,1966,2,female,253,48,35,32,5,0,2,32,3
1901199,49,14,1964,2,male,203,48,39,32,3,2,0,30,3
1376840,21,15,1992,7,male,76,49,46,32,13,32,9,0,4
2161011,69,24,1944,10,male,834,49,27,32,17,32,16,0,1
1159280,31,28,1982,3,male,219,48,15,32,49,32,40,0,9
1915462,49,27,1964,1,female,482,49,13,33,4,0,0,33,4
1765868,113,8,1900,7,female,1147,49,31,33,18,0,6,33,12
2015936,36,31,1977,3,female,524,49,17,33,29,21,15,12,14
1466937,52,29,1961,11,female,331,48,26,33,2,31,2,2,0
1132404,15,21,1998,3,male,258,48,13,33,0,33,0,0,0
1043648,51,21,1962,11,female,407,48,29,33,14,33,9,0,5
1610752,33,7,1980,7,female,116,48,45,33,43,33,33,0,10
1177068,68,8,1945,3,male,705,48,28,33,38,33,34,0,4
1557419,25,10,1988,12,male,543,48,33,34,21,0,6,34,15
1787725,49,24,1964,8,female,290,48,39,34,57,14,8,20,49
1317474,35,31,1978,10,female,590,49,21,34,57,26,51,8,6
1540227,15,19,1998,2,male,222,48,23,34,17,34,8,0,9
1205793,30,30,1983,5,male,312,48,18,34,50,34,23,0,27
1570850,50,19,1963,10,female,176,49,27,36,44,0,15,36,29
1966380,68,5,1945,5,female,1806,49,20,36,0,23,0,13,0
2189378,68,3,1945,8,female,1783,48,16,36,6,19,4,17,2
1195648,18,21,1995,12,male,325,48,44,36,4,36,4,0,0
1351799,22,7,1991,7,male,189,49,42,35,21,35,20,0,1
1049407,61,30,1952,4,female,776,49,27,36,43,36,26,0,17
1403868,16,2,1997,3,male,570,48,40,36,145,36,143,0,2
1207216,29,1,1984,11,female,446,48,22,36,55,36,53,0,2
1026687,38,31,1975,1,female,1017,49,21,37,49,6,16,31,33
1877998,55,28,1958,10,female,1428,48,15,37,55,18,25,19,30
1460026,22,16,1991,10,female,358,49,32,37,20,37,7,0,13
1116556,25,3,1988,5,male,109,48,32,37,10,37,6,0,4
1154674,54,4,1959,2,male,392,49,32,38,3,5,1,33,2
1549456,51,16,1962,8,male,1446,49,25,39,49,0,24,39,25
2049850,57,7,1956,4,male,478,49,28,39,4,11,2,28,2
1855722,17,22,1996,1,male,88,48,45,38,12,31,7,7,5
1324249,24,23,1989,7,female,136,48,27,38,73,28,51,10,22
1442771,21,1,1992,1,female,306,48,15,39,8,39,8,0,0
1086430,28,1,1985,1,male,209,49,41,39,19,39,19,0,0
1838873,59,13,1954,8,female,266,48,23,39,17,39,17,0,0
2023727,14,5,1999,5,male,145,48,39,40,21,25,7,15,14
1275473,72,5,1941,3,female,728,48,20,40,35,40,10,0,25
2072450,35,15,1978,7,female,380,49,23,42,6,0,1,42,5
1337412,101,29,1912,2,male,604,49,46,42,1,17,1,25,0
1323401,46,2,1967,1,female,709,49,28,42,103,26,59,16,44
1843935,37,20,1976,9,male,365,48,36,44,8,37,8,7,0
2094311,28,5,1985,3,male,202,48,33,44,35,41,21,3,14
1158530,37,3,1976,6,female,204,48,28,43,65,32,50,11,15
1813029,52,20,1961,9,female,157,49,36,44,6,44,6,0,0
1977676,33,13,1980,5,female,440,49,40,44,10,44,8,0,2
1665805,21,30,1992,8,male,137,48,20,43,49,43,35,0,14
2048603,33,3,1980,1,male,620,48,35,43,39,43,32,0,7
1731582,24,1,1989,9,female,73,48,16,43,117,43,86,0,31
1691699,41,16,1972,12,male,1539,49,18,45,56,43,39,2,17
1462347,24,17,1989,3,male,194,48,39,45,6,45,5,0,1
1755155,23,9,1990,5,female,292,48,22,45,21,45,13,0,8
1903669,62,16,1951,6,female,374,49,33,45,24,45,15,0,9
2160439,80,25,1933,9,female,303,48,27,47,22,0,19,47,3
2008062,18,1,1995,11,male,344,48,24,46,2,46,2,0,0
1399176,25,20,1988,10,male,27,48,34,46,12,46,11,0,1
1775360,33,25,1980,4,female,266,49,28,47,52,47,45,0,7
1720697,70,31,1943,8,male,994,49,17,49,560,0,83,49,477
1194324,71,28,1942,7,female,1836,48,2,48,26,47,16,1,10
1941814,18,25,1995,5,female,41,49,32,49,60,39,51,10,9
2084269,43,8,1970,8,male,608,48,41,48,5,48,3,0,2
1080158,21,7,1992,1,male,431,49,30,48,9,48,8,0,1
1684572,30,19,1983,2,female,411,49,38,51,7,51,6,0,1
1382296,32,23,1981,2,male,230,49,39,50,4,50,3,0,1
1668150,51,20,1962,5,female,184,49,34,51,1,51,1,0,0
1467587,75,19,1938,4,female,309,48,41,51,1,51,1,0,0
2153970,30,27,1983,12,female,912,48,17,50,14,50,13,0,1
1304638,31,6,1982,10,male,598,49,43,51,76,51,73,0,3
1985106,56,2,1957,2,female,356,49,32,50,35,50,24,0,11
1614233,66,18,1947,5,male,827,49,39,51,47,51,44,0,3
1522538,59,11,1954,5,female,747,48,33,53,6,0,3,53,3
1287224,20,10,1993,7,male,677,49,39,52,18,36,11,16,7
1414622,25,9,1988,10,male,408,48,37,52,5,52,1,0,4
1859174,50,15,1963,4,male,501,49,23,52,53,52,34,0,19
1112528,108,1,1905,1,NA,1724,48,29,54,33,5,27,49,6
1438802,37,13,1976,5,male,603,48,20,55,24,21,19,34,5
2108855,22,10,1991,1,female,442,49,24,54,48,54,46,0,2
1529700,45,18,1968,5,male,418,48,29,57,12,1,2,56,10
1277855,66,16,1947,4,female,1480,48,27,57,62,49,42,8,20
2029196,27,8,1986,6,male,1266,48,24,56,0,56,0,0,0
1240314,52,19,1961,4,male,143,48,39,58,7,58,7,0,0
1663969,22,29,1991,11,female,415,49,39,58,22,58,15,0,7
1065891,33,5,1980,11,male,277,49,32,60,21,0,10,60,11
1125187,50,1,1963,10,female,561,48,42,60,13,1,6,59,7
1990345,52,9,1961,2,male,1825,49,36,59,107,39,64,20,43
1519108,30,15,1983,2,female,859,49,9,59,8,58,6,1,2
2084179,47,8,1966,3,male,365,49,21,60,2,60,1,0,1
1673035,18,1,1995,1,male,261,48,34,59,51,59,46,0,5
1605616,50,10,1963,8,female,873,48,24,59,62,59,58,0,4
1551792,57,25,1956,2,female,430,49,37,62,9,0,5,62,4
1304020,73,9,1940,10,male,742,49,13,61,4,0,2,61,2
1729064,82,15,1931,7,female,2170,48,13,63,30,0,6,63,24
1490455,15,3,1998,11,male,498,48,21,61,15,60,12,1,3
2094561,58,1,1955,8,female,780,49,41,63,6,63,4,0,2
1323763,67,25,1946,1,female,598,48,26,62,4,62,2,0,2
1679083,26,12,1987,11,female,362,48,28,63,55,63,55,0,0
1017691,27,6,1986,6,male,153,49,33,61,47,61,45,0,2
1305241,50,9,1963,7,female,503,49,31,61,41,61,16,0,25
1200948,20,26,1993,12,male,409,48,28,64,24,34,8,30,16
1363502,53,4,1960,4,male,1388,49,32,65,81,61,32,4,49
1294224,58,15,1955,5,male,1460,49,24,65,8,65,2,0,6
1188980,23,2,1990,8,female,505,48,15,65,60,65,51,0,9
1721142,67,26,1946,4,female,523,49,35,66,27,0,19,66,8
1380709,58,10,1955,6,male,505,49,36,68,91,0,17,68,74
1441149,41,7,1972,2,female,454,49,31,66,17,47,16,19,1
2008959,46,28,1967,2,female,371,48,24,66,40,59,17,7,23
1789198,64,6,1949,9,male,1476,48,23,66,15,57,11,9,4
1512234,19,13,1994,1,male,297,48,35,67,32,67,30,0,2
1014931,100,21,1913,3,male,107,48,28,67,33,67,21,0,12
2057191,65,26,1948,4,male,1094,49,36,71,57,0,3,71,54
2174277,59,26,1954,9,female,530,49,18,69,10,16,5,53,5
1976820,25,25,1988,5,male,381,48,44,69,8,56,2,13,6
1055615,56,1,1957,6,female,397,49,34,69,25,69,7,0,18
2175164,28,18,1985,3,male,285,48,33,70,53,70,51,0,2
2016157,46,9,1967,11,male,400,48,34,74,3,0,2,74,1
1913649,22,11,1991,6,male,234,48,38,72,33,0,13,72,20
1545536,51,27,1962,12,female,290,49,29,73,20,12,7,61,13
1815136,54,24,1959,11,male,159,49,29,72,126,0,52,72,74
1818686,44,23,1969,5,female,276,48,34,73,10,70,4,3,6
1721203,31,3,1982,10,male,134,49,42,73,5,73,4,0,1
1520623,23,12,1990,9,female,504,48,31,73,22,73,17,0,5
1008709,57,8,1956,5,female,100,48,36,74,45,74,32,0,13
1284983,67,19,1946,12,female,677,49,38,74,16,74,13,0,3
1268773,22,15,1991,4,male,349,48,42,74,51,74,42,0,9
1748670,23,10,1990,10,female,440,49,26,75,24,1,9,74,15
1523538,35,3,1978,11,female,116,49,31,77,91,68,35,9,56
1398882,32,6,1981,3,female,732,49,31,77,35,77,34,0,1
1629778,56,25,1957,4,female,915,48,38,75,25,75,6,0,19
1410351,46,16,1967,8,female,352,48,26,77,132,77,42,0,90
1752321,69,3,1944,12,female,1646,49,33,79,6,29,5,50,1
1742391,23,29,1990,7,female,443,49,42,78,104,77,87,1,17
1640076,55,30,1958,7,female,488,48,26,79,10,79,8,0,2
1258790,16,7,1997,10,male,468,49,25,79,250,79,84,0,166
1136942,56,25,1957,12,female,513,49,25,81,8,43,4,38,4
1271654,16,19,1997,8,male,306,49,17,84,1,83,1,1,0
2041181,34,2,1979,6,male,369,49,34,82,60,80,36,2,24
1441912,34,20,1979,10,female,381,48,31,84,91,65,86,19,5
1731703,20,16,1993,4,male,156,49,11,81,35,81,30,0,5
1570860,33,1,1980,1,female,54,49,28,81,15,81,7,0,8
1600394,58,19,1955,2,female,438,48,30,81,28,81,11,0,17
1827357,73,30,1940,5,female,1151,49,20,84,32,84,19,0,13
2156080,13,28,2000,3,male,15,48,30,81,58,81,58,0,0
1452704,25,1,1988,1,female,11,48,31,84,138,84,128,0,10
1819383,36,21,1977,12,female,496,48,11,84,353,84,293,0,60
1222254,77,30,1936,10,female,1263,49,30,85,18,0,3,85,15
1607321,35,26,1978,2,male,603,48,32,85,60,81,44,4,16
1638221,38,23,1975,2,male,519,48,11,86,38,86,22,0,16
1766876,44,12,1969,12,female,508,49,21,86,50,86,43,0,7
1622095,57,1,1956,4,female,1235,48,28,90,5,70,4,20,1
1071019,19,5,1994,7,male,495,49,49,88,42,87,32,1,10
1965449,48,16,1965,10,male,1630,49,25,88,121,74,92,14,29
1538839,31,22,1982,7,female,488,48,33,91,54,91,41,0,13
1743893,50,9,1963,6,female,515,49,14,91,34,91,24,0,10
1607910,18,1,1995,4,female,363,49,38,92,32,5,15,87,17
1252404,74,25,1939,6,female,1655,48,28,92,278,0,13,92,265
1059616,17,10,1996,3,female,108,49,16,95,3,95,3,0,0
1426745,28,14,1985,8,female,247,48,36,96,64,90,33,6,31
2145476,30,11,1983,12,male,365,49,28,99,10,99,6,0,4
1680417,67,9,1946,6,female,1355,49,26,96,32,96,25,0,7
1210337,71,14,1942,8,male,1360,49,15,97,69,97,42,0,27
1907062,61,3,1952,11,female,501,48,42,100,88,0,23,100,65
1402163,50,7,1963,4,male,251,49,37,104,14,104,7,0,7
1511892,45,23,1968,5,female,134,48,28,106,32,1,17,105,15
1386015,56,25,1957,10,female,438,48,18,109,66,0,25,109,41
1229515,68,28,1945,3,female,661,49,20,105,30,0,16,105,14
1094917,46,15,1967,6,male,2058,48,33,109,102,64,63,45,39
2111470,67,5,1946,5,male,2173,49,21,108,158,53,76,55,82
1772765,44,8,1969,4,female,1732,49,34,106,32,81,14,25,18
1303356,19,24,1994,8,male,327,49,38,108,2,108,2,0,0
1197511,58,7,1955,10,male,283,48,26,110,52,0,15,110,37
1822709,59,1,1954,1,female,776,49,14,110,14,110,13,0,1
1880066,44,16,1969,1,male,164,48,31,113,65,113,49,0,16
1286068,57,2,1956,12,male,495,48,38,119,56,84,42,35,14
2049600,51,16,1962,9,female,48,49,39,116,70,114,67,2,3
1397953,44,20,1969,11,male,663,48,37,116,293,110,276,6,17
1421836,19,15,1994,1,female,305,48,36,117,13,117,3,0,10
1048393,36,28,1977,6,female,241,49,26,114,34,114,28,0,6
1030294,54,4,1959,1,female,1645,49,27,120,18,16,5,104,13
1663956,66,24,1947,10,female,676,48,24,122,125,0,93,122,32
1357624,57,5,1956,2,female,1187,48,22,126,68,0,10,126,58
1038579,77,24,1936,10,female,2115,48,13,128,29,0,21,128,8
1442550,28,22,1985,3,female,67,48,40,129,195,51,59,78,136
1945087,33,22,1980,8,female,351,49,26,125,38,125,30,0,8
2008774,33,24,1980,9,female,51,48,38,126,60,126,60,0,0
1377781,100,28,1913,8,female,555,48,8,128,130,128,103,0,27
1995136,44,1,1969,6,male,282,49,37,135,1,0,0,135,1
1602292,32,15,1981,8,female,1787,48,26,135,50,135,17,0,33
1950362,28,10,1985,10,female,388,49,37,141,15,0,1,141,14
2087995,63,20,1950,11,male,196,48,24,137,63,0,29,137,34
2078767,73,1,1940,1,female,445,48,30,140,31,48,14,92,17
1872605,38,10,1975,9,female,299,48,38,143,89,34,24,109,65
1195479,61,29,1952,8,male,393,49,33,142,147,128,63,14,84
1668590,15,4,1998,12,male,169,48,37,140,12,140,3,0,9
1615609,27,8,1986,1,male,188,48,44,137,31,137,22,0,9
1217775,19,27,1994,11,male,66,49,32,142,152,142,152,0,0
1154673,65,11,1948,9,female,377,49,39,145,2,145,1,0,1
1031847,58,2,1955,11,female,1382,48,17,149,193,149,134,0,59
1459008,23,31,1990,3,male,417,48,42,151,56,28,19,123,37
1406322,46,21,1967,7,female,340,49,23,157,15,156,10,1,5
1703323,51,24,1962,10,female,136,48,33,161,145,0,100,161,45
2167615,56,8,1957,1,female,338,49,27,164,200,0,84,164,116
1718488,57,18,1956,8,male,429,49,33,162,54,85,42,77,12
1278790,17,10,1996,4,male,320,48,29,164,63,159,24,5,39
1529329,53,1,1960,3,male,301,48,30,164,85,121,57,43,28
1629218,46,27,1967,10,female,653,49,15,164,165,149,28,15,137
1893231,98,3,1915,1,male,2054,48,10,164,28,164,20,0,8
1566956,15,15,1998,6,female,514,49,29,161,233,161,109,0,124
1656270,20,25,1993,2,female,253,49,36,159,313,159,269,0,44
1115371,23,27,1990,12,female,672,49,30,167,0,167,0,0,0
1593042,46,11,1967,2,female,74,49,36,168,24,168,23,0,1
1922423,20,22,1993,1,male,81,49,42,168,55,168,41,0,14
1591520,22,12,1991,7,female,214,48,40,165,126,165,80,0,46
2158968,34,27,1979,2,female,454,49,28,166,250,166,250,0,0
1731340,25,14,1988,9,female,226,48,21,177,206,37,74,140,132
1172980,17,10,1996,10,female,384,49,15,177,180,173,142,4,38
1879306,22,20,1991,12,female,307,49,29,174,394,159,141,15,253
2048557,29,7,1984,4,male,368,49,35,179,6,179,4,0,2
1516679,64,26,1949,1,female,2284,49,24,174,76,174,35,0,41
2045898,65,9,1948,3,female,276,49,36,177,88,177,66,0,22
1939888,51,8,1962,7,female,133,49,28,184,106,0,72,184,34
1857063,53,13,1960,9,male,325,48,27,184,121,0,10,184,111
1419305,19,6,1994,2,female,119,48,17,185,74,75,23,110,51
2080830,36,2,1977,4,male,262,49,35,185,1,169,1,16,0
1147880,36,4,1977,2,female,475,48,41,184,74,168,48,16,26
1617709,22,19,1991,6,female,128,49,20,188,145,188,145,0,0
1640862,30,1,1983,8,female,201,48,23,186,149,186,65,0,84
2178900,55,13,1958,7,female,493,49,28,196,32,0,26,196,6
1955425,68,2,1945,5,male,996,49,27,195,5,106,4,89,1
1582057,61,12,1952,8,female,787,48,13,207,195,29,143,178,52
1481459,66,17,1947,3,female,215,49,32,211,183,0,31,211,152
1599975,69,27,1944,4,female,311,48,19,207,7,207,1,0,6
1030868,108,30,1905,10,male,1342,49,26,206,142,206,93,0,49
1554238,51,3,1962,7,female,511,49,28,216,14,0,3,216,11
1121890,31,9,1982,8,female,282,49,31,219,54,219,32,0,22
1371196,39,9,1974,3,female,70,49,41,218,154,218,102,0,52
1375468,29,26,1984,10,female,299,48,31,226,209,221,120,5,89
1017440,67,16,1946,10,female,2248,48,22,229,226,216,198,13,28
1383606,48,21,1965,1,female,462,48,16,228,57,228,44,0,13
1953670,56,29,1957,4,female,200,48,33,230,272,230,229,0,43
1629035,60,13,1953,1,male,740,48,44,246,19,4,5,242,14
1638366,59,21,1954,4,female,203,49,16,239,473,210,87,29,386
1149554,31,27,1982,1,female,560,49,30,234,87,234,69,0,18
1924665,47,15,1966,2,female,149,48,36,239,184,239,165,0,19
1678087,22,1,1991,7,male,791,48,32,248,273,149,181,99,92
1135014,102,15,1911,10,female,2261,49,14,250,160,112,41,138,119
1853342,61,29,1952,6,female,627,48,23,256,136,192,50,64,86
1033902,20,1,1993,1,male,222,49,22,253,144,253,124,0,20
2016352,54,6,1959,5,female,307,49,46,255,45,255,44,0,1
2055323,22,5,1991,8,female,836,49,19,259,182,259,56,0,126
1423373,36,19,1977,12,female,593,49,35,268,58,211,23,57,35
1668798,34,16,1979,10,female,347,49,29,268,224,247,131,21,93
1904174,49,7,1964,6,male,1273,49,27,270,22,270,19,0,3
1512154,24,25,1989,3,male,39,49,44,267,144,267,142,0,2
1974773,26,18,1987,10,female,428,49,31,285,117,250,82,35,35
1067791,56,28,1957,4,female,143,49,37,300,20,0,2,300,18
1055094,70,31,1943,12,male,475,49,34,299,93,0,66,299,27
1926464,65,19,1948,10,female,1165,48,23,297,260,279,158,18,102
1304437,77,24,1936,7,female,1271,49,18,304,22,304,7,0,15
1398460,31,15,1982,4,female,739,48,16,296,153,296,35,0,118
1732590,37,2,1976,8,female,731,49,13,310,116,0,22,310,94
1799329,51,4,1962,6,female,807,48,26,315,67,0,15,315,52
1933066,30,12,1983,11,male,43,49,48,312,15,312,14,0,1
1370294,66,26,1947,1,female,1310,48,18,328,30,0,2,328,28
1666859,62,24,1951,9,male,1136,48,15,343,22,197,12,146,10
1129329,20,3,1993,10,female,173,48,33,336,193,94,96,242,97
1754438,55,19,1958,4,female,300,48,29,338,38,338,27,0,11
1701043,52,16,1961,2,female,594,48,30,367,156,211,127,156,29
1337269,62,30,1951,8,female,490,49,35,375,22,0,5,375,17
2164932,53,5,1960,12,female,227,48,36,385,22,385,15,0,7
1329895,28,4,1985,4,female,348,49,42,386,222,386,104,0,118
1979074,66,10,1947,7,female,1294,48,6,394,155,394,71,0,84
1034159,27,5,1986,12,male,168,49,31,398,109,306,50,92,59
1285829,23,10,1990,12,male,17,49,46,413,195,413,189,0,6
1290756,64,10,1949,1,male,904,48,29,443,46,443,37,0,9
1619824,20,6,1993,5,male,162,48,24,436,80,436,64,0,16
1113431,27,4,1986,10,female,51,49,32,426,136,426,121,0,15
2178404,56,2,1957,9,female,199,48,33,437,219,437,179,0,40
1275078,65,11,1948,2,male,128,48,42,478,64,339,7,139,57
1183592,51,2,1962,8,female,1603,48,22,469,162,258,95,211,67
1509563,20,8,1993,7,female,605,48,31,481,1170,258,419,223,751
1541888,31,18,1982,9,female,695,48,41,467,61,459,50,8,11
1875795,26,14,1987,9,female,649,48,28,464,242,463,146,1,96
2112254,59,21,1954,10,female,1126,48,29,510,271,510,211,0,60
1991564,65,15,1948,6,female,431,49,28,528,87,0,25,528,62
1557449,38,10,1975,1,female,282,49,41,558,153,558,131,0,22
1976189,52,2,1961,1,female,727,49,34,578,174,0,21,578,153
1752345,53,1,1960,11,female,725,49,22,584,167,580,93,4,74
1667036,28,23,1985,12,male,191,49,22,564,57,564,30,0,27
1079236,56,22,1957,12,female,292,49,36,582,151,582,100,0,51
2190007,79,7,1934,5,female,658,49,35,638,74,0,33,638,41
1651212,36,1,1977,9,female,198,48,25,650,579,650,520,0,59
2077636,18,23,1995,8,female,850,48,33,725,913,712,489,13,424
1039889,25,4,1988,10,female,525,49,30,690,40,690,19,0,21
2108134,58,14,1955,12,female,92,49,31,756,110,756,43,0,67
1841480,95,19,1918,4,male,229,48,15,839,47,0,39,839,8
1180755,20,23,1993,8,female,269,48,33,883,453,75,169,808,284
1476685,54,11,1959,11,male,739,48,24,966,792,641,107,325,685
1770474,36,11,1977,6,female,113,48,36,980,222,859,137,121,85
2148981,48,24,1965,11,female,662,49,35,914,297,914,157,0,140
1931528,25,1,1988,7,female,205,48,31,1130,1235,1114,488,16,747
1596232,23,24,1990,10,female,572,49,24,1121,274,1121,199,0,75
1187221,61,1,1952,11,female,1046,49,26,1144,303,0,38,1144,265
1453829,68,31,1945,10,female,1599,48,27,1168,32,387,18,781,14
1246880,73,18,1940,2,male,536,48,25,1148,54,305,27,843,27
2017974,58,9,1955,1,male,140,49,45,1637,159,0,62,1637,97
1272974,20,27,1993,11,female,1265,49,13,1816,181,1035,65,781,116
2062977,62,24,1951,11,male,154,49,40,2127,90,2127,55,0,35
2021060,47,25,1966,5,female,402,49,36,1961,441,1961,216,0,225
1922073,79,26,1934,11,female,1641,49,27,3109,44,3109,38,0,6
1934356,21,27,1992,5,female,297,48,15,2562,3949,2562,2960,0,989
1479484,32,10,1981,11,female,222,50,43,4,43,4,19,0,24
1072283,33,11,1980,11,female,142,50,42,4,12,4,10,0,2
1986965,42,20,1971,10,female,463,51,37,4,20,4,16,0,4
1129347,46,7,1967,6,male,396,51,7,5,0,0,0,5,0
2052821,73,6,1940,1,male,1495,51,30,5,0,0,0,5,0
1919829,62,26,1951,5,male,1754,50,21,5,2,0,1,5,1
1607164,43,14,1970,7,male,1708,51,27,5,5,0,3,5,2
1483304,59,30,1954,10,male,29,51,28,5,5,0,3,5,2
2098169,36,24,1977,3,female,478,51,27,5,15,0,7,5,8
1302859,59,11,1954,5,female,158,51,12,5,9,0,4,5,5
1563456,60,10,1953,2,male,445,50,31,5,8,0,0,5,8
1578151,19,18,1994,8,male,567,51,28,5,2,3,2,2,0
2168671,58,9,1955,10,female,445,50,43,5,18,4,10,1,8
2152877,18,12,1995,9,male,57,50,46,5,0,5,0,0,0
1461947,22,4,1991,2,female,561,50,41,5,0,5,0,0,0
1899363,58,1,1955,12,male,305,51,43,5,0,5,0,0,0
1362018,17,30,1996,8,male,559,51,41,5,3,5,2,0,1
1773881,29,7,1984,9,female,268,50,28,5,1,5,0,0,1
1124774,34,4,1979,12,female,253,50,21,5,2,5,2,0,0
2163293,36,25,1977,12,male,443,50,6,5,1,5,0,0,1
1935662,38,10,1975,2,male,362,51,45,5,3,5,1,0,2
1910470,43,1,1970,1,female,153,51,33,5,2,5,1,0,1
1854377,59,27,1954,5,male,688,51,10,5,1,5,1,0,0
1110127,26,10,1987,1,male,341,51,45,5,6,5,2,0,4
1046943,16,19,1997,2,female,71,50,26,5,46,5,41,0,5
2038450,29,26,1984,6,male,450,51,46,5,66,5,50,0,16
1106833,41,1,1972,1,male,159,50,39,5,72,5,36,0,36
1590274,63,15,1950,4,male,797,51,29,6,0,0,0,6,0
1067064,41,11,1972,8,male,1982,50,19,6,3,0,2,6,1
1457263,65,23,1948,11,female,2036,50,11,6,2,0,2,6,0
1741931,23,22,1990,8,male,78,51,41,6,9,0,8,6,1
2158269,18,1,1995,1,male,11,51,46,6,21,3,18,3,3
2087659,52,7,1961,2,female,164,50,29,6,15,4,5,2,10
1077851,28,1,1985,1,female,22,51,34,6,92,5,32,1,60
1769026,20,27,1993,12,female,8,50,10,6,1,6,1,0,0
1164949,23,7,1990,7,male,1072,51,39,6,2,6,2,0,0
1862685,25,1,1988,1,male,93,50,34,6,1,6,1,0,0
1071161,25,8,1988,7,male,62,50,47,6,3,6,1,0,2
1185534,22,26,1991,11,male,223,51,27,6,4,6,4,0,0
2041370,53,13,1960,9,male,1456,50,20,6,5,6,1,0,4
2062075,18,24,1995,4,male,257,51,34,6,12,6,1,0,11
1134396,27,1,1986,10,male,159,51,28,6,29,6,10,0,19
1042607,14,7,1999,12,male,311,51,44,7,0,0,0,7,0
1622849,23,10,1990,9,female,270,51,35,7,1,0,1,7,0
1391640,43,25,1970,9,male,364,50,34,7,1,0,0,7,1
1037030,66,4,1947,7,female,1865,51,24,7,0,0,0,7,0
1375806,62,5,1951,11,male,668,51,34,7,4,0,0,7,4
2042815,66,17,1947,3,female,198,50,42,7,4,0,0,7,4
2164793,89,19,1924,1,male,1814,51,4,7,6,1,6,6,0
1691604,66,6,1947,8,male,1495,50,18,7,18,0,3,7,15
1450149,39,1,1974,10,male,305,51,36,7,8,4,0,3,8
1416420,18,8,1995,7,male,228,51,21,7,20,4,7,3,13
1159217,28,7,1985,8,male,396,51,49,7,1,7,0,0,1
2092759,32,9,1981,9,male,850,50,25,7,0,7,0,0,0
1916213,39,31,1974,1,male,807,51,40,7,1,7,1,0,0
2137559,40,15,1973,11,female,339,50,41,7,2,7,2,0,0
1618145,42,10,1971,12,female,1672,51,24,7,4,7,4,0,0
1190259,94,12,1919,8,male,626,50,29,7,3,7,2,0,1
1063914,13,5,2000,3,male,132,51,44,7,9,7,9,0,0
1104044,19,27,1994,2,female,407,50,27,7,5,7,5,0,0
1786429,24,12,1989,1,female,91,51,30,7,5,7,3,0,2
2167721,20,25,1993,11,male,312,50,32,7,47,7,43,0,4
1708453,28,25,1985,3,male,913,51,28,7,12,7,7,0,5
1683073,40,22,1973,10,male,426,51,33,7,20,7,12,0,8
1091199,41,21,1972,7,male,85,51,34,7,13,7,5,0,8
1985167,50,27,1963,11,male,782,50,24,7,19,7,13,0,6
2060195,34,21,1979,8,male,349,51,46,8,1,0,1,8,0
1262711,56,2,1957,2,male,1729,51,15,8,0,0,0,8,0
1011163,57,17,1956,1,male,576,50,24,8,2,0,0,8,2
1585032,65,28,1948,10,male,1480,51,18,8,4,0,2,8,2
1353349,48,7,1965,4,female,1707,51,25,8,6,0,0,8,6
1036815,58,25,1955,9,female,1589,51,28,8,7,0,0,8,7
1336861,55,28,1958,12,male,530,50,15,8,14,0,0,8,14
1821098,69,12,1944,9,male,789,51,24,8,3,4,2,4,1
2080669,23,16,1990,1,male,394,51,38,8,6,3,5,5,1
2015449,31,21,1982,10,female,682,50,22,8,22,5,19,3,3
2032415,58,18,1955,6,female,535,51,27,8,0,7,0,1,0
1295593,16,9,1997,1,male,489,51,41,8,1,8,1,0,0
1100812,58,6,1955,11,female,854,50,29,8,0,8,0,0,0
1663291,14,10,1999,8,male,78,50,45,8,2,8,1,0,1
1752080,35,13,1978,11,female,84,50,23,8,4,8,3,0,1
2064912,55,1,1958,1,male,407,50,35,8,3,8,3,0,0
1520806,26,11,1987,9,male,109,51,16,8,9,8,6,0,3
1679120,31,12,1982,6,male,246,51,36,8,9,8,5,0,4
1169427,56,22,1957,2,female,1803,51,18,8,9,8,4,0,5
1365463,18,7,1995,7,female,117,51,34,8,17,8,14,0,3
1363153,23,16,1990,9,male,342,51,44,8,14,8,10,0,4
1231614,68,21,1945,6,female,477,51,24,8,12,8,11,0,1
1885618,16,2,1997,7,female,217,51,41,9,1,0,0,9,1
1120830,19,19,1994,1,male,394,51,28,9,1,0,1,9,0
1110575,49,10,1964,5,male,553,50,46,9,0,0,0,9,0
1518291,58,13,1955,4,female,800,51,43,9,1,0,0,9,1
2015208,71,29,1942,12,male,1409,50,33,9,2,0,0,9,2
1671952,52,6,1961,3,male,650,51,44,9,51,0,25,9,26
1195375,58,15,1955,10,male,255,50,41,9,139,0,10,9,129
1353472,59,6,1954,7,male,1665,50,31,9,28,1,7,8,21
1785842,85,27,1928,8,female,1566,50,37,9,0,3,0,6,0
1751441,54,25,1959,1,male,1315,50,28,9,4,4,0,5,4
1915011,22,10,1991,1,male,105,51,21,9,13,3,9,6,4
2151233,63,26,1950,9,female,697,51,35,9,7,2,2,7,5
1345291,67,3,1946,7,female,408,50,36,9,2,7,0,2,2
2193148,17,3,1996,3,male,620,51,34,9,0,9,0,0,0
1338782,18,24,1995,7,male,229,50,22,9,1,9,1,0,0
1239006,27,4,1986,3,female,185,50,29,9,0,9,0,0,0
1432786,37,19,1976,4,male,315,50,40,9,3,9,3,0,0
1763448,48,25,1965,11,male,314,51,43,9,7,9,4,0,3
1946592,52,17,1961,9,female,464,50,44,9,10,9,9,0,1
1428901,21,12,1992,8,male,261,51,37,9,42,9,39,0,3
1200104,24,2,1989,11,male,212,51,48,9,24,9,19,0,5
1879245,36,10,1977,11,male,483,51,7,9,29,9,28,0,1
1492691,25,12,1988,10,male,194,51,31,10,1,0,1,10,0
1323692,44,29,1969,10,male,324,50,38,10,11,0,0,10,11
1713565,66,28,1947,5,female,603,50,20,10,53,0,31,10,22
1010630,75,7,1938,7,female,1663,51,20,10,21,0,10,10,11
1203493,108,17,1905,6,male,977,50,26,10,3,7,3,3,0
2063127,23,16,1990,12,male,149,50,40,10,0,10,0,0,0
1451950,63,26,1950,9,female,2045,50,39,10,3,10,1,0,2
1727839,27,29,1986,3,male,301,51,24,10,7,10,7,0,0
1010394,30,9,1983,7,male,164,51,25,10,17,10,13,0,4
1008723,30,29,1983,8,female,142,50,23,10,23,10,10,0,13
1628614,52,12,1961,3,female,257,51,21,10,43,10,33,0,10
1751925,18,12,1995,8,female,884,50,5,11,0,2,0,9,0
1314025,24,14,1989,2,male,332,50,47,11,1,1,1,10,0
1986493,18,7,1995,1,male,120,50,45,11,3,0,1,11,2
1877884,18,26,1995,3,male,427,51,35,11,6,0,1,11,5
1156522,77,26,1936,8,male,403,51,36,11,10,0,3,11,7
1565067,54,4,1959,8,female,704,50,31,11,44,0,13,11,31
1338609,80,20,1933,5,female,1402,50,31,11,0,7,0,4,0
1315027,27,6,1986,3,male,607,50,38,11,6,3,6,8,0
1440431,48,1,1965,11,male,501,51,32,11,11,7,7,4,4
1558098,52,10,1961,7,female,363,50,31,11,30,9,25,2,5
1360955,30,1,1983,4,male,990,51,24,11,1,11,1,0,0
1688107,56,21,1957,3,female,681,50,27,11,0,11,0,0,0
1613434,26,6,1987,11,male,326,51,48,11,5,11,5,0,0
1826991,32,16,1981,3,male,102,50,22,11,4,11,4,0,0
1524532,39,22,1974,5,male,775,50,24,11,2,11,2,0,0
1203804,51,24,1962,3,female,391,51,36,11,2,11,2,0,0
1292217,20,1,1993,1,male,136,51,49,11,8,11,8,0,0
1723051,27,1,1986,1,male,251,50,37,11,33,11,13,0,20
1217350,55,31,1958,5,female,648,50,39,11,36,11,28,0,8
1207376,30,30,1983,6,male,461,51,16,12,0,0,0,12,0
1584299,20,18,1993,3,male,142,51,36,12,10,1,8,11,2
1680085,19,3,1994,7,male,38,50,48,12,5,12,5,0,0
1076510,61,21,1952,7,female,666,50,18,12,5,12,4,0,1
1174956,55,18,1958,6,female,624,50,36,12,10,12,7,0,3
1673374,33,1,1980,1,female,359,50,18,12,18,12,7,0,11
1511121,63,19,1950,5,female,717,50,41,13,2,2,2,11,0
1005617,48,1,1965,2,female,648,50,11,13,6,0,3,13,3
1895658,54,9,1959,5,female,514,50,29,13,4,0,0,13,4
1736451,55,23,1958,1,female,607,50,36,13,2,5,0,8,2
1485994,33,5,1980,2,male,89,51,31,13,0,13,0,0,0
1095562,65,28,1948,10,female,245,50,42,13,26,13,10,0,16
1902104,24,4,1989,3,male,854,51,45,14,5,0,2,14,3
1072591,60,27,1953,8,male,706,51,12,14,6,0,0,14,6
2168818,67,19,1946,9,male,54,51,47,14,12,1,6,13,6
1234625,69,20,1944,6,female,141,51,34,14,99,0,24,14,75
1234728,15,19,1998,4,male,119,50,39,14,37,7,11,7,26
1652865,15,4,1998,11,female,153,51,28,14,0,14,0,0,0
1727065,21,6,1992,2,male,228,51,15,14,2,14,2,0,0
1797509,51,25,1962,3,male,652,50,31,14,0,14,0,0,0
1729315,51,23,1962,4,female,426,50,31,14,2,14,2,0,0
1833450,13,21,2000,6,female,21,50,41,14,4,14,3,0,1
1047617,15,9,1998,9,male,27,50,43,14,4,14,0,0,4
1583022,43,12,1970,8,male,534,50,26,14,6,14,6,0,0
1386745,65,30,1948,6,male,649,50,34,14,6,14,5,0,1
2012693,42,10,1971,7,male,225,51,32,14,16,14,14,0,2
1770860,19,4,1994,10,male,168,51,34,14,68,14,2,0,66
2076337,89,1,1924,4,male,2058,51,31,15,1,0,0,15,1
1209216,103,19,1910,3,male,1755,51,25,15,8,0,7,15,1
1354538,65,29,1948,6,male,245,50,28,15,30,0,12,15,18
1565363,54,9,1959,4,male,622,50,41,15,21,7,13,8,8
1249848,49,19,1964,11,male,260,50,50,15,9,12,4,3,5
1457849,22,7,1991,4,female,455,50,43,15,22,14,18,1,4
1016387,25,24,1988,8,male,35,50,31,15,2,15,2,0,0
1572864,20,3,1993,3,male,366,51,27,15,8,15,8,0,0
1400342,27,26,1986,10,female,543,50,33,15,57,15,18,0,39
1331754,34,6,1979,11,male,616,51,21,16,11,0,1,16,10
1722244,42,11,1971,10,female,571,50,32,16,35,1,4,15,31
1705512,58,22,1955,10,male,72,51,50,16,8,4,5,12,3
1632416,29,18,1984,2,male,652,50,50,16,0,16,0,0,0
1087231,64,11,1949,1,male,186,51,43,17,3,0,1,17,2
1368307,25,17,1988,2,male,159,50,42,17,4,10,1,7,3
1877160,24,3,1989,12,male,508,51,34,17,7,17,5,0,2
1952918,52,16,1961,10,male,421,51,47,17,4,17,3,0,1
1942937,29,27,1984,6,male,212,50,47,17,16,17,14,0,2
1605178,51,25,1962,7,male,751,50,24,17,16,17,4,0,12
1720742,70,20,1943,11,male,726,50,17,17,24,17,11,0,13
2116612,24,13,1989,3,female,215,50,23,17,29,17,24,0,5
1495930,73,7,1940,9,female,54,51,10,17,46,17,45,0,1
1616870,44,12,1969,6,male,340,51,33,18,5,0,0,18,5
1327140,79,3,1934,9,female,616,50,23,18,36,0,15,18,21
1739113,72,22,1941,6,female,1823,50,13,18,16,12,8,6,8
1192245,45,9,1968,8,female,654,51,19,18,46,17,10,1,36
1367181,39,7,1974,12,female,457,50,39,18,1,18,1,0,0
2178133,22,21,1991,5,male,52,50,50,18,7,18,6,0,1
1498227,44,17,1969,8,male,399,51,37,18,3,18,0,0,3
1364735,66,24,1947,7,female,822,51,29,18,3,18,3,0,0
1181956,57,4,1956,9,female,432,51,25,18,19,18,17,0,2
1270482,17,16,1996,3,male,168,50,26,18,33,18,26,0,7
1501976,17,10,1996,5,male,212,50,29,18,36,18,32,0,4
1637621,20,20,1993,4,male,155,50,23,19,7,14,0,5,7
1793733,18,26,1995,2,male,233,50,45,19,1,19,0,0,1
2060989,29,25,1984,12,male,547,51,43,19,0,19,0,0,0
2157272,70,19,1943,9,female,531,50,37,19,4,19,4,0,0
1729528,22,26,1991,1,female,729,51,23,19,56,19,21,0,35
1195772,35,8,1978,4,female,554,50,21,19,35,19,17,0,18
1373827,63,23,1950,10,male,343,50,20,20,1,6,1,14,0
1770185,29,25,1984,2,male,438,51,48,20,3,16,3,4,0
1612275,41,31,1972,5,female,447,51,19,20,16,16,12,4,4
1285804,66,25,1947,3,NA,1622,50,26,20,26,19,19,1,7
1341328,32,5,1981,6,male,381,50,26,20,0,20,0,0,0
1899567,25,1,1988,1,male,292,51,34,20,10,20,10,0,0
1681582,48,18,1965,7,male,1315,50,18,20,7,20,7,0,0
2027588,106,1,1907,12,female,174,50,22,20,5,20,2,0,3
1965898,94,1,1919,1,male,431,50,39,20,27,20,22,0,5
1123902,24,26,1989,9,male,21,51,41,21,6,18,6,3,0
2040137,13,19,2000,2,male,19,50,49,21,12,21,10,0,2
1354292,37,15,1976,1,male,153,50,49,21,6,21,5,0,1
1713612,65,20,1948,7,female,170,50,45,22,1,0,0,22,1
1137855,65,4,1948,8,male,648,50,23,22,28,0,20,22,8
1592698,25,25,1988,2,female,621,51,19,22,8,22,7,0,1
1190058,69,22,1944,6,female,10,50,45,22,11,22,10,0,1
1873333,97,8,1916,4,female,444,51,16,22,32,22,12,0,20
1323014,31,28,1982,9,male,71,51,26,22,70,22,58,0,12
1614689,18,6,1995,11,female,257,50,35,23,1,0,1,23,0
1013678,71,24,1942,8,male,1725,50,34,23,12,12,1,11,11
1339211,17,7,1996,9,male,382,51,43,23,0,23,0,0,0
1645756,49,29,1964,10,male,877,51,44,23,0,23,0,0,0
1748482,21,28,1992,11,female,67,50,41,23,19,23,15,0,4
1310585,25,15,1988,4,female,43,51,22,23,74,23,71,0,3
1007808,34,16,1979,7,female,430,51,27,23,36,23,21,0,15
1601424,39,22,1974,2,female,172,50,40,23,130,23,130,0,0
1418559,18,15,1995,7,male,36,51,45,24,12,3,3,21,9
2092243,23,24,1990,12,female,207,50,26,24,11,15,10,9,1
1304071,41,31,1972,3,male,489,50,19,24,5,14,1,10,4
2052321,51,12,1962,6,male,102,51,35,24,16,14,8,10,8
1575787,54,23,1959,7,male,493,50,33,24,30,24,26,0,4
1315403,15,16,1998,7,male,46,51,22,25,0,1,0,24,0
2032761,51,21,1962,3,male,338,51,18,25,28,0,7,25,21
2139284,31,9,1982,10,male,488,51,23,25,17,25,14,0,3
1799729,50,5,1963,12,female,299,51,14,25,23,25,22,0,1
1207355,63,24,1950,12,male,1395,50,23,25,19,25,16,0,3
1601296,22,1,1991,9,male,312,51,31,25,39,25,24,0,15
2040401,23,27,1990,3,male,346,51,24,25,42,25,14,0,28
1598101,49,26,1964,12,female,1794,50,19,25,170,25,66,0,104
1881482,23,15,1990,8,male,197,51,45,26,3,0,0,26,3
1847890,47,3,1966,6,male,1020,50,27,26,8,0,5,26,3
1636908,108,26,1905,10,female,1104,51,23,26,68,0,51,26,17
1139107,63,11,1950,7,male,1022,50,36,26,4,26,4,0,0
1629943,53,3,1960,6,male,261,51,35,26,6,26,4,0,2
1546720,15,27,1998,12,male,355,50,30,27,13,0,1,27,12
2005946,46,13,1967,5,female,779,50,41,27,5,27,2,0,3
1750772,80,20,1933,5,male,1140,50,25,27,11,27,10,0,1
1150831,108,24,1905,1,female,360,50,20,27,6,27,6,0,0
1011949,23,8,1990,10,female,37,51,44,27,80,27,78,0,2
2037000,18,23,1995,10,male,10,51,43,28,21,0,9,28,12
2031512,67,28,1946,7,female,662,50,32,28,21,0,0,28,21
1609281,45,9,1968,2,male,94,50,19,28,27,7,11,21,16
1164793,14,9,1999,4,male,193,50,37,28,24,22,5,6,19
1397233,23,7,1990,12,male,310,50,39,28,11,28,7,0,4
1361832,24,4,1989,3,male,428,51,37,28,11,28,6,0,5
1358084,18,19,1995,1,male,89,50,40,28,27,28,15,0,12
2105454,41,16,1972,9,male,28,50,32,28,20,28,19,0,1
1905761,19,30,1994,1,male,146,50,26,29,10,2,3,27,7
1579894,35,16,1978,2,female,1136,51,29,29,39,0,18,29,21
1373856,56,17,1957,3,female,1631,50,34,29,22,2,12,27,10
1984220,69,13,1944,10,male,630,50,39,29,83,0,27,29,56
1041321,26,1,1987,1,female,289,51,39,29,14,17,5,12,9
1747651,21,3,1992,5,male,334,51,43,29,9,26,6,3,3
1537453,33,30,1980,5,male,148,50,44,29,84,29,54,0,30
2123227,21,23,1992,2,female,295,50,25,30,10,1,7,29,3
1386185,54,9,1959,10,female,391,50,40,31,32,0,22,31,10
1999053,70,4,1943,6,male,422,50,34,30,47,0,30,30,17
2114253,52,27,1961,4,male,30,50,44,31,0,31,0,0,0
1144173,23,25,1990,6,male,294,51,49,30,8,30,6,0,2
1750936,23,10,1990,4,female,220,51,28,30,43,30,43,0,0
1244914,35,1,1978,11,male,325,50,24,30,34,30,24,0,10
1168222,55,22,1958,9,male,80,50,41,30,43,30,25,0,18
1224884,65,17,1948,3,female,780,50,37,30,38,30,25,0,13
2028840,35,10,1978,10,female,113,50,37,31,63,31,48,0,15
1377509,58,10,1955,3,male,767,51,33,33,10,0,9,33,1
1738677,63,18,1950,6,male,2210,51,37,33,42,24,33,9,9
1344111,60,14,1953,5,male,1001,50,27,33,81,27,58,6,23
2109674,74,1,1939,3,male,142,50,38,33,0,33,0,0,0
1957812,29,24,1984,8,female,602,51,29,33,20,33,14,0,6
1809053,46,27,1967,7,female,371,51,24,33,16,33,12,0,4
1560561,23,29,1990,7,male,28,51,40,34,15,14,6,20,9
1874371,54,23,1959,3,male,839,51,35,34,13,34,12,0,1
1202042,25,14,1988,6,female,684,51,33,34,88,34,71,0,17
2048367,73,14,1940,4,female,1557,50,28,36,1,3,1,33,0
1959431,60,10,1953,1,female,863,51,31,35,28,0,15,35,13
1507755,32,10,1981,1,female,429,51,17,36,19,16,9,20,10
1873702,38,15,1975,4,male,343,51,24,36,26,12,7,24,19
1823020,59,25,1954,4,female,543,50,19,36,32,35,15,1,17
1997438,38,31,1975,1,male,417,50,17,36,4,36,2,0,2
1523219,64,13,1949,12,female,324,50,37,36,5,36,3,0,2
1107685,25,21,1988,12,female,500,50,36,35,29,35,24,0,5
2161619,40,22,1973,10,female,482,50,19,35,45,35,34,0,11
1917003,61,25,1952,9,male,268,50,34,35,26,35,24,0,2
2077765,31,12,1982,6,male,52,51,29,36,75,36,64,0,11
1678721,44,14,1969,3,male,1056,51,23,36,74,36,55,0,19
1834845,49,24,1964,8,female,1048,50,26,37,4,0,2,37,2
1961992,71,19,1942,2,female,375,50,32,37,4,20,4,17,0
1438997,23,1,1990,7,male,121,51,32,37,2,37,2,0,0
1050813,25,16,1988,5,female,1099,51,16,37,3,37,3,0,0
1240129,43,4,1970,12,male,511,50,32,37,18,37,12,0,6
2099550,33,1,1980,4,female,135,51,37,37,23,37,15,0,8
1984411,108,10,1905,6,male,1028,50,19,37,34,37,28,0,6
1713279,14,28,1999,11,male,267,50,28,38,1,0,0,38,1
1313714,27,15,1986,3,male,148,50,36,38,10,0,5,38,5
1651465,63,9,1950,12,male,522,50,29,39,67,0,4,39,63
1355129,41,1,1972,9,female,429,50,32,39,13,37,8,2,5
1675985,52,5,1961,9,female,63,50,35,39,9,39,9,0,0
1059777,108,11,1905,1,male,855,50,24,38,8,38,5,0,3
1035890,25,7,1988,7,female,160,51,35,39,79,39,19,0,60
2131014,50,9,1963,9,female,211,51,25,39,59,39,31,0,28
1285180,27,14,1986,2,male,248,50,32,40,29,0,16,40,13
2087740,42,9,1971,7,male,647,51,40,40,30,15,24,25,6
1266506,53,15,1960,7,female,219,51,21,40,6,40,4,0,2
1527013,73,23,1940,8,female,221,51,9,40,9,40,8,0,1
1406181,96,12,1917,4,male,14,51,48,40,14,40,11,0,3
1040725,43,3,1970,6,female,704,50,28,42,16,40,10,2,6
1599238,76,10,1937,12,male,534,50,42,41,24,41,13,0,11
1094220,36,1,1977,6,female,684,51,33,41,33,41,21,0,12
1313934,108,17,1905,1,male,1516,50,26,41,46,41,45,0,1
1420075,34,16,1979,6,male,121,50,42,42,323,42,317,0,6
1031909,52,1,1961,10,male,600,50,33,43,3,0,0,43,3
2129582,108,28,1905,11,female,1813,51,23,43,3,0,1,43,2
1764161,13,14,2000,2,female,64,51,38,44,4,44,2,0,2
1919952,49,18,1964,2,female,731,50,14,44,2,44,2,0,0
1579531,50,17,1963,11,female,605,50,34,43,16,43,16,0,0
1564675,101,10,1912,7,male,71,51,24,44,29,44,23,0,6
1582542,25,5,1988,5,male,293,51,26,45,3,0,3,45,0
1071441,48,30,1965,4,female,334,50,15,45,68,43,29,2,39
1141505,53,29,1960,1,female,650,50,40,45,4,45,1,0,3
1700102,15,26,1998,7,female,386,50,41,45,13,45,10,0,3
1965117,26,19,1987,4,female,194,50,23,45,22,45,15,0,7
1575835,29,3,1984,12,male,218,50,40,45,41,45,38,0,3
1114246,74,14,1939,11,female,675,50,16,47,7,0,3,47,4
1200896,100,1,1913,1,male,313,50,38,46,3,7,0,39,3
1173729,52,13,1961,11,female,1185,51,46,46,24,0,3,46,21
1895750,63,11,1950,3,male,671,50,34,46,21,0,5,46,16
1444398,37,10,1976,9,male,380,51,27,46,6,45,3,1,3
1051889,37,2,1976,3,male,226,51,35,46,22,46,10,0,12
1470104,39,16,1974,4,female,268,50,24,47,69,47,13,0,56
2077861,22,2,1991,1,female,171,51,12,47,78,47,47,0,31
2035399,38,12,1975,7,male,160,51,43,48,15,1,4,47,11
1713127,67,5,1946,5,female,368,50,44,48,16,0,2,48,14
1665783,31,1,1982,9,female,584,50,29,48,19,24,7,24,12
2178422,36,15,1977,5,male,437,51,25,49,29,22,10,27,19
1132777,18,4,1995,10,male,363,51,32,49,31,11,18,38,13
1359685,108,6,1905,10,male,92,50,37,48,20,47,15,1,5
1604767,17,9,1996,8,female,628,50,20,48,3,48,3,0,0
2060881,33,28,1980,3,male,440,50,37,48,2,48,2,0,0
1359628,28,1,1985,10,male,361,50,36,48,11,48,9,0,2
1108657,31,13,1982,10,male,360,50,12,48,145,48,107,0,38
1534853,54,7,1959,8,female,390,50,41,50,20,0,15,50,5
1122444,16,25,1997,3,female,217,51,28,53,19,0,4,53,15
1956528,63,21,1950,11,male,320,51,25,53,20,0,7,53,13
1353907,40,15,1973,1,female,449,51,34,53,22,24,13,29,9
1583860,39,19,1974,7,female,520,51,17,53,1,53,1,0,0
1489024,17,2,1996,3,male,298,50,34,54,2,12,1,42,1
1269391,68,14,1945,3,male,323,51,41,54,1,52,1,2,0
1614032,32,8,1981,11,female,194,50,33,55,2,55,2,0,0
2017031,20,9,1993,6,female,233,50,31,55,146,55,113,0,33
1687081,67,27,1946,12,male,135,50,27,57,6,0,5,57,1
1387718,63,12,1950,7,male,342,51,22,56,10,0,0,56,10
1923988,108,1,1905,1,male,847,51,34,57,11,0,0,57,11
1737731,17,1,1996,11,male,86,50,32,56,26,32,15,24,11
1468710,63,27,1950,1,female,2300,50,18,58,56,49,31,9,25
1507052,51,13,1962,1,female,344,50,27,57,110,51,75,6,35
1977246,71,11,1942,3,female,599,50,32,56,3,56,2,0,1
1955862,24,3,1989,3,female,120,51,35,58,31,58,28,0,3
2099766,62,31,1951,1,female,1343,51,32,60,17,0,8,60,9
1344578,52,14,1961,2,male,711,50,32,59,101,0,51,59,50
1355085,31,22,1982,9,male,859,50,43,60,4,60,4,0,0
2076172,17,21,1996,10,female,133,51,45,60,28,60,24,0,4
2111706,100,10,1913,4,male,189,51,31,59,13,59,12,0,1
2119141,26,14,1987,4,female,674,50,24,59,81,59,50,0,31
1890100,14,10,1999,10,female,140,50,29,61,7,0,2,61,5
2168716,16,1,1997,9,male,209,50,30,63,6,0,0,63,6
1233900,23,3,1990,11,female,502,50,21,62,67,53,41,9,26
1587493,37,27,1976,11,female,296,51,12,62,69,62,61,0,8
1819150,42,10,1971,9,male,641,50,17,61,55,61,35,0,20
1141979,65,14,1948,12,female,416,50,33,64,43,0,12,64,31
1067425,23,15,1990,12,female,150,51,41,65,127,50,28,15,99
1587113,22,1,1991,3,male,648,50,24,67,3,1,2,66,1
1724032,52,12,1961,5,male,851,50,15,68,15,26,6,42,9
1272875,68,30,1945,4,male,1235,51,36,67,95,38,50,29,45
1243578,27,13,1986,12,male,219,51,32,67,90,58,71,9,19
2131050,31,21,1982,11,female,292,50,40,69,45,27,20,42,25
1410654,36,9,1977,12,female,606,51,31,70,2,65,1,5,1
1968345,74,17,1939,2,male,1585,50,28,70,4,67,3,3,1
1786911,29,15,1984,5,female,107,50,36,71,23,71,23,0,0
1248608,33,11,1980,2,male,556,50,25,71,19,71,18,0,1
1537335,54,4,1959,10,male,644,51,40,69,179,69,157,0,22
1145284,77,4,1936,9,female,1483,51,16,73,114,1,84,72,30
1182110,22,28,1991,5,male,288,50,37,74,7,69,4,5,3
2116295,27,6,1986,6,male,193,50,38,72,4,72,3,0,1
2045521,37,28,1976,9,female,466,51,21,73,87,73,78,0,9
2140774,48,23,1965,8,female,339,51,21,73,58,73,44,0,14
1306837,90,9,1923,10,male,53,51,51,75,5,0,3,75,2
2009230,63,18,1950,9,male,776,51,7,75,64,0,23,75,41
1054327,37,14,1976,11,female,524,51,26,75,244,1,37,74,207
1149823,26,14,1987,7,male,663,51,48,75,8,25,2,50,6
1498023,30,8,1983,12,female,202,50,35,75,102,41,18,34,84
1118642,20,3,1993,6,male,354,51,33,76,0,76,0,0,0
1969766,21,1,1992,1,male,28,50,48,75,27,75,24,0,3
1567376,42,7,1971,5,female,415,50,39,79,65,12,22,67,43
1988966,57,6,1956,1,male,1298,50,10,80,30,23,9,57,21
1823804,35,26,1978,3,female,163,51,41,80,11,80,10,0,1
1560835,32,10,1981,7,female,195,50,40,79,30,79,27,0,3
1159199,42,13,1971,6,female,612,51,13,78,71,78,67,0,4
1037650,38,15,1975,12,female,715,50,16,81,22,45,9,36,13
1209552,53,7,1960,4,male,378,50,21,83,61,20,14,63,47
1349080,41,25,1972,12,male,278,51,37,82,41,82,37,0,4
2095369,31,29,1982,7,female,344,50,37,84,89,84,79,0,10
1307533,60,27,1953,7,female,519,50,44,85,5,0,0,85,5
2131583,19,18,1994,8,male,300,50,13,86,8,86,6,0,2
1208186,61,28,1952,9,male,34,51,45,86,5,86,3,0,2
1665345,71,3,1942,12,female,1638,51,26,87,19,87,11,0,8
1631567,39,8,1974,2,female,94,51,36,86,298,86,237,0,61
1737427,74,5,1939,12,female,935,50,23,91,58,0,20,91,38
2066682,18,1,1995,1,male,46,50,39,89,53,25,7,64,46
1694321,51,2,1962,10,female,637,50,29,91,86,29,54,62,32
1624752,19,2,1994,12,female,210,50,37,91,14,91,12,0,2
1043850,63,19,1950,7,female,203,50,28,95,1,0,0,95,1
1155444,46,29,1967,8,female,1295,50,20,93,63,34,28,59,35
1442413,53,17,1960,2,female,890,50,32,95,49,71,25,24,24
2061783,56,16,1957,9,female,851,50,26,94,39,78,33,16,6
1773686,27,22,1986,5,male,288,51,31,92,2,92,0,0,2
1804784,45,4,1968,10,female,594,50,34,94,9,94,3,0,6
1901718,20,27,1993,9,male,155,50,44,94,27,94,21,0,6
1519958,68,14,1945,7,female,397,50,34,99,68,96,44,3,24
1413686,39,1,1974,12,female,300,50,38,99,50,99,48,0,2
1198314,28,21,1985,11,female,306,50,32,98,122,98,79,0,43
1540755,36,13,1977,8,female,125,50,43,99,106,99,99,0,7
1033765,74,24,1939,9,female,78,51,42,101,14,0,9,101,5
2004268,25,19,1988,12,female,595,51,22,104,61,0,37,104,24
1146335,41,17,1972,6,female,85,50,37,101,62,0,13,101,49
2112642,23,3,1990,9,female,352,50,29,100,299,100,227,0,72
1297044,46,20,1967,10,female,460,51,31,101,279,101,135,0,144
1792530,17,9,1996,5,female,51,50,31,107,79,9,26,98,53
1202215,18,18,1995,8,female,45,50,29,106,69,27,10,79,59
2006643,59,12,1954,5,female,1272,50,14,107,31,98,25,9,6
1062158,34,27,1979,9,female,37,51,42,106,95,106,57,0,38
1229864,66,23,1947,9,male,380,50,14,105,82,105,59,0,23
1945937,52,13,1961,3,female,571,50,5,113,23,0,4,113,19
1462593,66,20,1947,11,female,141,51,40,111,1,111,0,0,1
1817382,69,17,1944,8,male,446,50,32,118,5,46,4,72,1
1323518,21,2,1992,4,male,187,51,14,114,57,113,42,1,15
1652243,42,5,1971,7,male,148,50,33,114,102,114,68,0,34
2150879,38,18,1975,9,male,389,50,35,114,198,114,87,0,111
1575155,69,24,1944,7,female,144,51,38,123,138,0,7,123,131
1970159,30,30,1983,3,male,453,50,28,124,29,124,26,0,3
1285334,61,29,1952,9,female,295,51,32,120,48,120,40,0,8
1605643,54,20,1959,7,female,149,51,28,121,78,121,60,0,18
1578818,21,25,1992,9,male,478,51,25,129,29,0,1,129,28
1268915,58,13,1955,12,female,304,51,34,128,59,0,51,128,8
1076588,22,4,1991,3,male,247,50,25,130,63,68,32,62,31
1478888,41,28,1972,3,female,518,50,27,125,42,70,30,55,12
1729548,21,4,1992,10,female,420,50,45,126,25,123,12,3,13
1568680,52,25,1961,8,female,152,51,34,126,62,94,28,32,34
1202337,26,20,1987,1,female,431,50,22,127,127,118,40,9,87
1172167,26,28,1987,4,female,12,51,30,128,114,126,76,2,38
1007585,53,6,1960,12,male,2409,51,27,125,27,124,16,1,11
2009259,74,1,1939,9,male,923,50,35,125,74,125,29,0,45
1972968,24,6,1989,2,female,273,51,32,128,139,128,113,0,26
1100628,37,4,1976,12,male,585,51,31,125,170,125,137,0,33
1353697,37,22,1976,4,female,508,51,26,132,12,0,2,132,10
1815118,61,21,1952,6,male,522,50,42,136,3,0,2,136,1
1439921,19,14,1994,3,male,414,51,35,135,36,126,27,9,9
1986609,47,18,1966,5,male,203,51,37,135,25,122,6,13,19
2135959,29,22,1984,5,female,1031,50,21,131,116,113,85,18,31
2083965,20,28,1993,2,male,172,51,44,136,2,136,1,0,1
2079300,33,20,1980,1,male,248,51,26,133,22,133,9,0,13
1186150,63,4,1950,7,female,1474,51,34,131,64,131,48,0,16
1774066,57,14,1956,11,female,586,50,15,139,14,0,0,139,14
1560218,62,28,1951,7,male,670,50,34,142,21,129,11,13,10
1933166,23,6,1990,12,male,196,51,49,143,13,143,3,0,10
1801506,39,6,1974,11,male,292,50,31,138,30,138,26,0,4
1727956,28,1,1985,3,female,192,50,15,143,135,143,94,0,41
1698407,16,1,1997,6,female,384,51,42,146,15,0,4,146,11
1372450,23,2,1990,1,male,556,50,29,149,40,11,19,138,21
1529912,27,12,1986,3,male,502,51,49,145,24,145,20,0,4
2118131,65,25,1948,4,female,1268,51,37,146,0,146,0,0,0
1436909,51,10,1962,11,male,554,50,35,146,45,146,44,0,1
1040179,56,20,1957,8,female,188,50,22,144,38,144,24,0,14
2113339,17,21,1996,3,female,467,51,27,152,48,150,6,2,42
1839871,36,21,1977,10,male,456,50,14,156,88,156,85,0,3
1639355,25,15,1988,5,male,280,50,45,164,2,0,1,164,1
1715648,22,1,1991,4,female,496,51,41,162,159,93,84,69,75
2044456,50,15,1963,10,female,1748,50,32,158,158,33,59,125,99
1045473,54,2,1959,4,male,126,50,30,160,11,160,2,0,9
1194969,14,16,1999,11,male,63,51,45,168,77,78,51,90,26
1987572,18,28,1995,12,male,107,51,48,165,151,138,57,27,94
1596757,43,3,1970,4,male,481,51,26,172,148,171,140,1,8
1403446,23,11,1990,3,female,138,51,21,171,980,170,238,1,742
1581964,14,14,1999,5,male,397,51,40,174,12,4,0,170,12
1453647,31,17,1982,1,female,290,50,28,178,77,0,50,178,27
1616838,57,21,1956,11,female,1497,51,37,176,213,129,135,47,78
1431539,46,5,1967,10,male,65,50,46,175,49,174,31,1,18
1373571,39,9,1974,2,female,254,50,24,176,74,176,30,0,44
2070079,25,11,1988,5,female,143,50,46,175,213,175,166,0,47
1806013,41,18,1972,1,female,230,51,28,179,113,179,94,0,19
1766089,74,3,1939,10,female,236,51,40,189,35,0,14,189,21
1061300,40,16,1973,9,female,183,51,33,184,11,184,3,0,8
1616437,56,2,1957,6,female,61,50,44,189,140,189,74,0,66
1308588,67,10,1946,1,female,221,50,40,200,25,0,10,200,15
1457691,23,14,1990,4,male,1571,51,19,191,24,149,15,42,9
2021539,26,4,1987,1,female,875,51,31,199,6,199,3,0,3
1768661,55,22,1958,5,female,1769,51,11,200,81,200,59,0,22
1004820,58,7,1955,10,female,225,51,46,191,96,191,61,0,35
1966262,55,2,1958,12,male,203,50,44,201,228,13,25,188,203
1726320,55,14,1958,2,female,2025,50,8,202,35,101,17,101,18
1449823,43,10,1970,7,male,401,51,17,201,18,201,15,0,3
1980413,103,23,1910,2,female,1860,51,32,208,30,208,15,0,15
1860548,57,12,1956,6,female,29,51,38,202,218,202,135,0,83
1066996,52,26,1961,2,female,1267,51,17,221,52,216,17,5,35
1149329,55,12,1958,8,female,1513,51,26,225,84,0,55,225,29
1790778,48,25,1965,12,male,335,51,44,230,15,220,7,10,8
1269705,53,25,1960,9,male,1006,51,14,223,145,221,80,2,65
1547652,102,5,1911,1,male,365,50,38,222,34,222,34,0,0
1660401,29,14,1984,11,female,179,51,38,227,42,227,39,0,3
1561404,59,9,1954,12,female,63,50,36,230,116,230,76,0,40
2120380,21,15,1992,4,male,537,50,33,242,100,0,58,242,42
1254244,70,15,1943,6,male,1444,50,21,242,48,66,23,176,25
2115341,58,9,1955,12,female,814,51,32,242,278,219,215,23,63
1973524,52,12,1961,12,female,1283,51,19,241,140,239,91,2,49
1793131,57,8,1956,3,female,59,51,38,235,84,234,54,1,30
1331569,30,16,1983,9,female,176,51,34,234,30,234,16,0,14
2000887,54,26,1959,3,female,586,51,41,236,115,236,18,0,97
1747327,30,11,1983,8,female,671,50,35,250,41,249,16,1,25
1646200,45,13,1968,5,male,261,51,27,257,91,257,83,0,8
1573778,47,8,1966,12,female,1361,50,24,270,470,135,359,135,111
1104501,27,15,1986,9,female,115,50,38,263,161,263,134,0,27
2149408,17,1,1996,1,female,301,50,36,288,67,186,23,102,44
1055699,13,17,2000,1,female,373,51,44,291,43,272,43,19,0
1369860,27,3,1986,10,male,440,51,16,292,38,292,31,0,7
1482859,54,20,1959,9,female,799,51,40,277,34,277,14,0,20
1866382,43,16,1970,4,female,649,50,27,280,482,280,401,0,81
1491055,53,22,1960,2,female,1027,50,15,299,46,299,29,0,17
1723826,32,28,1981,4,male,498,50,36,308,76,308,62,0,14
1778613,62,31,1951,5,female,636,50,36,320,14,0,4,320,10
1440865,100,5,1913,5,male,293,51,40,317,12,317,6,0,6
1337537,51,30,1962,5,female,211,51,33,311,70,311,18,0,52
1064941,63,10,1950,1,female,27,51,50,333,128,52,72,281,56
1583464,66,4,1947,6,female,2110,51,29,336,87,0,23,336,64
1231747,51,18,1962,11,male,1247,51,29,337,206,152,142,185,64
1801516,53,21,1960,1,female,393,50,38,336,145,333,72,3,73
1542434,36,9,1977,10,female,222,50,38,346,84,346,65,0,19
1427403,58,24,1955,6,female,78,50,33,356,95,1,17,355,78
1385243,58,27,1955,10,female,607,50,29,363,154,276,71,87,83
2166698,63,8,1950,6,female,170,50,24,352,23,352,16,0,7
2096230,76,3,1937,7,female,478,51,27,385,82,0,37,385,45
2025044,103,17,1910,10,female,641,51,38,374,172,157,80,217,92
1038964,60,5,1953,1,male,612,50,35,376,24,376,11,0,13
1169853,65,16,1948,2,female,1050,51,39,377,40,377,28,0,12
1343977,63,11,1950,4,female,497,51,20,411,147,14,40,397,107
2137514,54,17,1959,6,male,1422,50,23,396,75,172,56,224,19
1667357,47,1,1966,11,female,643,50,26,400,295,82,104,318,191
1698219,23,15,1990,3,female,384,50,36,396,374,372,209,24,165
1403678,46,14,1967,11,female,466,51,39,402,146,401,90,1,56
1217430,69,12,1944,5,female,714,50,31,429,237,0,13,429,224
1459180,30,10,1983,6,female,76,50,38,447,168,244,78,203,90
1043141,17,5,1996,2,female,30,51,45,426,118,426,96,0,22
1231880,67,7,1946,8,female,713,51,34,474,339,0,114,474,225
1387883,68,20,1945,1,female,71,51,36,477,43,477,29,0,14
1136483,58,4,1955,7,female,155,50,17,456,117,456,43,0,74
1955880,34,1,1979,1,female,214,50,32,515,700,0,57,515,643
2191231,24,16,1989,5,female,476,50,22,518,85,493,60,25,25
1390654,44,4,1969,4,female,1577,50,26,499,196,483,144,16,52
1208677,54,29,1959,6,female,1926,50,18,516,297,496,268,20,29
1800075,48,27,1965,7,female,173,50,34,503,166,503,108,0,58
2013086,108,22,1905,5,female,107,51,27,526,25,468,13,58,12
1342411,48,6,1965,3,female,77,50,36,558,360,558,267,0,93
1045703,52,3,1961,6,female,823,51,40,604,314,604,87,0,227
1427457,62,14,1951,2,male,144,50,31,600,145,600,135,0,10
1890118,45,11,1968,9,female,390,51,38,616,104,0,15,616,89
1460519,57,26,1956,6,female,150,50,20,693,211,285,23,408,188
1327779,49,22,1964,5,female,295,50,44,731,478,0,165,731,313
1255545,42,12,1971,2,female,162,51,25,731,98,729,70,2,28
1378841,57,2,1956,6,female,170,50,22,814,176,814,128,0,48
1532433,48,25,1965,6,male,1777,51,19,889,381,683,301,206,80
2038291,18,14,1995,9,male,315,51,37,978,13,978,12,0,1
1558263,41,8,1972,7,female,318,50,32,935,513,935,381,0,132
1055853,55,18,1958,12,female,80,51,19,1071,53,1071,31,0,22
1437821,63,29,1950,10,female,206,51,23,1172,351,0,96,1172,255
1622729,86,14,1927,2,female,421,50,8,1181,247,0,49,1181,198
1241072,22,7,1991,2,female,418,51,20,1284,226,1258,157,26,69
1765793,39,28,1974,5,female,644,51,26,1273,1855,924,1199,349,656
1891225,75,1,1938,6,female,802,50,34,1174,2,1165,2,9,0
1892256,56,1,1957,1,male,239,51,33,1157,109,1157,94,0,15
1501464,47,5,1966,11,female,311,51,18,1323,163,0,11,1323,152
1311965,19,15,1994,8,female,707,50,32,1980,873,1410,406,570,467
1564531,52,14,1961,3,female,347,50,26,2293,183,2293,91,0,92
1703637,49,31,1964,12,female,288,51,30,2820,61,0,12,2820,49
1891148,36,19,1977,3,female,544,51,43,3502,178,2968,139,534,39
1280149,47,3,1966,2,female,35,52,30,4,9,2,6,2,3
1480389,19,3,1994,2,male,356,52,15,4,8,3,4,1,4
1455534,44,12,1969,11,female,493,53,18,4,6,3,6,1,0
1805677,63,28,1950,2,female,1109,52,13,4,11,3,3,1,8
2021043,18,25,1995,9,male,104,52,47,4,0,4,0,0,0
1688966,27,1,1986,1,male,77,52,34,4,0,4,0,0,0
1225222,27,28,1986,9,male,650,52,39,4,0,4,0,0,0
1542750,32,1,1981,7,male,278,52,46,4,1,4,1,0,0
1886627,57,20,1956,8,male,628,52,45,4,1,4,0,0,1
1825481,18,15,1995,3,female,274,53,17,4,4,4,3,0,1
2049988,26,4,1987,1,male,98,52,45,4,5,4,4,0,1
1232578,44,24,1969,4,male,244,52,15,4,3,4,2,0,1
1527976,20,26,1993,9,male,119,52,23,4,13,4,7,0,6
1678179,24,4,1989,1,male,195,52,14,4,9,4,0,0,9
1473141,25,3,1988,3,male,719,52,28,4,6,4,4,0,2
1671630,58,30,1955,12,male,258,53,48,4,6,4,4,0,2
1990512,61,27,1952,12,female,498,52,10,4,10,4,8,0,2
1770793,21,23,1992,3,male,427,52,50,5,0,0,0,5,0
1137786,29,18,1984,1,male,290,53,17,5,0,0,0,5,0
1983034,46,6,1967,9,male,406,52,35,5,0,0,0,5,0
1339936,53,8,1960,7,female,526,52,38,5,2,0,0,5,2
1909946,19,15,1994,2,male,151,52,30,5,4,0,0,5,4
1486340,66,9,1947,9,male,45,53,44,5,7,0,2,5,5
1970588,17,28,1996,8,male,464,52,39,5,16,0,1,5,15
2031875,36,22,1977,4,female,313,53,46,5,2,2,2,3,0
1972138,55,8,1958,12,male,1685,53,25,5,2,2,1,3,1
1869842,54,16,1959,3,female,156,52,30,5,1,1,0,4,1
1759920,13,1,2000,1,male,116,52,36,5,4,3,3,2,1
1549952,30,4,1983,5,male,235,53,41,5,7,4,3,1,4
1962530,32,16,1981,3,male,296,53,33,5,0,5,0,0,0
1279386,40,19,1973,11,male,502,52,33,5,0,5,0,0,0
1022213,16,4,1997,10,male,21,52,38,5,2,5,2,0,0
1724108,21,11,1992,8,male,219,53,46,5,1,5,1,0,0
2102155,50,15,1963,12,male,903,52,17,5,3,5,2,0,1
1867702,62,24,1951,4,male,630,53,27,5,1,5,1,0,0
1246588,22,18,1991,8,male,425,53,17,5,6,5,3,0,3
1664742,108,1,1905,2,female,175,53,30,5,4,5,2,0,2
1983596,17,15,1996,8,male,212,53,41,5,13,5,13,0,0
1068583,20,28,1993,11,female,365,53,43,5,33,5,13,0,20
1500088,21,6,1992,9,male,549,52,20,5,15,5,12,0,3
2120904,24,20,1989,3,female,74,53,25,5,9,5,7,0,2
1193605,33,16,1980,10,female,188,52,34,5,53,5,34,0,19
1577569,57,6,1956,10,female,265,53,21,5,14,5,9,0,5
1382390,67,13,1946,2,male,609,53,38,5,181,5,59,0,122
1669344,23,10,1990,5,female,772,53,9,6,0,0,0,6,0
1561446,87,14,1926,3,NA,1997,52,24,6,0,0,0,6,0
2137433,15,18,1998,2,female,385,53,34,6,5,0,4,6,1
1682397,42,13,1971,2,male,174,53,36,6,7,0,5,6,2
1528237,21,27,1992,1,male,240,52,28,6,14,0,6,6,8
1172053,26,18,1987,3,male,65,53,43,6,2,2,0,4,2
1447523,49,15,1964,4,male,240,53,38,6,3,4,2,2,1
2106517,40,3,1973,1,male,1741,53,12,6,6,5,4,1,2
1209952,43,21,1970,5,female,294,53,35,6,22,5,11,1,11
1770282,16,12,1997,8,male,544,52,38,6,0,6,0,0,0
1390251,25,1,1988,1,male,155,52,27,6,0,6,0,0,0
2163859,26,27,1987,9,male,453,52,47,6,0,6,0,0,0
1535031,18,14,1995,7,male,416,52,28,6,1,6,0,0,1
1780141,26,1,1987,9,male,110,53,39,6,1,6,1,0,0
1855756,27,26,1986,6,male,220,52,39,6,3,6,3,0,0
1605874,29,13,1984,11,male,526,53,51,6,5,6,5,0,0
1133404,62,31,1951,5,male,1844,52,25,6,4,6,2,0,2
1503157,16,10,1997,9,male,10,53,48,6,20,6,9,0,11
1292293,18,25,1995,11,female,66,53,21,6,9,6,7,0,2
1423396,22,5,1991,5,female,111,53,32,6,9,6,4,0,5
2154371,23,12,1990,9,male,269,52,12,6,11,6,11,0,0
1428091,28,19,1985,7,male,11,53,51,6,9,6,9,0,0
1976235,40,2,1973,12,male,759,53,23,6,39,6,28,0,11
1447363,40,6,1973,6,male,329,52,39,6,16,6,15,0,1
1589996,33,19,1980,9,female,482,53,31,7,0,0,0,7,0
1446641,64,15,1949,9,male,1000,53,9,7,3,0,1,7,2
2090662,20,4,1993,2,male,165,53,33,7,5,0,1,7,4
1668763,23,28,1990,2,male,324,52,44,7,7,1,4,6,3
1186005,15,24,1998,11,female,126,52,12,7,2,2,0,5,2
1408807,19,18,1994,10,female,276,52,42,7,19,4,10,3,9
2180364,15,29,1998,5,male,306,53,22,7,1,7,1,0,0
2161334,28,4,1985,5,female,185,52,39,7,1,7,0,0,1
1620238,43,19,1970,12,male,268,52,32,7,1,7,1,0,0
2070707,26,1,1987,1,male,41,52,49,7,3,7,3,0,0
1204832,49,27,1964,4,male,745,53,38,7,4,7,3,0,1
1091719,58,16,1955,9,male,677,52,29,7,4,7,4,0,0
1797754,18,18,1995,12,male,401,53,33,7,7,7,6,0,1
1279295,24,8,1989,2,male,786,53,30,7,5,7,4,0,1
1841287,26,10,1987,5,male,245,53,41,7,10,7,10,0,0
1337305,60,16,1953,5,female,2209,53,20,7,8,7,5,0,3
1400204,108,30,1905,7,male,43,53,46,7,8,7,3,0,5
1851013,25,11,1988,3,female,109,53,17,7,14,7,11,0,3
1440247,33,6,1980,7,male,599,53,31,7,21,7,16,0,5
1373337,39,25,1974,7,male,308,53,44,7,20,7,19,0,1
1580788,40,16,1973,5,male,440,53,28,7,32,7,22,0,10
1240450,47,31,1966,12,female,255,53,24,7,31,7,29,0,2
1091921,62,10,1951,10,male,1377,53,19,7,23,7,14,0,9
1492605,64,20,1949,3,female,1508,52,20,7,17,7,11,0,6
1967337,27,14,1986,5,male,319,53,22,8,0,0,0,8,0
1093228,53,3,1960,4,male,415,53,42,8,2,0,0,8,2
2071305,18,28,1995,1,male,561,52,36,8,12,0,3,8,9
1118435,32,19,1981,10,male,474,53,19,8,20,0,5,8,15
1356141,32,31,1981,12,female,327,52,23,8,0,5,0,3,0
1348983,49,20,1964,6,female,2257,52,24,8,23,4,15,4,8
1662444,30,2,1983,3,male,436,53,21,8,18,7,14,1,4
1500216,34,12,1979,10,male,2390,52,12,8,23,6,17,2,6
1982166,26,20,1987,12,female,625,53,30,8,0,8,0,0,0
1418449,30,22,1983,2,male,265,53,44,8,0,8,0,0,0
2113178,52,4,1961,8,male,551,52,39,8,1,8,1,0,0
2054440,17,1,1996,9,male,554,52,37,8,3,8,2,0,1
2087432,40,12,1973,11,female,503,53,43,8,8,8,6,0,2
2181588,47,5,1966,9,female,71,52,25,8,32,8,25,0,7
1879447,18,2,1995,1,female,322,52,34,9,2,0,0,9,2
1812858,68,28,1945,1,female,404,52,34,9,3,0,2,9,1
1713351,57,4,1956,4,male,787,53,19,9,13,0,8,9,5
1307021,39,21,1974,7,male,583,53,34,9,19,0,1,9,18
1506524,70,12,1943,9,female,915,53,17,9,36,0,10,9,26
1325592,31,12,1982,8,female,372,53,30,9,18,7,11,2,7
1792212,18,11,1995,12,male,296,53,14,9,0,9,0,0,0
2054649,22,18,1991,8,male,406,53,45,9,1,9,1,0,0
1824504,25,25,1988,7,female,204,52,19,9,1,9,1,0,0
1586120,40,8,1973,6,male,261,53,39,9,0,9,0,0,0
1092646,26,15,1987,10,male,593,52,43,9,2,9,2,0,0
1262999,25,1,1988,1,male,116,53,41,9,6,9,6,0,0
2015214,42,24,1971,2,male,174,52,36,9,8,9,8,0,0
2001980,23,17,1990,1,male,279,52,36,9,40,9,35,0,5
1480021,23,21,1990,4,male,95,53,41,9,25,9,14,0,11
1580342,33,15,1980,11,male,37,52,45,9,20,9,16,0,4
1715881,43,12,1970,8,female,186,53,41,9,21,9,14,0,7
1046112,22,29,1991,1,male,1013,52,46,10,0,0,0,10,0
2001077,56,13,1957,5,female,488,52,22,10,1,0,0,10,1
1441291,60,18,1953,10,female,419,52,41,10,6,0,3,10,3
1250662,47,23,1966,8,female,400,53,37,10,29,0,3,10,26
1876936,31,15,1982,8,male,325,53,37,10,10,2,5,8,5
1697643,38,14,1975,5,male,618,52,32,10,10,7,8,3,2
1072714,17,2,1996,3,male,122,52,41,10,1,10,1,0,0
1743744,17,4,1996,7,male,93,52,16,10,0,10,0,0,0
1066758,19,20,1994,11,female,484,52,32,10,1,10,1,0,0
2174833,29,25,1984,11,male,348,53,33,10,0,10,0,0,0
2134717,15,22,1998,10,male,179,52,31,10,4,10,1,0,3
1612322,25,27,1988,2,male,208,53,22,10,47,10,20,0,27
1210207,25,2,1988,8,male,397,52,41,10,19,10,17,0,2
1850781,51,1,1962,1,female,1744,52,23,10,23,10,22,0,1
1632516,103,13,1910,2,female,1483,52,25,11,1,0,1,11,0
1213690,108,26,1905,12,male,1731,53,13,11,6,0,2,11,4
1800909,55,23,1958,4,female,216,53,19,11,107,0,39,11,68
1332208,50,5,1963,2,male,295,53,8,11,5,7,2,4,3
1942753,26,10,1987,7,male,233,53,43,11,5,11,4,0,1
1066173,69,20,1944,5,male,1271,53,35,11,5,11,4,0,1
1042935,19,3,1994,8,male,707,53,10,11,19,11,14,0,5
1701050,21,30,1992,6,male,791,52,31,11,24,11,24,0,0
2189808,27,14,1986,7,male,255,53,13,12,0,12,0,0,0
1556635,27,1,1986,8,male,416,53,36,12,1,12,1,0,0
1271235,45,8,1968,11,male,656,53,31,12,1,12,0,0,1
2154032,31,26,1982,1,male,391,53,37,12,3,12,2,0,1
1019624,48,10,1965,4,female,1460,53,36,12,14,12,9,0,5
2154600,34,24,1979,1,male,255,52,40,12,29,12,28,0,1
1028543,48,16,1965,3,female,1512,53,23,12,56,12,50,0,6
1622111,23,19,1990,5,male,371,53,39,13,2,0,0,13,2
1479950,22,21,1991,12,female,27,53,36,13,38,12,17,1,21
1821338,52,8,1961,3,female,382,52,49,13,4,13,4,0,0
1147577,32,24,1981,9,female,147,53,38,13,19,13,14,0,5
1806226,45,12,1968,1,female,1137,53,26,13,104,13,95,0,9
1326313,28,14,1985,2,male,272,53,28,14,2,0,0,14,2
2016552,63,25,1950,8,female,87,53,36,14,6,0,4,14,2
1640753,78,22,1935,2,male,311,53,39,14,4,0,1,14,3
1193657,65,3,1948,12,female,363,53,39,14,37,0,9,14,28
1157771,39,4,1974,10,female,433,53,13,14,56,9,52,5,4
1924732,33,17,1980,12,male,461,52,34,14,14,13,13,1,1
1898305,98,29,1915,7,male,51,52,40,14,2,14,2,0,0
1047735,20,24,1993,8,female,413,53,10,14,7,14,4,0,3
1161600,22,31,1991,10,male,248,52,29,14,3,14,3,0,0
1333308,34,27,1979,11,male,227,53,18,14,4,14,3,0,1
1101298,16,8,1997,12,female,73,53,49,14,19,14,18,0,1
1176171,22,14,1991,12,male,67,53,49,14,9,14,7,0,2
2031588,23,15,1990,2,female,318,52,21,14,54,14,53,0,1
1873018,61,16,1952,9,female,852,53,24,15,21,13,4,2,17
1401959,64,16,1949,5,male,734,53,33,15,10,13,7,2,3
1066197,16,9,1997,1,male,210,53,43,15,4,15,4,0,0
1810034,36,16,1977,8,male,97,53,51,15,4,15,1,0,3
1254572,43,12,1970,12,male,560,53,46,15,4,15,2,0,2
1192558,20,10,1993,5,male,171,52,39,15,17,15,10,0,7
2031078,38,17,1975,10,male,509,52,26,15,14,15,10,0,4
2182821,68,12,1945,2,female,1743,53,31,16,10,0,7,16,3
1398363,51,5,1962,7,female,111,53,34,16,62,6,45,10,17
1904136,28,19,1985,11,male,201,52,36,16,1,16,0,0,1
1017612,67,2,1946,12,male,670,53,32,16,7,16,3,0,4
1155331,27,7,1986,9,male,147,53,37,16,24,16,17,0,7
1572083,48,16,1965,10,female,1569,52,16,17,8,0,8,17,0
2157242,61,24,1952,1,female,902,52,23,17,5,0,3,17,2
1617908,76,19,1937,7,male,1399,52,38,17,38,0,11,17,27
2000766,21,12,1992,11,female,224,53,41,17,2,9,2,8,0
1244046,41,6,1972,3,male,302,52,36,17,0,14,0,3,0
1151797,66,25,1947,2,female,604,53,32,17,5,16,2,1,3
1896937,27,29,1986,8,male,50,52,44,17,0,17,0,0,0
1878953,28,30,1985,1,female,377,53,23,17,0,17,0,0,0
1748010,18,8,1995,8,male,75,53,46,17,18,17,18,0,0
2017755,20,15,1993,7,female,58,53,23,17,19,17,13,0,6
1422996,70,20,1943,11,female,1761,52,26,17,34,17,19,0,15
1615853,72,11,1941,2,male,907,52,34,17,42,17,30,0,12
2086649,47,7,1966,8,male,443,52,20,18,7,0,1,18,6
2185698,53,18,1960,1,female,233,52,35,18,14,1,2,17,12
1798648,32,11,1981,5,male,81,52,33,18,0,18,0,0,0
1236590,14,26,1999,5,male,83,53,39,18,9,18,6,0,3
1832937,18,23,1995,8,male,103,52,35,18,5,18,4,0,1
2050944,64,15,1949,5,male,1338,53,20,18,13,18,11,0,2
1463918,33,9,1980,7,male,901,53,9,18,56,18,46,0,10
1018974,43,12,1970,12,male,82,53,36,18,43,18,41,0,2
1540132,66,23,1947,12,female,1773,52,7,19,5,0,2,19,3
1399355,71,22,1942,2,female,1066,52,39,19,7,0,4,19,3
1393658,103,3,1910,7,male,1231,53,36,19,17,0,3,19,14
1569396,29,10,1984,10,male,168,52,26,19,0,19,0,0,0
1439471,51,3,1962,4,male,575,53,35,19,1,19,0,0,1
1567754,25,20,1988,4,female,555,52,30,19,9,19,1,0,8
1474146,47,6,1966,12,female,404,52,33,19,5,19,4,0,1
1419664,63,30,1950,8,male,1290,52,31,19,18,19,12,0,6
1487690,16,13,1997,12,male,1,53,50,20,4,0,3,20,1
1429769,22,4,1991,11,female,552,53,25,20,5,0,1,20,4
1223719,108,5,1905,2,male,1022,53,18,20,27,2,4,18,23
1995184,26,28,1987,6,female,303,53,23,20,11,10,11,10,0
1311596,66,18,1947,6,male,940,53,29,20,102,10,51,10,51
1453080,23,1,1990,10,male,464,52,39,20,0,19,0,1,0
1328228,31,1,1982,1,female,193,52,24,20,2,20,1,0,1
1015469,36,31,1977,12,male,232,52,43,20,7,20,1,0,6
2186687,22,22,1991,10,male,137,53,37,20,13,20,5,0,8
1902471,35,25,1978,4,female,384,52,29,20,26,20,26,0,0
1897174,50,21,1963,9,female,619,53,42,22,1,22,1,0,0
1513553,55,14,1958,2,female,708,53,30,22,9,22,6,0,3
1056744,31,15,1982,6,female,210,52,34,22,18,22,16,0,2
1928247,65,28,1948,7,male,1053,52,30,23,9,0,5,23,4
1598339,63,10,1950,4,male,515,53,28,23,54,0,10,23,44
1594750,18,27,1995,2,male,365,52,38,23,2,10,0,13,2
1985093,18,9,1995,2,male,15,53,17,23,10,23,7,0,3
1702188,19,5,1994,4,male,300,52,41,23,23,23,11,0,12
2131927,24,31,1989,5,male,24,53,48,23,16,23,15,0,1
1876579,54,19,1959,6,female,791,52,29,24,5,0,4,24,1
1101649,62,9,1951,10,female,360,52,40,24,52,0,21,24,31
1876200,46,4,1967,9,female,430,52,38,24,10,18,7,6,3
1874961,30,30,1983,11,male,631,53,13,24,59,24,14,0,45
1997534,49,5,1964,6,male,1031,52,28,24,40,24,6,0,34
1406933,18,8,1995,1,male,289,53,25,25,0,18,0,7,0
1334622,50,15,1963,9,female,469,53,39,25,50,25,40,0,10
1802049,38,1,1975,5,female,111,53,44,26,17,22,8,4,9
1180209,66,1,1947,10,male,1591,52,20,26,2,26,2,0,0
1468072,94,1,1919,1,male,543,53,21,27,32,20,19,7,13
1333176,94,9,1919,11,female,1499,52,19,27,0,27,0,0,0
1135159,19,1,1994,1,male,587,52,43,27,8,27,1,0,7
1852595,43,26,1970,7,male,145,53,45,27,6,27,6,0,0
1858333,24,29,1989,11,male,56,53,51,28,12,10,9,18,3
2077161,52,18,1961,12,female,1366,52,42,28,25,25,4,3,21
1127004,41,1,1972,5,female,544,53,39,28,40,28,37,0,3
1200562,44,11,1969,7,female,241,52,29,28,97,28,67,0,30
1687636,64,27,1949,5,female,626,52,17,29,29,7,24,22,5
1335272,24,1,1989,1,male,71,52,50,29,0,29,0,0,0
1589626,27,11,1986,4,female,511,52,13,29,0,29,0,0,0
2127392,52,18,1961,4,male,613,52,44,29,0,29,0,0,0
1951581,16,17,1997,9,male,792,53,17,29,5,29,3,0,2
1603170,19,21,1994,8,male,482,52,40,29,9,29,8,0,1
1164155,41,31,1972,12,male,315,53,44,29,9,29,8,0,1
1598900,47,3,1966,1,male,143,53,46,29,13,29,13,0,0
1402373,57,5,1956,3,female,154,53,51,29,9,29,5,0,4
1229057,34,13,1979,5,male,646,53,27,29,69,29,59,0,10
1396408,26,8,1987,5,male,323,53,52,31,1,6,1,25,0
1167816,31,11,1982,5,male,313,52,35,31,0,0,0,31,0
1388806,29,30,1984,11,female,318,52,25,31,49,21,20,10,29
1310196,25,1,1988,1,male,26,53,33,31,35,29,17,2,18
1086758,56,14,1957,3,male,27,53,46,30,105,28,81,2,24
1686098,43,27,1970,11,male,41,53,48,30,37,30,21,0,16
1333965,25,10,1988,9,male,22,52,45,30,49,30,39,0,10
1164070,55,14,1958,8,female,620,52,16,30,93,30,74,0,19
2158464,20,2,1993,9,male,223,53,27,33,2,2,2,31,0
1101365,19,11,1994,2,male,205,53,48,33,43,0,19,33,24
1828296,64,13,1949,9,male,103,53,26,33,43,0,18,33,25
1450774,57,17,1956,2,male,452,52,18,33,111,0,64,33,47
1324169,19,24,1994,6,male,199,53,30,33,7,23,3,10,4
1409806,30,25,1983,6,male,260,52,23,33,76,30,49,3,27
2057121,41,4,1972,4,male,1184,53,11,33,19,33,11,0,8
1183338,73,27,1940,4,female,715,52,30,33,14,33,3,0,11
1007600,82,17,1931,4,female,560,53,32,34,1,33,0,1,1
1712258,25,13,1988,7,male,70,53,47,34,1,34,1,0,0
1281412,29,8,1984,11,female,403,53,26,34,2,34,2,0,0
1003481,26,19,1987,7,female,200,53,34,34,39,34,25,0,14
1067533,34,1,1979,1,male,352,53,43,36,6,0,2,36,4
1519673,53,14,1960,1,female,1821,52,18,35,21,0,17,35,4
1805425,58,21,1955,4,male,15,52,43,36,231,0,16,36,215
1070142,70,7,1943,10,female,1192,52,32,35,7,34,2,1,5
1261113,26,29,1987,3,male,374,52,20,35,70,28,22,7,48
2100184,51,30,1962,9,female,33,53,51,35,113,35,35,0,78
1594903,56,6,1957,3,female,55,52,35,35,103,35,44,0,59
1707481,37,1,1976,1,female,290,53,34,37,55,6,16,31,39
1460985,54,4,1959,6,male,1184,53,22,37,78,22,23,15,55
1712478,15,20,1998,9,male,785,52,21,37,15,36,9,1,6
1059643,31,10,1982,10,male,295,53,39,37,8,37,5,0,3
1255477,59,15,1954,6,female,101,53,45,38,2,0,1,38,1
1328592,35,26,1978,7,female,258,52,40,39,26,10,20,29,6
1520922,44,14,1969,5,male,442,53,23,38,3,34,3,4,0
1911312,17,30,1996,10,female,33,52,18,39,28,31,14,8,14
1492962,32,28,1981,8,female,391,53,23,39,25,34,16,5,9
1735708,23,28,1990,12,male,429,53,32,38,0,38,0,0,0
1917744,25,10,1988,1,male,219,52,51,38,22,38,22,0,0
1334848,16,1,1997,2,female,172,52,13,39,26,39,17,0,9
1543650,61,12,1952,11,male,209,52,37,38,30,38,25,0,5
1052493,17,4,1996,8,male,336,52,23,39,86,39,82,0,4
1801728,18,21,1995,7,female,301,52,29,40,20,3,17,37,3
1740819,108,2,1905,2,male,91,53,51,40,19,36,18,4,1
1196031,57,17,1956,11,male,461,53,14,40,124,35,65,5,59
1018107,27,26,1986,7,male,320,53,35,40,2,40,2,0,0
1781821,37,29,1976,6,male,1193,53,17,40,5,40,4,0,1
1066497,21,7,1992,3,male,8,53,52,40,14,40,8,0,6
1218494,66,15,1947,12,female,945,52,45,40,26,40,23,0,3
1734431,50,11,1963,10,female,461,52,28,40,106,40,66,0,40
1694725,38,28,1975,11,female,428,53,19,41,6,10,2,31,4
2125640,27,21,1986,11,female,153,53,45,42,7,12,2,30,5
1053013,22,7,1991,4,male,166,53,37,42,19,39,11,3,8
1282389,24,6,1989,9,male,233,53,46,41,4,41,3,0,1
1353271,37,22,1976,5,male,412,53,28,42,6,42,5,0,1
1240932,61,29,1952,8,female,507,52,40,42,1,42,1,0,0
1170939,14,1,1999,1,male,621,52,41,41,27,41,19,0,8
1763681,27,3,1986,6,female,282,53,41,42,72,42,72,0,0
1137097,33,10,1980,9,female,413,52,34,44,43,44,43,0,0
1900494,58,22,1955,12,female,69,52,41,44,42,44,27,0,15
1220451,100,18,1913,12,male,1376,52,31,44,93,44,78,0,15
1110424,33,27,1980,12,male,532,53,36,45,17,41,10,4,7
1689033,37,31,1976,12,male,334,52,37,45,8,45,7,0,1
1334700,68,25,1945,9,female,1379,52,28,45,15,45,14,0,1
1339398,21,15,1992,10,female,469,52,30,45,40,45,38,0,2
1847018,54,23,1959,6,female,168,53,27,45,110,45,82,0,28
1995361,43,8,1970,5,male,432,52,32,47,6,47,3,0,3
1944335,44,4,1969,6,male,645,52,34,46,1,46,1,0,0
1519242,48,17,1965,7,male,692,53,17,47,0,47,0,0,0
1894495,43,14,1970,6,male,205,52,40,46,9,46,7,0,2
1288580,36,21,1977,10,male,141,53,31,47,84,47,60,0,24
1023761,56,20,1957,4,female,673,53,32,47,219,47,175,0,44
1326217,45,29,1968,3,male,902,53,43,49,11,7,10,42,1
1904603,59,19,1954,3,male,417,53,11,48,1,45,1,3,0
2143641,23,27,1990,2,female,480,52,51,49,13,39,13,10,0
1968416,54,11,1959,7,male,173,53,48,49,8,49,5,0,3
1103482,35,7,1978,9,male,339,52,28,49,26,49,24,0,2
1432711,34,28,1979,10,male,362,53,34,48,60,48,47,0,13
1816242,63,11,1950,6,female,2080,53,26,48,70,48,42,0,28
1962337,43,1,1970,11,female,195,53,33,51,41,35,34,16,7
1828756,31,1,1982,8,female,457,53,11,51,10,39,8,12,2
1699976,72,31,1941,5,female,1516,52,38,50,1,50,1,0,0
1881035,14,1,1999,1,male,24,53,43,50,30,50,21,0,9
1763671,18,1,1995,1,male,74,53,38,50,15,50,15,0,0
1625262,30,13,1983,2,female,509,53,24,50,74,50,67,0,7
1086571,25,24,1988,5,male,112,52,38,52,29,0,12,52,17
1939089,95,29,1918,7,female,1220,53,35,52,23,10,15,42,8
1634672,54,24,1959,4,female,321,52,33,52,39,0,14,52,25
1082056,20,11,1993,2,female,321,53,41,53,0,53,0,0,0
1781471,58,25,1955,4,female,75,52,43,52,4,52,2,0,2
1219212,25,24,1988,10,male,170,52,27,52,19,52,17,0,2
1915340,19,20,1994,5,male,341,53,45,55,0,16,0,39,0
1108553,24,23,1989,9,male,269,53,34,54,12,51,11,3,1
1850620,52,2,1961,4,female,94,53,38,55,39,54,35,1,4
1471939,22,28,1991,3,male,70,52,21,55,18,55,16,0,2
1453896,67,24,1946,12,female,986,52,26,55,45,55,39,0,6
1269341,36,21,1977,3,male,136,52,30,58,31,0,2,58,29
2097158,55,16,1958,9,female,615,52,27,56,42,50,29,6,13
2006070,47,12,1966,5,female,125,53,43,56,8,56,5,0,3
1561558,37,2,1976,10,female,585,52,29,58,70,58,62,0,8
1752048,29,1,1984,6,male,186,53,39,59,0,59,0,0,0
1408168,50,20,1963,9,female,2046,53,20,59,87,59,70,0,17
1141366,68,2,1945,7,female,1420,53,46,62,114,0,40,62,74
1255930,50,8,1963,12,male,937,52,47,63,65,49,28,14,37
1924741,20,2,1993,7,female,33,53,51,61,0,61,0,0,0
1318971,43,21,1970,10,male,593,52,9,63,131,63,109,0,22
1451257,64,4,1949,6,female,684,52,48,65,0,8,0,57,0
1306011,22,12,1991,11,female,174,52,37,65,52,44,39,21,13
2086815,47,15,1966,2,female,1280,53,31,65,134,64,60,1,74
1460213,61,20,1952,9,female,1074,53,15,65,0,65,0,0,0
1974632,57,6,1956,11,female,212,52,25,68,36,28,21,40,15
1265828,21,10,1992,10,male,605,52,36,67,31,67,26,0,5
1446288,35,13,1978,11,female,422,53,34,67,40,67,29,0,11
1812235,40,30,1973,4,female,109,52,30,68,36,68,26,0,10
2138764,33,12,1980,2,female,352,53,20,67,109,67,64,0,45
1363764,34,1,1979,3,male,255,53,26,66,139,66,35,0,104
1726592,41,26,1972,10,female,184,53,47,70,25,55,2,15,23
1668905,82,20,1931,2,female,353,53,27,69,20,69,8,0,12
1203040,86,4,1927,5,male,953,53,35,72,5,2,1,70,4
2063876,60,31,1953,1,female,77,53,38,73,178,2,110,71,68
1436004,21,10,1992,2,male,59,52,39,74,9,74,8,0,1
1058034,31,6,1982,10,male,556,52,50,73,8,73,6,0,2
1439280,31,12,1982,11,male,89,53,34,77,44,75,39,2,5
1116762,75,5,1938,3,female,771,53,14,78,13,0,9,78,4
1496407,66,7,1947,1,male,62,53,38,78,77,0,34,78,43
1494937,60,13,1953,11,female,1824,53,36,80,74,26,38,54,36
1897194,28,26,1985,2,female,497,52,28,79,10,63,4,16,6
1216012,23,7,1990,1,male,306,53,38,78,26,78,24,0,2
1890609,43,1,1970,12,female,422,53,37,80,70,80,20,0,50
1362652,24,11,1989,1,male,1431,52,45,82,29,47,14,35,15
1731818,21,23,1992,12,female,645,53,38,82,113,22,74,60,39
1286157,23,8,1990,7,female,310,52,43,82,34,81,9,1,25
1441660,39,7,1974,9,female,618,53,24,84,98,82,91,2,7
1104332,22,23,1991,11,male,288,53,39,81,60,81,37,0,23
1683481,22,20,1991,7,female,35,52,31,84,73,84,24,0,49
1512934,36,20,1977,7,male,155,53,42,86,132,6,61,80,71
1410835,23,3,1990,3,female,159,53,25,86,61,86,47,0,14
1497801,57,18,1956,8,male,759,52,17,91,45,56,25,35,20
1636134,54,29,1959,8,male,1575,52,17,88,108,45,76,43,32
1611701,44,22,1969,8,female,195,53,39,91,13,91,8,0,5
1583968,57,5,1956,6,female,725,53,37,91,1,91,0,0,1
1523906,70,22,1943,7,female,1717,53,21,90,12,90,10,0,2
1965956,21,20,1992,11,male,256,53,18,90,51,90,35,0,16
1359457,44,19,1969,4,female,160,52,11,89,79,89,57,0,22
1536253,47,25,1966,9,female,183,52,30,91,140,91,112,0,28
1029808,50,6,1963,7,female,286,53,36,91,160,91,112,0,48
1271656,47,7,1966,1,male,555,52,36,92,49,88,40,4,9
1165036,108,1,1905,1,female,225,53,38,92,35,89,24,3,11
1052700,28,18,1985,9,female,430,53,49,96,93,24,27,72,66
2056770,29,10,1984,1,female,353,52,36,98,21,98,21,0,0
1453882,40,8,1973,6,female,260,52,32,98,195,98,182,0,13
1494413,59,27,1954,5,male,1039,53,32,101,54,0,14,101,40
1201656,65,17,1948,4,male,114,53,33,102,39,2,12,100,27
1378087,55,26,1958,2,female,592,52,15,100,151,0,65,100,86
1968865,17,27,1996,7,male,60,53,41,102,238,23,56,79,182
1948335,27,22,1986,1,female,502,53,23,104,38,85,16,19,22
1094609,54,13,1959,4,male,495,52,13,100,20,93,8,7,12
1439463,68,27,1945,12,female,980,52,25,103,43,92,23,11,20
1746440,23,30,1990,6,female,99,52,49,100,144,80,122,20,22
1417354,41,4,1972,12,female,22,53,27,103,96,95,44,8,52
1094514,51,4,1962,7,male,579,52,22,102,124,102,69,0,55
1161898,66,11,1947,4,female,984,52,31,109,61,0,31,109,30
1297246,52,2,1961,5,NA,2290,53,29,106,71,104,44,2,27
1661478,61,28,1952,9,female,1043,53,26,113,89,112,86,1,3
1119801,40,23,1973,6,male,251,52,37,112,16,112,13,0,3
1338348,22,17,1991,11,male,647,52,36,111,20,111,17,0,3
2090055,45,7,1968,9,male,440,52,40,112,136,112,113,0,23
2060495,71,22,1942,4,male,1823,53,16,115,16,10,9,105,7
1484170,63,17,1950,8,female,761,52,33,114,52,0,11,114,41
1727267,19,10,1994,2,female,382,53,33,119,19,109,13,10,6
1572024,18,14,1995,12,male,224,53,34,117,0,117,0,0,0
2110392,42,16,1971,4,male,250,52,50,118,19,118,17,0,2
1724395,24,12,1989,5,female,358,52,29,115,52,115,36,0,16
1721912,25,1,1988,1,male,242,53,26,115,67,115,60,0,7
1071856,25,31,1988,12,male,150,52,42,114,142,114,122,0,20
1018553,56,12,1957,9,male,269,52,21,117,77,117,46,0,31
1540438,52,28,1961,10,female,152,53,41,120,207,0,98,120,109
1970647,36,16,1977,10,female,170,53,41,121,226,56,139,65,87
1960001,25,2,1988,8,female,195,52,22,121,136,118,76,3,60
1168359,14,12,1999,8,female,231,53,36,130,1,0,1,130,0
1736953,82,11,1931,7,female,1520,53,19,125,6,4,1,121,5
1418242,75,4,1938,7,male,155,53,38,127,47,0,13,127,34
1667850,49,28,1964,6,male,510,53,23,128,3,95,1,33,2
1161190,49,14,1964,11,male,522,52,44,131,47,0,4,131,43
1352005,63,21,1950,12,male,448,52,41,131,63,24,11,107,52
1683978,70,7,1943,3,female,442,53,41,134,1,80,0,54,1
1096642,36,7,1977,11,female,407,52,18,136,480,135,450,1,30
1848151,51,16,1962,10,male,549,52,38,131,32,131,25,0,7
1717717,71,7,1942,5,female,1126,53,22,139,9,0,2,139,7
2143342,98,1,1915,1,female,614,53,32,140,16,0,7,140,9
2096176,46,10,1967,7,female,395,53,9,140,34,0,9,140,25
1509089,25,4,1988,10,female,191,52,20,139,13,33,4,106,9
1875079,16,30,1997,3,female,101,53,45,143,5,120,1,23,4
1500733,18,18,1995,7,female,47,53,33,141,69,141,60,0,9
1141025,56,10,1957,10,male,421,53,38,149,22,0,10,149,12
1045695,58,16,1955,9,female,132,53,43,144,45,28,23,116,22
1852716,47,9,1966,10,female,62,53,13,148,81,79,63,69,18
1815278,39,29,1974,10,female,278,53,25,145,181,110,31,35,150
1826574,34,24,1979,12,male,253,53,45,147,146,147,93,0,53
1802616,37,9,1976,11,male,320,52,42,157,26,13,9,144,17
2101407,28,19,1985,7,female,615,53,40,153,135,43,122,110,13
1231641,31,29,1982,6,female,216,53,53,154,15,154,14,0,1
1813254,28,13,1985,11,female,563,52,25,152,66,152,50,0,16
1282176,28,8,1985,8,male,93,52,26,155,36,155,31,0,5
1204638,50,6,1963,3,female,373,53,19,156,66,156,65,0,1
1590412,37,8,1976,11,female,1065,53,16,160,10,0,0,160,10
1336474,65,7,1948,7,female,671,53,32,159,224,0,65,159,159
1241924,38,8,1975,4,male,121,53,46,160,94,119,35,41,59
1700955,59,16,1954,2,female,786,53,33,158,58,158,15,0,43
2031307,56,11,1957,3,female,1128,52,37,166,54,115,18,51,36
1799818,50,16,1963,9,female,742,52,22,168,49,168,46,0,3
1494622,18,18,1995,8,female,47,53,28,171,109,171,63,0,46
1629284,69,5,1944,8,female,667,53,2,181,64,0,21,181,43
1670239,30,25,1983,6,male,76,53,40,175,43,175,23,0,20
1607222,71,1,1942,1,female,580,52,33,183,39,0,19,183,20
1144112,31,19,1982,2,female,220,52,30,186,129,180,26,6,103
2152880,101,13,1912,10,female,615,53,29,186,124,184,82,2,42
1089359,30,23,1983,3,female,431,52,24,187,0,187,0,0,0
1660856,29,24,1984,8,male,106,53,43,186,60,186,8,0,52
1587946,48,13,1965,8,male,391,53,45,194,20,194,18,0,2
1272774,58,4,1955,12,male,549,53,32,210,25,0,12,210,13
1863319,79,26,1934,1,female,672,53,35,205,34,0,15,205,19
1595240,33,31,1980,7,female,212,53,44,203,391,42,148,161,243
1932553,59,19,1954,2,female,338,52,37,206,29,206,28,0,1
1252295,35,4,1978,1,male,164,52,16,204,64,204,44,0,20
1071698,56,16,1957,9,female,571,52,27,201,60,201,37,0,23
1893740,55,2,1958,5,female,368,52,39,214,57,0,28,214,29
1275778,75,19,1938,10,female,272,52,33,215,72,5,50,210,22
2005434,58,16,1955,9,female,567,53,28,219,64,56,40,163,24
1255482,74,31,1939,7,female,672,52,26,212,37,212,12,0,25
1606883,17,1,1996,5,female,48,53,46,223,1,223,1,0,0
2143579,19,4,1994,12,female,164,53,8,233,128,233,65,0,63
2081361,23,19,1990,3,female,220,53,30,234,155,8,23,226,132
1748353,53,15,1960,4,female,615,52,27,241,109,203,89,38,20
1365577,58,26,1955,7,female,796,53,29,244,103,238,64,6,39
1431788,31,5,1982,12,female,414,53,37,246,118,246,45,0,73
1885076,19,8,1994,9,male,643,53,28,249,82,0,38,249,44
1760173,66,11,1947,2,female,812,52,37,249,86,0,6,249,80
1174483,57,16,1956,11,female,250,53,41,249,43,131,6,118,37
1602784,64,27,1949,6,female,891,53,37,247,72,87,30,160,42
1744795,63,16,1950,11,female,99,53,40,248,41,228,20,20,21
1794742,33,15,1980,11,female,962,52,22,271,131,229,97,42,34
1628730,37,19,1976,7,female,151,53,34,265,234,259,109,6,125
1689439,34,12,1979,9,female,142,52,35,264,110,264,110,0,0
1687915,78,25,1935,7,female,1590,53,24,288,44,1,35,287,9
1880551,46,24,1967,4,female,217,53,45,291,167,5,73,286,94
1971962,20,24,1993,7,female,131,52,42,278,414,5,212,273,202
1483655,63,6,1950,7,female,863,52,29,283,133,218,78,65,55
1883937,65,23,1948,11,female,862,53,24,279,91,278,57,1,34
1507310,26,1,1987,2,male,342,52,40,279,34,279,28,0,6
1901489,19,24,1994,8,female,318,52,29,297,149,4,49,293,100
1013012,54,2,1959,1,male,1090,52,37,296,99,3,4,293,95
1993844,34,3,1979,8,male,421,53,42,303,93,292,59,11,34
1429308,66,23,1947,10,female,1873,52,16,303,88,273,21,30,67
1504492,57,24,1956,10,female,922,52,22,302,80,302,56,0,24
1438781,60,17,1953,5,female,421,53,42,320,52,0,27,320,25
2178270,81,26,1932,4,male,1383,53,25,327,114,0,16,327,98
1606896,54,28,1959,11,female,1692,52,28,325,320,274,210,51,110
1506529,59,3,1954,12,female,159,52,28,323,23,323,22,0,1
2048193,58,18,1955,10,female,207,53,27,309,145,309,116,0,29
2142000,21,22,1992,2,male,157,52,26,328,162,200,86,128,76
1433799,46,21,1967,4,male,151,53,26,331,33,330,23,1,10
1687580,23,5,1990,3,female,220,52,33,332,1105,332,784,0,321
2041941,57,20,1956,3,female,53,53,35,366,161,0,64,366,97
1283359,39,26,1974,9,female,20,52,36,361,95,361,45,0,50
1709714,53,4,1960,9,male,232,52,30,362,205,362,135,0,70
1126053,30,6,1983,4,male,76,53,45,403,344,403,344,0,0
1670970,36,11,1977,8,male,332,52,35,431,74,431,73,0,1
1702459,71,20,1942,11,female,1687,52,40,467,5,462,3,5,2
1231558,25,1,1988,4,male,155,52,31,467,38,467,18,0,20
2066377,21,22,1992,9,female,393,52,41,477,322,477,264,0,58
1376546,26,22,1987,7,female,165,53,3,476,1392,476,844,0,548
1220972,24,22,1989,6,female,222,52,44,490,101,308,60,182,41
1611799,36,25,1977,11,female,289,53,36,485,321,480,119,5,202
1342384,48,20,1965,10,male,111,53,52,493,13,493,9,0,4
1523098,23,2,1990,2,male,62,53,41,498,99,498,90,0,9
1975231,65,4,1948,3,female,1355,52,20,598,292,270,164,328,128
1176425,14,15,1999,1,female,234,52,22,566,516,150,205,416,311
1937645,47,15,1966,12,female,796,53,35,573,1328,144,844,429,484
2175108,54,4,1959,6,female,1309,53,17,568,53,412,39,156,14
1433089,43,11,1970,9,female,600,53,25,649,97,0,27,649,70
1897436,59,30,1954,1,female,1080,53,48,628,690,0,30,628,660
1592162,48,14,1965,5,female,1551,53,27,657,150,590,84,67,66
1717397,68,21,1945,9,female,1718,52,18,610,789,535,63,75,726
1445171,18,28,1995,10,female,703,52,47,614,94,614,91,0,3
1653338,49,3,1964,5,female,414,52,32,710,58,710,39,0,19
1650010,24,10,1989,9,male,7,52,32,730,491,730,366,0,125
2004608,44,27,1969,2,female,77,53,46,798,82,798,30,0,52
1724137,100,13,1913,9,female,251,52,40,886,332,886,270,0,62
1038621,44,30,1969,5,male,302,53,29,952,828,952,632,0,196
1116419,53,27,1960,1,female,147,52,39,1132,144,7,7,1125,137
1538989,36,29,1977,1,female,95,53,50,1161,191,1128,86,33,105
1852752,63,4,1950,12,female,1766,53,28,1205,77,1205,71,0,6
1678786,54,5,1959,5,female,1599,52,28,1477,858,28,234,1449,624
1304341,25,2,1988,11,female,281,52,36,1816,77,1816,50,0,27
2109921,55,9,1958,10,female,409,53,24,1546,220,1546,151,0,69
1576511,59,25,1954,6,female,306,52,46,3245,295,0,145,3245,150
2041440,33,6,1980,11,female,1254,53,26,9884,6793,2892,3329,6992,3464
1289932,57,27,1956,4,female,107,52,39,4910,390,4910,93,0,297
2060546,23,21,1990,3,male,217,55,28,4,3,4,3,0,0
1526239,20,20,1993,2,male,204,55,41,4,11,4,10,0,1
1794745,23,17,1990,5,female,59,55,26,4,31,4,28,0,3
1453033,32,27,1981,11,male,360,55,39,4,16,4,10,0,6
1606374,51,27,1962,4,female,493,55,49,4,16,4,7,0,9
1671629,51,7,1962,9,female,577,55,24,4,12,4,4,0,8
1684695,46,30,1967,9,male,203,54,35,5,0,0,0,5,0
1930856,23,19,1990,11,female,187,55,28,5,3,0,0,5,3
1999495,23,10,1990,12,male,569,55,11,5,2,0,2,5,0
1129864,47,27,1966,9,male,88,55,44,5,1,0,0,5,1
1067921,82,14,1931,3,female,1512,55,8,5,1,0,1,5,0
1370405,48,5,1965,8,female,144,54,25,5,3,2,2,3,1
1169731,42,15,1971,4,male,242,54,29,5,6,3,5,2,1
1553325,108,2,1905,10,female,193,54,47,5,6,1,3,4,3
1411777,23,15,1990,4,male,192,54,50,5,9,1,6,4,3
1389762,16,27,1997,1,female,420,54,31,5,0,5,0,0,0
1163882,27,30,1986,7,male,321,54,49,5,0,5,0,0,0
1496143,41,25,1972,3,male,297,54,29,5,0,5,0,0,0
1827107,56,13,1957,3,male,2097,55,11,5,0,5,0,0,0
1507887,19,30,1994,8,male,347,54,36,5,2,5,2,0,0
2045795,21,20,1992,7,male,224,55,45,5,2,5,1,0,1
1275072,22,1,1991,1,male,129,55,45,5,3,5,2,0,1
1397432,31,27,1982,1,male,448,55,2,5,3,5,1,0,2
1958254,60,13,1953,1,male,900,55,25,5,1,5,0,0,1
1723702,19,1,1994,1,male,671,54,23,5,10,5,9,0,1
1137016,37,5,1976,5,male,528,55,48,5,18,5,10,0,8
1916412,60,14,1953,12,female,1490,55,22,5,13,5,8,0,5
1290398,63,9,1950,7,male,156,54,18,5,23,5,12,0,11
1044498,53,24,1960,8,male,327,54,21,6,0,0,0,6,0
1134658,22,30,1991,4,male,621,55,43,6,1,0,0,6,1
1728767,24,18,1989,6,female,86,54,41,6,3,0,0,6,3
1145873,62,18,1951,10,female,1521,54,19,6,7,0,1,6,6
1954648,27,1,1986,10,male,363,54,35,6,9,0,0,6,9
1114011,42,24,1971,8,male,345,55,48,6,3,5,1,1,2
1863717,39,21,1974,7,male,805,54,10,6,0,6,0,0,0
1547140,39,26,1974,8,female,278,54,31,6,0,6,0,0,0
1711963,55,21,1958,2,male,115,55,34,6,0,6,0,0,0
1857733,26,17,1987,8,male,200,55,44,6,1,6,1,0,0
1567196,33,11,1980,11,male,116,54,44,6,7,6,7,0,0
1617559,20,16,1993,6,male,56,55,46,6,11,6,10,0,1
2134088,29,23,1984,5,male,460,54,21,6,14,6,10,0,4
1105998,30,19,1983,9,female,96,55,49,6,23,6,23,0,0
1757610,18,11,1995,3,male,142,54,49,7,1,0,0,7,1
1132833,23,14,1990,8,male,392,55,51,7,0,0,0,7,0
2147687,53,17,1960,7,male,1617,55,17,7,0,0,0,7,0
1753253,51,4,1962,12,female,605,54,6,7,4,1,4,6,0
1175971,42,21,1971,6,male,275,55,45,7,5,0,4,7,1
1611630,23,25,1990,6,male,523,54,34,7,0,4,0,3,0
2135612,35,17,1978,11,female,150,55,32,7,0,5,0,2,0
1599914,67,1,1946,11,male,1538,55,13,7,8,5,4,2,4
1682125,38,19,1975,4,male,250,55,40,7,11,2,4,5,7
1836308,19,1,1994,1,male,810,54,45,7,0,6,0,1,0
1474608,68,20,1945,3,female,1737,54,22,7,0,6,0,1,0
1691896,33,27,1980,2,male,499,54,19,7,0,7,0,0,0
1253698,13,5,2000,1,male,54,55,33,7,2,7,1,0,1
1528138,19,29,1994,6,male,359,54,39,7,3,7,3,0,0
2152401,26,30,1987,3,male,252,55,34,7,2,7,2,0,0
1711091,33,28,1980,10,male,92,55,20,7,4,7,1,0,3
1160528,53,18,1960,3,female,1752,55,21,7,4,7,1,0,3
1509358,61,9,1952,7,female,1542,54,20,7,2,7,1,0,1
1449689,21,22,1992,6,male,36,54,44,7,10,7,7,0,3
1504840,25,17,1988,8,female,462,54,48,7,9,7,4,0,5
2066401,28,3,1985,7,male,51,54,44,7,10,7,9,0,1
2110034,29,19,1984,4,female,508,54,27,7,35,7,18,0,17
2054668,48,1,1965,11,male,1859,54,12,7,17,7,10,0,7
1981571,98,25,1915,12,female,1648,55,21,8,20,0,4,8,16
1606947,72,24,1941,5,female,719,54,30,8,1,4,0,4,1
1199618,23,25,1990,1,male,533,54,48,8,2,7,1,1,1
1820290,18,30,1995,5,male,18,55,52,8,7,7,2,1,5
1903145,64,26,1949,10,male,318,54,45,8,5,6,2,2,3
1006430,22,21,1991,9,female,348,54,20,8,22,7,1,1,21
1425398,18,22,1995,2,male,58,55,50,8,0,8,0,0,0
1252736,28,19,1985,2,male,402,55,44,8,0,8,0,0,0
1318377,64,25,1949,8,male,1638,55,33,8,0,8,0,0,0
1561465,17,31,1996,12,female,265,55,37,8,2,8,1,0,1
1705937,24,20,1989,6,female,208,55,38,8,7,8,7,0,0
1411603,22,11,1991,11,male,1053,55,24,8,27,8,19,0,8
1971427,25,22,1988,11,female,724,55,35,8,13,8,9,0,4
1680244,37,3,1976,1,female,829,55,26,9,9,0,2,9,7
1715038,50,25,1963,10,male,415,55,13,9,7,0,0,9,7
1871494,57,19,1956,9,female,574,54,21,9,6,0,2,9,4
1861841,59,22,1954,7,male,158,54,26,9,13,0,5,9,8
1344957,60,25,1953,7,male,393,54,38,9,21,0,11,9,10
1312941,108,21,1905,9,male,415,55,12,9,99,0,66,9,33
1739945,39,4,1974,7,male,47,55,52,9,0,7,0,2,0
1938164,58,29,1955,11,male,1742,55,35,9,1,7,0,2,1
1929916,43,31,1970,12,female,724,55,49,9,2,8,2,1,0
1639400,24,8,1989,12,female,574,54,28,9,2,9,2,0,0
1388908,31,10,1982,6,female,278,55,39,9,5,9,5,0,0
1310731,49,30,1964,4,female,1682,54,22,9,6,9,3,0,3
1049821,53,9,1960,1,female,114,55,39,9,7,9,5,0,2
1530537,65,8,1948,9,male,385,55,36,10,11,0,4,10,7
1140627,62,21,1951,7,female,422,54,45,10,24,0,4,10,20
1013248,52,1,1961,10,male,235,55,41,10,30,5,22,5,8
1749407,23,15,1990,6,male,1116,54,50,10,1,10,1,0,0
1931254,29,27,1984,7,male,521,54,24,10,0,10,0,0,0
1766829,42,12,1971,11,male,598,55,37,10,1,10,1,0,0
1859170,22,12,1991,5,female,453,55,34,10,2,10,1,0,1
1914262,25,16,1988,8,male,596,54,33,10,4,10,4,0,0
1703629,35,23,1978,5,male,1173,55,21,10,5,10,3,0,2
1855617,22,15,1991,11,male,121,55,44,10,13,10,13,0,0
2047101,22,2,1991,8,male,503,55,37,10,8,10,5,0,3
1168291,25,28,1988,1,male,208,55,32,10,10,10,10,0,0
1234816,29,21,1984,12,male,18,55,53,10,14,10,10,0,4
1190482,43,7,1970,10,female,609,55,28,10,10,10,8,0,2
2091283,60,25,1953,10,female,175,54,28,10,31,10,30,0,1
1473119,50,1,1963,10,male,314,55,29,11,3,0,2,11,1
1631705,19,18,1994,11,female,361,55,26,11,15,0,2,11,13
1962276,22,12,1991,8,female,400,54,13,11,22,6,14,5,8
1308613,32,22,1981,8,female,1345,54,23,11,22,10,13,1,9
1763242,18,20,1995,7,male,409,55,49,11,1,11,1,0,0
1354592,23,6,1990,12,male,52,55,23,11,0,11,0,0,0
2166807,47,3,1966,1,male,2244,55,17,11,1,11,1,0,0
1358815,57,30,1956,8,male,1111,55,34,11,0,11,0,0,0
1291829,17,29,1996,11,male,200,54,26,11,7,11,4,0,3
1569843,24,7,1989,12,male,186,55,34,11,16,11,15,0,1
1941229,58,10,1955,5,female,592,55,31,11,14,11,9,0,5
1914472,62,17,1951,9,male,1792,54,26,11,9,11,8,0,1
1731439,49,15,1964,9,female,132,54,29,11,35,11,22,0,13
1007858,52,30,1961,4,female,374,55,36,12,3,0,0,12,3
1851043,51,6,1962,1,female,727,54,34,12,17,0,4,12,13
1214579,23,10,1990,8,male,183,55,36,12,8,6,5,6,3
1458611,18,7,1995,6,female,377,54,16,12,39,5,29,7,10
2124910,18,1,1995,1,male,500,54,31,12,24,10,19,2,5
1117000,74,16,1939,10,male,1466,54,14,12,48,10,29,2,19
1717311,32,1,1981,1,male,668,55,48,12,0,12,0,0,0
1417926,20,15,1993,6,female,102,55,39,12,4,12,4,0,0
1971773,23,6,1990,6,male,167,54,40,12,7,12,5,0,2
1185966,64,29,1949,12,female,1725,55,24,12,5,12,2,0,3
1178602,22,1,1991,9,female,281,54,45,12,19,12,3,0,16
1595081,27,6,1986,4,male,412,54,41,12,28,12,12,0,16
1421004,97,16,1916,8,male,20,54,50,13,13,1,11,12,2
2189173,108,27,1905,2,male,885,54,20,13,36,0,35,13,1
1411725,48,21,1965,1,male,84,54,32,13,10,3,5,10,5
1855487,25,28,1988,3,male,101,55,50,13,24,9,24,4,0
2100723,15,4,1998,4,female,218,54,41,13,2,13,2,0,0
1925203,56,4,1957,12,male,794,54,38,13,1,13,0,0,1
1277473,22,30,1991,1,female,98,54,40,13,19,13,12,0,7
2152844,43,9,1970,8,female,81,54,34,13,30,13,23,0,7
1823867,17,18,1996,1,male,75,55,50,14,2,0,1,14,1
1686847,69,16,1944,5,female,476,54,28,14,23,0,2,14,21
2074178,102,10,1911,1,male,1102,54,29,14,4,4,1,10,3
2153266,23,17,1990,5,male,511,54,28,14,11,3,7,11,4
1690815,22,3,1991,4,male,274,55,30,14,1,13,1,1,0
1676979,26,10,1987,11,male,323,55,33,14,3,14,1,0,2
1590590,52,5,1961,5,female,294,55,38,14,3,14,3,0,0
2061535,108,1,1905,5,male,25,54,40,14,6,14,6,0,0
1427286,33,5,1980,8,male,541,54,28,14,18,14,9,0,9
1145751,29,6,1984,8,male,758,54,34,14,25,14,22,0,3
2017975,38,15,1975,5,male,650,54,9,14,32,14,22,0,10
1027125,63,1,1950,1,male,931,54,32,14,41,14,21,0,20
1544930,25,28,1988,9,male,265,54,42,15,1,0,0,15,1
1764372,23,14,1990,1,female,489,54,38,15,4,0,1,15,3
1003156,59,5,1954,4,female,424,55,35,15,11,2,8,13,3
1509168,84,7,1929,2,female,1616,54,10,15,22,2,9,13,13
1112485,35,24,1978,6,male,573,55,34,15,2,10,2,5,0
1527103,67,1,1946,10,male,1794,55,14,15,68,5,23,10,45
1589678,23,28,1990,2,male,403,54,31,15,55,11,35,4,20
1427927,35,21,1978,4,male,607,55,37,15,2,15,1,0,1
1190855,17,7,1996,11,male,96,54,42,15,15,15,11,0,4
1018330,42,14,1971,4,female,8,55,52,15,17,15,14,0,3
1557359,26,17,1987,8,female,102,55,42,16,59,0,38,16,21
1993744,41,13,1972,1,female,98,54,40,16,23,10,16,6,7
1884331,67,27,1946,3,male,1615,55,41,16,5,14,1,2,4
2151278,15,20,1998,9,male,485,54,36,16,0,16,0,0,0
1964769,30,16,1983,6,male,171,54,46,16,1,16,1,0,0
1768096,40,26,1973,1,male,170,55,38,16,0,16,0,0,0
1199274,21,8,1992,9,male,599,55,33,16,8,16,2,0,6
2084178,66,24,1947,1,female,2107,55,24,16,4,16,3,0,1
1968961,15,15,1998,2,male,27,55,47,16,10,16,6,0,4
1229615,17,30,1996,9,male,49,54,44,16,10,16,9,0,1
1897041,26,1,1987,1,male,315,54,44,16,16,16,8,0,8
2116114,17,3,1996,12,male,864,54,33,17,0,0,0,17,0
1907534,23,3,1990,3,male,266,55,44,17,4,0,0,17,4
1830334,42,19,1971,6,female,518,54,28,17,8,3,3,14,5
1070732,64,13,1949,5,female,1975,54,14,17,22,0,19,17,3
1905833,21,4,1992,9,female,1514,54,29,17,30,6,13,11,17
1777017,60,16,1953,4,male,1167,55,30,17,0,17,0,0,0
1581292,65,10,1948,12,female,988,55,38,17,5,17,5,0,0
1601807,31,31,1982,1,male,252,54,31,17,17,17,8,0,9
2053241,49,25,1964,11,male,671,54,24,17,15,17,4,0,11
1856352,35,18,1978,10,male,525,54,15,17,28,17,22,0,6
1469382,41,1,1972,1,male,716,55,39,18,0,0,0,18,0
1365831,54,3,1959,7,female,211,54,38,18,4,0,1,18,3
2128292,31,27,1982,6,male,405,54,28,18,23,0,4,18,19
1451825,57,21,1956,1,female,132,54,43,18,32,0,9,18,23
1148095,64,26,1949,7,female,602,54,33,18,67,0,38,18,29
1129172,27,17,1986,8,female,390,55,16,18,30,16,22,2,8
1254503,29,17,1984,3,male,433,54,32,18,8,18,8,0,0
2049606,24,16,1989,4,male,383,55,33,18,21,18,7,0,14
1569416,19,25,1994,3,male,285,54,46,19,0,0,0,19,0
1855445,60,1,1953,6,female,571,54,49,19,1,0,0,19,1
1141693,21,7,1992,4,male,179,55,49,19,0,19,0,0,0
1964994,23,9,1990,2,female,308,54,33,19,0,19,0,0,0
1044148,31,19,1982,9,female,224,55,30,19,20,19,20,0,0
2086181,15,27,1998,4,male,186,54,46,19,30,19,18,0,12
1150606,23,23,1990,10,male,202,54,30,19,77,19,13,0,64
1740287,33,23,1980,7,female,370,55,21,19,89,19,79,0,10
1421128,38,26,1975,12,male,666,55,43,19,38,19,32,0,6
1118305,19,27,1994,3,male,317,55,51,20,0,0,0,20,0
1653120,19,24,1994,10,male,330,55,46,20,0,0,0,20,0
1659574,31,29,1982,1,male,262,55,31,20,2,0,1,20,1
1383417,67,12,1946,10,male,1118,55,31,20,12,0,8,20,4
1137308,54,17,1959,3,male,645,55,30,20,15,12,12,8,3
1413672,14,4,1999,12,female,449,55,32,20,30,19,19,1,11
1007722,20,26,1993,3,male,392,55,41,20,1,20,0,0,1
2145692,15,23,1998,5,female,103,54,40,20,5,20,4,0,1
1423233,69,19,1944,12,female,162,54,34,20,24,20,23,0,1
1457841,52,3,1961,8,male,1784,54,15,20,51,20,39,0,12
1659481,108,17,1905,10,female,1609,55,32,21,18,0,2,21,16
1057545,14,18,1999,2,male,279,55,32,21,26,8,10,13,16
1997827,31,19,1982,11,male,592,55,27,21,3,21,3,0,0
1201711,26,1,1987,11,male,752,55,11,21,8,21,5,0,3
1695247,21,15,1992,9,female,233,55,15,21,16,21,16,0,0
1530239,29,1,1984,1,male,193,54,20,21,28,21,18,0,10
1621826,54,27,1959,9,male,772,54,37,21,20,21,13,0,7
1040650,31,27,1982,3,male,328,54,22,21,108,21,82,0,26
1259948,19,16,1994,4,female,291,55,38,22,5,4,3,18,2
2041682,42,28,1971,6,male,116,55,39,22,7,0,3,22,4
1602858,69,16,1944,10,female,660,55,38,22,24,0,6,22,18
1994357,68,17,1945,8,female,1031,54,37,22,2,18,2,4,0
2138052,33,14,1980,7,female,54,55,48,22,72,22,44,0,28
1397604,35,23,1978,12,male,773,54,35,22,59,22,31,0,28
2012968,49,5,1964,10,male,821,54,33,22,40,22,39,0,1
1508218,30,21,1983,6,female,156,54,30,23,7,0,2,23,5
1239905,54,31,1959,10,female,1346,54,14,23,9,0,2,23,7
1716634,52,28,1961,8,male,242,55,38,23,10,5,0,18,10
1325579,22,24,1991,1,female,190,55,33,23,8,23,7,0,1
1634940,63,4,1950,4,male,1297,54,19,23,5,23,4,0,1
1607854,24,8,1989,12,male,394,54,46,23,79,23,66,0,13
1038896,36,6,1977,12,male,612,54,26,23,39,23,25,0,14
1585096,45,1,1968,2,male,373,55,20,23,142,23,134,0,8
2060234,62,14,1951,10,male,1713,55,11,23,42,23,26,0,16
1360138,65,8,1948,12,female,289,54,30,24,3,1,0,23,3
1279560,98,7,1915,1,male,1621,55,40,24,8,0,3,24,5
1841084,64,17,1949,10,female,1734,54,25,24,11,24,7,0,4
2020147,67,20,1946,1,male,474,54,42,24,8,24,8,0,0
1317927,29,3,1984,3,male,71,55,38,24,19,24,16,0,3
2006819,36,3,1977,6,male,173,55,34,24,21,24,12,0,9
1684855,20,17,1993,10,female,255,55,26,24,37,24,25,0,12
1988306,50,3,1963,1,female,567,54,24,25,3,1,3,24,0
1779802,53,20,1960,8,female,662,54,39,25,27,0,9,25,18
2063243,65,5,1948,2,female,1727,55,15,25,3,7,2,18,1
1479450,25,1,1988,1,male,88,55,21,25,46,11,28,14,18
2143118,34,22,1979,5,male,406,54,45,25,0,25,0,0,0
1633447,60,4,1953,1,female,428,55,39,25,3,25,2,0,1
1912407,17,1,1996,3,male,142,54,49,25,7,25,5,0,2
2182732,29,19,1984,11,female,257,55,24,25,9,25,9,0,0
1615417,66,12,1947,6,female,458,55,40,26,20,0,11,26,9
2114097,32,26,1981,6,male,553,55,16,26,58,14,21,12,37
1346545,19,24,1994,7,male,205,55,40,26,2,26,2,0,0
1080698,44,1,1969,6,male,851,55,31,26,1,26,1,0,0
1812008,52,27,1961,12,female,287,55,32,26,39,26,20,0,19
1015400,26,15,1987,3,male,438,55,15,27,2,27,2,0,0
1293610,73,11,1940,1,female,675,54,41,27,2,27,2,0,0
1885699,20,18,1993,5,female,412,54,25,27,8,27,7,0,1
1371245,23,15,1990,11,male,182,55,24,27,5,27,3,0,2
1271789,40,23,1973,12,male,433,55,27,27,11,27,3,0,8
1175551,40,16,1973,2,male,275,55,22,27,10,27,8,0,2
1891958,74,9,1939,2,female,1679,54,30,27,9,27,8,0,1
1910418,68,24,1945,9,female,1360,55,19,27,17,27,11,0,6
1567015,26,25,1987,12,male,457,55,43,28,6,28,6,0,0
1310212,30,11,1983,2,male,239,55,31,29,28,1,4,28,24
1233987,108,23,1905,9,male,917,55,20,29,181,1,51,28,130
1248584,20,11,1993,4,male,644,55,15,29,24,15,14,14,10
1209136,28,25,1985,9,female,489,54,47,29,31,22,14,7,17
2023421,61,4,1952,7,female,915,55,39,29,38,29,22,0,16
2002270,25,7,1988,3,female,523,55,34,29,82,29,44,0,38
2099675,58,8,1955,1,male,156,55,36,30,16,0,0,30,16
1423041,44,8,1969,10,male,306,54,32,31,46,26,41,5,5
1342963,53,20,1960,8,female,486,54,25,31,31,26,16,5,15
1942124,57,10,1956,11,female,458,55,38,31,4,31,4,0,0
1078718,19,25,1994,3,female,340,54,30,31,15,31,1,0,14
2123609,21,12,1992,8,male,1497,55,18,31,7,31,3,0,4
2101504,44,18,1969,3,female,188,55,22,31,8,31,3,0,5
1353001,49,15,1964,6,female,1206,55,34,31,8,31,4,0,4
1250919,53,15,1960,2,female,226,55,31,30,11,30,6,0,5
1159123,65,8,1948,6,female,1382,54,29,30,9,30,9,0,0
1465545,31,4,1982,11,male,303,54,14,30,28,30,19,0,9
1930330,31,10,1982,6,female,477,55,31,32,71,0,10,32,61
2098916,69,2,1944,10,female,506,54,23,32,114,29,49,3,65
1469914,60,29,1953,8,female,1230,54,30,32,11,32,4,0,7
1620056,62,27,1951,7,male,117,54,32,32,55,32,41,0,14
2157779,58,24,1955,8,male,376,55,38,33,9,0,3,33,6
1735453,42,29,1971,9,male,341,55,38,33,13,33,12,0,1
2100738,63,24,1950,1,male,1418,55,41,33,45,33,33,0,12
1530346,28,22,1985,1,male,195,55,8,34,0,33,0,1,0
1592022,20,19,1993,3,male,265,54,37,34,5,34,5,0,0
1828908,51,16,1962,12,female,47,55,33,34,1,34,1,0,0
1094713,17,21,1996,5,female,510,55,20,34,11,34,3,0,8
1241931,52,12,1961,7,male,85,55,42,34,14,34,14,0,0
1358328,54,17,1959,1,male,369,55,46,34,6,34,2,0,4
2123702,29,23,1984,4,male,326,54,41,35,92,0,1,35,91
1171006,32,12,1981,11,male,233,55,38,36,14,24,6,12,8
1881529,100,14,1913,11,male,773,54,14,35,8,23,2,12,6
1010003,34,20,1979,4,male,377,55,34,36,142,23,58,13,84
1940196,21,9,1992,10,female,1159,54,15,36,50,29,45,7,5
1969320,36,19,1977,10,male,703,54,43,36,23,36,20,0,3
2011888,54,16,1959,8,male,1167,54,11,37,14,0,8,37,6
1726176,47,21,1966,12,female,1113,55,43,37,66,0,12,37,54
1103256,48,10,1965,8,female,1959,55,44,37,377,8,193,29,184
1391654,26,10,1987,11,male,481,54,36,37,4,37,2,0,2
1443286,68,1,1945,1,female,1820,55,12,37,27,37,15,0,12
2060473,60,22,1953,7,female,344,54,47,38,5,36,1,2,4
1746872,21,28,1992,5,female,599,54,48,38,0,38,0,0,0
1426978,39,6,1974,8,male,1764,55,12,39,14,39,10,0,4
1954860,40,11,1973,8,female,278,54,36,38,10,38,1,0,9
1503482,47,20,1966,4,male,1385,55,25,38,13,38,11,0,2
1590014,27,17,1986,8,male,579,54,52,39,26,39,26,0,0
1622409,43,19,1970,4,female,270,55,14,38,28,38,19,0,9
1928425,33,22,1980,9,male,474,54,28,40,6,0,4,40,2
1966846,47,2,1966,3,male,1583,54,47,40,173,19,115,21,58
1329602,34,23,1979,11,female,1014,55,29,40,30,37,16,3,14
1401742,43,27,1970,5,female,113,54,36,40,38,39,27,1,11
1076300,56,27,1957,2,female,396,55,23,40,43,37,33,3,10
1195704,63,25,1950,4,female,56,54,35,40,6,40,4,0,2
2190906,24,9,1989,6,male,349,54,52,41,6,0,1,41,5
1043610,54,28,1959,12,female,443,55,38,42,8,0,2,42,6
1757144,58,28,1955,7,female,1851,55,23,41,51,27,16,14,35
1501726,75,23,1938,8,female,1551,54,31,41,0,40,0,1,0
1255033,33,27,1980,10,male,450,54,27,41,74,41,48,0,26
1008844,14,23,1999,1,male,36,54,24,44,3,1,0,43,3
1264979,58,14,1955,5,female,135,55,27,44,16,0,15,44,1
1008220,47,9,1966,2,male,390,54,24,44,42,21,33,23,9
2139543,15,26,1998,11,female,27,54,15,43,7,43,2,0,5
1490313,21,10,1992,8,male,39,55,34,44,0,44,0,0,0
1320332,26,16,1987,5,male,415,55,36,44,19,44,17,0,2
1416149,31,1,1982,12,male,442,54,42,43,51,43,46,0,5
1226351,71,12,1942,3,female,1382,55,35,45,6,0,2,45,4
1103596,60,9,1953,5,female,593,55,49,45,25,0,14,45,11
1149242,36,9,1977,3,female,12,55,45,45,29,0,1,45,28
1763792,31,15,1982,5,male,556,54,21,45,8,45,8,0,0
2150445,20,26,1993,11,female,215,55,23,47,74,7,7,40,67
1794112,53,30,1960,11,female,46,54,38,46,81,2,43,44,38
1738913,25,20,1988,1,male,393,55,24,47,3,47,3,0,0
1616483,41,4,1972,2,female,605,54,42,46,0,46,0,0,0
1384252,57,20,1956,3,female,1363,54,39,47,8,47,8,0,0
1290435,22,3,1991,3,female,279,54,40,48,21,0,7,48,14
1307218,54,2,1959,1,female,186,54,36,48,11,48,8,0,3
1708059,35,20,1978,6,female,34,54,31,49,31,49,30,0,1
1564855,38,1,1975,5,male,740,55,14,49,73,49,62,0,11
1200873,47,9,1966,2,female,426,54,10,48,62,48,40,0,22
1005092,56,2,1957,2,male,556,54,39,51,5,0,2,51,3
1051308,25,19,1988,9,male,754,54,40,51,20,15,10,36,10
1912758,24,27,1989,1,male,389,54,7,51,21,37,19,14,2
1992944,13,6,2000,6,male,55,54,38,50,28,50,20,0,8
1714969,29,22,1984,6,female,394,55,33,50,17,50,6,0,11
1563370,23,5,1990,2,male,168,55,43,53,29,1,13,52,16
1681521,41,25,1972,11,male,359,55,36,53,30,7,13,46,17
1855458,15,2,1998,5,male,256,54,49,52,17,48,13,4,4
1904559,51,25,1962,2,male,1794,54,19,52,58,48,13,4,45
1303417,34,11,1979,9,male,405,54,24,52,2,52,2,0,0
1086560,25,1,1988,1,male,292,55,23,53,17,53,17,0,0
1765265,30,29,1983,3,female,508,54,12,52,28,52,24,0,4
1737234,32,16,1981,7,female,482,55,27,52,54,52,44,0,10
1504544,38,2,1975,1,female,15,55,43,53,169,53,146,0,23
1150214,51,25,1962,7,female,1209,55,28,55,57,0,2,55,55
1587659,54,17,1959,8,male,206,55,23,54,49,0,31,54,18
1770488,60,24,1953,3,male,1622,54,17,54,28,38,27,16,1
1002552,35,10,1978,11,female,132,54,40,54,186,52,23,2,163
2122217,37,17,1976,3,male,206,54,25,55,0,55,0,0,0
1333013,68,30,1945,8,male,1503,54,37,55,120,55,74,0,46
1456832,57,10,1956,10,female,267,54,9,57,144,0,7,57,137
1871373,70,7,1943,10,male,574,55,30,56,3,54,2,2,1
1820435,26,21,1987,10,male,567,54,35,57,6,57,5,0,1
1569986,19,9,1994,8,female,149,55,44,56,28,56,23,0,5
1557329,31,22,1982,4,female,558,54,19,57,19,57,8,0,11
2049480,56,7,1957,7,male,351,54,50,58,35,58,32,0,3
1469276,21,15,1992,8,male,1145,54,36,56,62,56,42,0,20
1928571,27,14,1986,8,male,44,54,26,58,73,58,57,0,16
1959478,45,2,1968,11,male,394,54,41,56,45,56,43,0,2
1395267,18,29,1995,3,male,168,54,29,60,9,2,3,58,6
1522956,29,25,1984,4,female,512,55,35,59,0,2,0,57,0
2024308,56,5,1957,6,female,94,55,47,60,83,1,31,59,52
1521230,24,19,1989,8,male,362,54,35,59,10,49,8,10,2
1039689,27,21,1986,9,male,636,55,33,59,4,59,3,0,1
1063228,40,6,1973,3,female,374,54,37,60,30,60,16,0,14
2035285,20,15,1993,10,female,162,54,28,59,154,59,108,0,46
1144101,53,20,1960,2,female,1325,55,14,61,74,6,34,55,40
1890560,40,16,1973,8,male,408,55,43,63,6,39,3,24,3
1077677,61,18,1952,9,female,1099,55,28,63,4,58,3,5,1
1666544,29,10,1984,2,male,24,54,54,61,19,59,14,2,5
1949061,26,9,1987,4,female,305,55,30,61,2,61,2,0,0
2058470,33,22,1980,8,female,419,54,26,63,19,63,14,0,5
1580238,53,3,1960,12,female,1573,54,23,61,20,61,16,0,4
1627146,63,11,1950,11,male,494,54,39,64,65,0,18,64,47
1514773,19,18,1994,8,male,273,54,26,64,66,41,42,23,24
1972462,29,1,1984,2,female,208,55,35,65,30,56,21,9,9
1860831,28,1,1985,5,male,232,54,29,65,113,65,52,0,61
1514865,68,14,1945,6,male,23,55,50,67,71,1,61,66,10
2044742,31,12,1982,4,male,721,54,25,67,20,66,11,1,9
1507306,66,30,1947,1,female,548,54,27,68,37,68,20,0,17
1024515,108,6,1905,2,female,47,54,45,69,135,0,48,69,87
1993119,18,24,1995,5,female,342,54,17,69,179,68,51,1,128
1843092,18,4,1995,11,male,6,55,51,69,0,69,0,0,0
1731387,46,7,1967,1,male,300,55,49,71,1,71,1,0,0
1682156,53,14,1960,12,female,235,54,31,69,19,69,16,0,3
1121475,57,12,1956,10,female,117,54,38,69,23,69,18,0,5
1707348,70,30,1943,5,male,1453,54,30,69,41,69,20,0,21
2142568,101,7,1912,5,female,773,55,37,71,77,71,77,0,0
1784909,61,14,1952,12,female,1332,55,37,70,151,70,135,0,16
2103827,68,28,1945,4,female,1061,55,31,73,4,0,1,73,3
1295652,55,8,1958,10,female,804,55,33,74,17,2,4,72,13
1618884,25,5,1988,1,female,80,55,38,74,197,69,197,5,0
2015892,57,18,1956,1,male,300,55,39,73,2,73,2,0,0
1069527,20,16,1993,9,female,647,54,28,72,29,72,27,0,2
1726631,18,15,1995,12,male,210,55,36,72,71,72,40,0,31
1038318,74,9,1939,11,female,1048,55,23,75,8,73,5,2,3
1258366,23,7,1990,2,male,357,55,38,77,22,77,19,0,3
1351933,52,14,1961,11,female,223,54,35,75,34,75,33,0,1
1168009,108,1,1905,11,female,59,54,50,76,29,76,25,0,4
2086142,70,8,1943,10,male,662,54,44,79,17,49,6,30,11
1360350,14,4,1999,8,male,56,55,52,79,1,71,1,8,0
1628679,48,12,1965,9,female,975,54,15,80,28,77,11,3,17
1703449,25,5,1988,5,male,30,55,38,80,32,80,28,0,4
1287250,17,1,1996,9,male,70,55,50,84,0,0,0,84,0
1346958,21,23,1992,6,male,409,55,45,84,32,0,13,84,19
1540405,35,24,1978,10,female,152,54,35,81,33,1,18,80,15
1326914,108,25,1905,1,male,265,54,23,82,220,20,61,62,159
1707075,36,8,1977,12,male,163,54,42,81,7,79,4,2,3
1691201,32,7,1981,4,male,775,55,23,81,71,77,44,4,27
1857786,60,31,1953,3,female,892,55,17,86,3,86,2,0,1
2105955,23,8,1990,1,male,196,55,13,86,16,86,11,0,5
2032436,49,16,1964,5,female,355,55,32,88,11,10,9,78,2
1257538,15,21,1998,5,female,439,54,33,91,7,58,1,33,6
1295380,21,7,1992,12,male,505,54,32,89,11,57,11,32,0
1309241,50,26,1963,2,female,1694,55,23,90,51,77,39,13,12
2090463,30,27,1983,10,female,345,55,19,91,31,91,27,0,4
1446127,47,29,1966,10,female,161,54,31,90,98,90,30,0,68
1251535,35,10,1978,6,male,436,55,30,92,37,14,15,78,22
1789174,21,3,1992,11,male,265,55,30,92,28,19,10,73,18
1698456,29,31,1984,12,male,324,55,40,93,35,25,18,68,17
1513274,19,14,1994,11,male,31,55,51,93,3,93,3,0,0
1827086,31,5,1982,3,male,88,55,39,92,15,92,10,0,5
1307497,71,14,1942,2,female,1343,55,16,95,22,95,14,0,8
2095291,32,15,1981,11,female,488,55,43,95,153,95,22,0,131
1966097,38,10,1975,3,male,379,55,31,97,22,9,3,88,19
1132121,58,13,1955,10,male,187,55,42,99,48,0,14,99,34
2186981,45,9,1968,5,female,411,54,33,98,53,62,40,36,13
1628170,14,4,1999,8,female,136,55,44,97,30,90,20,7,10
1424632,17,19,1996,8,female,358,55,37,97,0,97,0,0,0
1856017,26,9,1987,7,female,411,55,34,96,54,96,33,0,21
1695067,48,23,1965,5,female,4,55,34,96,53,96,25,0,28
1336082,23,24,1990,2,male,39,54,54,99,101,99,75,0,26
1226144,52,22,1961,2,male,606,54,22,100,26,0,11,100,15
1492954,32,15,1981,1,male,314,54,36,102,216,68,181,34,35
1083689,59,14,1954,11,female,602,54,27,101,54,100,44,1,10
1493105,59,6,1954,6,female,473,54,34,103,39,103,26,0,13
1507526,45,1,1968,2,female,264,55,35,108,51,8,11,100,40
1732717,42,3,1971,7,male,396,55,42,108,159,25,50,83,109
1832956,49,23,1964,12,male,662,54,28,107,23,105,9,2,14
1860573,61,15,1952,9,female,642,54,31,106,7,106,4,0,3
1001421,25,1,1988,1,male,248,54,27,108,33,108,33,0,0
1086192,42,25,1971,1,female,703,54,17,107,75,107,55,0,20
1629717,20,1,1993,1,male,68,54,46,111,0,0,0,111,0
1546000,66,16,1947,4,female,1278,54,18,112,61,0,35,112,26
1076517,33,1,1980,7,male,581,55,31,114,64,19,14,95,50
1483601,57,26,1956,9,female,1309,54,31,124,9,123,3,1,6
1751941,68,16,1945,4,male,155,54,41,124,8,124,7,0,1
1679063,52,24,1961,12,female,842,55,20,120,28,120,28,0,0
1043822,68,10,1945,6,female,860,55,27,127,10,0,8,127,2
1792923,49,10,1964,11,female,271,54,40,128,88,0,26,128,62
1458260,19,14,1994,11,male,28,55,47,129,29,81,26,48,3
1755654,52,11,1961,2,female,257,54,31,134,50,0,46,134,4
2045874,45,28,1968,10,male,1378,55,27,135,169,71,126,64,43
2027248,16,27,1997,3,female,156,54,33,135,32,132,16,3,16
1179698,50,8,1963,12,female,453,54,36,133,76,133,67,0,9
2047027,25,9,1988,2,female,481,54,30,143,58,0,21,143,37
1404288,33,16,1980,11,male,739,54,12,141,69,140,64,1,5
1490896,19,31,1994,10,male,437,55,30,138,53,138,38,0,15
1885090,20,29,1993,6,female,687,55,16,139,78,139,76,0,2
1617385,43,11,1970,7,female,601,55,21,138,44,138,35,0,9
1301274,54,7,1959,3,female,311,55,32,140,88,140,48,0,40
1099073,62,16,1951,6,female,537,55,45,149,71,49,30,100,41
2067785,48,8,1965,9,female,475,54,34,144,12,144,5,0,7
1091682,81,26,1932,11,female,482,54,44,149,17,149,10,0,7
1046460,18,22,1995,3,male,569,55,23,147,30,147,26,0,4
1818313,55,17,1958,5,female,1440,54,31,146,86,146,75,0,11
1388093,102,24,1911,11,male,1140,54,38,152,17,0,8,152,9
1717446,21,6,1992,8,male,160,54,29,155,116,0,45,155,71
2178482,15,14,1998,11,female,218,55,14,157,51,157,46,0,5
2175883,31,27,1982,2,female,266,54,17,152,225,152,114,0,111
1142630,74,21,1939,5,female,1689,54,9,160,8,0,3,160,5
1868477,57,17,1956,2,male,272,54,34,158,12,128,9,30,3
1717769,18,29,1995,8,female,196,55,25,160,45,154,12,6,33
1288969,32,9,1981,9,female,638,54,41,162,61,162,27,0,34
1975564,51,22,1962,1,female,1005,55,34,163,99,163,80,0,19
1844288,75,4,1938,7,female,1122,54,28,171,56,0,11,171,45
1121152,65,13,1948,7,female,2054,54,23,169,98,151,57,18,41
1527515,34,10,1979,7,male,344,55,49,170,6,170,6,0,0
2183934,18,25,1995,7,female,492,55,30,168,50,168,37,0,13
1109690,35,29,1978,8,female,388,54,28,170,29,170,27,0,2
1615936,43,1,1970,1,male,704,55,40,165,43,165,24,0,19
1426981,18,15,1995,1,female,436,55,41,170,157,170,56,0,101
1709441,25,1,1988,1,male,193,54,34,175,45,171,31,4,14
1116034,15,17,1998,10,male,386,55,38,180,4,180,2,0,2
2172947,38,14,1975,7,male,477,54,35,174,26,174,24,0,2
1646721,23,10,1990,5,male,166,55,27,180,46,180,39,0,7
1530936,23,10,1990,4,female,136,55,47,182,134,143,68,39,66
1356582,93,17,1920,4,male,919,54,19,188,61,188,40,0,21
1886901,27,8,1986,3,female,402,54,3,188,223,188,222,0,1
1895720,50,8,1963,2,male,559,54,39,194,84,0,15,194,69
1924816,53,22,1960,12,female,240,55,32,192,38,0,3,192,35
1719481,21,7,1992,9,male,417,55,44,194,12,194,11,0,1
2157439,33,6,1980,4,female,29,55,17,196,168,196,91,0,77
1635647,57,10,1956,10,female,575,54,36,210,146,32,47,178,99
1259832,54,26,1959,11,female,339,55,41,210,49,174,38,36,11
1512655,25,26,1988,2,male,210,55,36,201,50,201,39,0,11
1817922,36,29,1977,12,female,1142,54,33,203,211,203,201,0,10
1301845,35,9,1978,4,male,191,54,51,202,561,202,433,0,128
1802784,18,17,1995,3,male,336,54,26,219,354,14,62,205,292
1779608,23,24,1990,3,female,617,54,35,216,96,180,59,36,37
1412166,24,4,1989,12,male,337,55,13,212,7,212,7,0,0
1933033,62,29,1951,5,female,1562,55,23,229,26,229,23,0,3
1947212,56,10,1957,7,male,288,55,33,229,212,229,194,0,18
2034381,38,8,1975,8,male,504,54,28,235,20,40,15,195,5
1446871,71,12,1942,11,female,412,55,39,244,72,0,19,244,53
1426490,18,29,1995,8,female,733,55,39,236,148,235,119,1,29
2100638,52,29,1961,1,female,164,54,38,249,82,0,37,249,45
1922581,23,18,1990,8,male,345,55,39,254,4,185,0,69,4
1414604,37,12,1976,8,female,134,54,18,254,738,244,550,10,188
2054215,65,16,1948,10,female,69,55,41,250,52,249,40,1,12
1913138,44,27,1969,11,female,548,55,29,268,217,187,103,81,114
1276438,54,1,1959,6,female,1059,55,29,276,31,208,17,68,14
1818673,73,10,1940,1,female,1724,55,24,270,21,212,9,58,12
1274046,50,28,1963,11,female,297,55,40,276,57,231,20,45,37
2105863,21,28,1992,1,female,291,54,49,266,155,266,153,0,2
2068360,72,15,1941,3,female,1499,55,45,283,21,0,8,283,13
1803325,58,11,1955,7,female,195,54,33,289,55,0,27,289,28
1519207,31,10,1982,2,male,652,54,23,290,13,150,6,140,7
1783719,22,25,1991,12,male,34,54,28,286,550,194,131,92,419
1218688,15,15,1998,2,female,195,54,46,287,89,251,82,36,7
1336946,53,9,1960,3,male,289,55,41,290,135,222,132,68,3
1290475,39,17,1974,10,male,244,54,31,313,192,65,141,248,51
2172294,31,19,1982,3,male,316,54,51,328,17,0,4,328,13
1915796,30,7,1983,11,female,1707,55,36,359,599,170,363,189,236
1896211,47,25,1966,1,female,670,55,38,354,48,354,44,0,4
1173862,56,13,1957,10,female,653,54,33,364,124,364,106,0,18
2086927,36,23,1977,12,female,134,55,46,381,202,41,38,340,164
1045207,17,3,1996,1,male,403,54,33,387,110,352,55,35,55
1914061,68,5,1945,2,male,1363,54,10,403,90,29,83,374,7
1345486,31,3,1982,6,male,13,54,42,421,125,249,70,172,55
1172579,56,29,1957,8,female,2376,55,49,446,219,0,67,446,152
1230480,68,29,1945,3,female,1392,54,38,425,46,414,32,11,14
1860119,25,1,1988,1,male,179,54,43,451,28,451,26,0,2
1417520,35,9,1978,9,male,212,55,40,431,250,431,193,0,57
1088241,40,21,1973,1,female,153,55,32,449,125,449,96,0,29
1645052,60,23,1953,2,female,917,55,20,493,66,0,24,493,42
1333594,62,2,1951,12,female,255,55,44,513,52,4,5,509,47
1352686,71,3,1942,8,female,1005,54,34,488,81,0,24,488,57
1514263,57,20,1956,10,female,687,54,26,533,152,524,96,9,56
2073301,28,3,1985,7,female,239,54,42,522,334,496,86,26,248
1460514,33,19,1980,12,female,183,54,30,613,135,613,68,0,67
2035219,35,5,1978,12,male,338,55,42,613,108,613,107,0,1
1878738,107,20,1906,10,female,945,55,41,683,378,0,60,683,318
1267998,29,10,1984,8,female,419,54,26,676,335,676,262,0,73
1231686,23,23,1990,7,female,285,55,46,750,693,0,60,750,633
1453472,68,18,1945,12,male,1452,55,18,754,633,0,179,754,454
1282004,53,10,1960,8,female,1650,54,32,729,124,158,17,571,107
1590238,55,13,1958,4,female,272,55,31,728,175,728,86,0,89
1342590,21,18,1992,11,female,656,55,30,867,655,444,227,423,428
1278648,36,13,1977,11,male,72,55,37,853,45,853,44,0,1
1872713,26,26,1987,4,male,102,54,23,876,754,876,435,0,319
1716793,60,8,1953,10,female,139,55,36,948,807,15,172,933,635
1233897,67,22,1946,5,female,995,54,28,935,124,935,61,0,63
1574859,42,17,1971,5,female,559,55,19,880,521,880,367,0,154
2146003,103,13,1910,11,female,920,55,38,991,929,0,95,991,834
1679338,18,17,1995,4,female,406,54,35,1003,774,446,322,557,452
1163893,59,15,1954,4,female,1310,54,9,1056,752,1033,590,23,162
1881970,70,29,1943,10,female,211,54,27,1179,353,0,74,1179,279
1710549,35,1,1978,5,female,849,54,27,1892,404,1784,217,108,187
1148970,45,8,1968,5,male,435,54,19,2136,369,1743,207,393,162
1947050,64,5,1949,6,male,1566,55,25,3332,327,3332,238,0,89
1861980,70,26,1943,4,female,1704,54,22,2580,777,2580,299,0,478
1219628,56,24,1957,11,male,86,54,35,7920,648,1456,144,6464,504
2144913,28,8,1985,10,female,347,55,26,4052,4955,3920,2950,132,2005
1829450,41,26,1972,10,female,444,55,18,5615,5600,5615,3457,0,2143
1193098,52,11,1961,10,female,234,56,26,4,4,4,1,0,3
1783772,62,3,1951,4,male,765,56,39,4,5,4,5,0,0
1493413,64,24,1949,11,male,660,57,49,4,3,4,3,0,0
1279587,67,18,1946,2,female,1692,57,23,4,3,4,2,0,1
1433334,15,23,1998,2,female,329,57,29,4,12,4,12,0,0
2126360,25,22,1988,11,male,735,57,32,4,10,4,10,0,0
2056646,47,14,1966,12,female,988,56,30,4,7,4,7,0,0
1758628,46,6,1967,4,male,153,57,49,4,9,4,5,0,4
1555123,55,7,1958,8,female,579,56,38,5,1,0,0,5,1
2042331,56,29,1957,4,female,500,56,22,5,3,0,2,5,1
1129826,63,2,1950,8,female,1591,56,27,5,17,0,1,5,16
1717889,23,11,1990,9,male,393,56,45,5,0,3,0,2,0
1589759,31,9,1982,3,male,1056,57,20,5,0,1,0,4,0
1673944,61,14,1952,1,male,1216,57,31,5,46,3,36,2,10
1646194,38,9,1975,1,male,381,56,37,5,0,5,0,0,0
1853909,44,10,1969,7,male,223,56,34,5,0,5,0,0,0
1720922,19,25,1994,1,female,837,56,35,5,1,5,1,0,0
1983780,41,17,1972,7,male,284,57,46,5,1,5,0,0,1
2009566,18,23,1995,5,female,471,57,39,5,5,5,5,0,0
1138170,26,25,1987,3,male,16,56,45,5,6,5,6,0,0
1266061,27,15,1986,5,male,175,57,52,5,7,5,5,0,2
1715464,38,12,1975,10,female,558,57,33,5,4,5,3,0,1
1067012,18,1,1995,7,female,677,57,44,5,26,5,9,0,17
1963585,72,4,1941,3,female,357,56,34,5,19,5,9,0,10
1048892,108,25,1905,9,female,1619,57,30,6,2,0,2,6,0
1586020,51,12,1962,10,male,1091,57,41,6,8,0,3,6,5
1834326,45,8,1968,12,male,34,56,40,6,45,0,0,6,45
1245734,62,1,1951,11,female,1314,57,24,6,13,0,1,6,12
1007806,19,12,1994,12,female,474,56,41,6,0,4,0,2,0
2142592,17,8,1996,2,female,179,56,11,6,8,3,3,3,5
1508818,61,16,1952,1,male,638,56,35,6,5,2,3,4,2
2123665,20,5,1993,5,male,70,56,48,6,0,6,0,0,0
1507635,18,28,1995,3,male,77,57,43,6,2,6,2,0,0
1417730,21,26,1992,12,male,535,56,41,6,2,6,2,0,0
1445721,31,15,1982,4,male,443,56,32,6,2,6,0,0,2
1004889,28,27,1985,4,male,504,57,41,6,6,6,6,0,0
1611424,14,16,1999,11,male,160,56,47,6,40,6,34,0,6
1551886,17,25,1996,6,female,277,56,27,6,15,6,15,0,0
1168276,22,14,1991,1,male,341,57,45,6,10,6,2,0,8
1769396,24,25,1989,5,female,99,56,31,6,37,6,29,0,8
1866611,34,31,1979,3,male,487,56,45,6,70,6,56,0,14
1540563,41,27,1972,2,male,350,56,41,6,18,6,18,0,0
2058646,68,17,1945,12,female,736,56,35,6,15,6,12,0,3
1803902,72,15,1941,12,male,1208,56,45,6,18,6,8,0,10
1723114,24,18,1989,12,male,296,56,26,7,1,0,1,7,0
1080993,30,1,1983,1,male,132,56,20,7,5,0,4,7,1
1208656,65,10,1948,8,male,546,57,44,7,5,0,3,7,2
1979359,29,26,1984,9,male,441,57,36,7,22,0,5,7,17
1304392,50,26,1963,5,male,732,57,48,7,17,0,0,7,17
2163500,55,27,1958,6,male,448,57,39,7,22,0,12,7,10
1984893,23,21,1990,4,male,1644,57,53,7,0,5,0,2,0
2006780,23,11,1990,11,male,713,57,38,7,10,2,3,5,7
1547568,41,27,1972,8,male,318,56,36,7,7,3,3,4,4
1219254,36,23,1977,1,male,307,56,22,7,22,4,7,3,15
1187283,53,22,1960,5,female,273,56,48,7,44,6,18,1,26
2061750,14,12,1999,12,female,156,57,47,7,0,7,0,0,0
2136970,26,1,1987,1,male,237,57,46,7,1,7,1,0,0
1051770,31,13,1982,3,male,581,57,32,7,0,7,0,0,0
1774903,20,14,1993,2,male,547,56,39,7,3,7,3,0,0
1571963,21,1,1992,4,male,15,57,52,7,3,7,3,0,0
2188712,21,18,1992,3,female,127,57,40,7,7,7,3,0,4
1838170,45,24,1968,4,female,468,57,29,7,9,7,9,0,0
1981968,106,17,1907,11,female,394,56,16,7,8,7,6,0,2
1852204,30,29,1983,9,male,338,57,35,8,1,0,0,8,1
1347002,31,31,1982,3,male,341,56,54,8,0,0,0,8,0
1710380,53,25,1960,4,male,373,56,23,8,101,0,11,8,90
1514827,58,12,1955,7,male,551,57,56,8,14,0,3,8,11
1162461,34,29,1979,4,male,243,56,46,8,1,2,0,6,1
1592706,51,30,1962,3,female,89,57,40,8,100,6,83,2,17
1592528,64,20,1949,4,male,763,56,44,8,21,7,21,1,0
1356213,20,30,1993,9,female,232,57,4,8,1,8,1,0,0
1500648,26,1,1987,1,male,316,57,31,8,0,8,0,0,0
1121309,40,17,1973,7,male,570,56,34,8,0,8,0,0,0
1530217,29,10,1984,11,female,236,57,34,8,4,8,0,0,4
1014093,25,11,1988,5,female,576,56,17,8,18,8,12,0,6
1852977,26,1,1987,1,male,167,56,54,8,88,8,53,0,35
2124743,58,5,1955,4,male,649,56,31,8,16,8,15,0,1
1691972,65,31,1948,8,female,91,56,55,9,4,0,3,9,1
1580120,19,22,1994,9,male,545,56,35,9,7,0,0,9,7
1978589,22,26,1991,9,female,6,57,57,9,6,0,0,9,6
1582350,20,7,1993,11,male,50,57,49,9,4,8,0,1,4
1358665,16,21,1997,3,female,656,56,17,9,0,9,0,0,0
1899955,48,7,1965,9,female,267,57,40,9,0,9,0,0,0
1005096,25,22,1988,2,male,147,56,48,9,5,9,1,0,4
1918830,66,25,1947,9,male,118,57,38,9,3,9,3,0,0
2083007,70,20,1943,11,female,211,56,27,9,3,9,1,0,2
1296024,31,12,1982,3,female,470,57,37,9,50,9,44,0,6
1330318,37,17,1976,1,female,1417,56,40,10,6,0,2,10,4
1831548,29,1,1984,9,male,464,57,49,10,4,7,0,3,4
1085322,55,10,1958,10,male,1323,56,18,10,50,9,25,1,25
1163561,33,4,1980,5,female,547,57,46,10,0,10,0,0,0
1457172,57,25,1956,12,female,571,56,19,10,0,10,0,0,0
1284815,16,24,1997,6,female,480,57,30,10,4,10,1,0,3
1436604,49,25,1964,6,female,858,56,44,10,3,10,0,0,3
2048787,50,12,1963,8,female,546,57,37,10,6,10,6,0,0
1890604,15,27,1998,8,male,158,57,31,10,8,10,8,0,0
1359309,31,13,1982,3,male,267,56,38,10,7,10,7,0,0
1161717,54,4,1959,2,male,1261,57,20,10,14,10,10,0,4
1284280,14,11,1999,7,male,295,57,41,10,32,10,15,0,17
1742522,24,28,1989,5,female,328,56,48,10,68,10,52,0,16
1363670,61,20,1952,8,male,403,57,41,10,16,10,10,0,6
2123041,20,23,1993,5,male,783,57,49,11,0,0,0,11,0
1688057,54,30,1959,5,male,174,57,34,11,10,0,1,11,9
1983547,54,28,1959,10,female,522,56,42,11,263,0,119,11,144
1514337,20,14,1993,6,male,442,56,40,11,0,8,0,3,0
2113936,19,1,1994,6,female,185,56,53,11,3,11,1,0,2
1031590,47,7,1966,11,male,765,56,28,11,9,11,5,0,4
1756356,65,3,1948,2,male,443,57,25,11,11,11,2,0,9
1949593,93,1,1920,1,male,635,56,45,12,2,0,0,12,2
1440410,14,8,1999,10,male,550,56,29,12,9,0,0,12,9
1419309,26,30,1987,1,male,414,56,36,12,8,0,0,12,8
1541695,46,6,1967,8,female,1480,56,36,12,30,6,11,6,19
1275330,52,20,1961,10,female,244,56,32,12,3,12,2,0,1
1972400,63,11,1950,7,male,69,57,50,12,2,12,2,0,0
1207804,47,6,1966,7,female,494,57,10,12,14,12,10,0,4
1090513,22,9,1991,8,male,153,56,37,12,18,12,13,0,5
1718729,23,13,1990,10,male,19,56,53,12,25,12,21,0,4
1963351,25,12,1988,1,male,295,57,39,13,4,0,2,13,2
1287500,22,11,1991,2,male,590,57,32,13,10,0,5,13,5
1045045,43,14,1970,6,female,108,57,34,13,41,0,12,13,29
1935344,18,25,1995,2,male,357,57,40,13,0,4,0,9,0
1447617,20,18,1993,10,female,328,57,40,13,29,9,9,4,20
1110622,18,27,1995,7,male,209,56,39,13,0,13,0,0,0
1347883,29,23,1984,11,male,259,56,48,13,0,13,0,0,0
1121396,28,29,1985,3,male,996,56,39,13,0,13,0,0,0
1273880,34,28,1979,7,male,696,56,51,13,2,13,2,0,0
2069635,43,11,1970,10,male,290,57,31,13,26,13,17,0,9
1997179,78,4,1935,6,female,1500,57,20,14,0,0,0,14,0
2137807,61,1,1952,3,male,601,57,40,14,8,0,3,14,5
1296042,66,30,1947,4,male,707,56,31,14,19,1,8,13,11
1152259,43,26,1970,10,female,542,56,33,14,87,4,48,10,39
2104365,66,18,1947,11,male,590,56,39,14,38,8,15,6,23
1520020,68,28,1945,11,male,457,56,12,14,4,11,0,3,4
2085536,25,5,1988,6,female,398,56,42,14,0,14,0,0,0
1245342,63,20,1950,1,female,2035,56,26,14,1,14,1,0,0
2164311,20,3,1993,3,male,344,56,43,14,12,14,12,0,0
2018802,57,14,1956,3,female,234,57,40,14,84,14,54,0,30
1153857,53,9,1960,2,female,994,57,21,15,1,12,1,3,0
1424605,43,23,1970,1,male,1581,57,10,15,39,11,10,4,29
1974017,25,20,1988,7,male,139,56,33,15,2,15,2,0,0
2035967,53,30,1960,1,female,247,57,17,15,1,15,1,0,0
2190568,59,19,1954,6,female,163,56,19,15,1,15,1,0,0
1481962,66,13,1947,11,female,908,57,15,15,9,15,6,0,3
1316698,18,11,1995,7,female,105,56,53,15,22,15,19,0,3
1564841,26,29,1987,6,male,264,56,30,15,10,15,8,0,2
1355348,49,20,1964,4,male,389,56,30,15,12,15,8,0,4
1511009,57,3,1956,12,male,1537,56,26,15,29,15,17,0,12
1424684,56,10,1957,4,female,1694,56,14,16,4,2,0,14,4
1351367,64,26,1949,3,female,839,56,22,16,19,3,13,13,6
1033845,24,7,1989,7,female,1358,57,17,16,31,3,22,13,9
1526872,44,1,1969,2,female,1295,57,43,16,137,6,109,10,28
1311275,22,22,1991,7,male,371,57,47,16,0,16,0,0,0
2144002,31,19,1982,5,female,488,56,37,16,9,16,9,0,0
1844489,33,12,1980,12,male,483,57,47,16,10,16,7,0,3
1220272,21,8,1992,12,male,382,56,37,16,25,16,11,0,14
1749906,106,11,1907,10,female,301,56,41,16,49,16,20,0,29
1074879,51,8,1962,5,male,379,56,32,17,7,0,2,17,5
2054754,22,24,1991,9,female,348,57,34,17,2,16,2,1,0
1905538,23,1,1990,1,male,475,57,27,17,3,17,2,0,1
1179363,56,13,1957,5,female,569,57,45,17,25,17,13,0,12
2046912,33,3,1980,2,female,90,57,21,17,53,17,4,0,49
1624589,37,9,1976,2,female,420,56,40,17,34,17,28,0,6
1936066,63,1,1950,12,female,920,57,37,17,49,17,38,0,11
1890221,33,12,1980,4,female,361,56,25,18,2,0,0,18,2
1015078,47,11,1966,5,male,362,56,40,18,1,0,1,18,0
1955389,14,6,1999,12,male,605,56,26,18,7,7,3,11,4
2074652,67,13,1946,3,male,1296,56,11,18,8,4,4,14,4
1874970,23,5,1990,5,male,140,56,32,18,0,18,0,0,0
1319589,38,5,1975,8,female,225,56,35,18,5,18,0,0,5
1944210,70,7,1943,3,male,1057,57,34,18,13,18,6,0,7
1813698,21,27,1992,6,female,81,56,28,18,40,18,18,0,22
1958520,24,8,1989,7,male,174,57,49,18,39,18,39,0,0
2170780,32,13,1981,12,female,588,56,27,19,68,11,27,8,41
1437102,65,14,1948,4,male,1728,56,10,19,2,17,1,2,1
1660926,58,12,1955,12,female,1574,57,35,19,16,19,6,0,10
1407028,48,10,1965,1,female,411,57,43,19,76,19,68,0,8
1535041,58,26,1955,12,female,269,56,33,20,15,2,10,18,5
1623295,26,28,1987,11,female,551,56,21,20,38,0,6,20,32
1277435,53,27,1960,9,female,376,56,26,20,133,2,70,18,63
1499034,66,10,1947,8,male,220,57,4,20,15,8,8,12,7
1704246,21,10,1992,12,male,132,56,51,20,2,20,2,0,0
1281214,23,22,1990,8,female,397,57,24,20,4,20,2,0,2
1022992,59,17,1954,6,female,271,57,29,20,6,20,6,0,0
2174029,94,1,1919,9,male,160,57,53,20,6,20,5,0,1
1474360,22,11,1991,1,female,435,57,26,20,27,20,26,0,1
1343727,37,30,1976,9,male,617,57,28,20,27,20,12,0,15
1083594,51,23,1962,3,male,1803,56,30,20,20,20,13,0,7
1282563,66,10,1947,4,female,852,56,29,21,11,0,7,21,4
1490420,113,30,1900,9,female,1605,57,42,21,5,0,1,21,4
1180362,18,24,1995,8,male,236,56,19,21,12,9,10,12,2
1006011,21,16,1992,4,female,475,57,28,21,5,19,5,2,0
1293144,22,13,1991,9,male,419,57,17,22,10,2,7,20,3
1421820,27,14,1986,7,male,278,57,39,22,3,10,3,12,0
1458541,46,28,1967,6,female,527,57,26,22,56,9,20,13,36
1760904,43,19,1970,11,male,458,57,26,22,0,17,0,5,0
1230184,63,17,1950,8,female,250,57,22,22,0,22,0,0,0
1282165,41,1,1972,1,male,271,57,39,22,12,22,9,0,3
1534878,51,12,1962,10,female,479,57,35,22,19,22,14,0,5
1145923,24,29,1989,8,male,574,57,35,23,32,4,20,19,12
1692931,63,10,1950,1,male,1145,57,17,23,61,9,15,14,46
1105346,21,21,1992,9,male,388,56,31,23,3,23,3,0,0
1994276,19,14,1994,8,male,290,56,34,23,9,23,9,0,0
1553809,25,7,1988,7,male,593,56,36,23,6,23,6,0,0
1398646,55,11,1958,5,female,186,56,46,23,10,23,7,0,3
1214393,18,1,1995,1,male,189,57,53,23,17,23,10,0,7
1923194,34,15,1979,8,male,314,57,35,23,27,23,26,0,1
1047397,58,13,1955,7,female,500,56,47,24,7,0,1,24,6
1430414,27,31,1986,8,male,355,57,46,24,19,2,2,22,17
2059241,58,23,1955,7,male,286,57,24,24,1,24,1,0,0
1393877,21,14,1992,11,male,434,56,1,24,27,24,24,0,3
1694316,35,18,1978,10,male,799,57,48,24,31,24,29,0,2
1748963,44,1,1969,5,male,516,57,34,24,32,24,23,0,9
1099350,52,22,1961,4,female,1461,57,15,25,2,16,1,9,1
1427557,101,18,1912,10,female,915,56,41,25,10,17,5,8,5
1055259,24,28,1989,8,male,173,57,44,25,25,25,14,0,11
2035670,42,13,1971,10,female,624,57,11,25,34,25,28,0,6
1090321,56,20,1957,5,female,424,57,39,25,28,25,15,0,13
1692271,17,25,1996,7,male,58,56,31,26,5,0,1,26,4
1573522,56,24,1957,9,male,792,56,46,26,23,0,8,26,15
2020657,71,20,1942,3,female,1290,57,47,27,4,0,1,27,3
1632896,34,11,1979,2,male,100,56,43,27,16,27,6,0,10
1088743,54,19,1959,7,male,312,56,25,27,6,27,6,0,0
1670417,55,18,1958,8,male,921,56,22,28,27,28,15,0,12
1036530,39,18,1974,10,female,212,56,49,29,17,19,17,10,0
1210964,28,5,1985,6,male,487,56,36,29,10,29,6,0,4
1510918,55,30,1958,9,male,1107,57,42,31,2,0,1,31,1
2146824,24,10,1989,3,male,314,57,50,31,12,0,3,31,9
1208857,53,29,1960,3,female,320,57,25,30,29,0,20,30,9
1702946,27,16,1986,4,female,403,57,27,31,6,21,2,10,4
2180804,34,22,1979,4,female,279,56,19,31,27,13,25,18,2
1605301,52,23,1961,3,female,1376,56,18,30,12,30,10,0,2
2012310,25,1,1988,1,male,526,56,27,30,89,30,52,0,37
1176918,44,1,1969,1,male,257,56,24,31,64,31,28,0,36
1604943,53,11,1960,1,male,1226,56,30,31,54,31,26,0,28
2191049,53,30,1960,5,female,88,56,47,32,13,0,7,32,6
1737198,46,18,1967,3,male,580,56,33,32,15,29,13,3,2
1819481,25,3,1988,5,male,499,56,41,32,3,32,3,0,0
1504873,30,24,1983,6,female,692,57,30,32,4,32,4,0,0
1113912,62,7,1951,8,female,216,56,45,32,3,32,3,0,0
1603255,31,30,1982,1,female,468,56,37,32,32,32,32,0,0
1911962,15,24,1998,12,male,86,56,32,33,20,2,13,31,7
1536112,58,12,1955,4,male,622,56,42,33,30,0,20,33,10
1695173,54,27,1959,6,female,1818,57,27,33,107,32,94,1,13
2144589,26,21,1987,3,male,613,56,32,33,5,33,4,0,1
1313982,41,2,1972,8,male,191,56,43,33,6,33,6,0,0
1961899,45,3,1968,6,female,395,56,33,33,8,33,4,0,4
1185069,49,3,1964,12,male,366,56,39,33,39,33,18,0,21
1174770,46,4,1967,5,male,610,57,22,34,37,33,26,1,11
1448342,27,10,1986,4,female,512,57,45,34,6,34,0,0,6
2183634,69,8,1944,8,male,986,57,33,36,6,0,5,36,1
1735679,20,18,1993,2,female,306,57,19,36,22,12,12,24,10
1738245,25,11,1988,10,male,333,56,49,35,0,34,0,1,0
1804791,32,14,1981,3,male,81,56,35,35,2,35,0,0,2
1885703,38,21,1975,5,male,117,56,34,35,1,35,1,0,0
2094259,25,19,1988,7,female,280,56,18,36,71,36,69,0,2
1803267,46,11,1967,1,male,418,57,51,37,35,1,4,36,31
2124237,67,20,1946,3,female,635,57,34,37,19,11,16,26,3
1054418,40,8,1973,3,male,52,57,41,37,83,37,44,0,39
1970953,38,20,1975,2,male,362,57,43,39,7,0,1,39,6
1696150,111,18,1902,10,male,2301,57,34,39,13,5,7,34,6
1105990,26,26,1987,10,female,299,57,37,38,30,20,10,18,20
1962340,28,26,1985,11,male,610,57,27,39,0,37,0,2,0
1718765,16,26,1997,5,male,70,56,43,38,1,38,0,0,1
1541616,46,6,1967,11,male,493,57,31,38,6,38,2,0,4
2094266,30,20,1983,2,male,424,56,48,38,42,38,20,0,22
1254958,64,14,1949,9,female,503,57,24,39,54,39,44,0,10
1209824,51,25,1962,4,male,22,57,14,40,92,20,48,20,44
1071600,21,26,1992,5,female,351,56,40,40,8,31,1,9,7
1285885,54,17,1959,5,male,953,57,29,40,13,38,9,2,4
1625449,36,3,1977,5,male,491,56,35,40,119,39,114,1,5
1377531,66,27,1947,9,male,807,57,33,40,21,40,8,0,13
2152231,33,1,1980,1,male,672,56,45,40,25,40,18,0,7
1734910,30,12,1983,4,female,453,57,25,40,198,40,183,0,15
2005808,79,7,1934,1,female,2063,56,45,41,23,0,15,41,8
1372387,103,1,1910,1,female,1687,56,31,42,99,0,25,42,74
1829349,17,19,1996,9,male,229,56,43,42,5,30,5,12,0
1966335,24,18,1989,10,female,361,56,37,42,31,41,15,1,16
1601906,25,20,1988,4,male,267,57,42,41,25,40,14,1,11
1442050,22,7,1991,1,male,62,57,35,42,0,42,0,0,0
1279884,27,20,1986,10,male,660,56,8,41,0,41,0,0,0
1001391,30,8,1983,4,male,480,57,44,42,2,42,2,0,0
1452028,29,2,1984,2,male,359,56,31,41,24,41,24,0,0
1632844,32,12,1981,9,male,608,56,49,44,2,0,0,44,2
1766548,63,13,1950,10,male,269,56,32,43,66,0,32,43,34
1472588,28,10,1985,12,male,227,57,55,43,4,43,4,0,0
1305109,59,17,1954,11,male,359,56,21,45,19,43,11,2,8
1821806,37,8,1976,9,female,112,57,50,45,26,45,21,0,5
2013254,47,6,1966,1,female,936,57,43,45,27,45,6,0,21
2027811,53,11,1960,8,female,1174,57,47,45,42,45,24,0,18
1223307,55,28,1958,7,female,223,56,22,46,34,0,13,46,21
1437805,53,14,1960,7,female,488,57,34,46,5,11,3,35,2
1231185,74,1,1939,7,male,20,56,56,47,2,44,1,3,1
1997100,14,2,1999,11,male,280,57,33,46,10,42,8,4,2
1685373,61,6,1952,7,male,1870,57,35,47,56,39,32,8,24
1823292,25,6,1988,6,male,237,57,46,46,4,46,4,0,0
1631695,65,2,1948,12,female,92,56,42,46,6,46,4,0,2
1393037,47,7,1966,4,male,33,56,2,46,29,46,28,0,1
1358450,82,13,1931,12,female,1088,56,34,48,6,0,3,48,3
1857347,66,14,1947,11,female,768,57,42,49,9,0,6,49,3
1193679,53,25,1960,9,female,114,56,19,49,97,0,12,49,85
1246538,19,8,1994,3,male,319,56,41,48,36,19,21,29,15
2022485,43,30,1970,10,male,308,56,38,49,46,24,10,25,36
1940426,19,25,1994,8,female,458,57,32,49,8,49,2,0,6
1167382,66,11,1947,5,female,1093,57,30,49,13,49,11,0,2
1609093,26,1,1987,1,female,312,56,29,49,33,49,27,0,6
2099858,38,13,1975,6,male,209,57,37,51,18,20,10,31,8
2039967,36,3,1977,2,male,540,56,32,50,1,50,0,0,1
1569176,63,5,1950,3,female,1235,57,27,51,0,51,0,0,0
2192073,25,13,1988,10,male,530,57,32,51,11,51,3,0,8
1906003,44,1,1969,1,male,142,56,54,50,23,50,19,0,4
2032605,66,7,1947,12,female,1809,56,32,53,49,0,13,53,36
1850444,36,15,1977,10,male,600,56,51,52,15,22,15,30,0
1428657,43,16,1970,6,male,1372,56,21,53,1,43,0,10,1
1052017,19,1,1994,9,male,458,57,33,53,33,51,12,2,21
1467154,25,10,1988,7,male,842,57,28,53,3,53,3,0,0
1882385,58,27,1955,10,female,522,57,47,53,23,53,12,0,11
1820912,55,23,1958,11,female,602,57,41,52,96,52,41,0,55
1550035,60,23,1953,4,male,700,57,10,55,32,8,19,47,13
1144956,80,19,1933,3,female,8,57,46,54,18,0,1,54,17
2094840,52,4,1961,1,female,327,56,30,54,78,5,57,49,21
1018010,20,10,1993,3,male,311,56,43,54,20,54,17,0,3
1980452,53,1,1960,1,male,90,57,44,54,169,54,61,0,108
1592942,15,1,1998,1,female,348,56,2,58,0,21,0,37,0
1964680,49,20,1964,1,female,158,57,52,56,1,40,1,16,0
1031278,64,11,1949,11,female,170,56,46,56,5,45,4,11,1
2135282,69,8,1944,5,male,1849,56,17,56,51,54,35,2,16
1642692,51,29,1962,11,female,143,56,48,57,10,57,9,0,1
1863479,54,11,1959,11,male,405,56,45,59,0,0,0,59,0
1685280,38,1,1975,3,male,922,57,39,59,17,0,15,59,2
2053072,48,15,1965,12,male,1088,56,26,60,2,23,1,37,1
1363584,23,12,1990,12,female,515,56,13,60,0,60,0,0,0
1874613,21,2,1992,10,female,72,57,51,59,148,59,106,0,42
1347693,56,27,1957,5,female,740,57,38,62,27,0,21,62,6
1367672,25,24,1988,12,male,466,57,33,63,43,6,10,57,33
1317355,61,21,1952,3,female,280,56,36,62,1,35,1,27,0
1304998,23,19,1990,4,female,465,56,42,62,39,57,25,5,14
1571191,30,3,1983,5,female,432,56,26,62,217,51,24,11,193
1641849,26,28,1987,9,male,40,57,56,61,2,61,2,0,0
1601422,31,24,1982,6,male,458,57,45,63,24,63,20,0,4
1829051,16,18,1997,12,female,117,56,26,64,2,64,1,0,1
1872113,29,6,1984,4,female,450,56,37,65,68,65,37,0,31
1073948,35,22,1978,8,male,140,57,48,64,76,64,76,0,0
1588809,45,29,1968,9,female,205,56,48,64,53,64,43,0,10
1650410,51,29,1962,8,male,184,56,29,64,70,64,67,0,3
1295378,65,11,1948,3,male,621,56,33,65,52,65,34,0,18
2052456,19,8,1994,6,male,15,57,57,67,5,17,0,50,5
1778252,27,22,1986,6,male,389,56,29,67,0,19,0,48,0
1600471,33,29,1980,1,male,571,56,40,67,82,28,11,39,71
1233684,23,1,1990,1,male,251,56,37,67,0,61,0,6,0
1997131,26,7,1987,12,female,190,57,39,68,179,64,164,4,15
1018306,32,16,1981,1,male,573,57,28,66,1,66,1,0,0
2122522,33,2,1980,5,female,467,57,49,67,9,67,5,0,4
1588673,55,21,1958,1,female,870,56,37,68,14,68,10,0,4
1693375,108,1,1905,1,male,919,56,24,68,39,68,10,0,29
2170354,55,28,1958,5,female,1562,56,37,67,54,67,29,0,25
1361680,62,8,1951,9,female,1047,57,17,70,5,0,1,70,4
1915667,56,11,1957,6,male,1059,56,15,69,78,43,57,26,21
1881682,25,31,1988,12,female,647,56,17,69,87,69,81,0,6
1766888,15,29,1998,4,male,547,57,9,70,163,70,121,0,42
1235648,23,1,1990,2,male,480,57,18,72,36,0,23,72,13
2057204,18,20,1995,2,male,212,57,30,72,23,62,23,10,0
1417231,17,3,1996,3,male,208,56,51,73,9,73,9,0,0
1613629,30,12,1983,5,male,230,57,42,74,25,74,22,0,3
1391351,68,20,1945,4,male,91,57,34,75,6,0,1,75,5
2154070,52,5,1961,10,female,411,56,26,77,80,0,21,77,59
1711005,20,1,1993,10,female,372,56,13,76,0,17,0,59,0
1095164,17,16,1996,10,female,152,56,25,75,100,67,63,8,37
1173455,22,29,1991,4,female,37,56,8,75,98,59,66,16,32
1414140,16,18,1997,1,male,34,56,52,77,13,77,10,0,3
1269872,21,24,1992,1,male,146,56,43,77,20,77,17,0,3
1421109,59,19,1954,12,female,998,56,26,78,1,78,1,0,0
1189039,48,4,1965,11,male,424,56,41,79,70,79,25,0,45
1684840,71,20,1942,5,female,520,56,31,82,39,0,16,82,23
1702709,18,26,1995,7,female,387,57,30,83,11,83,6,0,5
1206973,45,20,1968,9,male,529,57,48,83,4,83,2,0,2
1650348,43,29,1970,7,female,514,56,35,81,46,81,21,0,25
1975840,23,1,1990,1,male,220,56,32,82,74,82,56,0,18
1694544,25,1,1988,1,male,134,56,7,81,83,81,70,0,13
1407902,25,1,1988,1,male,111,57,28,81,56,81,35,0,21
1157030,67,27,1946,11,male,420,56,38,86,29,41,18,45,11
2027141,72,1,1941,8,male,1819,56,30,86,49,20,22,66,27
1773727,19,8,1994,1,male,353,57,37,87,17,82,12,5,5
2174988,46,20,1967,10,female,341,57,36,85,24,85,22,0,2
1215962,19,23,1994,6,male,180,57,32,89,29,87,25,2,4
1438899,36,8,1977,5,male,524,56,13,91,126,91,96,0,30
1321084,38,7,1975,12,female,1060,57,31,90,88,90,49,0,39
1300275,93,8,1920,12,male,1707,56,30,92,34,0,13,92,21
1104375,27,24,1986,4,male,1209,56,16,93,50,91,40,2,10
1657702,67,1,1946,10,female,1437,56,29,92,80,68,59,24,21
1961690,49,31,1964,7,male,577,56,29,94,172,94,60,0,112
1957025,23,12,1990,12,male,358,56,47,98,7,60,1,38,6
1382392,34,7,1979,6,male,130,56,53,99,9,99,8,0,1
1246339,50,14,1963,4,female,1295,56,27,97,13,97,12,0,1
1194212,24,10,1989,8,male,183,57,40,99,26,99,25,0,1
1787639,48,19,1965,7,female,384,57,36,103,8,102,5,1,3
1753017,17,8,1996,5,female,29,57,33,104,55,103,32,1,23
1527872,17,29,1996,7,female,283,56,40,101,38,101,24,0,14
1770314,17,25,1996,12,female,29,57,51,104,144,104,119,0,25
1216508,53,10,1960,2,male,457,56,27,101,94,101,37,0,57
1656263,18,18,1995,2,male,102,57,56,107,15,0,9,107,6
2100430,73,9,1940,5,male,339,56,50,108,5,0,1,108,4
1645042,66,10,1947,7,male,1634,57,21,109,104,7,57,102,47
1426876,38,9,1975,6,male,1474,57,43,108,43,104,13,4,30
1426058,49,4,1964,12,female,675,57,41,109,68,104,27,5,41
1071521,42,2,1971,11,male,65,56,47,108,10,107,9,1,1
1706163,20,31,1993,10,female,48,56,27,109,31,109,24,0,7
1366829,34,27,1979,6,male,634,57,34,108,49,108,26,0,23
1633268,36,10,1977,5,male,891,56,18,106,110,106,108,0,2
1607435,57,19,1956,9,female,88,57,40,108,168,108,125,0,43
1809098,80,8,1933,1,female,2097,57,9,117,13,0,11,117,2
1704609,51,12,1962,10,male,112,57,50,117,68,0,45,117,23
1966302,39,10,1974,3,female,272,57,40,115,4,115,4,0,0
1371578,38,6,1975,4,female,492,57,33,114,34,114,28,0,6
1718329,63,14,1950,5,female,987,56,38,119,37,119,15,0,22
1490001,108,25,1905,2,male,1047,57,41,124,18,0,7,124,11
1618815,27,13,1986,5,female,355,57,33,120,55,92,31,28,24
1860696,34,18,1979,2,female,226,57,42,124,16,124,8,0,8
1642170,99,2,1914,4,female,950,56,32,124,30,124,22,0,8
2163678,59,1,1954,1,female,392,57,32,128,19,0,17,128,2
1471660,56,8,1957,6,female,137,56,28,125,46,0,21,125,25
1530495,27,31,1986,8,male,98,57,50,130,58,29,46,101,12
1595456,19,21,1994,10,female,82,56,49,128,85,72,53,56,32
1386390,24,5,1989,7,female,258,56,33,130,180,130,168,0,12
2013939,39,7,1974,2,female,675,57,23,127,84,127,78,0,6
1198845,24,4,1989,11,female,38,56,36,128,318,128,297,0,21
1120181,71,19,1942,3,female,977,57,29,134,14,0,0,134,14
1476120,55,3,1958,2,male,464,56,30,131,69,19,54,112,15
2058209,37,2,1976,9,female,437,57,5,132,124,132,102,0,22
1256491,52,10,1961,6,female,1454,56,32,133,196,133,140,0,56
1287697,53,30,1960,5,male,381,57,43,138,53,38,35,100,18
1463381,50,16,1963,10,male,349,56,43,140,9,140,9,0,0
1258119,23,3,1990,10,male,184,56,24,149,90,24,25,125,65
1507036,54,27,1959,4,male,458,57,30,148,26,2,13,146,13
1851285,50,23,1963,10,female,1161,57,28,148,58,45,28,103,30
2186561,42,2,1971,4,male,157,56,43,147,91,76,61,71,30
1379778,42,7,1971,10,female,1028,56,28,144,60,143,40,1,20
1847540,17,25,1996,10,male,42,56,43,144,21,144,19,0,2
1620763,54,18,1959,5,male,732,56,45,148,0,148,0,0,0
1335279,47,23,1966,11,male,483,56,41,150,34,150,29,0,5
2069893,60,15,1953,6,female,672,57,45,150,27,150,15,0,12
1411120,59,10,1954,3,female,1376,56,35,156,16,0,10,156,6
1517345,69,5,1944,7,female,630,56,39,151,47,124,36,27,11
1172486,16,5,1997,5,male,74,56,41,162,25,12,16,150,9
1025953,48,25,1965,6,female,253,57,28,162,23,162,14,0,9
1981921,63,13,1950,2,female,393,56,32,168,31,0,5,168,26
1960701,53,8,1960,10,female,129,56,48,168,25,168,13,0,12
1363829,35,4,1978,4,female,257,56,35,166,42,166,24,0,18
1521064,56,1,1957,12,female,1015,57,29,167,216,167,142,0,74
1748166,44,1,1969,4,female,682,57,30,174,24,168,6,6,18
1235254,31,30,1982,4,female,1458,57,20,175,109,169,60,6,49
2084632,50,4,1963,7,male,309,57,50,177,16,177,10,0,6
2058489,59,24,1954,8,male,1498,56,30,176,45,176,17,0,28
1021153,30,10,1983,5,female,537,57,28,187,50,178,24,9,26
1823132,37,2,1976,2,female,317,57,31,190,281,188,209,2,72
1504570,20,5,1993,11,female,300,57,39,189,50,189,48,0,2
1482850,40,22,1973,9,male,63,57,34,183,127,183,116,0,11
2107480,61,3,1952,2,female,227,56,36,183,360,183,177,0,183
1860467,22,1,1991,2,male,419,57,40,198,26,196,2,2,24
1835071,19,11,1994,1,male,707,57,46,192,14,192,14,0,0
1659893,40,7,1973,2,male,566,57,45,208,36,0,1,208,35
1410508,62,6,1951,5,female,455,57,34,211,162,0,17,211,145
1622808,56,10,1957,9,female,1350,57,16,204,389,0,153,204,236
1823061,44,6,1969,11,male,315,57,32,209,169,196,151,13,18
2115401,19,29,1994,4,male,412,56,48,206,21,206,21,0,0
1419736,48,2,1965,12,female,532,57,30,211,31,211,20,0,11
2033578,45,23,1968,9,female,66,56,37,208,87,208,54,0,33
1838531,60,21,1953,7,female,593,56,41,206,303,206,259,0,44
1740432,17,15,1996,6,male,599,57,44,218,34,0,1,218,33
1969398,52,2,1961,10,female,1032,57,20,219,20,219,15,0,5
1987274,36,15,1977,8,male,386,56,50,213,37,213,25,0,12
2125860,38,5,1975,6,female,426,57,45,223,79,216,54,7,25
1757626,23,17,1990,6,female,13,56,52,230,67,230,43,0,24
1930435,26,7,1987,12,female,239,57,33,228,110,228,107,0,3
1831803,103,25,1910,2,female,792,57,33,227,60,227,21,0,39
1673872,52,15,1961,10,female,615,56,35,239,161,135,51,104,110
1595718,56,4,1957,11,female,1384,57,18,237,258,228,143,9,115
1124897,65,13,1948,3,female,1416,57,26,248,44,241,32,7,12
2073721,37,26,1976,11,female,523,56,25,253,164,191,90,62,74
1737828,31,30,1982,7,male,81,57,47,251,2,251,1,0,1
1115178,37,4,1976,5,female,257,56,27,256,41,256,19,0,22
1821504,53,18,1960,3,female,273,57,51,257,25,257,24,0,1
2001228,38,12,1975,9,female,276,57,51,269,597,268,563,1,34
1055691,15,2,1998,2,female,395,56,43,261,61,261,50,0,11
1503869,66,26,1947,3,male,416,57,38,286,63,0,19,286,44
1518919,64,8,1949,4,female,599,57,26,278,189,0,51,278,138
1022875,26,18,1987,1,male,223,56,49,288,11,288,9,0,2
1895337,33,19,1980,9,female,281,56,38,308,134,180,115,128,19
1498783,103,1,1910,4,male,562,57,34,296,95,296,88,0,7
1987467,33,21,1980,1,female,419,57,43,300,411,300,346,0,65
1381854,41,15,1972,9,female,209,56,38,323,36,319,33,4,3
2044019,67,5,1946,12,female,1842,57,28,317,60,313,44,4,16
1487438,26,26,1987,6,female,274,57,22,317,102,316,77,1,25
1910333,63,5,1950,9,female,1303,56,23,323,244,323,96,0,148
1031308,31,1,1982,6,female,403,56,43,337,209,314,192,23,17
2032608,65,23,1948,4,female,46,56,43,331,78,331,67,0,11
1177223,20,15,1993,8,male,449,56,33,361,17,0,1,361,16
1080112,32,16,1981,10,female,239,56,31,356,176,356,61,0,115
1371787,46,16,1967,12,female,1234,56,30,372,440,63,123,309,317
2161761,65,12,1948,9,female,1752,56,30,381,132,376,70,5,62
1192362,64,22,1949,2,female,662,56,24,375,263,372,183,3,80
1796470,25,1,1988,11,female,312,57,43,391,269,391,36,0,233
1258156,48,21,1965,10,female,683,57,32,403,160,0,74,403,86
1553061,77,6,1936,7,female,573,57,13,430,28,0,23,430,5
1814816,66,21,1947,4,female,89,57,49,437,79,0,34,437,45
1249022,19,27,1994,9,female,593,56,15,436,816,252,103,184,713
1745816,47,3,1966,12,male,564,57,38,433,75,428,71,5,4
1629203,52,1,1961,2,female,479,56,32,434,15,434,11,0,4
1010990,32,12,1981,9,male,388,56,24,478,4,228,2,250,2
1363716,23,3,1990,7,male,522,56,34,468,360,186,118,282,242
1610879,45,27,1968,9,male,946,56,44,497,57,320,43,177,14
2109935,38,4,1975,5,male,292,56,41,511,1,414,1,97,0
1763978,46,22,1967,11,female,201,57,25,504,90,488,30,16,60
1946697,44,20,1969,5,female,545,56,29,497,526,453,445,44,81
2023890,28,5,1985,4,female,284,57,33,506,129,506,126,0,3
1335620,67,3,1946,5,female,311,56,22,543,58,0,23,543,35
1256339,108,8,1905,8,female,1007,57,18,576,77,1,46,575,31
1910278,18,14,1995,3,female,363,56,47,642,420,620,346,22,74
1873178,59,30,1954,3,male,208,57,55,623,162,623,150,0,12
1481599,48,28,1965,5,female,479,57,29,674,290,672,133,2,157
1401939,58,6,1955,5,female,141,56,46,869,215,0,30,869,185
1223015,25,24,1988,5,female,479,57,24,799,657,142,223,657,434
1437605,24,21,1989,4,female,2064,57,47,873,250,519,152,354,98
2086666,22,19,1991,11,female,962,56,43,836,1002,236,320,600,682
1687860,19,25,1994,8,female,177,56,38,849,1145,849,395,0,750
1471498,31,16,1982,8,female,161,57,43,927,1455,7,127,920,1328
1824367,51,6,1962,5,female,386,56,31,947,592,672,439,275,153
1936870,77,21,1936,1,female,114,57,43,979,157,979,110,0,47
1097486,23,2,1990,4,female,548,57,27,1232,421,978,165,254,256
1101307,51,21,1962,9,female,140,57,39,1328,69,1328,45,0,24
1767379,52,5,1961,6,male,563,56,29,1408,209,1408,128,0,81
1390048,41,2,1972,1,female,57,57,50,1297,1341,1297,975,0,366
1784519,35,10,1978,9,male,522,56,46,1537,323,0,242,1537,81
1043410,43,25,1970,8,female,1052,57,27,1693,399,1581,285,112,114
1655623,49,19,1964,4,male,265,57,19,1743,8,1743,5,0,3
2110783,56,8,1957,2,female,814,57,33,2881,697,10,424,2871,273
1336821,14,7,1999,1,female,81,58,34,10,3,0,2,10,1
1641823,15,18,1998,10,male,378,59,23,10,2,0,1,10,1
1611616,100,25,1913,11,male,936,58,47,10,5,0,4,10,1
1806033,62,18,1951,12,female,573,59,45,10,10,0,7,10,3
1354364,67,20,1946,10,male,339,58,47,10,15,0,13,10,2
1485688,14,1,1999,4,male,138,59,44,10,3,9,1,1,2
1332030,49,23,1964,12,female,1077,58,30,10,6,8,3,2,3
2021126,14,24,1999,12,female,155,58,48,10,0,10,0,0,0
1060413,16,7,1997,1,female,408,58,32,10,0,10,0,0,0
1128408,16,1,1997,1,male,101,59,11,10,0,10,0,0,0
1491017,18,1,1995,1,female,169,58,46,10,1,10,1,0,0
1847547,19,4,1994,12,male,343,59,39,10,5,10,5,0,0
1005535,21,19,1992,6,male,21,58,55,10,5,10,5,0,0
1770774,28,28,1985,11,male,151,58,36,10,4,10,2,0,2
1418709,28,25,1985,5,male,406,59,49,10,6,10,4,0,2
1564597,33,13,1980,2,male,209,59,37,10,3,10,2,0,1
1283406,39,22,1974,9,female,786,59,44,10,14,10,14,0,0
1570607,68,7,1945,6,male,1046,58,27,10,10,10,3,0,7
1309779,19,7,1994,12,male,260,58,41,10,30,10,11,0,19
2077087,33,1,1980,1,male,397,59,39,10,16,10,12,0,4
1451187,50,5,1963,6,female,356,59,45,10,30,10,14,0,16
1156315,71,9,1942,7,female,245,58,46,11,2,0,0,11,2
1871335,56,22,1957,9,male,423,59,56,11,10,6,5,5,5
1114332,31,27,1982,8,male,354,59,47,11,106,10,18,1,88
1583947,29,17,1984,3,female,377,58,24,11,0,11,0,0,0
1140026,23,17,1990,5,female,211,58,7,11,2,11,2,0,0
1792463,30,5,1983,6,female,862,59,31,11,2,11,2,0,0
1325047,39,27,1974,12,male,408,59,46,11,5,11,5,0,0
1936409,108,20,1905,1,male,437,59,41,11,4,11,4,0,0
1120368,27,11,1986,10,female,140,58,39,11,21,11,13,0,8
1778165,33,15,1980,11,male,161,58,40,11,20,11,15,0,5
1105763,42,2,1971,2,female,391,59,27,12,56,0,17,12,39
1404342,27,6,1986,8,female,284,58,44,12,0,9,0,3,0
1775065,29,25,1984,8,female,494,59,26,12,27,10,10,2,17
1561024,45,10,1968,11,female,146,58,17,12,54,10,24,2,30
1810916,65,2,1948,10,female,978,59,22,12,32,11,9,1,23
2171080,23,17,1990,6,male,139,59,53,12,2,12,2,0,0
1841618,32,1,1981,1,male,839,59,16,12,3,12,1,0,2
1637514,69,24,1944,7,male,285,59,40,12,3,12,1,0,2
1294054,26,18,1987,4,female,69,58,48,12,15,12,13,0,2
1799968,58,27,1955,7,female,357,59,19,12,14,12,8,0,6
1763755,21,2,1992,9,male,94,58,32,12,19,12,19,0,0
1395342,28,1,1985,1,male,230,59,29,12,34,12,11,0,23
1028654,60,31,1953,3,male,1414,58,29,12,22,12,22,0,0
1853150,64,23,1949,10,male,1629,59,16,12,20,12,12,0,8
1259296,35,9,1978,1,female,608,59,32,13,5,0,5,13,0
1262813,50,15,1963,5,male,375,59,49,13,4,0,1,13,3
1238548,84,20,1929,2,male,340,58,51,13,4,0,1,13,3
1250423,59,7,1954,1,male,1131,58,38,13,15,0,7,13,8
1434952,21,23,1992,12,male,157,59,52,13,6,6,1,7,5
1175676,22,1,1991,1,female,145,59,41,13,6,9,5,4,1
1933734,31,6,1982,4,male,318,59,49,13,93,9,65,4,28
2020849,18,1,1995,1,male,101,59,48,13,1,13,1,0,0
1047853,23,10,1990,3,male,168,59,47,13,1,13,1,0,0
1281667,27,1,1986,4,male,146,58,39,13,2,13,2,0,0
1393739,24,2,1989,5,male,35,58,41,13,5,13,2,0,3
1368092,18,12,1995,3,male,339,59,38,13,8,13,8,0,0
1916247,19,12,1994,1,male,256,59,29,13,10,13,4,0,6
2126182,21,11,1992,11,female,398,58,43,13,38,13,33,0,5
1594402,23,26,1990,9,female,117,59,51,13,25,13,17,0,8
1176494,24,11,1989,1,male,237,59,49,13,24,13,20,0,4
1349616,19,23,1994,11,male,376,59,45,14,1,0,0,14,1
1560995,17,24,1996,11,female,431,58,27,14,16,9,11,5,5
1503345,20,15,1993,10,female,719,58,47,14,6,12,4,2,2
1984923,30,3,1983,3,male,547,59,19,14,16,13,2,1,14
1111521,24,26,1989,8,female,186,59,34,14,3,14,3,0,0
1209119,18,15,1995,2,female,180,59,51,14,17,14,14,0,3
2191439,26,12,1987,8,male,61,58,49,14,11,14,10,0,1
1886462,61,6,1952,5,male,136,58,35,14,19,14,11,0,8
1995419,27,4,1986,4,female,311,59,40,14,23,14,18,0,5
1028114,82,16,1931,6,male,25,59,59,15,14,0,7,15,7
1975615,24,1,1989,10,male,226,58,36,15,1,4,1,11,0
2182224,65,5,1948,12,female,2228,59,20,15,31,10,17,5,14
2128302,22,18,1991,4,female,464,59,28,15,0,15,0,0,0
1290063,22,10,1991,9,male,41,58,47,15,7,15,6,0,1
1322496,19,24,1994,4,male,81,58,57,15,22,15,20,0,2
1832432,50,9,1963,12,female,592,59,36,16,4,0,1,16,3
1575234,108,26,1905,4,female,83,58,52,16,46,5,14,11,32
1933175,13,11,2000,10,male,24,59,58,16,33,13,24,3,9
1436312,23,4,1990,1,male,308,58,33,16,1,16,0,0,1
1639383,24,15,1989,10,male,305,59,49,16,0,16,0,0,0
1243733,47,21,1966,6,female,948,58,23,17,8,0,2,17,6
1534643,48,2,1965,12,female,1571,58,40,17,9,11,4,6,5
2049501,67,29,1946,5,female,1347,59,25,17,19,10,8,7,11
1588662,27,5,1986,2,female,225,59,10,17,0,17,0,0,0
2161890,41,9,1972,6,male,660,58,26,17,9,17,9,0,0
1935975,38,28,1975,5,male,350,58,47,17,25,17,12,0,13
1099992,65,20,1948,9,male,123,59,37,17,19,17,16,0,3
2074964,66,22,1947,3,female,242,58,38,18,13,0,7,18,6
1624275,64,1,1949,9,female,1396,58,26,18,43,4,27,14,16
1680047,27,17,1986,4,male,10,58,58,18,0,16,0,2,0
1639764,30,6,1983,5,male,397,58,38,18,0,17,0,1,0
1341824,69,12,1944,5,male,655,59,37,18,37,16,22,2,15
1737775,31,2,1982,2,male,268,59,37,18,1,18,1,0,0
1330381,30,11,1983,2,male,9,59,32,19,4,0,0,19,4
1651565,73,17,1940,10,female,301,59,42,19,89,0,29,19,60
1024910,19,1,1994,1,male,327,59,53,19,0,6,0,13,0
1848044,53,24,1960,12,female,1731,58,41,19,5,18,3,1,2
1910178,18,1,1995,1,female,27,59,12,19,3,19,3,0,0
1689717,56,16,1957,9,male,470,58,27,19,25,19,17,0,8
1785869,24,28,1989,12,female,114,59,35,19,64,19,43,0,21
1621584,61,19,1952,2,male,1758,59,13,19,84,19,75,0,9
1973276,64,26,1949,7,female,364,59,47,20,5,0,5,20,0
1231919,63,31,1950,12,male,715,59,29,20,125,0,25,20,100
1242649,26,4,1987,2,female,300,59,14,20,0,20,0,0,0
1323782,53,10,1960,3,male,979,58,38,20,44,20,28,0,16
1055740,43,28,1970,5,female,348,58,26,21,59,13,46,8,13
1614670,32,28,1981,4,male,328,59,12,21,3,21,2,0,1
1326805,42,31,1971,8,male,591,58,41,21,3,21,1,0,2
1737767,63,30,1950,4,male,2187,59,26,21,1,21,1,0,0
1216444,21,2,1992,2,male,498,58,40,21,11,21,8,0,3
1630372,23,4,1990,11,female,616,58,23,21,12,21,11,0,1
1565867,35,7,1978,12,male,645,59,16,21,4,21,4,0,0
1696436,52,21,1961,3,female,474,58,35,21,10,21,9,0,1
1576382,48,2,1965,7,female,1922,58,14,21,15,21,11,0,4
1891436,63,2,1950,9,female,145,58,27,21,130,21,30,0,100
1090460,49,1,1964,1,male,431,59,31,22,14,2,2,20,12
1737459,50,25,1963,5,male,1839,58,18,22,15,15,5,7,10
1683579,56,4,1957,2,male,694,59,37,22,8,22,6,0,2
2136207,14,12,1999,1,female,185,58,45,22,17,22,8,0,9
1216982,22,26,1991,10,male,301,58,31,22,37,22,25,0,12
1419922,42,6,1971,6,male,824,58,48,23,2,2,1,21,1
1561824,25,4,1988,4,male,106,59,45,23,0,22,0,1,0
1343695,32,5,1981,7,male,152,58,44,23,7,23,6,0,1
1758757,26,7,1987,7,male,285,59,39,23,54,23,7,0,47
1999803,107,22,1906,4,male,1705,58,37,24,2,0,1,24,1
1440894,62,19,1951,10,female,751,58,47,24,58,0,27,24,31
1186926,27,16,1986,11,female,178,58,27,24,22,12,7,12,15
1813432,46,30,1967,3,male,810,58,19,24,37,8,22,16,15
1364372,49,7,1964,3,female,257,58,27,25,5,0,1,25,4
1415826,27,5,1986,6,male,276,58,39,25,13,22,10,3,3
2012813,19,8,1994,4,male,333,58,30,25,14,25,13,0,1
2027297,66,31,1947,3,female,62,58,56,25,8,25,8,0,0
1759050,25,15,1988,1,male,260,58,50,25,22,25,16,0,6
1897099,47,10,1966,2,male,979,59,21,26,40,5,38,21,2
1386687,24,12,1989,6,male,437,58,50,26,2,22,0,4,2
1507988,18,9,1995,2,female,1023,59,29,26,14,26,13,0,1
1059579,25,1,1988,1,male,71,59,30,26,10,26,2,0,8
2142725,58,26,1955,7,female,1354,59,17,26,7,26,3,0,4
2003883,22,8,1991,10,female,183,59,38,26,16,26,14,0,2
1844852,35,20,1978,6,female,502,59,43,26,35,26,10,0,25
1125884,55,25,1958,7,male,243,59,26,26,19,26,15,0,4
1572844,65,3,1948,12,male,1366,58,26,26,62,26,37,0,25
1144075,49,27,1964,5,female,324,59,35,27,14,0,2,27,12
1062936,27,9,1986,3,male,301,58,27,27,44,3,14,24,30
1334679,65,11,1948,5,male,928,59,44,27,5,21,3,6,2
1190174,21,23,1992,11,female,351,58,19,27,0,27,0,0,0
2013063,14,23,1999,8,female,555,59,39,27,13,27,8,0,5
1875973,23,11,1990,8,female,443,59,46,27,17,27,15,0,2
1312338,32,8,1981,9,male,184,59,34,27,37,27,32,0,5
1926079,108,1,1905,1,male,1734,58,23,28,10,3,7,25,3
1606224,28,2,1985,5,female,404,59,31,28,46,26,11,2,35
1196039,31,1,1982,10,male,869,59,36,28,6,28,4,0,2
1752684,26,14,1987,9,male,389,58,34,29,0,0,0,29,0
2180518,55,9,1958,8,female,723,58,35,29,1,0,0,29,1
2171148,63,25,1950,4,female,563,59,33,29,81,0,10,29,71
1789916,35,15,1978,6,male,329,58,43,29,3,15,1,14,2
1705643,65,12,1948,11,female,744,58,25,29,5,28,2,1,3
1094256,95,14,1918,7,female,1892,59,21,29,21,21,18,8,3
1550603,17,18,1996,8,male,667,59,36,29,48,23,47,6,1
1540813,19,25,1994,10,male,332,59,40,29,13,29,8,0,5
1909883,23,16,1990,6,female,157,58,34,29,16,29,14,0,2
1161815,33,15,1980,3,male,34,59,53,29,8,29,7,0,1
1785901,65,23,1948,2,female,347,59,51,29,34,29,30,0,4
1357499,19,1,1994,7,female,236,59,25,29,47,29,26,0,21
1837408,28,20,1985,4,female,111,58,27,29,44,29,9,0,35
2034859,21,21,1992,7,male,419,58,46,30,10,5,5,25,5
1885389,19,21,1994,3,male,96,59,52,31,42,30,37,1,5
1683505,93,20,1920,1,male,1548,59,20,31,78,26,64,5,14
1305629,26,4,1987,10,male,613,58,55,31,14,31,14,0,0
1043291,53,9,1960,9,female,701,59,15,30,122,30,108,0,14
1237223,54,21,1959,10,female,676,59,33,32,26,0,10,32,16
1925951,71,12,1942,9,female,1773,58,40,32,38,0,10,32,28
1709063,18,30,1995,3,male,177,59,31,32,1,24,0,8,1
1822959,29,19,1984,3,male,515,59,37,32,16,32,7,0,9
1114667,61,22,1952,5,female,191,59,52,32,8,32,7,0,1
1095672,22,7,1991,4,female,500,58,28,32,31,32,23,0,8
1780944,32,23,1981,8,female,173,58,36,32,56,32,51,0,5
1017675,70,28,1943,12,female,1760,59,28,33,6,0,2,33,4
2060898,65,17,1948,7,female,987,59,22,33,125,0,82,33,43
1916334,72,27,1941,5,female,1776,59,26,33,5,10,3,23,2
1638397,23,15,1990,4,male,659,59,35,33,4,33,3,0,1
1551713,56,30,1957,6,female,446,59,28,33,1,33,1,0,0
1537048,15,31,1998,7,female,218,59,14,33,13,33,11,0,2
1578732,44,21,1969,7,female,91,59,44,34,25,31,14,3,11
1821567,55,15,1958,6,female,1560,58,46,34,38,25,21,9,17
1995847,70,17,1943,10,female,591,59,27,36,99,0,39,36,60
1006536,60,18,1953,3,male,102,59,40,36,3,33,2,3,1
1020981,18,24,1995,8,male,258,58,32,35,13,34,3,1,10
1152595,21,11,1992,4,male,72,58,53,36,54,34,52,2,2
1929897,30,29,1983,9,female,401,59,32,36,59,36,48,0,11
1513136,61,9,1952,7,female,1825,58,26,37,56,6,30,31,26
1458342,56,1,1957,6,female,1000,58,26,37,11,37,8,0,3
2023838,108,1,1905,1,female,1584,58,38,39,19,22,8,17,11
1579370,37,4,1976,8,male,968,59,41,39,18,39,14,0,4
1843218,54,14,1959,2,female,253,58,39,38,31,38,18,0,13
1364448,48,16,1965,3,female,299,58,41,38,209,38,63,0,146
1383346,28,16,1985,2,male,296,58,41,40,39,7,11,33,28
2046410,44,24,1969,2,male,162,58,26,40,12,40,6,0,6
1601842,53,22,1960,10,female,254,59,51,42,24,0,11,42,13
1499178,65,22,1948,8,female,1577,59,34,41,66,29,27,12,39
2132769,65,13,1948,7,male,1782,58,16,41,4,38,1,3,3
1352019,46,1,1967,5,male,292,59,34,41,37,38,17,3,20
1595442,106,17,1907,6,male,190,58,33,42,3,42,0,0,3
1137837,41,6,1972,1,male,624,59,55,42,10,42,8,0,2
2174026,59,28,1954,10,male,140,58,28,43,59,3,16,40,43
1513978,20,16,1993,6,male,113,59,55,44,71,3,23,41,48
2035574,69,25,1944,6,female,590,58,25,43,254,14,55,29,199
1746496,17,1,1996,8,male,396,58,41,44,0,39,0,5,0
2091521,66,16,1947,2,female,542,59,51,44,26,43,19,1,7
1555144,37,12,1976,4,male,446,59,26,44,0,44,0,0,0
1681201,70,21,1943,10,female,1299,59,31,45,19,0,10,45,9
1624616,50,2,1963,3,female,1977,58,22,45,48,39,40,6,8
1918047,69,29,1944,1,male,1029,58,30,46,15,19,9,27,6
1191187,108,14,1905,10,female,1199,59,38,47,54,12,34,35,20
1512724,54,20,1959,12,male,446,58,43,46,21,46,13,0,8
1875295,18,25,1995,1,male,66,58,42,49,29,16,19,33,10
1146305,50,20,1963,6,female,663,59,18,48,34,18,20,30,14
1939027,61,26,1952,11,male,1618,59,23,49,5,49,4,0,1
1499950,65,9,1948,1,female,143,59,45,49,38,49,16,0,22
1442577,31,12,1982,6,male,220,59,43,51,13,0,4,51,9
1723144,17,15,1996,5,male,349,58,48,51,18,23,2,28,16
1886982,30,26,1983,1,female,255,59,33,51,42,11,31,40,11
1019852,38,12,1975,4,male,194,58,30,51,28,51,16,0,12
1564703,30,28,1983,6,female,880,58,20,51,69,51,60,0,9
1324718,21,7,1992,1,female,855,59,27,50,132,50,80,0,52
1289716,38,6,1975,3,male,300,58,15,53,31,30,6,23,25
1972365,28,3,1985,3,male,116,59,34,52,57,36,21,16,36
1001765,55,27,1958,6,female,1331,58,22,53,79,15,13,38,66
1541677,28,15,1985,4,female,211,59,42,52,34,52,25,0,9
1157368,27,6,1986,6,male,1251,58,32,54,3,9,2,45,1
1140430,61,17,1952,6,female,1391,58,42,55,0,0,0,55,0
1715876,17,8,1996,8,female,418,58,42,54,204,17,168,37,36
1456142,58,20,1955,8,female,684,58,28,54,6,53,2,1,4
1992483,103,21,1910,8,male,360,59,49,55,27,40,18,15,9
1794310,23,2,1990,8,male,250,59,44,54,33,51,23,3,10
1462108,54,19,1959,11,female,293,59,38,55,1,55,1,0,0
1178861,28,5,1985,5,male,59,59,49,54,88,54,80,0,8
1154632,39,10,1974,6,male,151,59,52,54,81,54,77,0,4
1019112,56,29,1957,9,female,488,59,24,56,16,0,4,56,12
1813711,57,7,1956,8,male,1680,58,10,56,18,0,3,56,15
1871162,54,5,1959,5,female,246,58,40,58,64,0,38,58,26
1960818,15,6,1998,9,male,248,58,35,58,1,57,1,1,0
1230946,30,8,1983,8,male,1048,59,21,58,35,43,13,15,22
2037693,15,10,1998,4,female,293,58,6,57,33,57,28,0,5
2150443,54,21,1959,2,male,1572,58,23,56,10,56,8,0,2
1187554,54,7,1959,1,female,284,59,42,60,17,3,5,57,12
1615078,57,5,1956,12,female,846,58,42,59,20,0,8,59,12
1479764,76,27,1937,2,female,524,58,41,60,34,0,5,60,29
1915162,104,17,1909,4,female,1235,58,20,61,70,42,12,19,58
1952264,35,28,1978,4,female,324,59,33,62,162,62,137,0,25
1783592,59,25,1954,8,male,866,59,24,61,93,61,90,0,3
1424844,81,16,1932,3,female,485,58,38,65,22,0,5,65,17
1716323,103,21,1910,5,female,2081,59,16,64,2,61,1,3,1
1584118,21,15,1992,12,male,79,59,56,65,21,51,11,14,10
2097961,23,8,1990,8,male,288,58,46,64,1,64,1,0,0
1225114,24,10,1989,1,male,70,59,49,65,12,65,5,0,7
1416705,59,22,1954,2,female,610,59,30,65,89,65,40,0,49
1080100,15,5,1998,10,female,603,59,35,67,39,66,35,1,4
1329952,108,29,1905,5,male,362,58,40,66,39,66,31,0,8
1160707,39,5,1974,7,female,79,58,44,69,14,3,13,66,1
1584158,27,15,1986,4,female,482,59,43,71,6,27,6,44,0
2180873,57,20,1956,12,male,497,59,47,70,13,25,12,45,1
1129206,23,22,1990,10,female,1432,59,28,69,98,60,27,9,71
1579058,47,2,1966,3,female,332,58,36,71,156,52,119,19,37
1928943,22,1,1991,9,male,458,58,36,69,14,69,9,0,5
1639342,23,19,1990,4,male,60,59,38,69,15,69,13,0,2
1724457,57,12,1956,11,male,1031,58,26,74,13,9,9,65,4
1196288,19,7,1994,12,male,227,58,44,74,100,17,36,57,64
1240020,18,16,1995,2,female,219,59,23,73,31,73,28,0,3
1770415,67,10,1946,11,male,396,58,55,75,75,0,23,75,52
1208878,61,7,1952,12,female,1928,59,22,80,13,1,0,79,13
1939049,57,16,1956,4,female,645,58,30,78,33,0,2,78,31
2071857,83,28,1930,3,female,1729,58,29,80,39,80,32,0,7
1596512,57,15,1956,6,female,808,58,40,82,30,0,0,82,30
1056305,53,29,1960,3,female,660,59,23,82,134,4,22,78,112
1443476,25,5,1988,4,male,707,58,37,84,15,78,4,6,11
2073313,76,14,1937,1,female,1275,59,23,81,47,65,25,16,22
1117735,58,25,1955,2,male,2018,58,19,83,111,82,93,1,18
1926323,23,10,1990,10,male,141,58,57,81,4,81,4,0,0
2155236,37,1,1976,1,male,111,58,48,84,36,84,33,0,3
1983324,58,24,1955,6,male,44,59,39,81,21,81,12,0,9
1933853,45,15,1968,10,female,403,58,11,81,149,81,132,0,17
1359222,18,13,1995,3,male,309,59,56,87,3,14,0,73,3
1277902,16,13,1997,5,female,62,58,36,87,88,86,62,1,26
1643639,39,23,1974,6,male,607,59,51,87,1,87,1,0,0
1959260,29,11,1984,6,male,353,59,40,88,0,12,0,76,0
1612556,21,5,1992,3,female,26,58,34,89,30,73,26,16,4
1000059,15,10,1998,5,male,625,58,29,90,8,90,5,0,3
1547195,19,10,1994,10,female,198,58,40,94,42,0,14,94,28
1341452,68,25,1945,11,female,1275,59,33,95,34,1,9,94,25
1176589,55,3,1958,6,female,384,58,37,93,60,0,8,93,52
1445561,31,4,1982,4,male,426,59,44,94,19,87,10,7,9
1296727,50,11,1963,1,male,826,59,23,93,20,73,11,20,9
1944877,30,28,1983,1,male,504,58,9,93,0,93,0,0,0
1621002,33,12,1980,10,male,278,59,35,92,38,92,29,0,9
1922532,51,23,1962,6,female,1415,59,23,97,31,2,6,95,25
1533462,77,19,1936,6,male,837,59,23,97,87,0,44,97,43
1966322,70,4,1943,10,male,929,58,27,96,3,96,2,0,1
1531280,26,23,1987,9,female,409,59,28,99,128,99,124,0,4
1326001,66,10,1947,4,female,804,59,34,96,66,96,37,0,29
2037784,52,14,1961,2,female,571,59,44,103,53,2,33,101,20
1365374,20,21,1993,4,female,307,58,35,102,0,102,0,0,0
1625242,67,22,1946,5,female,1938,59,36,108,8,0,2,108,6
2075415,107,6,1906,5,female,1020,58,35,109,22,64,3,45,19
1577953,57,1,1956,3,female,474,59,27,108,67,90,41,18,26
1814062,34,11,1979,7,female,208,58,49,109,21,109,11,0,10
1773819,49,11,1964,8,female,211,59,38,108,33,108,26,0,7
1490461,26,5,1987,5,male,259,58,46,111,9,97,6,14,3
1508917,103,8,1910,2,female,1051,59,33,113,48,113,30,0,18
1361487,25,5,1988,3,male,108,58,44,116,77,77,40,39,37
1851675,33,22,1980,1,female,918,58,18,117,107,83,51,34,56
1937506,22,5,1991,2,male,359,58,29,117,169,87,62,30,107
1074788,27,10,1986,11,female,393,59,35,118,389,112,187,6,202
1666081,68,19,1945,3,female,491,58,33,118,36,118,11,0,25
1020498,57,19,1956,2,male,304,58,24,121,18,0,15,121,3
1001217,60,3,1953,8,female,2259,59,35,127,59,78,28,49,31
1323852,66,28,1947,2,female,2149,59,36,125,89,113,70,12,19
1957728,50,1,1963,8,male,70,59,44,127,24,127,15,0,9
1727675,31,2,1982,1,female,308,58,30,125,117,125,88,0,29
2152437,19,3,1994,3,male,569,59,23,132,6,127,4,5,2
1424675,38,11,1975,4,male,415,58,36,133,8,133,6,0,2
1236152,40,29,1973,10,male,573,59,24,133,63,133,52,0,11
1408719,37,1,1976,1,female,302,59,25,131,130,131,85,0,45
1112016,44,20,1969,4,male,244,58,18,136,144,136,73,0,71
1721670,43,13,1970,4,male,777,58,17,140,492,92,447,48,45
1574009,17,7,1996,1,female,80,59,45,143,2,143,1,0,1
1742559,70,4,1943,7,female,742,59,39,150,195,0,72,150,123
2094861,70,28,1943,5,female,1124,58,22,150,6,106,4,44,2
1082829,64,23,1949,8,female,203,58,33,150,10,146,8,4,2
1828064,62,20,1951,4,female,2155,58,15,146,81,106,23,40,58
2086434,69,26,1944,10,female,991,59,32,147,74,147,42,0,32
1795807,71,4,1942,10,female,1431,59,33,155,85,91,42,64,43
2107497,58,28,1955,11,female,556,58,49,153,23,137,17,16,6
2188214,20,15,1993,10,female,906,58,37,157,241,144,215,13,26
1029257,53,6,1960,2,male,137,58,46,156,8,156,7,0,1
1930085,42,27,1971,3,male,275,59,39,153,87,153,53,0,34
1134652,47,18,1966,5,male,658,58,30,156,26,156,21,0,5
1115016,51,1,1962,2,female,207,58,44,157,51,157,34,0,17
1418990,56,17,1957,10,male,1483,58,36,151,171,151,82,0,89
2062871,65,20,1948,12,male,305,58,45,160,4,0,2,160,2
1010406,32,8,1981,12,female,488,59,42,158,27,6,13,152,14
1124048,31,20,1982,5,female,364,59,19,160,17,55,6,105,11
2016180,23,26,1990,8,female,287,58,25,158,119,101,94,57,25
1917305,42,9,1971,7,male,392,58,30,160,10,160,10,0,0
1665418,46,20,1967,9,male,652,58,6,162,20,162,16,0,4
1336134,17,19,1996,9,female,153,58,30,164,112,164,62,0,50
1659864,36,15,1977,3,female,448,58,30,167,235,99,131,68,104
1557897,28,16,1985,1,male,267,58,46,172,35,159,8,13,27
1984355,22,9,1991,12,female,518,58,36,171,93,170,67,1,26
1934216,23,25,1990,9,female,116,58,30,166,94,166,37,0,57
1850410,43,21,1970,3,female,520,58,55,180,99,23,67,157,32
2005570,46,6,1967,4,female,1432,59,34,176,32,167,12,9,20
1601592,60,9,1953,7,female,250,58,44,180,16,180,7,0,9
1769930,51,19,1962,6,female,1573,58,27,176,96,176,91,0,5
1633009,53,10,1960,3,female,655,59,34,176,184,176,129,0,55
1120221,26,20,1987,7,male,116,58,47,175,269,175,253,0,16
1205358,42,25,1971,4,female,274,58,23,190,113,0,31,190,82
1134773,68,20,1945,5,female,1020,59,39,186,50,0,49,186,1
2192937,25,14,1988,11,male,562,58,34,182,34,157,18,25,16
1322423,43,22,1970,10,female,96,58,35,189,138,179,82,10,56
1899807,21,23,1992,11,male,296,59,40,184,19,183,12,1,7
1898320,64,6,1949,10,male,549,58,29,182,87,182,33,0,54
1491524,64,5,1949,10,female,28,59,47,182,72,182,63,0,9
1073682,69,31,1944,7,female,1209,58,26,183,61,183,49,0,12
1049191,16,10,1997,1,female,412,59,33,187,119,187,102,0,17
1306640,58,24,1955,12,female,618,58,56,192,4,0,0,192,4
1750021,27,2,1986,10,male,256,59,44,191,141,177,108,14,33
1079114,51,16,1962,2,female,380,59,36,193,83,193,47,0,36
2140453,29,19,1984,7,female,947,58,21,206,140,43,48,163,92
1275995,71,24,1942,7,female,1160,59,37,206,24,205,6,1,18
1610346,46,15,1967,1,female,790,59,19,221,260,175,181,46,79
1856250,20,23,1993,8,female,332,59,13,214,20,214,18,0,2
1329021,29,5,1984,1,male,471,58,41,220,1,220,1,0,0
2000236,108,1,1905,7,male,954,59,13,232,30,0,13,232,17
1777572,20,19,1993,3,male,638,59,32,226,97,93,70,133,27
1829111,22,16,1991,3,female,122,58,37,227,113,58,48,169,65
1488212,29,2,1984,9,female,301,58,48,232,308,163,193,69,115
1534883,41,12,1972,12,female,276,59,35,225,105,225,72,0,33
2129604,23,29,1990,1,male,208,58,43,228,256,228,189,0,67
1837054,65,7,1948,2,female,510,59,39,242,56,13,18,229,38
1795764,45,22,1968,10,female,572,58,28,246,105,191,65,55,40
1870025,36,1,1977,3,male,296,59,32,244,192,243,152,1,40
1171992,53,4,1960,6,female,257,59,31,241,61,241,52,0,9
1674931,66,10,1947,4,female,590,59,46,253,61,0,21,253,40
1525630,67,2,1946,1,male,1518,58,31,255,58,11,37,244,21
2155826,67,13,1946,5,female,1515,59,27,251,197,238,148,13,49
1912090,64,20,1949,7,female,134,59,49,254,4,254,1,0,3
1609256,62,14,1951,6,male,1186,58,26,267,33,0,9,267,24
1742938,52,16,1961,2,female,263,58,39,276,53,0,12,276,41
1449861,44,11,1969,11,female,803,59,30,274,23,93,12,181,11
1286970,21,15,1992,6,male,14,59,46,261,49,97,45,164,4
1583920,50,27,1963,8,male,985,58,43,275,128,259,113,16,15
1116718,43,15,1970,4,male,152,59,46,276,8,276,6,0,2
1590984,27,9,1986,3,female,182,58,47,264,63,264,52,0,11
1458400,56,2,1957,4,female,869,59,40,285,153,2,106,283,47
1849011,63,25,1950,3,female,1845,59,24,284,95,102,47,182,48
1330897,18,1,1995,8,female,106,59,48,286,4,286,3,0,1
1017981,56,24,1957,5,female,462,58,25,303,148,0,96,303,52
1459925,34,8,1979,3,female,1477,58,42,303,315,130,159,173,156
1639291,17,22,1996,3,female,256,59,41,304,195,279,139,25,56
1061337,18,1,1995,1,male,108,59,44,304,58,304,37,0,21
1037330,28,5,1985,5,female,145,59,15,299,127,299,124,0,3
1484062,44,15,1969,1,male,464,58,37,299,142,299,117,0,25
1551023,52,1,1961,3,female,191,59,49,302,158,302,138,0,20
1401280,21,20,1992,11,female,317,58,34,322,132,322,119,0,13
1935872,23,8,1990,1,male,108,59,45,311,62,311,60,0,2
1557975,21,26,1992,2,female,57,59,54,332,1454,202,996,130,458
1044782,19,12,1994,9,male,560,59,29,340,45,340,31,0,14
1373480,56,5,1957,9,female,1032,59,34,333,100,333,95,0,5
1850385,52,29,1961,10,female,565,59,38,340,381,340,335,0,46
1423321,45,31,1968,10,female,410,59,26,369,85,0,42,369,43
1417589,51,1,1962,2,female,351,58,40,364,108,355,43,9,65
2109237,29,4,1984,3,female,301,59,43,387,33,387,26,0,7
2176009,80,3,1933,1,female,175,58,32,381,51,381,32,0,19
1588965,31,20,1982,6,female,409,59,43,378,231,378,150,0,81
1903646,25,1,1988,1,male,81,58,55,410,90,410,68,0,22
2100112,36,26,1977,12,male,336,59,41,413,90,413,9,0,81
2117162,65,2,1948,10,female,508,59,37,428,258,0,217,428,41
1753612,18,16,1995,3,male,217,59,39,429,523,45,181,384,342
1096609,20,2,1993,4,female,151,59,46,434,756,271,249,163,507
1181078,25,2,1988,12,male,45,58,28,428,147,428,77,0,70
2131215,18,16,1995,4,male,231,58,31,473,87,473,46,0,41
2065783,67,16,1946,4,female,1307,59,45,482,208,482,64,0,144
1200100,76,10,1937,11,female,569,59,34,488,77,488,72,0,5
1096370,50,22,1963,9,female,508,58,37,507,220,507,155,0,65
1713568,52,20,1961,7,female,210,59,40,485,115,485,80,0,35
1680349,55,6,1958,11,male,506,58,52,523,83,0,38,523,45
2096948,21,6,1992,10,female,574,58,30,529,62,529,39,0,23
1445847,43,10,1970,1,female,409,58,29,584,247,55,32,529,215
2069165,62,3,1951,1,female,1122,59,31,584,333,0,76,584,257
1759323,30,14,1983,2,male,279,58,28,577,287,307,68,270,219
1886479,24,23,1989,12,female,243,58,32,580,71,580,64,0,7
1969936,62,1,1951,1,female,1476,59,19,572,342,572,109,0,233
1552517,74,29,1939,9,female,317,58,32,577,154,577,128,0,26
1666332,50,19,1963,2,female,63,58,47,629,424,0,39,629,385
1050858,24,30,1989,4,male,44,59,36,636,570,636,462,0,108
1181988,67,6,1946,8,female,1132,58,30,717,272,13,174,704,98
1469119,51,29,1962,12,female,1551,59,24,690,265,678,196,12,69
1965029,53,10,1960,2,female,858,59,45,698,142,663,76,35,66
1045726,94,21,1919,5,female,367,59,37,676,197,676,169,0,28
1104227,25,19,1988,7,female,33,59,55,952,258,952,98,0,160
1009472,64,8,1949,3,female,348,58,46,989,234,989,164,0,70
1131029,17,26,1996,4,female,403,58,50,1333,217,0,43,1333,174
1201478,64,29,1949,5,female,125,58,50,1408,98,1408,67,0,31
1074796,51,11,1962,8,female,827,59,29,1332,715,1332,613,0,102
1186194,54,17,1959,4,male,435,58,33,1572,753,296,343,1276,410
1034932,19,26,1994,9,female,213,59,18,2157,501,197,156,1960,345
1056536,58,17,1955,3,female,1211,58,28,2360,220,1924,103,436,117
1756040,17,7,1996,7,male,156,61,36,7,17,7,11,0,6
1937153,22,15,1991,2,male,136,60,32,7,21,7,17,0,4
1762577,28,11,1985,12,female,394,60,20,7,14,7,12,0,2
1274073,27,23,1986,7,female,276,60,43,7,25,7,21,0,4
1821023,52,6,1961,9,female,1090,61,17,7,416,7,355,0,61
2016692,58,17,1955,5,female,286,61,30,7,11,7,4,0,7
1405844,68,12,1945,7,male,1721,60,25,7,39,7,34,0,5
1892450,43,13,1970,1,male,364,60,16,8,0,0,0,8,0
2147482,60,29,1953,11,female,506,61,47,8,3,0,0,8,3
1956416,42,6,1971,7,female,1267,61,47,8,10,0,3,8,7
1243707,84,19,1929,5,male,311,60,38,8,10,0,1,8,9
1432590,21,5,1992,8,male,220,60,48,8,2,3,1,5,1
1976947,14,8,1999,3,male,9,61,57,8,0,8,0,0,0
1171422,15,7,1998,9,male,394,61,54,8,2,8,2,0,0
1772448,25,20,1988,11,male,373,61,54,8,2,8,2,0,0
2057295,21,19,1992,3,male,461,60,19,8,5,8,5,0,0
2008214,33,23,1980,6,female,288,61,37,8,17,8,7,0,10
1928008,41,20,1972,12,male,189,60,26,8,49,8,30,0,19
1597094,59,9,1954,11,male,1154,61,20,8,13,8,13,0,0
1750491,20,5,1993,4,male,360,60,43,9,3,0,0,9,3
1809605,67,28,1946,11,male,1959,61,24,9,34,0,18,9,16
1667797,69,25,1944,3,female,405,61,21,9,23,0,11,9,12
1657992,16,13,1997,8,male,112,60,54,9,12,4,2,5,10
1520809,53,15,1960,11,male,17,61,52,9,6,5,4,4,2
1515238,53,1,1960,5,male,802,60,14,9,20,4,7,5,13
1782953,32,21,1981,6,male,192,60,42,9,0,9,0,0,0
1282293,41,28,1972,7,male,617,61,32,9,2,9,0,0,2
1589822,22,2,1991,6,male,60,60,32,9,6,9,6,0,0
1474234,71,26,1942,7,female,84,61,47,9,7,9,5,0,2
1586465,35,25,1978,5,female,600,61,11,10,0,0,0,10,0
1953255,29,1,1984,1,female,99,61,34,10,2,0,1,10,1
1411154,58,9,1955,4,female,570,60,35,10,10,0,3,10,7
2021762,66,24,1947,6,female,1513,60,25,10,27,0,11,10,16
1871441,37,25,1976,12,male,1270,61,17,10,5,7,2,3,3
1264902,46,4,1967,11,male,354,60,37,10,3,9,3,1,0
1721101,15,20,1998,11,male,230,60,25,10,44,8,39,2,5
1363282,15,28,1998,1,male,261,60,33,10,0,10,0,0,0
1090424,20,1,1993,10,male,44,60,44,10,10,10,4,0,6
1118830,25,1,1988,2,female,657,61,51,10,12,10,8,0,4
1051689,49,17,1964,10,male,430,61,51,10,11,10,4,0,7
1281497,34,12,1979,1,male,184,61,41,10,27,10,22,0,5
1297925,52,26,1961,10,male,120,61,48,10,50,10,34,0,16
1945775,59,10,1954,10,female,492,61,60,10,23,10,19,0,4
1581655,20,16,1993,2,male,1090,61,51,11,0,2,0,9,0
1533075,95,9,1918,7,male,1797,60,23,11,5,2,2,9,3
1533445,61,5,1952,10,female,1224,61,32,11,53,2,25,9,28
1823923,45,10,1968,8,female,263,60,37,11,4,7,0,4,4
1487267,18,20,1995,2,male,238,61,47,11,1,9,1,2,0
2151746,30,15,1983,7,male,430,61,35,11,1,11,0,0,1
1711566,14,26,1999,9,male,89,60,35,11,2,11,2,0,0
1016699,25,22,1988,12,male,224,60,29,11,4,11,4,0,0
1821145,24,5,1989,10,female,545,61,37,11,5,11,5,0,0
1844614,18,19,1995,12,female,82,61,47,11,7,11,5,0,2
1838153,25,8,1988,2,male,592,61,43,11,11,11,3,0,8
2165275,25,2,1988,2,female,330,61,22,11,7,11,5,0,2
1718284,27,7,1986,2,male,147,60,54,11,12,11,11,0,1
1005283,43,16,1970,1,male,944,61,7,11,12,11,6,0,6
1788685,45,6,1968,6,male,783,60,17,11,8,11,5,0,3
2019055,30,29,1983,4,female,353,60,35,11,40,11,28,0,12
2180100,16,2,1997,6,female,48,61,54,12,0,0,0,12,0
1916904,87,10,1926,7,female,855,60,21,12,21,0,12,12,9
2072383,27,13,1986,4,female,258,61,44,12,7,4,2,8,5
1463433,17,8,1996,6,male,379,61,51,12,1,12,1,0,0
1151235,22,25,1991,11,male,274,60,43,12,0,12,0,0,0
1826809,29,13,1984,8,female,371,61,39,12,12,12,11,0,1
2045766,39,15,1974,9,male,347,61,25,12,13,12,11,0,2
1550992,44,1,1969,2,female,327,60,41,12,8,12,6,0,2
1900808,22,18,1991,11,male,510,60,25,12,30,12,19,0,11
1792392,25,7,1988,11,female,256,60,44,12,56,12,43,0,13
1438016,24,12,1989,5,male,226,60,40,12,23,12,13,0,10
2039207,29,10,1984,10,female,403,61,37,12,40,12,37,0,3
2088348,15,5,1998,4,male,314,61,32,13,0,0,0,13,0
2025254,113,12,1900,10,female,1432,61,27,13,23,0,18,13,5
1769399,41,1,1972,2,male,593,61,58,13,2,13,2,0,0
1114127,34,1,1979,2,male,650,60,58,13,3,13,1,0,2
1231761,22,5,1991,5,female,287,61,26,13,49,13,24,0,25
1638810,38,20,1975,6,female,206,61,44,13,26,13,14,0,12
1059208,71,14,1942,12,male,638,61,43,14,6,0,2,14,4
1209390,90,2,1923,11,male,104,60,53,14,20,0,16,14,4
1200108,23,13,1990,12,female,482,61,31,14,49,1,22,13,27
1734191,53,20,1960,5,male,1147,61,21,14,14,3,11,11,3
1913870,35,1,1978,11,male,242,60,26,14,11,13,6,1,5
1154200,52,29,1961,1,female,269,61,47,14,6,14,6,0,0
1135815,26,11,1987,9,male,459,61,38,14,38,14,12,0,26
1954831,36,8,1977,7,male,817,61,28,14,41,14,14,0,27
1574324,72,14,1941,6,male,682,60,44,15,2,0,0,15,2
1853859,72,19,1941,3,female,1378,61,27,15,9,0,2,15,7
2026740,44,12,1969,7,female,840,60,20,15,31,0,8,15,23
1203985,63,1,1950,1,male,288,61,53,15,0,15,0,0,0
1799460,20,14,1993,1,male,548,61,51,15,6,15,5,0,1
1063941,23,14,1990,3,male,469,61,33,15,33,15,33,0,0
1314678,38,31,1975,7,female,259,61,47,15,48,15,27,0,21
1930405,53,10,1960,10,female,468,60,32,15,83,15,67,0,16
1572979,15,27,1998,5,female,206,61,46,16,0,0,0,16,0
1073622,48,26,1965,1,male,950,61,29,16,2,0,0,16,2
1045881,25,1,1988,1,male,399,61,33,16,9,2,9,14,0
1888594,54,17,1959,1,female,870,61,46,16,6,0,3,16,3
1182448,93,23,1920,11,male,1789,60,24,16,3,0,1,16,2
2036128,20,6,1993,5,female,301,61,41,16,9,9,5,7,4
2172348,19,16,1994,11,female,166,61,34,16,46,8,6,8,40
1168647,50,23,1963,4,male,26,60,14,16,34,15,34,1,0
1447739,23,8,1990,7,male,383,60,50,16,0,16,0,0,0
1921854,23,24,1990,9,male,270,61,51,16,3,16,2,0,1
1732617,31,21,1982,2,male,384,61,37,16,7,16,4,0,3
1276976,34,10,1979,8,female,412,60,49,16,8,16,4,0,4
2014837,43,26,1970,7,female,638,60,20,16,15,16,11,0,4
1252953,71,23,1942,6,female,1853,61,8,16,13,16,8,0,5
1202969,32,22,1981,6,male,248,61,47,16,61,16,10,0,51
1167033,17,17,1996,9,male,298,61,43,17,2,0,1,17,1
1555510,75,19,1938,11,female,1466,61,26,17,1,0,1,17,0
1197984,13,9,2000,6,male,150,61,43,17,9,0,0,17,9
2011003,61,22,1952,11,female,1541,61,42,17,15,0,3,17,12
1217897,60,5,1953,10,female,776,60,31,17,18,0,1,17,17
1768239,51,7,1962,2,male,549,60,21,17,62,0,45,17,17
1206569,28,14,1985,4,male,166,61,55,17,1,17,1,0,0
1911879,18,23,1995,8,male,153,61,39,17,5,17,5,0,0
1793013,25,5,1988,5,male,226,60,29,17,5,17,5,0,0
1185764,27,2,1986,6,female,455,61,41,17,3,17,1,0,2
1395647,53,15,1960,10,female,91,60,36,17,3,17,3,0,0
1408355,34,8,1979,3,male,385,60,44,17,25,17,15,0,10
1303129,38,14,1975,10,female,58,61,46,17,28,17,28,0,0
2054824,29,24,1984,10,male,631,60,40,18,8,0,2,18,6
2033967,29,25,1984,9,female,304,61,21,18,6,5,6,13,0
1164197,68,17,1945,8,male,630,61,27,18,7,18,3,0,4
1371959,28,2,1985,5,male,205,61,47,18,95,18,80,0,15
1108637,15,4,1998,9,male,179,61,49,19,8,0,1,19,7
1350669,75,15,1938,2,female,1813,60,22,19,87,7,14,12,73
1349704,54,4,1959,12,female,242,61,37,19,26,19,21,0,5
1944583,27,6,1986,3,male,517,61,18,20,0,0,0,20,0
1375091,20,6,1993,8,female,649,60,35,20,15,0,1,20,14
1004730,36,17,1977,8,female,801,60,39,20,48,0,10,20,38
1315002,21,26,1992,6,female,435,61,45,20,1,20,1,0,0
1171207,73,1,1940,1,female,289,61,55,20,0,20,0,0,0
1347040,21,28,1992,2,female,719,60,25,20,4,20,2,0,2
1871599,85,23,1928,3,male,1238,60,27,21,22,0,16,21,6
1363152,63,25,1950,5,female,695,61,31,21,60,0,7,21,53
1065861,90,8,1923,10,female,1713,60,20,21,22,21,16,0,6
1961823,24,22,1989,1,male,540,61,47,21,36,21,27,0,9
1799576,46,21,1967,4,male,130,61,38,22,47,10,34,12,13
1012289,23,11,1990,2,male,172,61,50,23,78,0,49,23,29
1578374,32,24,1981,10,male,630,61,31,23,19,22,18,1,1
1249220,57,30,1956,10,male,96,61,49,23,5,23,4,0,1
1349282,30,4,1983,12,female,400,60,35,23,34,23,11,0,23
2062925,91,1,1922,1,male,41,60,48,23,66,23,16,0,50
1173602,108,21,1905,12,male,18,60,59,24,3,0,1,24,2
1234695,15,3,1998,8,female,290,60,42,24,11,2,7,22,4
1946619,65,26,1948,12,female,901,60,19,24,50,17,32,7,18
1795074,93,8,1920,8,male,183,60,46,24,1,24,1,0,0
1851169,17,4,1996,7,male,77,61,40,24,4,24,4,0,0
1374684,18,20,1995,7,female,260,60,29,24,30,24,25,0,5
1547725,59,16,1954,9,female,488,61,53,24,27,24,19,0,8
1745893,33,19,1980,10,male,104,61,56,25,1,0,0,25,1
1678002,66,29,1947,11,female,309,60,57,25,15,0,9,25,6
1536447,63,30,1950,11,female,2035,60,32,25,37,8,17,17,20
1913396,58,12,1955,7,NA,1980,60,22,25,15,21,3,4,12
1674751,28,1,1985,3,female,199,60,8,25,1,25,1,0,0
1408894,100,2,1913,11,female,1199,61,42,25,23,25,9,0,14
1951972,26,18,1987,7,male,332,60,38,25,43,25,43,0,0
1155893,34,21,1979,4,female,527,61,40,26,8,0,0,26,8
1732437,41,20,1972,5,male,696,61,35,26,4,25,3,1,1
2173962,42,8,1971,3,male,407,60,32,26,8,25,4,1,4
1855483,26,28,1987,12,male,451,60,42,26,44,19,36,7,8
1267152,28,6,1985,8,male,779,61,41,26,4,26,4,0,0
1921772,49,15,1964,2,male,1054,60,24,26,0,26,0,0,0
1839606,33,17,1980,4,male,153,61,59,26,15,26,7,0,8
1144234,18,2,1995,1,male,61,61,42,27,11,0,6,27,5
1068993,16,21,1997,6,male,311,60,32,27,130,3,82,24,48
1410346,40,12,1973,4,male,683,61,48,27,44,12,7,15,37
1675495,26,18,1987,7,female,175,61,31,27,0,27,0,0,0
2096798,52,4,1961,6,male,1397,61,39,28,49,16,21,12,28
2164664,41,17,1972,6,male,218,61,46,28,2,28,0,0,2
1611977,33,9,1980,3,male,180,61,53,29,8,16,8,13,0
1083487,56,2,1957,11,male,202,60,52,29,15,19,10,10,5
1427167,107,28,1906,4,male,1016,61,34,29,4,28,3,1,1
1426276,14,12,1999,3,male,135,61,53,29,6,29,5,0,1
1119781,35,29,1978,1,female,227,60,35,29,28,29,20,0,8
1966332,108,30,1905,12,female,1902,60,22,29,25,29,11,0,14
1761029,22,22,1991,2,male,99,61,30,31,6,6,0,25,6
1283204,28,16,1985,1,male,296,60,41,31,50,0,31,31,19
1694962,29,9,1984,11,male,247,60,32,30,8,13,0,17,8
1831641,15,3,1998,11,female,320,61,32,31,15,29,6,2,9
1860151,59,4,1954,3,male,566,61,23,30,19,30,12,0,7
1630402,22,7,1991,5,male,178,61,38,30,57,30,55,0,2
1723011,64,9,1949,7,male,177,60,31,32,73,30,48,2,25
2141745,52,8,1961,6,female,330,60,52,33,13,0,1,33,12
1151303,16,18,1997,1,female,430,60,47,33,20,23,13,10,7
1852678,67,23,1946,7,female,1831,61,21,33,14,30,6,3,8
1857046,38,29,1975,7,male,162,60,58,33,1,33,1,0,0
1799065,43,18,1970,3,male,754,60,43,33,21,33,10,0,11
1988960,56,13,1957,5,female,126,60,41,34,41,6,21,28,20
1966195,24,4,1989,12,male,416,60,38,34,1,34,1,0,0
1268854,55,22,1958,12,male,184,61,43,34,8,34,6,0,2
1790744,34,4,1979,4,male,276,61,23,34,38,34,24,0,14
1897013,63,27,1950,9,male,55,61,53,35,31,0,7,35,24
1746186,85,2,1928,3,male,1168,60,36,36,23,0,8,36,15
1671225,95,5,1918,6,female,87,61,49,35,287,1,150,34,137
1605850,23,19,1990,11,male,529,60,28,36,11,28,7,8,4
1230751,42,1,1971,2,male,39,61,44,35,78,33,37,2,41
1575335,78,11,1935,7,male,183,61,36,36,35,36,33,0,2
1933947,24,7,1989,5,female,134,61,41,37,1,37,1,0,0
2070356,32,28,1981,3,female,586,60,21,37,6,37,5,0,1
1143780,54,19,1959,2,female,308,61,52,37,1,37,1,0,0
1856825,19,30,1994,9,female,51,61,43,37,27,37,15,0,12
2174227,101,25,1912,12,male,230,61,45,37,30,37,30,0,0
1423662,65,14,1948,1,female,1112,60,38,37,78,37,53,0,25
1312931,61,29,1952,4,male,914,60,33,39,4,0,4,39,0
1818533,62,16,1951,8,male,1424,60,16,38,211,0,108,38,103
1232620,47,21,1966,4,male,470,60,28,39,54,26,31,13,23
1810469,20,23,1993,1,male,357,61,32,38,28,37,11,1,17
1401018,23,1,1990,1,male,102,60,34,38,93,35,28,3,65
1594387,33,12,1980,10,male,154,61,55,39,3,39,3,0,0
1221115,15,11,1998,11,male,25,60,49,38,13,38,3,0,10
1942231,21,26,1992,3,female,185,61,20,38,20,38,20,0,0
1984915,70,20,1943,4,female,1424,60,34,38,23,38,23,0,0
2043122,18,24,1995,9,female,269,61,28,40,13,0,2,40,11
1725156,31,3,1982,10,female,230,60,24,40,85,37,63,3,22
2139944,59,25,1954,7,female,53,61,58,42,31,3,12,39,19
1780514,67,15,1946,8,male,2319,61,21,42,42,11,16,31,26
1838551,54,2,1959,10,male,934,61,20,42,136,40,105,2,31
1771139,18,17,1995,8,male,117,60,58,41,11,41,9,0,2
1942461,14,8,1999,7,female,5,60,33,42,45,42,45,0,0
1063153,66,10,1947,8,female,1563,60,32,44,4,0,1,44,3
1200417,17,25,1996,5,male,182,60,42,43,0,10,0,33,0
1822417,18,8,1995,8,male,624,61,44,43,21,15,21,28,0
1788949,37,12,1976,10,male,831,61,33,44,10,37,8,7,2
1946009,36,17,1977,9,male,516,61,52,44,0,44,0,0,0
1658304,15,9,1998,8,male,221,60,41,43,19,43,15,0,4
1512162,22,27,1991,11,male,285,60,41,43,8,43,7,0,1
1382532,56,20,1957,4,female,694,60,34,44,63,44,49,0,14
1291657,18,13,1995,3,male,23,61,22,43,116,43,55,0,61
1223042,25,23,1988,8,female,134,60,57,43,65,43,63,0,2
1039517,72,7,1941,7,male,1427,60,37,45,58,44,32,1,26
1133891,63,26,1950,8,male,263,61,18,46,49,0,11,46,38
1261994,24,21,1989,5,male,498,60,25,46,13,45,3,1,10
1269866,26,23,1987,7,male,481,60,32,46,16,36,15,10,1
2188607,20,1,1993,1,male,159,60,53,46,5,46,3,0,2
1920824,51,10,1962,12,male,78,61,40,46,6,46,6,0,0
1385909,18,22,1995,7,male,675,61,37,47,18,47,5,0,13
1543898,52,21,1961,1,male,1560,60,24,47,36,47,34,0,2
2038759,15,16,1998,4,female,225,61,41,49,66,0,46,49,20
2177941,55,23,1958,1,male,443,61,56,48,46,0,18,48,28
1314443,46,1,1967,11,female,538,60,33,48,29,33,22,15,7
1804680,15,24,1998,9,male,89,60,47,49,36,49,33,0,3
1712038,70,30,1943,4,female,614,61,46,50,31,0,22,50,9
2131433,17,10,1996,1,male,411,60,45,51,20,50,12,1,8
2108813,34,26,1979,10,male,412,60,56,50,128,47,92,3,36
1603269,14,9,1999,12,male,412,61,43,50,5,50,4,0,1
1548043,29,15,1984,9,female,177,61,46,50,8,50,7,0,1
1501823,37,1,1976,8,female,510,61,54,51,29,51,25,0,4
1738108,32,18,1981,4,female,409,60,39,50,204,50,75,0,129
1587163,46,25,1967,11,female,1113,60,30,51,88,51,58,0,30
2115131,20,1,1993,5,male,228,60,39,52,3,52,0,0,3
2186965,21,15,1992,10,male,135,60,53,52,38,52,24,0,14
1502335,33,9,1980,7,female,194,60,26,53,43,53,37,0,6
1976272,113,1,1900,1,male,1680,60,19,54,84,0,26,54,58
2058854,50,23,1963,6,male,759,61,39,54,39,24,8,30,31
2035754,43,13,1970,9,female,161,60,54,55,2,55,1,0,1
1146496,37,3,1976,6,female,715,60,28,54,33,54,31,0,2
1369911,48,26,1965,4,female,356,60,29,54,54,54,13,0,41
1657872,36,30,1977,7,female,159,60,49,56,7,8,2,48,5
1739545,30,18,1983,7,male,177,61,45,58,0,58,0,0,0
1728487,33,6,1980,9,male,923,60,27,58,4,58,1,0,3
1030588,40,27,1973,7,male,331,60,36,60,19,10,13,50,6
1523565,27,13,1986,7,female,477,60,28,59,43,59,42,0,1
1889073,36,21,1977,6,male,493,60,32,59,82,59,81,0,1
2056222,53,23,1960,9,female,219,61,35,61,49,0,6,61,43
2090861,62,12,1951,8,female,991,61,44,61,74,0,2,61,72
2147462,20,6,1993,9,female,316,61,42,61,104,40,58,21,46
2173321,31,9,1982,8,male,425,61,38,62,89,51,54,11,35
2058558,14,2,1999,7,male,75,60,51,62,2,62,2,0,0
1500529,13,24,2000,5,female,161,61,46,61,12,61,12,0,0
1416791,34,2,1979,6,female,668,61,26,62,27,62,22,0,5
1870003,64,12,1949,7,female,558,61,8,64,4,0,2,64,2
1780049,44,9,1969,10,male,542,61,23,65,40,0,8,65,32
1711185,54,15,1959,6,female,1355,60,13,64,20,61,16,3,4
1694881,14,9,1999,6,male,307,60,30,64,9,64,7,0,2
1550525,30,26,1983,7,female,466,60,26,65,64,65,60,0,4
2137975,93,29,1920,2,male,1520,60,19,66,15,49,6,17,9
1272928,30,11,1983,8,female,472,61,29,68,42,57,26,11,16
1504601,30,27,1983,12,female,697,61,30,68,49,68,40,0,9
1711495,59,27,1954,8,female,637,60,53,70,41,0,13,70,28
1072102,108,27,1905,6,male,1872,60,40,70,23,0,18,70,5
1693981,23,8,1990,7,female,292,61,28,71,4,67,2,4,2
1246903,20,15,1993,3,male,493,60,52,70,28,62,16,8,12
1739248,32,20,1981,7,male,38,61,55,71,101,67,98,4,3
1809294,30,3,1983,3,female,665,61,25,70,5,70,5,0,0
1408263,77,1,1936,5,male,1293,60,40,72,33,0,13,72,20
1943734,19,6,1994,9,male,33,61,45,72,34,43,14,29,20
1903861,27,11,1986,11,male,604,61,27,72,24,70,17,2,7
1538883,50,27,1963,11,female,1979,60,24,74,39,65,33,9,6
1771717,27,20,1986,4,female,277,61,32,73,99,63,36,10,63
1489500,15,6,1998,5,female,83,60,18,73,5,73,3,0,2
1887997,49,6,1964,3,female,808,60,30,73,3,73,3,0,0
1636940,71,9,1942,5,female,399,61,45,74,1,74,1,0,0
1437786,73,17,1940,12,male,1555,60,14,74,19,74,5,0,14
1184587,32,15,1981,5,female,472,60,31,74,67,74,58,0,9
2015636,71,9,1942,5,female,316,61,21,77,8,0,1,77,7
1577624,58,23,1955,5,female,216,60,52,77,27,0,2,77,25
1810761,63,31,1950,10,female,670,60,24,76,22,0,16,76,6
1867945,61,11,1952,11,male,329,60,42,76,47,0,33,76,14
1206879,39,27,1974,11,female,715,61,30,75,147,60,53,15,94
1846575,23,8,1990,9,male,544,61,41,75,0,75,0,0,0
1394337,34,29,1979,6,male,222,60,8,76,4,76,3,0,1
1367873,24,1,1989,1,female,154,60,40,77,282,77,107,0,175
1464733,52,15,1961,3,female,764,60,24,79,41,55,24,24,17
1523478,19,26,1994,1,female,107,60,45,80,86,75,54,5,32
1861483,33,16,1980,11,male,833,60,10,79,21,79,3,0,18
1596334,48,12,1965,5,male,221,60,53,79,46,79,29,0,17
1247880,31,27,1982,1,female,397,60,28,79,149,79,136,0,13
1401896,51,23,1962,1,male,306,61,39,83,77,0,4,83,73
1677332,39,18,1974,1,male,722,61,33,82,25,58,15,24,10
1783208,25,14,1988,1,male,142,60,40,82,0,82,0,0,0
1400021,31,29,1982,7,female,411,61,5,82,2,82,1,0,1
1781064,19,24,1994,8,female,448,61,25,82,96,82,62,0,34
1021249,22,23,1991,8,female,147,61,30,83,66,83,57,0,9
1694589,36,1,1977,5,female,143,60,22,84,200,84,178,0,22
1171174,31,18,1982,8,male,525,60,46,87,13,0,2,87,11
1665586,59,17,1954,10,female,311,61,42,86,98,0,21,86,77
1172815,45,22,1968,8,male,474,60,47,86,3,61,3,25,0
1361547,62,24,1951,9,female,1731,61,51,87,63,81,52,6,11
1721113,34,14,1979,9,female,131,61,44,86,17,86,7,0,10
1087699,42,8,1971,10,female,447,60,19,86,49,86,36,0,13
1480592,19,12,1994,6,female,170,61,48,91,45,0,21,91,24
1988314,47,29,1966,7,male,671,61,27,89,143,39,120,50,23
1978091,30,6,1983,12,female,260,60,31,88,63,84,55,4,8
1218282,22,3,1991,5,female,394,60,21,88,15,88,14,0,1
1757812,23,5,1990,2,male,30,61,59,89,42,89,38,0,4
1282918,51,22,1962,4,female,1011,61,23,90,41,90,33,0,8
1566284,25,17,1988,10,female,63,61,41,88,55,88,25,0,30
1004691,57,22,1956,6,female,1515,61,33,93,14,2,5,91,9
1485188,53,20,1960,5,female,366,60,42,94,10,24,2,70,8
1537621,52,1,1961,6,male,124,60,26,93,20,63,9,30,11
1563344,18,22,1995,5,female,484,61,52,92,46,80,24,12,22
1077907,16,15,1997,8,female,262,60,45,92,66,78,29,14,37
1769298,46,19,1967,5,female,824,61,25,92,6,92,6,0,0
1143488,60,16,1953,5,female,304,61,34,95,40,95,20,0,20
1582307,25,23,1988,11,male,518,60,19,94,88,94,68,0,20
2122914,66,17,1947,11,female,1800,60,34,96,28,0,10,96,18
1591101,51,23,1962,5,female,1094,60,45,98,59,52,45,46,14
1097705,53,6,1960,2,female,841,61,24,98,80,59,32,39,48
1298835,14,3,1999,10,male,22,61,29,98,141,98,133,0,8
1582881,57,13,1956,8,female,70,60,33,98,70,98,30,0,40
1569669,77,25,1936,9,female,860,60,40,100,12,0,1,100,11
1816249,25,31,1988,7,male,413,60,47,101,20,0,11,101,9
1927399,106,10,1907,1,male,1164,61,28,104,54,0,21,104,33
1393170,65,5,1948,9,female,44,60,50,101,78,0,31,101,47
1039281,41,2,1972,11,male,413,60,46,101,27,33,23,68,4
1075434,72,18,1941,4,female,1699,61,21,102,28,93,15,9,13
1039379,24,13,1989,6,female,234,61,41,104,65,97,51,7,14
1885191,66,13,1947,5,female,103,61,48,101,112,99,36,2,76
1683531,38,30,1975,5,male,95,61,31,102,65,102,56,0,9
2035695,62,27,1951,12,male,1335,60,10,105,91,0,27,105,64
2110193,64,6,1949,1,male,1544,61,35,109,46,80,24,29,22
1327592,62,12,1951,6,female,2125,60,24,112,37,0,21,112,16
1476924,51,8,1962,1,male,452,61,46,112,78,60,67,52,11
1414360,59,22,1954,9,female,1702,61,36,110,29,109,20,1,9
1869926,31,8,1982,4,female,467,60,30,112,35,112,34,0,1
1032144,50,16,1963,10,female,306,60,51,113,38,113,35,0,3
2092797,79,23,1934,9,female,1029,61,21,116,27,0,15,116,12
1243035,66,12,1947,4,female,1114,61,27,116,115,0,22,116,93
2153609,20,15,1993,5,male,201,60,13,116,68,34,32,82,36
2022724,33,27,1980,7,female,187,60,27,116,38,31,8,85,30
1684420,32,1,1981,1,male,315,60,51,117,162,116,105,1,57
1307859,70,14,1943,12,male,984,61,39,119,31,119,21,0,10
1315180,85,27,1928,12,female,129,61,41,123,11,0,1,123,10
1114155,50,15,1963,1,female,311,61,52,123,133,15,39,108,94
1117961,27,19,1986,11,male,473,60,41,124,18,117,12,7,6
1035290,45,15,1968,8,female,288,61,54,120,259,118,85,2,174
2030556,25,1,1988,1,male,28,61,58,122,13,122,8,0,5
1297290,24,10,1989,5,male,149,60,39,124,98,124,69,0,29
1432213,19,16,1994,2,male,93,60,49,129,141,0,0,129,141
1238638,113,4,1900,10,female,2185,60,31,126,109,81,46,45,63
1115034,77,5,1936,9,female,1157,61,23,128,18,122,8,6,10
1809564,46,1,1967,1,male,617,60,32,129,78,122,25,7,53
1158421,18,28,1995,11,male,171,60,50,130,33,130,23,0,10
1717875,57,26,1956,7,female,1267,61,42,125,48,125,41,0,7
1649239,59,21,1954,11,male,604,61,26,130,22,130,22,0,0
1901559,24,17,1989,11,female,402,60,31,127,124,127,111,0,13
1935189,43,25,1970,2,female,196,61,39,128,170,128,106,0,64
1784031,29,14,1984,4,male,22,60,60,133,22,125,15,8,7
1849872,47,1,1966,3,female,1157,60,34,133,31,130,24,3,7
1112537,15,8,1998,1,male,132,60,32,132,63,132,39,0,24
2003959,50,12,1963,12,female,236,61,28,141,49,57,23,84,26
1209437,26,28,1987,9,female,151,61,52,139,19,139,8,0,11
2107422,100,5,1913,9,female,616,61,26,142,8,142,2,0,6
1836952,41,30,1972,5,female,637,61,39,138,83,138,67,0,16
1640435,18,25,1995,11,male,40,61,54,138,101,138,66,0,35
1994110,28,6,1985,9,female,195,61,40,142,163,142,163,0,0
1716537,22,5,1991,2,male,274,61,57,147,29,1,2,146,27
1283555,62,17,1951,9,male,944,61,20,148,14,139,11,9,3
2190586,61,20,1952,3,female,193,61,41,149,3,149,3,0,0
1992123,27,3,1986,8,male,371,61,42,149,75,149,55,0,20
1104575,27,1,1986,2,male,204,61,42,145,243,145,105,0,138
2089367,60,23,1953,9,female,1643,60,29,157,38,94,18,63,20
1114401,67,23,1946,10,female,978,61,39,151,125,93,59,58,66
1790204,30,30,1983,11,male,266,61,14,157,178,157,178,0,0
1808610,42,18,1971,4,male,366,60,37,163,20,163,5,0,15
1968553,22,1,1991,1,male,226,60,39,168,205,83,143,85,62
1767359,19,15,1994,8,male,68,61,35,165,51,165,45,0,6
1912989,76,2,1937,8,female,1637,60,51,174,111,0,39,174,72
1871390,53,19,1960,12,female,332,61,57,173,4,91,4,82,0
1290158,24,10,1989,11,male,1768,60,36,175,63,114,55,61,8
1150687,50,20,1963,6,female,868,61,21,174,94,93,49,81,45
1262710,23,23,1990,5,female,548,60,42,177,10,174,9,3,1
1411600,50,6,1963,5,male,101,60,30,174,26,174,19,0,7
1487295,22,28,1991,8,male,60,61,56,179,32,179,27,0,5
1394335,46,9,1967,11,male,650,61,12,180,40,180,34,0,6
1071561,33,25,1980,10,female,977,60,37,177,502,177,313,0,189
1654367,45,18,1968,7,female,424,61,45,188,139,103,34,85,105
1039187,36,14,1977,8,male,408,61,43,190,63,189,37,1,26
1980305,31,2,1982,1,male,293,61,34,190,14,190,11,0,3
1735546,43,5,1970,5,female,125,60,48,185,6,185,6,0,0
1747152,35,17,1978,10,female,27,60,59,187,130,187,101,0,29
1610908,60,7,1953,6,female,415,61,19,197,1,0,0,197,1
1678676,16,12,1997,12,female,89,61,50,198,4,198,3,0,1
1237247,24,26,1989,10,male,320,61,49,199,9,199,4,0,5
1986397,55,26,1958,5,female,719,61,55,209,114,56,44,153,70
2107626,25,19,1988,11,female,738,61,51,209,137,77,12,132,125
2078111,56,5,1957,2,female,816,61,51,201,116,163,67,38,49
1300202,21,31,1992,10,female,93,61,46,209,88,208,47,1,41
1347374,20,11,1993,12,male,418,60,35,204,1,204,1,0,0
1249611,45,9,1968,8,female,814,61,37,206,13,206,8,0,5
1582587,53,30,1960,3,female,202,60,29,205,2,205,0,0,2
1947775,23,31,1990,10,female,18,60,51,219,60,65,11,154,49
1685615,35,3,1978,5,female,532,60,39,220,34,204,33,16,1
1134778,44,24,1969,10,male,628,61,39,213,108,188,63,25,45
1056254,23,7,1990,9,female,363,61,24,213,193,203,57,10,136
1456899,22,27,1991,4,male,534,61,49,212,5,212,5,0,0
1755253,45,15,1968,3,female,551,61,40,217,1,217,1,0,0
1738385,45,8,1968,9,male,6,61,34,213,129,213,109,0,20
1807744,76,19,1937,1,female,616,60,32,229,74,0,19,229,55
1085611,20,15,1993,8,male,37,61,54,230,239,90,85,140,154
1932713,60,16,1953,12,female,1498,61,20,231,136,200,55,31,81
1085444,22,4,1991,3,female,198,60,37,226,48,225,30,1,18
1012745,22,25,1991,2,male,140,61,53,233,49,233,36,0,13
1185798,59,12,1954,5,female,328,60,41,230,73,230,22,0,51
1225880,18,30,1995,8,male,122,61,34,246,169,78,88,168,81
1694126,36,5,1977,4,female,532,60,31,235,160,212,12,23,148
1765437,53,8,1960,5,male,1473,61,9,236,30,236,26,0,4
1461926,26,20,1987,6,female,368,60,47,245,321,245,269,0,52
2163162,32,27,1981,8,male,152,60,38,241,161,241,42,0,119
1155003,93,17,1920,4,female,1703,60,26,257,3,0,3,257,0
1087382,108,25,1905,8,female,1377,61,27,259,34,0,13,259,21
1469365,29,29,1984,4,female,28,61,59,259,404,122,205,137,199
1628463,57,30,1956,6,female,979,61,32,248,129,235,71,13,58
2008848,21,19,1992,7,female,333,61,23,251,5,251,2,0,3
1542592,59,29,1954,1,female,446,60,46,256,27,256,22,0,5
1707912,31,1,1982,2,female,44,60,39,247,90,247,63,0,27
1698306,23,16,1990,6,male,384,60,51,266,1,0,0,266,1
1601751,59,21,1954,1,female,332,60,10,263,128,0,9,263,119
1991078,66,2,1947,12,female,408,60,46,272,67,0,16,272,51
1359200,16,9,1997,8,female,314,60,25,271,234,112,115,159,119
1166893,22,20,1991,12,female,191,61,52,264,75,258,57,6,18
1610565,55,10,1958,10,female,960,60,45,266,105,259,81,7,24
1016178,24,13,1989,12,female,1838,60,9,265,152,265,92,0,60
1647341,57,27,1956,11,female,593,60,23,296,155,194,30,102,125
1000922,16,1,1997,1,male,92,60,35,303,15,276,7,27,8
1091530,58,23,1955,1,female,283,61,38,322,88,0,16,322,72
1953795,40,6,1973,9,male,256,61,43,312,7,192,5,120,2
1446446,42,1,1971,1,female,779,61,32,323,100,192,71,131,29
2074095,25,1,1988,5,male,56,61,42,314,303,306,122,8,181
1227593,41,22,1972,1,male,196,61,49,313,80,313,66,0,14
1934587,37,16,1976,8,female,226,61,51,329,136,307,74,22,62
1270893,73,29,1940,12,female,638,60,28,355,87,0,47,355,40
1442063,18,5,1995,5,male,216,61,49,350,249,30,68,320,181
1949766,54,11,1959,9,female,313,61,49,349,307,0,88,349,219
1667610,108,27,1905,7,male,46,61,57,347,59,201,40,146,19
1622641,36,25,1977,5,female,482,61,45,362,273,362,263,0,10
1446726,29,6,1984,1,female,259,61,45,371,329,51,60,320,269
1804304,32,6,1981,4,female,2248,61,57,370,106,202,62,168,44
1076694,59,23,1954,11,female,1552,61,30,393,164,202,93,191,71
1496364,38,21,1975,4,male,128,60,58,374,148,372,119,2,29
1533489,31,13,1982,4,female,96,61,29,393,81,393,58,0,23
1306734,25,20,1988,12,male,54,61,28,412,38,412,37,0,1
1979467,44,20,1969,4,male,360,60,38,437,25,0,3,437,22
2108021,59,9,1954,10,female,238,61,35,443,133,157,122,286,11
1320756,18,5,1995,3,female,304,61,37,432,41,425,37,7,4
1161334,72,15,1941,9,female,317,60,42,442,218,363,84,79,134
1162290,32,29,1981,9,female,407,60,20,446,85,446,69,0,16
1690211,40,8,1973,2,male,239,60,42,439,127,439,83,0,44
1947271,38,29,1975,7,female,121,61,47,507,44,460,19,47,25
2134518,26,26,1987,9,female,651,60,31,496,166,422,68,74,98
1118215,43,26,1970,12,female,309,60,46,518,59,518,49,0,10
1412722,70,13,1943,3,female,773,60,33,550,197,0,48,550,149
1297734,26,19,1987,7,female,255,61,20,543,88,543,80,0,8
1087818,22,12,1991,10,female,497,61,32,545,188,545,133,0,55
1849972,31,8,1982,11,male,348,61,39,548,153,548,114,0,39
1812723,51,27,1962,10,female,460,60,44,590,168,193,138,397,30
1687792,16,13,1997,12,male,400,61,46,588,378,197,128,391,250
2105455,50,20,1963,9,female,933,61,38,601,40,601,27,0,13
1880215,103,23,1910,2,male,546,60,30,612,28,612,8,0,20
1790677,25,6,1988,1,female,307,60,30,659,182,659,174,0,8
1306190,27,12,1986,12,male,423,61,57,624,104,624,77,0,27
1482523,56,2,1957,10,male,296,60,43,626,179,626,149,0,30
1031434,71,25,1942,6,female,2132,61,7,696,96,0,54,696,42
1829813,50,24,1963,9,female,184,61,31,688,356,3,15,685,341
1446787,55,6,1958,9,female,696,61,27,701,134,0,103,701,31
1795309,97,23,1916,7,female,1206,60,38,755,155,655,72,100,83
1617691,55,7,1958,11,female,269,60,38,780,247,780,115,0,132
1369904,51,18,1962,2,female,137,61,41,746,516,746,262,0,254
2158003,19,2,1994,10,male,1495,61,49,961,131,165,51,796,80
1927854,33,7,1980,4,female,1210,60,28,889,948,0,627,889,321
1844975,58,12,1955,8,female,949,60,24,908,190,403,98,505,92
1644003,66,3,1947,4,female,1838,60,35,963,90,963,61,0,29
1373392,73,19,1940,5,female,875,61,52,1001,98,0,39,1001,59
1306492,38,6,1975,12,female,483,60,15,1003,1509,16,161,987,1348
1828545,56,7,1957,1,female,139,60,42,1116,26,1116,20,0,6
1554688,65,26,1948,8,female,725,61,30,1260,545,0,96,1260,449
1252028,60,14,1953,12,female,270,61,30,1155,782,0,6,1155,776
1757261,50,25,1963,3,female,192,61,37,1252,46,1252,37,0,9
1320925,16,10,1997,11,female,27,60,52,1407,1887,505,787,902,1100
1798876,33,5,1980,6,male,257,61,48,1311,15,1311,12,0,3
1851282,35,24,1978,12,female,41,60,46,1442,570,1442,312,0,258
1019414,63,30,1950,5,female,149,60,38,1736,386,1736,268,0,118
1840263,37,1,1976,1,male,308,61,53,2189,142,1296,123,893,19
1440210,100,7,1913,9,female,168,60,34,2048,177,2048,115,0,62
1042121,20,19,1993,6,male,150,60,45,4626,2360,3991,1030,635,1330
1724524,23,25,1990,3,female,533,62,59,2,1,0,0,2,1
1523623,38,14,1975,10,male,378,62,47,2,2,0,0,2,2
1783573,56,17,1957,12,female,836,62,11,2,2,0,1,2,1
1270266,60,9,1953,4,male,846,63,43,2,2,0,0,2,2
1672465,20,26,1993,3,male,201,64,36,2,22,0,4,2,18
2184238,22,5,1991,5,male,376,63,43,2,7,0,1,2,6
1356098,32,4,1981,4,male,331,62,43,2,7,0,7,2,0
1317419,33,10,1980,1,male,473,63,46,2,4,0,4,2,0
1194242,54,7,1959,3,female,225,63,43,2,17,0,10,2,7
1146344,55,26,1958,8,male,1502,64,17,2,4,0,3,2,1
2044338,63,6,1950,9,female,854,62,38,2,6,0,2,2,4
1889020,83,26,1930,3,female,1066,64,28,2,11,0,10,2,1
1681486,103,31,1910,12,male,1193,64,23,2,3,0,1,2,2
1644095,113,1,1900,4,female,1816,64,12,2,7,0,5,2,2
1176594,20,6,1993,7,male,176,64,42,2,16,1,5,1,11
1093617,21,22,1992,6,male,782,64,24,2,23,1,4,1,19
2033338,40,9,1973,2,male,445,64,42,2,23,1,4,1,19
2119907,66,1,1947,1,male,694,62,44,2,9,1,6,1,3
2105985,14,9,1999,10,male,721,64,8,2,0,2,0,0,0
1526661,14,22,1999,10,female,614,64,38,2,0,2,0,0,0
1711102,16,26,1997,7,male,230,62,11,2,0,2,0,0,0
1597700,19,2,1994,10,male,718,63,38,2,0,2,0,0,0
1780513,21,15,1992,5,female,452,63,20,2,0,2,0,0,0
1840505,22,22,1991,5,male,122,64,54,2,0,2,0,0,0
1039168,25,20,1988,6,female,370,63,19,2,0,2,0,0,0
1509639,27,29,1986,5,male,157,62,34,2,0,2,0,0,0
1726698,28,21,1985,8,female,560,62,36,2,0,2,0,0,0
1646772,29,27,1984,1,female,261,63,48,2,0,2,0,0,0
2072373,30,10,1983,6,male,406,63,34,2,0,2,0,0,0
1622987,57,18,1956,4,male,349,64,50,2,0,2,0,0,0
1167149,61,18,1952,12,male,2083,64,10,2,0,2,0,0,0
1004118,62,5,1951,7,male,282,63,32,2,0,2,0,0,0
1625370,14,15,1999,3,male,134,63,45,2,1,2,1,0,0
1817175,16,11,1997,9,male,260,62,48,2,1,2,1,0,0
1920501,17,7,1996,8,male,366,63,42,2,1,2,1,0,0
2021778,19,3,1994,12,male,218,64,50,2,1,2,1,0,0
1254468,19,4,1994,8,male,963,63,44,2,1,2,0,0,1
1211700,20,5,1993,8,male,147,64,55,2,1,2,0,0,1
1245074,26,25,1987,12,male,424,63,38,2,1,2,1,0,0
1855496,27,27,1986,4,male,1580,62,39,2,1,2,1,0,0
2042128,30,2,1983,7,male,651,62,45,2,1,2,1,0,0
1392768,35,16,1978,7,male,294,62,41,2,1,2,1,0,0
1999238,59,29,1954,11,female,659,63,36,2,1,2,1,0,0
1623372,21,9,1992,3,male,179,64,41,2,2,2,2,0,0
1732693,40,5,1973,4,male,33,62,21,2,2,2,1,0,1
1171732,15,19,1998,12,male,36,62,58,2,8,2,7,0,1
1333847,14,6,1999,2,male,620,62,53,2,3,2,3,0,0
1726074,15,31,1998,8,male,91,64,52,2,33,2,27,0,6
1019742,17,13,1996,11,male,522,62,28,2,38,2,32,0,6
1332237,16,1,1997,7,male,62,64,58,2,3,2,3,0,0
1774167,18,24,1995,12,male,73,63,52,2,26,2,21,0,5
1380957,20,26,1993,12,male,388,64,22,2,17,2,12,0,5
1352953,19,10,1994,1,male,156,64,59,2,5,2,5,0,0
1151228,20,26,1993,8,male,376,63,40,2,3,2,1,0,2
1863341,21,12,1992,8,female,21,62,53,2,22,2,16,0,6
1237704,26,14,1987,4,male,157,64,61,2,15,2,7,0,8
2071756,27,23,1986,6,male,170,64,62,2,12,2,8,0,4
1038054,28,19,1985,8,male,192,63,51,2,14,2,9,0,5
1595571,29,12,1984,9,male,34,63,59,2,16,2,10,0,6
1647016,36,3,1977,3,female,278,64,40,2,6,2,4,0,2
2018127,39,10,1974,2,male,76,64,50,2,4,2,3,0,1
2182132,42,9,1971,2,male,603,64,54,2,4,2,3,0,1
2068824,43,13,1970,5,male,446,64,23,2,3,2,3,0,0
1142367,44,31,1969,3,female,435,64,56,2,7,2,7,0,0
1274399,47,3,1966,12,male,578,63,24,2,8,2,8,0,0
1844380,48,3,1965,9,female,396,64,59,2,3,2,2,0,1
1332833,16,30,1997,4,male,302,63,49,3,0,0,0,3,0
1125319,20,9,1993,4,male,120,62,54,3,0,0,0,3,0
1630534,24,15,1989,8,female,380,62,17,3,0,0,0,3,0
2101475,29,19,1984,5,male,544,64,39,3,1,0,0,3,1
1530129,50,4,1963,8,male,1385,63,21,3,1,0,0,3,1
1802415,54,8,1959,1,male,412,62,50,3,1,0,1,3,0
1841024,59,20,1954,6,male,97,64,59,3,1,0,1,3,0
2129796,13,8,2000,1,male,268,63,53,3,4,0,0,3,4
1054316,19,17,1994,8,female,236,62,46,3,2,0,2,3,0
1820770,21,17,1992,2,male,129,62,52,3,2,0,1,3,1
1260884,23,4,1990,11,male,210,62,35,3,3,0,0,3,3
1898193,22,15,1991,4,female,395,64,49,3,4,0,0,3,4
1754268,22,7,1991,10,male,525,64,21,3,3,0,1,3,2
1659134,33,7,1980,8,male,661,63,41,3,3,0,1,3,2
1887942,36,8,1977,8,male,209,63,35,3,3,0,2,3,1
1356457,21,5,1992,3,female,72,64,57,3,5,0,1,3,4
1951641,37,3,1976,4,male,266,63,36,3,32,0,18,3,14
2165892,47,31,1966,5,female,452,63,35,3,10,0,5,3,5
1621585,70,26,1943,5,female,1130,63,33,3,0,2,0,1,0
1914885,47,17,1966,6,male,512,64,50,3,3,2,2,1,1
1075637,54,4,1959,4,female,1322,62,10,3,4,1,3,2,1
1655865,23,18,1990,8,male,297,62,39,3,8,2,7,1,1
1505637,24,19,1989,5,female,422,64,45,3,249,2,9,1,240
1478603,35,27,1978,11,female,45,63,56,3,30,1,12,2,18
1104310,39,24,1974,11,female,450,62,46,3,12,2,8,1,4
1086200,51,12,1962,2,female,962,64,42,3,13,1,6,2,7
1741213,64,15,1949,2,female,1605,62,16,3,51,2,32,1,19
1203355,15,16,1998,11,male,106,64,60,3,0,3,0,0,0
1976419,17,6,1996,12,male,247,63,45,3,0,3,0,0,0
2118152,18,11,1995,2,male,522,64,43,3,0,3,0,0,0
1265127,21,5,1992,1,male,18,64,59,3,0,3,0,0,0
1033859,21,10,1992,10,male,221,63,60,3,0,3,0,0,0
1202595,23,10,1990,11,male,104,62,58,3,0,3,0,0,0
1496026,23,22,1990,3,male,283,63,49,3,0,3,0,0,0
1909400,26,8,1987,8,male,853,64,52,3,0,3,0,0,0
1035071,26,22,1987,8,female,475,63,25,3,0,3,0,0,0
1375274,30,11,1983,11,male,88,63,59,3,0,3,0,0,0
1175762,36,20,1977,2,male,540,63,18,3,0,3,0,0,0
1603203,43,10,1970,1,male,231,62,56,3,0,3,0,0,0
1948227,72,2,1941,9,female,1440,63,19,3,0,3,0,0,0
1906738,14,29,1999,7,female,13,62,47,3,1,3,1,0,0
1208668,15,31,1998,1,male,357,63,40,3,1,3,1,0,0
2164837,23,18,1990,9,male,733,64,37,3,1,3,1,0,0
2083118,103,1,1910,7,male,793,63,31,3,1,3,1,0,0
1943496,14,15,1999,9,male,51,62,44,3,2,3,2,0,0
1648623,15,15,1998,4,male,21,63,18,3,4,3,3,0,1
1436037,15,15,1998,10,male,88,64,62,3,2,3,2,0,0
2185281,25,5,1988,2,male,434,62,38,3,2,3,2,0,0
1925743,37,19,1976,10,female,204,63,21,3,2,3,2,0,0
1519820,108,21,1905,3,male,339,64,53,3,3,3,3,0,0
1224359,108,10,1905,7,male,248,62,54,3,2,3,2,0,0
1674837,14,14,1999,11,male,186,64,41,3,5,3,1,0,4
1677228,21,4,1992,12,male,107,64,37,3,30,3,18,0,12
1952975,29,1,1984,4,male,256,62,51,3,27,3,23,0,4
1079491,30,9,1983,1,male,269,63,26,3,15,3,13,0,2
1060946,31,15,1982,2,female,495,62,38,3,11,3,5,0,6
2049250,37,20,1976,7,male,617,62,48,3,6,3,4,0,2
1948859,39,11,1974,7,female,562,64,33,3,40,3,15,0,25
1252908,44,31,1969,1,male,201,62,30,3,18,3,8,0,10
1698301,15,25,1998,7,male,576,63,55,4,0,0,0,4,0
1380943,29,1,1984,8,male,324,62,58,4,1,0,1,4,0
1867678,51,9,1962,5,female,925,63,37,4,1,0,1,4,0
2099227,63,1,1950,8,male,278,64,25,4,1,0,0,4,1
2058852,69,14,1944,3,male,613,62,12,4,4,0,2,4,2
1064513,18,11,1995,12,male,104,64,59,4,12,0,3,4,9
1933300,41,25,1972,7,male,429,62,48,4,19,0,13,4,6
1623899,56,11,1957,10,male,863,62,13,4,38,0,25,4,13
1945203,67,30,1946,11,male,1071,64,30,4,18,0,4,4,14
1297338,77,29,1936,6,male,149,63,47,4,4,1,1,3,3
1953811,25,18,1988,9,male,510,63,59,4,6,1,4,3,2
1549435,52,15,1961,9,female,186,62,35,4,12,1,1,3,11
2151037,62,20,1951,2,male,827,62,19,4,10,2,9,2,1
1904978,15,31,1998,5,female,535,62,35,4,0,3,0,1,0
2156396,20,28,1993,3,male,253,62,59,4,1,3,1,1,0
1964420,23,8,1990,1,male,286,64,11,4,1,3,1,1,0
1766718,25,25,1988,8,male,838,63,31,4,2,3,2,1,0
1175339,110,10,1903,7,female,1512,64,29,4,1,3,1,1,0
1518700,21,8,1992,8,male,557,64,58,4,0,4,0,0,0
1061025,24,9,1989,1,female,370,63,40,4,0,4,0,0,0
1065301,32,28,1981,8,male,773,62,12,4,0,4,0,0,0
1973073,52,3,1961,2,male,794,62,42,4,0,4,0,0,0
1891693,20,11,1993,2,male,155,62,54,4,2,4,2,0,0
1090378,26,12,1987,6,male,462,62,18,4,2,4,2,0,0
2159352,29,8,1984,9,male,235,62,48,4,1,4,1,0,0
1458118,44,8,1969,9,male,938,64,45,4,2,4,1,0,1
1234444,47,10,1966,2,female,804,62,31,4,1,4,1,0,0
1121863,67,6,1946,10,male,409,62,45,4,1,4,1,0,0
1147947,69,18,1944,9,male,1223,64,25,4,1,4,1,0,0
1799873,17,1,1996,9,male,276,62,15,4,3,4,3,0,0
1109551,23,1,1990,1,female,611,64,18,4,4,4,2,0,2
1677442,26,1,1987,1,male,493,63,41,4,5,4,5,0,0
1518791,17,6,1996,1,male,96,64,63,4,17,4,13,0,4
1214117,22,21,1991,9,female,584,63,38,4,35,4,34,0,1
1107343,23,17,1990,8,male,63,62,36,4,6,4,5,0,1
2131062,24,12,1989,3,male,75,62,52,4,8,4,8,0,0
1907437,27,3,1986,5,female,14,63,36,4,8,4,8,0,0
2038788,27,15,1986,10,male,192,62,54,4,38,4,32,0,6
1871166,30,5,1983,9,female,226,64,35,4,7,4,7,0,0
1923995,33,16,1980,12,male,94,62,60,4,18,4,14,0,4
1824577,36,13,1977,3,female,109,63,4,4,72,4,58,0,14
1035283,103,20,1910,2,female,353,63,30,4,12,4,8,0,4
1621420,14,15,1999,8,male,328,64,48,5,0,0,0,5,0
1502863,16,15,1997,8,male,44,64,62,5,0,0,0,5,0
1074388,58,6,1955,11,male,1802,62,8,5,0,0,0,5,0
2049941,18,2,1995,1,male,26,63,52,5,2,0,0,5,2
1317406,47,1,1966,10,female,350,62,34,5,1,0,1,5,0
2023710,23,15,1990,12,male,159,62,61,5,5,0,3,5,2
1138795,47,16,1966,7,male,129,64,39,5,4,0,2,5,2
1846211,16,18,1997,8,male,200,64,49,5,13,0,0,5,13
1997784,23,2,1990,11,male,69,62,38,5,13,0,1,5,12
1460653,47,1,1966,3,male,391,64,49,5,20,0,17,5,3
1186051,59,29,1954,8,male,1179,62,32,5,16,0,6,5,10
1144344,64,23,1949,3,male,219,63,51,5,21,0,9,5,12
1779136,71,10,1942,10,female,1650,62,34,5,21,0,5,5,16
1868853,67,1,1946,9,male,1572,64,42,5,1,2,1,3,0
1922019,73,26,1940,6,female,553,64,45,5,1,1,0,4,1
1146144,33,26,1980,6,male,454,63,42,5,7,1,1,4,6
1595697,66,24,1947,4,male,1404,62,33,5,20,2,12,3,8
1881423,70,5,1943,10,female,1305,63,28,5,15,3,10,2,5
1950995,19,1,1994,1,male,369,62,18,5,0,4,0,1,0
1575829,48,22,1965,12,male,685,64,14,5,5,4,4,1,1
1838612,65,13,1948,6,female,790,62,34,5,33,4,14,1,19
1570918,16,28,1997,4,male,81,63,44,5,0,5,0,0,0
1781302,18,25,1995,12,male,945,63,31,5,0,5,0,0,0
1187011,18,20,1995,8,male,307,63,43,5,0,5,0,0,0
1878844,28,29,1985,1,male,83,63,51,5,0,5,0,0,0
1703905,57,13,1956,4,female,639,62,49,5,0,5,0,0,0
1330021,16,7,1997,10,male,258,62,43,5,1,5,1,0,0
1903213,21,11,1992,10,male,89,64,61,5,4,5,3,0,1
1678350,32,15,1981,11,male,395,62,49,5,7,5,5,0,2
1690667,14,28,1999,3,female,213,64,47,5,26,5,19,0,7
1258784,18,26,1995,4,male,162,63,55,5,10,5,9,0,1
1275324,18,29,1995,4,female,64,63,52,5,85,5,63,0,22
1934771,19,22,1994,3,male,78,63,52,5,26,5,15,0,11
1204106,20,30,1993,8,female,144,64,19,5,17,5,7,0,10
1579191,40,17,1973,11,male,433,64,17,5,15,5,13,0,2
1717154,40,17,1973,9,female,290,63,28,5,9,5,2,0,7
1312244,60,26,1953,3,female,592,63,35,5,13,5,4,0,9
2134310,14,4,1999,10,male,155,62,53,6,0,0,0,6,0
2039320,17,13,1996,7,male,489,63,62,6,1,0,0,6,1
1609746,33,23,1980,8,male,300,63,26,6,3,0,0,6,3
1529935,40,13,1973,4,male,335,63,45,6,2,0,1,6,1
1580424,58,26,1955,5,male,577,64,44,6,2,0,0,6,2
1633974,108,1,1905,4,male,1382,62,36,6,2,1,1,5,1
1741577,57,30,1956,9,male,140,64,51,6,7,0,5,6,2
2079909,28,24,1985,11,male,378,63,53,6,9,0,0,6,9
1791433,108,1,1905,1,female,1465,62,19,6,1,3,1,3,0
1712573,23,1,1990,7,male,430,64,31,6,4,4,3,2,1
1127051,45,4,1968,9,male,989,64,36,6,8,2,8,4,0
1783235,66,30,1947,9,female,1481,64,22,6,34,3,26,3,8
1668587,23,1,1990,10,male,250,62,27,6,0,6,0,0,0
1633426,25,30,1988,11,male,434,62,5,6,0,6,0,0,0
1827860,24,29,1989,7,male,690,64,17,6,0,6,0,0,0
1746134,29,14,1984,4,male,288,64,50,6,0,6,0,0,0
1752908,19,24,1994,7,male,383,64,20,6,1,6,1,0,0
1931181,26,16,1987,11,male,154,63,52,6,1,6,1,0,0
1340593,43,7,1970,5,male,651,63,60,6,1,6,0,0,1
1728476,50,18,1963,4,female,277,64,40,6,2,6,2,0,0
1450634,53,6,1960,6,female,745,62,32,6,3,6,2,0,1
1852636,25,12,1988,11,male,699,64,23,6,8,6,2,0,6
1258903,29,7,1984,12,female,502,63,28,6,5,6,4,0,1
1526047,29,1,1984,4,male,528,63,34,6,7,6,6,0,1
1097719,33,13,1980,9,female,222,64,52,6,4,6,4,0,0
1307774,34,10,1979,8,male,253,63,48,6,4,6,3,0,1
1430000,48,19,1965,8,male,358,64,36,6,6,6,5,0,1
1534419,25,1,1988,1,female,220,64,44,6,99,6,90,0,9
1447431,31,21,1982,3,female,255,64,42,6,16,6,12,0,4
1321839,43,20,1970,10,male,367,64,48,6,62,6,52,0,10
1749359,53,19,1960,8,female,145,64,48,6,37,6,32,0,5
1662367,62,27,1951,10,male,1566,64,24,6,14,6,7,0,7
1828633,76,22,1937,8,male,717,63,38,6,11,6,11,0,0
1469129,55,25,1958,3,male,639,64,30,7,1,0,0,7,1
2118522,57,8,1956,1,male,1566,63,16,7,2,0,0,7,2
1561615,24,26,1989,11,male,399,63,43,7,8,0,2,7,6
1245935,43,3,1970,8,male,271,62,44,7,7,0,0,7,7
2104653,22,10,1991,11,male,156,64,61,7,0,4,0,3,0
2061860,18,3,1995,1,male,72,64,60,7,3,3,0,4,3
1829760,44,1,1969,10,male,956,63,31,7,28,4,22,3,6
1696705,47,14,1966,6,male,276,64,26,7,52,6,10,1,42
1103544,49,28,1964,3,male,371,62,47,7,20,6,14,1,6
1199099,20,21,1993,11,female,156,64,61,7,1,7,1,0,0
1857387,43,26,1970,5,female,283,62,42,7,1,7,1,0,0
1060868,56,7,1957,8,female,947,62,44,7,1,7,1,0,0
2168189,21,31,1992,1,male,448,63,15,7,2,7,0,0,2
2128334,28,14,1985,4,male,491,64,45,7,4,7,0,0,4
2078061,30,22,1983,6,male,736,62,37,7,2,7,2,0,0
1398094,27,25,1986,5,male,239,64,60,7,10,7,6,0,4
2090479,30,28,1983,2,male,806,64,32,7,6,7,4,0,2
1925455,33,26,1980,9,male,75,63,53,7,10,7,4,0,6
1639301,28,17,1985,12,male,248,63,35,7,50,7,36,0,14
1578959,46,25,1967,7,female,120,62,60,7,26,7,22,0,4
1446558,48,14,1965,6,female,241,63,27,8,0,0,0,8,0
1965340,63,2,1950,12,male,1394,63,29,8,2,0,0,8,2
1322713,21,26,1992,1,female,309,62,54,8,0,5,0,3,0
1014503,22,10,1991,1,female,622,63,43,8,3,4,2,4,1
1122371,19,18,1994,3,male,287,62,47,8,0,7,0,1,0
1918027,19,2,1994,10,male,652,62,35,8,0,7,0,1,0
1199286,47,15,1966,11,female,393,62,56,8,9,6,7,2,2
1931203,21,6,1992,1,female,156,64,56,8,3,8,0,0,3
1687348,22,9,1991,2,male,441,64,32,8,3,8,3,0,0
2134570,25,20,1988,12,female,154,62,61,8,2,8,2,0,0
1793373,49,11,1964,1,male,149,63,50,8,2,8,0,0,2
2043088,20,7,1993,5,male,102,64,52,8,11,8,9,0,2
2152577,32,21,1981,10,male,103,63,49,8,5,8,3,0,2
1038445,39,21,1974,4,male,256,63,55,8,11,8,10,0,1
1580810,56,12,1957,10,female,82,62,57,8,10,8,8,0,2
2071964,34,25,1979,4,male,138,64,31,8,70,8,39,0,31
1315894,35,20,1978,6,female,349,64,37,9,1,1,1,8,0
1070793,67,22,1946,2,male,1750,63,18,9,2,0,1,9,1
1830562,18,27,1995,8,male,25,63,61,9,3,5,3,4,0
1564670,19,13,1994,3,female,101,62,24,9,3,3,2,6,1
2087960,38,21,1975,9,male,42,63,31,9,43,5,23,4,20
2085130,42,19,1971,5,male,157,64,60,9,21,2,18,7,3
1629679,19,21,1994,9,male,346,62,54,9,0,8,0,1,0
2010008,63,23,1950,11,female,89,63,38,9,18,8,5,1,13
1121432,33,6,1980,2,male,402,62,48,9,0,9,0,0,0
1428355,43,23,1970,6,male,1674,64,16,9,1,9,1,0,0
1147159,49,29,1964,2,male,840,63,32,9,0,9,0,0,0
1303001,28,5,1985,9,male,368,64,27,9,4,9,4,0,0
1677755,32,23,1981,1,male,946,64,34,9,4,9,1,0,3
2169770,33,1,1980,1,male,368,62,54,9,5,9,5,0,0
2001532,49,28,1964,4,male,714,64,41,9,4,9,2,0,2
1264774,61,3,1952,12,female,1557,63,38,9,2,9,2,0,0
1334116,22,23,1991,7,male,127,63,51,9,9,9,7,0,2
1316354,26,13,1987,9,female,486,64,25,9,11,9,6,0,5
1122034,36,11,1977,3,male,625,64,11,9,7,9,1,0,6
1160623,45,25,1968,7,male,405,64,27,9,10,9,5,0,5
1730765,51,4,1962,6,male,487,62,35,9,9,9,9,0,0
1617288,59,22,1954,3,male,363,64,48,9,10,9,10,0,0
2150567,17,17,1996,6,male,13,63,51,9,16,9,13,0,3
2173151,20,15,1993,6,male,593,63,34,9,71,9,40,0,31
1630338,23,24,1990,4,male,257,63,38,9,63,9,44,0,19
2060457,30,30,1983,4,female,42,62,41,9,30,9,19,0,11
1708555,47,24,1966,6,female,756,62,26,9,18,9,11,0,7
1552914,56,21,1957,9,female,272,64,36,9,22,9,6,0,16
1644835,15,6,1998,5,male,153,64,52,10,1,0,1,10,0
2157726,70,4,1943,10,male,1450,64,36,10,4,0,2,10,2
1501899,18,25,1995,9,female,3,64,63,10,10,0,1,10,9
1115724,57,14,1956,7,male,56,62,55,10,9,0,8,10,1
1860914,64,29,1949,12,male,1705,62,25,10,17,0,11,10,6
1121953,23,11,1990,9,male,306,62,28,10,0,2,0,8,0
1746503,60,10,1953,12,male,530,63,13,10,0,7,0,3,0
1961023,29,12,1984,1,female,781,64,30,10,16,6,4,4,12
1630231,30,25,1983,11,male,278,63,34,10,16,9,10,1,6
1352021,13,24,2000,1,female,261,63,56,10,1,10,1,0,0
1852139,24,16,1989,5,male,152,62,53,10,5,10,5,0,0
1958649,24,19,1989,7,female,211,62,50,10,4,10,3,0,1
1890272,24,17,1989,8,female,263,64,38,10,2,10,1,0,1
1403879,29,28,1984,2,female,309,62,51,10,4,10,4,0,0
1682033,45,25,1968,9,female,122,64,47,10,5,10,4,0,1
1601042,23,4,1990,10,female,222,64,12,10,12,10,11,0,1
2182767,23,20,1990,11,male,659,63,26,10,26,10,14,0,12
1424805,25,19,1988,2,female,348,63,28,10,28,10,6,0,22
1720959,28,24,1985,10,male,397,64,38,10,41,10,33,0,8
1226728,14,6,1999,2,male,291,63,41,11,1,0,1,11,0
1197724,21,5,1992,11,male,195,64,49,11,1,0,1,11,0
1560380,21,18,1992,2,male,360,64,51,11,1,0,0,11,1
1151825,55,4,1958,9,female,696,63,38,11,0,0,0,11,0
1569606,13,23,2000,6,male,77,62,23,11,14,0,0,11,14
1228372,18,4,1995,3,female,224,62,57,11,11,0,0,11,11
1290192,31,8,1982,2,male,338,63,38,11,7,0,2,11,5
1482081,68,21,1945,3,female,499,64,27,11,15,1,2,10,13
1940694,32,1,1981,1,male,658,63,44,11,76,0,10,11,66
2083000,18,9,1995,7,female,129,62,52,11,0,9,0,2,0
1593958,17,5,1996,2,male,195,63,48,11,3,11,3,0,0
1677463,19,20,1994,4,female,262,62,44,11,17,11,17,0,0
1276244,25,8,1988,10,male,382,64,38,11,29,11,9,0,20
1203893,54,15,1959,7,male,840,62,55,12,0,0,0,12,0
1733881,50,30,1963,10,female,302,63,24,12,7,1,6,11,1
1329174,18,15,1995,1,female,568,64,20,12,12,3,7,9,5
2120339,18,16,1995,7,male,449,63,53,12,8,6,0,6,8
1613176,26,10,1987,1,male,1176,64,47,12,5,11,5,1,0
1321822,54,23,1959,11,female,1638,64,48,12,15,10,12,2,3
1164856,82,30,1931,7,female,836,63,16,12,27,10,22,2,5
1291954,101,4,1912,5,female,1870,64,35,12,36,11,26,1,10
1331300,19,4,1994,9,male,324,64,35,12,0,12,0,0,0
1084271,15,2,1998,11,female,309,64,39,12,3,12,3,0,0
2069799,20,10,1993,3,female,466,62,40,12,2,12,2,0,0
2133868,38,28,1975,7,male,639,64,41,12,15,12,12,0,3
1567908,21,20,1992,11,male,141,62,36,12,75,12,53,0,22
1429527,26,9,1987,7,female,280,63,43,12,252,12,195,0,57
1051286,44,9,1969,10,male,699,63,42,12,19,12,17,0,2
1032910,60,8,1953,9,male,419,63,33,12,24,12,17,0,7
2017437,68,12,1945,10,male,1389,62,24,12,52,12,40,0,12
1839247,60,13,1953,3,female,1566,63,43,13,9,0,3,13,6
1706868,71,23,1942,9,male,350,64,56,13,20,0,3,13,17
2125861,56,16,1957,11,male,333,64,37,13,0,8,0,5,0
1096786,41,2,1972,10,female,532,63,35,13,5,7,1,6,4
1670070,47,21,1966,11,male,770,63,44,13,8,5,7,8,1
1480909,48,4,1965,8,female,562,63,47,13,16,5,6,8,10
1508455,63,23,1950,9,male,801,64,37,13,15,11,13,2,2
1386168,21,30,1992,3,male,439,62,10,13,1,13,1,0,0
1836617,21,1,1992,6,male,250,63,60,13,0,13,0,0,0
2035034,23,13,1990,2,male,47,62,62,13,9,13,9,0,0
1151829,28,8,1985,10,male,37,63,18,13,17,13,17,0,0
1483626,43,12,1970,2,male,238,63,28,13,9,13,7,0,2
2099343,19,17,1994,3,female,302,64,35,13,74,13,44,0,30
1255734,21,21,1992,1,male,383,62,25,13,36,13,8,0,28
1759898,26,17,1987,3,male,587,63,35,13,20,13,19,0,1
1855746,56,6,1957,2,female,515,64,53,13,36,13,16,0,20
1311644,24,11,1989,6,female,361,63,34,14,3,0,1,14,2
2112050,44,23,1969,9,male,262,64,38,14,16,0,14,14,2
1103600,59,28,1954,5,female,1499,62,19,14,19,1,4,13,15
1402011,52,14,1961,9,female,149,62,25,14,44,0,2,14,42
1651463,59,12,1954,12,male,52,64,51,14,25,0,5,14,20
1589649,54,4,1959,2,male,507,63,44,14,15,9,10,5,5
1072349,25,1,1988,1,male,122,64,39,14,2,14,2,0,0
1865787,56,29,1957,10,male,321,62,4,14,3,14,2,0,1
2145854,24,5,1989,5,male,56,63,50,14,12,14,9,0,3
2115942,37,19,1976,11,female,272,62,35,14,11,14,7,0,4
1608341,103,23,1910,1,female,1333,62,17,14,10,14,10,0,0
1647488,18,21,1995,2,male,343,63,58,14,24,14,23,0,1
2150530,22,1,1991,6,male,165,63,48,14,26,14,21,0,5
1850470,28,17,1985,3,male,272,62,52,14,22,14,22,0,0
1718281,37,30,1976,10,male,502,63,52,14,21,14,21,0,0
2143950,51,20,1962,12,female,2094,64,12,15,8,1,4,14,4
1435759,53,21,1960,2,male,733,63,45,15,22,0,0,15,22
1437227,19,6,1994,10,male,353,62,30,15,70,2,15,13,55
1703474,31,1,1982,5,male,529,62,50,15,38,0,15,15,23
1434204,23,18,1990,4,male,85,64,51,15,9,6,5,9,4
2141671,44,3,1969,8,male,603,64,46,15,67,11,9,4,58
1106463,32,9,1981,2,male,138,62,53,15,0,15,0,0,0
2172319,32,28,1981,12,male,100,63,50,15,4,15,4,0,0
1761368,49,12,1964,1,male,271,64,55,15,3,15,3,0,0
1747547,18,14,1995,12,male,290,63,24,15,10,15,10,0,0
1640363,27,16,1986,5,male,155,62,50,15,11,15,8,0,3
1801463,52,19,1961,9,female,174,62,35,15,30,15,28,0,2
2066004,62,24,1951,6,female,1054,62,28,15,23,15,15,0,8
1886483,31,16,1982,6,female,142,63,46,16,6,0,0,16,6
1359135,71,11,1942,10,male,118,63,8,16,14,0,0,16,14
1976067,22,3,1991,4,female,307,64,37,16,9,14,6,2,3
1324794,67,14,1946,9,female,1516,64,24,16,5,14,1,2,4
2018558,59,10,1954,3,male,643,64,45,16,25,15,23,1,2
1080053,17,1,1996,7,male,206,64,47,16,0,16,0,0,0
1306620,23,2,1990,2,male,120,63,41,16,2,16,2,0,0
1757213,93,18,1920,2,male,140,64,54,16,2,16,0,0,2
1042790,56,25,1957,1,male,1470,64,28,16,6,16,3,0,3
1671427,20,3,1993,1,female,1527,64,19,16,10,16,9,0,1
1358678,38,1,1975,6,male,622,62,20,16,12,16,10,0,2
2159736,57,28,1956,12,male,826,64,6,16,96,16,78,0,18
1019155,70,9,1943,2,female,251,63,21,16,24,16,18,0,6
1217294,25,16,1988,8,female,470,64,56,17,3,0,3,17,0
2114439,23,15,1990,8,male,913,64,35,17,0,14,0,3,0
1483465,32,19,1981,7,male,566,64,48,17,1,16,0,1,1
1715398,19,28,1994,7,male,249,63,24,17,10,15,10,2,0
2096739,22,28,1991,4,female,1136,62,18,17,0,17,0,0,0
1813575,31,25,1982,1,male,401,64,47,17,0,17,0,0,0
1966029,30,29,1983,12,female,370,64,57,17,6,17,6,0,0
1456816,14,17,1999,10,male,166,63,45,17,23,17,21,0,2
1641516,48,22,1965,12,female,215,64,54,17,13,17,8,0,5
1285538,14,10,1999,1,female,306,62,56,18,0,1,0,17,0
1419777,31,27,1982,2,female,81,63,45,18,22,0,11,18,11
1170201,46,16,1967,2,male,341,62,42,18,19,0,7,18,12
1948740,72,20,1941,1,male,593,63,34,18,87,0,41,18,46
1501308,52,6,1961,3,male,276,62,54,18,0,7,0,11,0
1096086,31,29,1982,3,female,405,63,46,18,8,9,3,9,5
1538150,18,9,1995,6,male,27,62,32,18,52,8,14,10,38
1145540,49,14,1964,1,female,155,64,46,18,0,16,0,2,0
1671347,36,13,1977,1,female,424,63,31,18,24,15,4,3,20
1445353,31,30,1982,3,male,31,63,20,18,35,17,29,1,6
1190595,15,26,1998,9,female,171,64,59,18,0,18,0,0,0
2089316,23,1,1990,7,male,2,64,57,18,1,18,1,0,0
1186668,31,24,1982,12,male,50,64,43,18,0,18,0,0,0
1461443,21,10,1992,1,male,138,63,42,18,6,18,4,0,2
1142019,44,23,1969,7,female,204,64,54,18,26,18,19,0,7
1109493,49,1,1964,5,male,180,62,20,18,12,18,12,0,0
1921621,25,15,1988,12,female,440,63,12,18,32,18,25,0,7
1255855,65,4,1948,8,female,2351,63,33,19,10,1,5,18,5
1972457,93,5,1920,1,male,1670,64,35,19,28,0,10,19,18
1737252,20,26,1993,2,male,388,63,41,19,1,10,1,9,0
1965597,29,11,1984,2,male,27,64,57,19,41,14,12,5,29
1112511,16,1,1997,1,male,467,62,41,19,10,19,2,0,8
1598575,17,18,1996,4,male,25,62,61,19,5,19,5,0,0
1808859,31,31,1982,3,male,319,64,54,19,6,19,4,0,2
2017852,82,31,1931,5,female,244,64,41,19,8,19,6,0,2
1425101,18,5,1995,7,female,196,64,55,19,12,19,12,0,0
1597730,26,5,1987,5,male,466,64,59,19,23,19,21,0,2
1806478,77,17,1936,10,male,243,62,47,19,17,19,14,0,3
1861123,23,2,1990,8,male,290,64,36,19,76,19,56,0,20
1592458,32,20,1981,7,female,279,62,30,19,76,19,42,0,34
1182369,64,6,1949,1,male,800,62,7,20,30,9,15,11,15
1616505,70,8,1943,11,female,1592,63,30,20,13,16,3,4,10
2050223,22,24,1991,9,male,292,62,54,20,2,20,1,0,1
1738492,30,4,1983,2,male,278,62,21,20,0,20,0,0,0
1477719,22,16,1991,10,male,549,62,52,20,5,20,5,0,0
1361868,62,1,1951,4,female,1324,64,21,20,12,20,8,0,4
2169085,26,22,1987,11,male,822,64,31,20,19,20,18,0,1
1494090,29,4,1984,10,male,715,64,22,20,31,20,28,0,3
1624586,33,17,1980,5,female,319,63,15,20,115,20,78,0,37
1567261,55,8,1958,3,male,646,64,45,21,2,0,2,21,0
1741091,14,20,1999,6,female,89,62,38,21,0,15,0,6,0
1712411,26,15,1987,10,male,360,64,32,21,3,21,3,0,0
1689315,28,2,1985,3,male,340,63,17,21,8,21,8,0,0
1909625,103,8,1910,10,female,1115,62,32,21,20,21,20,0,0
1780850,31,7,1982,10,male,27,63,48,21,90,21,67,0,23
2079080,64,12,1949,8,male,356,62,40,21,57,21,30,0,27
1227214,15,20,1998,4,female,456,64,39,22,1,22,1,0,0
1828778,25,18,1988,3,female,15,62,30,22,3,22,3,0,0
1720564,33,16,1980,8,male,259,62,61,22,2,22,0,0,2
1734578,52,6,1961,10,female,476,64,30,22,4,22,4,0,0
2037283,34,30,1979,6,female,153,62,49,22,20,22,8,0,12
1340391,48,24,1965,2,male,288,62,46,22,15,22,6,0,9
1243650,50,18,1963,2,male,261,64,33,22,50,22,27,0,23
1589409,69,8,1944,7,male,1243,64,29,23,5,0,2,23,3
1337568,33,30,1980,4,male,137,62,45,23,36,15,16,8,20
2119848,20,17,1993,10,male,129,62,23,23,12,18,10,5,2
2087290,34,23,1979,12,male,534,63,58,23,253,22,217,1,36
1722490,15,26,1998,6,male,121,64,35,23,3,23,3,0,0
1920270,20,2,1993,8,male,428,64,44,23,2,23,1,0,1
2174138,44,8,1969,3,male,213,64,60,23,3,23,2,0,1
1331627,51,12,1962,2,female,452,62,25,23,7,23,7,0,0
1875372,54,20,1959,1,female,270,63,29,23,35,23,34,0,1
1842558,17,17,1996,6,male,267,63,39,24,0,4,0,20,0
1676482,19,16,1994,7,male,347,64,52,24,2,0,0,24,2
1976017,86,2,1927,5,NA,1691,64,10,24,58,8,18,16,40
1392358,113,1,1900,1,male,1645,62,42,24,39,17,22,7,17
1554270,15,14,1998,6,female,113,63,60,24,9,20,5,4,4
1941337,19,26,1994,3,male,127,62,46,24,10,19,9,5,1
2172588,55,9,1958,12,male,735,62,27,24,3,24,1,0,2
1429068,58,11,1955,4,male,413,62,50,24,4,24,4,0,0
1083877,18,1,1995,1,male,37,63,51,24,29,24,7,0,22
1701267,22,16,1991,7,female,521,62,51,24,17,24,5,0,12
1065713,27,30,1986,11,male,556,64,29,24,18,24,13,0,5
1062351,58,20,1955,11,female,2254,62,28,24,34,24,6,0,28
1057593,20,11,1993,3,female,120,62,52,24,38,24,33,0,5
1793588,66,29,1947,5,female,2122,62,8,25,13,6,13,19,0
1574550,28,17,1985,11,male,408,62,6,25,7,25,5,0,2
1946240,43,2,1970,2,male,524,64,56,25,5,25,3,0,2
2181968,17,16,1996,7,male,487,64,35,25,34,25,22,0,12
1231280,18,18,1995,8,female,54,63,34,25,16,25,10,0,6
1377591,52,6,1961,4,female,354,63,25,26,4,0,1,26,3
1017910,43,10,1970,7,male,349,64,44,26,10,22,5,4,5
1245296,38,1,1975,1,male,285,64,43,26,75,25,64,1,11
1997973,51,21,1962,1,male,523,63,46,26,4,26,2,0,2
1103510,20,5,1993,9,male,417,63,32,26,7,26,7,0,0
1178027,21,2,1992,2,male,439,64,64,26,13,26,11,0,2
1193316,61,26,1952,2,female,812,62,31,26,8,26,7,0,1
1871826,13,22,2000,4,male,141,64,35,26,21,26,18,0,3
1103098,17,24,1996,12,male,26,62,57,26,16,26,13,0,3
1788443,20,1,1993,1,male,222,62,36,27,3,0,1,27,2
2113972,26,1,1987,1,male,287,62,58,27,6,0,2,27,4
1227336,108,23,1905,8,female,850,63,55,27,66,0,9,27,57
1977953,24,5,1989,10,male,217,62,37,27,3,27,3,0,0
1941603,45,23,1968,12,male,491,62,24,27,0,27,0,0,0
1944460,14,8,1999,8,female,123,63,34,27,7,27,2,0,5
2084455,23,13,1990,11,male,386,63,40,27,16,27,13,0,3
1258560,30,18,1983,7,female,479,63,38,27,10,27,6,0,4
1720331,53,15,1960,9,female,362,63,57,27,9,27,9,0,0
1434941,21,25,1992,3,male,637,63,37,27,18,27,6,0,12
1244033,28,12,1985,2,male,442,63,18,27,25,27,22,0,3
2084119,54,17,1959,7,male,82,62,43,27,35,27,33,0,2
1154952,65,3,1948,5,male,1075,62,24,27,38,27,15,0,23
1390505,108,1,1905,1,male,1977,62,28,28,33,1,21,27,12
2038727,43,29,1970,8,female,415,64,42,28,20,13,5,15,15
1270630,53,3,1960,12,female,1998,64,20,28,78,13,56,15,22
1796427,23,10,1990,10,male,340,64,33,28,18,28,16,0,2
1950816,28,16,1985,5,female,133,62,32,29,9,0,0,29,9
1966574,20,18,1993,8,male,254,63,42,29,18,11,6,18,12
1197975,48,5,1965,12,female,505,62,33,29,29,29,20,0,9
1118432,70,3,1943,11,female,1078,62,10,30,4,0,2,30,2
1761464,28,13,1985,2,male,500,63,48,30,6,0,0,30,6
1389606,53,5,1960,6,female,1843,64,11,30,113,1,39,29,74
1189079,60,10,1953,7,male,323,63,47,31,51,0,32,31,19
2071568,61,9,1952,6,female,307,63,27,31,23,22,8,9,15
1918646,93,1,1920,1,male,511,62,19,31,26,24,5,7,21
1485902,46,16,1967,7,male,947,62,22,31,1,31,1,0,0
1998729,17,28,1996,9,male,489,64,23,31,10,31,9,0,1
1775324,33,16,1980,3,female,389,62,49,30,5,30,1,0,4
1176994,19,9,1994,2,male,54,63,62,31,25,31,23,0,2
1628355,27,19,1986,9,male,219,62,55,31,22,31,19,0,3
1400003,31,5,1982,10,female,1538,63,28,30,32,30,30,0,2
1439253,56,3,1957,8,male,155,62,43,32,10,0,0,32,10
2124203,47,1,1966,6,male,622,62,22,32,1,12,1,20,0
1022064,103,1,1910,1,female,1487,63,35,32,15,32,6,0,9
2010892,20,17,1993,10,female,5,62,41,32,22,32,7,0,15
2063897,23,28,1990,5,female,368,64,36,32,34,32,15,0,19
1408919,25,7,1988,11,female,233,63,33,32,50,32,40,0,10
1687012,58,19,1955,3,female,1489,63,12,33,10,1,4,32,6
1402450,63,3,1950,10,female,1488,62,19,33,6,0,3,33,3
1220490,25,26,1988,5,male,735,63,26,33,5,33,3,0,2
1010038,67,8,1946,12,female,1328,62,41,33,13,33,5,0,8
1091761,43,27,1970,10,male,80,64,53,33,81,33,57,0,24
1330841,55,19,1958,4,male,1031,63,17,33,60,33,55,0,5
1655733,75,10,1938,6,female,1308,64,41,34,13,0,9,34,4
1359970,27,3,1986,3,female,38,63,57,34,16,17,6,17,10
2000578,44,3,1969,9,female,308,64,28,34,53,8,22,26,31
1190428,27,6,1986,12,male,49,63,14,34,6,34,5,0,1
1644805,29,18,1984,5,male,559,64,26,34,17,34,17,0,0
1718942,39,25,1974,8,female,245,64,38,34,28,34,21,0,7
1971033,96,11,1917,5,male,1089,62,21,34,42,34,23,0,19
1913376,15,5,1998,10,male,59,62,29,35,5,0,1,35,4
1440879,21,4,1992,5,female,409,64,53,35,20,0,4,35,16
1435441,33,2,1980,10,male,414,64,34,35,39,0,10,35,29
1435598,51,18,1962,6,female,551,63,41,36,95,0,55,36,40
1580003,108,1,1905,1,male,1869,62,48,35,20,10,6,25,14
2112898,16,8,1997,11,female,537,62,48,35,40,26,15,9,25
1185293,20,21,1993,6,male,92,64,59,36,73,31,20,5,53
1631005,70,10,1943,4,female,1555,63,28,36,0,36,0,0,0
1823015,46,28,1967,5,male,627,64,21,36,15,36,13,0,2
1589690,52,25,1961,1,male,76,62,37,36,11,36,7,0,4
1805579,60,7,1953,3,female,404,62,41,35,21,35,13,0,8
1047903,108,14,1905,2,male,999,64,30,35,13,35,10,0,3
2115665,17,9,1996,4,male,212,64,44,35,26,35,11,0,15
1317445,35,10,1978,5,male,218,64,15,35,45,35,42,0,3
1427006,22,20,1991,9,male,22,64,48,36,57,36,27,0,30
1446095,57,16,1956,6,female,534,64,20,37,59,0,16,37,43
1608585,29,23,1984,7,male,487,63,13,37,0,37,0,0,0
1339244,27,4,1986,3,female,477,64,37,37,20,37,19,0,1
1213740,64,2,1949,1,male,618,62,31,38,14,8,7,30,7
2158414,27,30,1986,1,female,536,62,28,38,36,14,16,24,20
1823471,56,30,1957,8,female,1592,62,35,39,5,33,2,6,3
2120815,40,16,1973,9,male,317,63,32,38,17,35,8,3,9
1983408,54,21,1959,8,female,1418,63,38,39,17,36,13,3,4
1348137,30,23,1983,3,male,194,63,14,39,25,38,9,1,16
1144025,62,6,1951,5,male,649,62,21,39,53,38,41,1,12
1555244,29,3,1984,11,male,676,63,38,38,1,38,1,0,0
1360517,88,25,1925,9,female,300,63,22,39,6,39,4,0,2
1211973,37,7,1976,6,male,624,62,19,39,17,39,7,0,10
2141552,23,2,1990,12,male,1055,62,39,38,41,38,33,0,8
1250052,23,25,1990,9,male,26,63,50,38,31,38,22,0,9
1394327,25,15,1988,5,female,216,62,48,38,41,38,16,0,25
1764079,35,11,1978,1,female,589,64,49,39,41,39,38,0,3
1477138,54,23,1959,4,female,20,62,55,38,25,38,9,0,16
2168376,18,3,1995,11,male,693,62,37,40,10,6,2,34,8
2154752,62,30,1951,3,male,1081,64,19,40,30,1,16,39,14
1760137,72,29,1941,10,female,2222,62,41,40,19,19,3,21,16
1561977,27,10,1986,9,female,304,64,44,40,3,40,1,0,2
2053849,47,18,1966,5,male,1707,62,38,40,7,40,3,0,4
1159726,62,16,1951,10,female,440,62,25,40,15,40,10,0,5
1022437,35,9,1978,4,male,382,64,26,41,14,0,1,41,13
1865529,61,5,1952,8,female,904,64,27,41,8,0,0,41,8
2100164,24,30,1989,7,female,137,62,30,41,44,1,4,40,40
2127150,31,15,1982,10,female,312,64,43,42,100,0,67,42,33
1222820,56,3,1957,7,female,941,63,34,42,151,1,102,41,49
1811948,54,17,1959,6,female,706,64,42,41,14,16,7,25,7
1511627,51,15,1962,7,male,469,64,38,41,39,26,32,15,7
1763234,85,17,1928,9,female,1044,64,47,41,0,40,0,1,0
1275810,21,2,1992,9,female,368,63,48,41,24,40,3,1,21
1855332,26,15,1987,1,female,63,63,51,42,8,39,7,3,1
1496698,37,19,1976,1,male,388,63,30,42,11,41,7,1,4
1943757,78,7,1935,10,female,446,63,45,41,23,39,21,2,2
1857688,21,6,1992,6,female,441,62,40,42,32,41,23,1,9
1726419,33,1,1980,11,female,14,63,46,43,33,6,14,37,19
1447560,36,29,1977,5,male,242,63,31,44,1,23,0,21,1
1072030,52,4,1961,4,female,311,64,31,44,13,27,6,17,7
1479477,25,22,1988,11,male,530,63,53,43,6,43,5,0,1
1721049,21,4,1992,3,female,149,62,49,43,15,43,8,0,7
1920356,50,11,1963,9,male,916,64,14,43,30,43,21,0,9
1118242,23,3,1990,2,male,265,62,33,44,73,44,67,0,6
1872284,25,28,1988,9,female,467,64,32,43,74,43,44,0,30
1069435,113,1,1900,1,male,1512,64,56,45,2,0,1,45,1
1401475,48,17,1965,6,female,383,64,33,45,64,1,35,44,29
2146183,35,29,1978,10,female,127,62,51,45,33,29,21,16,12
1848453,33,10,1980,1,male,330,64,43,45,0,45,0,0,0
1274257,56,12,1957,2,female,290,63,8,45,2,45,1,0,1
2158092,22,15,1991,9,female,254,63,23,45,16,45,8,0,8
1036256,55,27,1958,5,female,1076,62,33,45,30,45,15,0,15
2179636,63,28,1950,10,male,451,64,55,47,1,0,0,47,1
1101342,91,30,1922,4,female,103,63,59,47,2,0,0,47,2
1035523,14,1,1999,2,male,145,63,49,47,16,0,1,47,15
1915344,26,12,1987,2,male,450,64,40,46,20,31,16,15,4
1932225,23,3,1990,3,female,355,63,44,46,56,29,21,17,35
1182585,28,24,1985,1,male,423,62,25,47,25,38,18,9,7
2075845,23,1,1990,8,male,375,64,48,47,4,47,4,0,0
1631321,28,27,1985,2,female,225,62,46,47,0,47,0,0,0
1292885,30,20,1983,11,female,503,62,43,46,0,46,0,0,0
1016787,29,6,1984,5,female,628,62,42,47,178,47,160,0,18
1804234,18,8,1995,8,male,209,63,29,49,6,2,1,47,5
1239340,75,2,1938,7,male,1022,62,33,49,23,0,3,49,20
2132962,68,5,1945,6,male,770,62,38,49,60,0,16,49,44
1910080,60,1,1953,10,female,284,62,27,48,94,0,32,48,62
1856481,32,31,1981,1,male,196,63,57,48,5,48,5,0,0
1841547,27,16,1986,11,male,202,63,55,48,20,48,13,0,7
1684524,29,11,1984,11,male,149,62,50,49,12,49,9,0,3
1596935,44,3,1969,7,male,369,64,39,49,10,49,8,0,2
1395930,56,21,1957,2,female,1228,63,16,48,24,48,5,0,19
1038027,41,5,1972,2,female,229,62,34,48,59,48,9,0,50
1418313,49,16,1964,7,female,235,63,42,48,56,48,49,0,7
1293951,51,15,1962,2,female,532,63,52,48,46,48,27,0,19
1901349,20,16,1993,1,male,257,62,50,51,7,8,0,43,7
1842351,64,2,1949,5,female,693,62,37,51,68,0,24,51,44
2009082,43,20,1970,2,male,436,64,37,51,11,33,9,18,2
1616834,63,7,1950,6,male,1770,63,28,51,4,42,2,9,2
1657823,21,2,1992,7,female,613,62,28,50,6,50,6,0,0
2068670,33,13,1980,12,female,491,64,42,50,5,50,4,0,1
1546525,37,28,1976,1,male,224,62,54,50,2,50,0,0,2
1370593,37,7,1976,1,male,117,64,62,50,0,50,0,0,0
2158233,26,20,1987,6,female,146,64,16,51,17,51,11,0,6
1864097,38,3,1975,10,male,575,62,48,50,17,50,10,0,7
1600472,24,19,1989,12,male,890,63,16,51,63,51,30,0,33
1816710,47,12,1966,5,female,400,64,47,50,35,50,29,0,6
2156776,55,12,1958,11,female,677,64,39,50,38,50,33,0,5
1511097,26,17,1987,11,female,676,64,12,51,153,51,147,0,6
1421653,59,2,1954,9,female,747,63,25,52,21,16,13,36,8
1683832,49,17,1964,6,male,327,62,21,53,47,38,35,15,12
2161374,15,14,1998,6,female,184,63,35,52,2,45,0,7,2
1720913,43,1,1970,4,female,787,62,37,52,49,39,36,13,13
1686737,59,20,1954,10,male,876,63,45,52,56,45,41,7,15
1503290,112,15,1901,1,male,1218,63,19,53,2,53,2,0,0
2031527,24,31,1989,7,female,346,64,41,53,72,53,68,0,4
2107559,67,27,1946,11,female,500,63,50,53,87,53,76,0,11
1725715,46,11,1967,6,male,1051,64,12,54,47,5,28,49,19
1011520,20,21,1993,1,female,304,63,16,54,2,49,1,5,1
1651008,37,9,1976,11,male,150,62,27,55,57,54,51,1,6
1968234,53,28,1960,1,male,462,64,48,55,5,55,5,0,0
1866753,66,24,1947,1,female,797,63,45,55,0,55,0,0,0
1038844,52,24,1961,6,male,851,62,23,55,67,55,40,0,27
2122075,17,12,1996,1,female,267,64,50,54,103,54,102,0,1
1285714,60,30,1953,9,male,186,63,20,56,65,0,24,56,41
2000675,44,18,1969,8,female,442,64,56,56,63,30,33,26,30
1182544,15,15,1998,3,male,496,62,39,56,1,46,1,10,0
2163716,29,28,1984,3,female,457,63,33,56,3,56,2,0,1
1927312,63,2,1950,11,male,795,62,58,58,7,58,6,0,1
1078047,27,1,1986,1,male,65,63,42,56,68,56,33,0,35
1353607,71,5,1942,11,female,1028,63,45,59,1,0,0,59,1
2117187,65,13,1948,9,male,332,64,51,60,17,0,9,60,8
1345967,25,11,1988,12,male,485,63,51,59,8,58,1,1,7
1389683,31,15,1982,2,female,1321,64,52,59,20,56,16,3,4
1117415,22,26,1991,3,male,497,64,48,59,8,59,2,0,6
1393716,18,12,1995,10,female,36,63,29,60,37,60,23,0,14
1603926,29,5,1984,10,female,133,62,24,59,81,59,50,0,31
1536345,66,22,1947,5,male,1748,62,21,63,6,6,0,57,6
1732188,49,25,1964,3,female,443,64,45,62,33,0,9,62,24
1583382,59,11,1954,11,female,619,64,32,62,7,37,7,25,0
2055088,19,21,1994,11,male,342,63,56,63,12,44,5,19,7
1891577,18,28,1995,1,female,160,62,14,63,45,37,39,26,6
2015819,20,31,1993,12,male,438,62,39,62,54,16,6,46,48
1368849,34,3,1979,1,female,387,62,26,61,32,61,25,0,7
1157337,37,20,1976,10,male,52,63,57,61,68,61,56,0,12
1889760,16,10,1997,9,male,482,63,51,65,3,0,0,65,3
1197123,55,6,1958,10,female,1437,62,28,65,114,0,18,65,96
1344002,77,19,1936,10,female,992,63,26,65,127,5,57,60,70
2084267,21,4,1992,3,female,220,64,51,65,5,17,0,48,5
1719619,36,18,1977,2,female,265,64,32,65,25,60,23,5,2
1034002,36,8,1977,5,female,432,62,43,65,36,56,21,9,15
1376491,24,4,1989,12,male,769,64,43,64,3,64,3,0,0
1873786,20,24,1993,12,male,272,64,51,65,12,65,11,0,1
1554076,15,21,1998,9,male,472,62,25,67,19,0,2,67,17
2158099,73,30,1940,8,male,789,62,46,66,21,0,13,66,8
1841605,42,17,1971,7,male,198,64,27,66,12,35,6,31,6
2074313,23,18,1990,11,male,368,63,33,66,61,29,38,37,23
1325534,54,4,1959,5,female,1356,62,29,66,73,31,62,35,11
2038149,25,1,1988,1,male,163,64,60,66,19,60,17,6,2
1341896,18,23,1995,7,male,131,64,49,66,10,66,6,0,4
1452977,23,1,1990,1,male,213,62,45,68,5,68,5,0,0
1909855,51,28,1962,3,female,419,64,33,67,1,67,1,0,0
2131799,31,3,1982,5,female,620,64,22,68,15,68,12,0,3
1998877,108,2,1905,12,male,26,63,40,66,26,66,25,0,1
2167336,28,10,1985,9,female,383,63,25,68,47,68,27,0,20
1846098,33,1,1980,5,female,424,63,33,67,44,67,37,0,7
1673404,53,18,1960,1,female,495,63,30,71,34,14,26,57,8
1567092,24,8,1989,12,female,210,63,6,69,16,35,4,34,12
2003334,19,19,1994,3,male,92,64,52,69,29,62,20,7,9
1623151,23,6,1990,4,male,150,64,26,70,9,70,7,0,2
1423845,34,21,1979,9,female,873,62,31,69,17,69,17,0,0
1348400,59,3,1954,6,female,654,62,34,71,20,71,19,0,1
1879912,38,24,1975,10,male,577,63,19,70,110,70,78,0,32
2178291,49,8,1964,7,female,1255,62,53,70,105,70,58,0,47
1879772,20,31,1993,5,female,81,62,50,74,44,65,28,9,16
1007796,31,16,1982,10,male,193,64,62,73,18,66,11,7,7
1001075,33,3,1980,9,female,110,62,33,72,30,65,19,7,11
1648718,22,20,1991,9,female,357,63,31,72,49,53,32,19,17
1582349,31,10,1982,9,female,1333,64,48,72,53,62,37,10,16
1706769,35,22,1978,11,male,344,63,28,74,8,74,6,0,2
1769360,63,15,1950,4,female,173,62,24,73,3,73,3,0,0
1309243,35,1,1978,2,female,1166,63,26,72,51,72,32,0,19
2173236,38,1,1975,2,female,229,63,47,73,58,73,32,0,26
2004446,25,1,1988,1,male,11,62,44,77,250,44,230,33,20
1305710,91,23,1922,4,NA,2039,63,18,76,42,74,17,2,25
1884205,33,10,1980,11,male,475,62,24,76,105,69,55,7,50
1273340,33,1,1980,4,male,362,62,32,75,49,74,26,1,23
2077800,42,17,1971,3,male,228,64,34,76,80,75,54,1,26
1387018,58,9,1955,6,female,1356,62,15,77,5,77,1,0,4
1131626,51,13,1962,10,female,95,63,34,76,30,76,26,0,4
1191725,34,1,1979,8,male,741,62,54,76,92,76,75,0,17
2041424,66,3,1947,3,female,897,63,42,80,22,0,15,80,7
1349879,86,29,1927,10,female,1202,63,33,80,23,0,0,80,23
1796267,31,15,1982,4,male,34,63,50,79,28,56,15,23,13
2148230,62,16,1951,10,female,418,63,49,79,44,77,38,2,6
1469767,21,16,1992,9,male,418,64,15,78,83,74,63,4,20
1280195,22,7,1991,2,male,726,63,57,79,0,79,0,0,0
2085798,19,24,1994,10,female,168,63,22,79,35,79,25,0,10
1747844,58,22,1955,6,male,1713,62,17,80,127,80,55,0,72
1923976,45,20,1968,6,male,365,62,30,81,17,0,3,81,14
1736499,54,2,1959,4,female,457,64,42,81,28,6,4,75,24
1301425,48,1,1965,1,male,1907,64,36,84,87,70,69,14,18
1117776,54,12,1959,6,female,568,64,38,83,18,83,12,0,6
1696531,67,5,1946,6,female,1152,62,21,81,15,81,10,0,5
1953641,67,9,1946,9,female,1667,64,27,84,47,84,27,0,20
1727090,42,1,1971,5,male,276,62,31,85,7,75,6,10,1
1165860,51,5,1962,7,female,894,62,33,85,91,84,64,1,27
1756986,64,24,1949,11,female,1517,63,23,87,9,87,5,0,4
2104484,33,17,1980,8,female,647,64,35,86,32,86,28,0,4
1893265,43,27,1970,10,female,212,63,41,87,52,87,28,0,24
1386436,50,9,1963,11,male,1348,62,45,86,30,86,12,0,18
1793868,93,25,1920,1,male,1277,64,32,87,22,87,14,0,8
1604894,69,28,1944,11,male,423,63,50,88,14,0,2,88,12
2079569,30,7,1983,11,female,711,62,44,91,49,61,32,30,17
2182601,37,9,1976,7,male,121,64,35,90,60,29,25,61,35
1460266,59,2,1954,9,female,1599,62,39,88,85,40,39,48,46
1278534,50,22,1963,8,female,483,64,41,90,155,38,50,52,105
2029771,64,15,1949,5,female,1203,62,15,88,13,88,4,0,9
1344804,17,10,1996,8,female,199,64,43,91,35,91,23,0,12
1949164,66,26,1947,4,female,636,64,33,91,24,91,18,0,6
1236089,24,7,1989,10,male,91,64,38,90,61,90,33,0,28
1091347,31,18,1982,11,male,327,64,47,91,61,91,54,0,7
1178308,57,15,1956,4,male,2295,64,31,89,67,89,49,0,18
1058152,59,18,1954,10,male,1003,63,34,95,6,16,0,79,6
1942137,33,6,1980,1,female,278,62,36,94,241,40,142,54,99
1914569,23,15,1990,7,female,143,62,40,92,6,89,5,3,1
1582246,43,9,1970,4,female,1713,62,21,93,5,93,5,0,0
1414650,21,23,1992,1,female,447,64,45,93,41,93,36,0,5
2119080,20,29,1993,1,male,147,64,20,93,124,93,54,0,70
1740834,22,6,1991,3,female,499,64,53,95,92,95,68,0,24
2032338,37,15,1976,4,male,127,63,55,93,153,93,73,0,80
1135682,57,17,1956,12,female,958,62,28,96,56,2,6,94,50
1402313,77,21,1936,12,female,827,62,21,98,21,2,1,96,20
2128759,70,25,1943,10,female,1913,64,23,96,15,63,10,33,5
1019552,20,16,1993,1,male,563,62,46,96,23,96,19,0,4
1928447,23,9,1990,9,male,360,63,29,97,133,97,132,0,1
1034728,51,5,1962,12,female,334,64,34,102,51,0,25,102,26
1837846,59,15,1954,3,female,1270,63,14,102,33,14,21,88,12
2130289,72,27,1941,4,female,1740,63,47,103,36,37,10,66,26
1960712,100,18,1913,11,female,1604,64,41,101,137,49,54,52,83
2082831,33,5,1980,1,male,563,64,58,100,4,87,3,13,1
1003514,25,24,1988,1,male,218,64,60,103,10,103,10,0,0
1860341,72,7,1941,6,female,71,62,49,100,16,100,9,0,7
2013950,28,25,1985,9,female,613,62,40,102,154,102,71,0,83
1353653,63,15,1950,2,female,154,62,30,102,159,102,158,0,1
1394973,35,20,1978,7,female,149,62,48,108,113,73,34,35,79
1335005,64,1,1949,4,female,1782,62,35,106,59,102,41,4,18
2137499,16,27,1997,10,male,463,62,41,107,12,107,11,0,1
1599904,39,28,1974,2,female,205,63,43,105,11,105,7,0,4
1260669,62,5,1951,7,female,288,63,38,107,35,107,22,0,13
1783248,29,7,1984,7,female,34,63,29,105,127,105,90,0,37
1030048,61,21,1952,3,male,1049,62,41,111,57,32,44,79,13
1488445,27,11,1986,7,male,574,63,52,111,87,59,60,52,27
1598259,32,16,1981,4,male,357,63,48,113,15,113,13,0,2
1903510,22,26,1991,6,female,57,62,61,111,27,111,14,0,13
1054829,48,3,1965,7,female,30,62,52,113,32,113,7,0,25
1762715,55,5,1958,11,female,525,64,42,111,37,111,33,0,4
2000279,20,1,1993,3,male,109,62,31,110,109,110,99,0,10
1124435,37,25,1976,3,female,992,62,38,110,346,110,256,0,90
1127797,66,28,1947,8,female,244,62,48,114,11,14,5,100,6
2133611,106,25,1907,5,female,1814,63,19,118,7,0,2,118,5
1193642,29,8,1984,6,female,325,62,34,119,70,109,33,10,37
2032088,30,16,1983,7,female,106,62,59,119,99,93,64,26,35
1420802,31,18,1982,5,male,294,63,46,117,14,117,11,0,3
1761134,40,15,1973,12,female,301,64,43,115,284,115,185,0,99
1550538,56,20,1957,3,female,1551,63,33,124,151,17,95,107,56
1532004,23,3,1990,8,female,202,63,16,122,266,83,190,39,76
2130584,33,28,1980,11,female,24,64,62,121,61,119,47,2,14
1358847,17,12,1996,4,male,47,63,45,124,68,124,26,0,42
1081287,30,4,1983,5,male,606,64,38,120,41,120,1,0,40
1680874,63,6,1950,12,female,1438,63,24,124,53,124,39,0,14
1087050,20,3,1993,12,female,624,62,31,120,149,120,138,0,11
1783551,108,8,1905,2,male,438,64,63,126,20,1,9,125,11
1518426,59,1,1954,10,female,894,63,34,127,56,0,16,127,40
2000874,39,13,1974,8,male,610,64,28,125,18,118,16,7,2
1621088,28,15,1985,3,male,726,62,42,129,7,129,5,0,2
1532250,57,24,1956,10,male,553,63,49,131,65,0,41,131,24
1151836,35,24,1978,1,female,21,62,57,136,49,127,29,9,20
1326890,52,26,1961,4,female,63,63,46,131,112,115,41,16,71
1467976,19,6,1994,8,female,435,62,43,131,5,131,4,0,1
2122671,30,30,1983,1,female,374,62,43,134,4,134,3,0,1
1309000,57,28,1956,3,female,323,62,35,134,30,134,15,0,15
2168399,69,3,1944,12,female,260,62,15,136,158,136,136,0,22
1296792,46,31,1967,5,male,217,62,54,140,12,0,9,140,3
1093196,58,20,1955,2,male,1775,62,25,143,9,0,1,143,8
1787197,65,5,1948,5,male,27,64,45,138,21,0,9,138,12
1581144,68,10,1945,12,male,1347,62,25,142,156,0,8,142,148
1506288,47,24,1966,10,male,580,62,18,141,105,140,86,1,19
1490682,64,22,1949,8,female,1372,64,28,149,36,0,0,149,36
1287027,58,27,1955,4,female,620,63,32,145,195,13,147,132,48
1748772,15,30,1998,7,female,32,63,63,145,38,55,12,90,26
1097607,25,26,1988,4,male,348,62,59,150,31,108,20,42,11
1294928,51,22,1962,11,female,723,64,30,150,25,80,19,70,6
1829665,69,5,1944,11,female,390,64,45,144,18,135,8,9,10
1190912,24,18,1989,6,male,98,63,24,150,47,150,45,0,2
1941204,17,22,1996,3,male,342,64,36,157,5,0,2,157,3
1139347,57,21,1956,11,male,813,64,25,156,244,0,213,156,31
1754531,22,17,1991,10,male,413,64,32,153,159,82,57,71,102
1985516,60,20,1953,9,male,1336,62,17,155,123,97,71,58,52
1157855,28,12,1985,3,male,82,62,58,153,8,153,6,0,2
1086000,45,19,1968,10,male,384,62,44,157,14,157,11,0,3
1114092,56,27,1957,7,female,1427,63,42,163,8,93,5,70,3
1023595,33,6,1980,7,male,545,63,38,160,7,160,7,0,0
2018216,14,22,1999,6,female,28,63,40,160,77,160,12,0,65
1432888,23,13,1990,11,female,619,64,27,160,56,160,16,0,40
1338274,58,17,1955,11,female,322,64,45,163,86,163,34,0,52
2021479,61,18,1952,4,female,369,63,46,162,29,162,19,0,10
1710046,32,29,1981,4,female,219,63,56,158,190,158,118,0,72
1237331,36,30,1977,10,male,514,64,38,159,116,159,85,0,31
1643036,80,18,1933,7,female,1678,64,5,172,23,0,18,172,5
2094275,28,24,1985,1,male,660,62,31,170,29,0,15,170,14
1807737,51,22,1962,5,female,285,62,31,171,77,31,29,140,48
2002763,18,17,1995,4,male,215,63,42,171,100,106,41,65,59
1617313,52,11,1961,5,female,457,62,37,169,7,169,3,0,4
2180374,58,5,1955,7,female,589,62,37,166,24,166,21,0,3
1997015,74,5,1939,10,female,169,63,46,165,103,165,85,0,18
1882697,51,19,1962,12,female,172,63,18,171,540,171,422,0,118
1524764,51,28,1962,2,female,1199,62,37,180,87,0,26,180,61
2033076,23,1,1990,1,male,79,63,40,176,7,176,6,0,1
1120412,29,5,1984,12,male,618,62,42,177,141,177,140,0,1
1829425,36,24,1977,2,female,734,64,55,176,181,176,170,0,11
1213493,39,1,1974,11,female,279,64,38,175,153,175,116,0,37
1248528,62,4,1951,12,male,646,63,28,190,22,0,5,190,17
1725827,58,25,1955,9,female,560,63,42,187,86,0,17,187,69
2155065,20,4,1993,4,male,370,64,30,188,95,170,56,18,39
1294825,25,17,1988,10,male,179,62,57,187,123,141,44,46,79
1297295,67,31,1946,7,male,142,64,47,184,3,184,0,0,3
1856363,36,1,1977,1,female,333,62,34,187,44,187,41,0,3
1132046,54,25,1959,7,female,580,64,14,193,4,0,3,193,1
1766512,37,9,1976,3,male,733,62,38,199,109,176,82,23,27
1912881,27,8,1986,3,male,235,63,32,191,23,191,22,0,1
1384993,47,8,1966,9,male,298,64,59,195,7,195,5,0,2
1615019,30,7,1983,12,female,424,64,31,193,77,193,48,0,29
1793655,45,30,1968,9,female,574,63,29,200,245,200,218,0,27
1920409,49,4,1964,8,female,1337,62,15,194,119,194,99,0,20
1015238,60,12,1953,9,female,1112,63,39,209,91,30,44,179,47
1302111,41,13,1972,7,female,91,63,11,201,75,104,66,97,9
1312170,76,5,1937,5,female,1350,64,17,205,18,201,13,4,5
1942115,19,30,1994,6,female,259,62,25,209,0,208,0,1,0
1259968,50,10,1963,6,female,231,63,29,203,114,203,101,0,13
1502759,51,5,1962,3,male,167,63,50,207,90,207,36,0,54
1329126,32,12,1981,3,female,177,64,51,203,173,203,134,0,39
1355056,61,26,1952,7,female,823,63,32,217,99,208,94,9,5
2055295,56,14,1957,11,female,1021,63,26,225,40,0,11,225,29
1141949,108,26,1905,11,female,170,62,29,222,58,11,24,211,34
1523205,18,17,1995,9,female,38,63,57,232,560,179,151,53,409
1620530,68,23,1945,8,female,1018,64,26,235,76,87,43,148,33
1910518,68,30,1945,1,male,1423,63,38,246,26,246,25,0,1
1072605,53,19,1960,5,female,1099,64,28,253,126,0,3,253,123
1560805,53,18,1960,7,female,931,64,34,247,85,0,27,247,58
2052642,35,20,1978,1,male,42,64,35,253,222,249,117,4,105
1679873,23,26,1990,7,male,482,64,27,259,14,259,12,0,2
1285084,54,3,1959,12,female,123,64,37,252,137,252,82,0,55
2000305,32,9,1981,6,male,471,64,22,263,68,0,22,263,46
1081765,63,25,1950,5,female,1569,64,33,275,64,0,19,275,45
1083355,31,8,1982,1,female,185,64,29,270,120,270,78,0,42
1349703,40,1,1973,3,female,280,64,51,273,87,273,34,0,53
1616943,28,27,1985,10,male,305,64,49,263,175,263,80,0,95
1582766,46,1,1967,1,female,297,64,46,269,306,269,186,0,120
1006878,28,24,1985,7,female,148,62,46,277,96,264,46,13,50
1239016,61,9,1952,7,female,430,62,27,284,28,284,22,0,6
2148369,53,17,1960,12,female,132,62,32,284,74,284,27,0,47
1391023,57,27,1956,4,female,388,63,58,285,130,285,80,0,50
1171500,53,1,1960,6,male,37,64,58,289,316,289,59,0,257
2146439,57,31,1956,5,female,820,64,37,298,38,2,16,296,22
1931825,50,29,1963,3,female,524,62,58,300,248,47,176,253,72
2151035,22,12,1991,1,male,155,64,40,301,44,283,15,18,29
1915042,16,1,1997,11,male,608,64,43,298,46,298,35,0,11
1144479,25,1,1988,1,male,32,62,50,296,42,296,33,0,9
1953793,24,2,1989,3,male,198,62,41,298,130,298,89,0,41
1686398,36,15,1977,8,female,376,63,54,304,83,304,69,0,14
1684687,19,26,1994,2,female,210,64,53,320,442,38,155,282,287
1880791,64,25,1949,5,female,1163,64,37,325,121,172,9,153,112
1803022,39,28,1974,5,male,597,63,48,317,16,302,10,15,6
1468352,54,16,1959,3,male,337,64,46,318,6,311,4,7,2
2045714,46,17,1967,7,male,605,63,36,312,11,312,11,0,0
1629212,48,31,1965,7,female,309,64,38,321,260,321,177,0,83
1918406,53,25,1960,6,female,731,64,34,332,76,0,10,332,66
1073855,66,10,1947,6,female,490,63,32,336,37,336,23,0,14
1493381,24,30,1989,4,female,397,63,27,333,121,333,104,0,17
1980849,22,1,1991,1,male,85,64,41,361,46,361,29,0,17
2172579,39,9,1974,11,female,382,62,44,362,20,362,17,0,3
1915679,31,7,1982,7,female,950,64,29,367,101,367,52,0,49
1841904,56,24,1957,7,female,232,62,43,364,291,364,198,0,93
1886041,41,3,1972,2,female,500,63,27,385,443,68,140,317,303
1227894,49,10,1964,1,female,621,62,42,385,775,32,571,353,204
2090626,41,17,1972,6,female,237,62,43,371,227,175,105,196,122
1457756,44,1,1969,5,female,1390,64,20,381,367,275,191,106,176
1357698,61,7,1952,5,female,1627,64,30,404,206,6,81,398,125
1302032,26,6,1987,9,female,102,64,46,419,115,419,82,0,33
1568843,28,11,1985,3,female,159,63,52,406,180,406,86,0,94
1767788,31,18,1982,11,male,144,64,49,419,180,419,149,0,31
1069730,42,23,1971,4,male,320,62,58,420,73,420,60,0,13
1355510,53,21,1960,5,female,447,64,36,400,87,400,53,0,34
2051534,44,22,1969,10,female,761,64,33,405,373,405,294,0,79
1141096,60,9,1953,4,female,896,64,37,450,52,87,35,363,17
2152919,22,2,1991,4,female,1473,62,41,436,478,5,181,431,297
1224428,63,12,1950,3,female,1751,63,29,429,170,128,48,301,122
2152750,14,5,1999,8,female,631,63,41,423,63,375,43,48,20
1952878,20,17,1993,1,female,204,62,28,426,281,408,71,18,210
1376868,26,12,1987,11,male,455,64,18,449,113,447,60,2,53
1708070,75,29,1938,1,NA,1297,62,26,442,68,442,35,0,33
1804585,108,29,1905,1,female,1172,64,50,481,94,0,35,481,59
1272472,23,10,1990,4,male,274,63,22,456,1243,9,564,447,679
1082133,18,11,1995,5,male,33,63,33,479,81,389,55,90,26
1201622,54,21,1959,9,female,1945,63,48,469,243,359,73,110,170
2069127,23,5,1990,5,female,588,62,43,465,520,423,436,42,84
1213732,36,6,1977,9,female,1457,64,44,468,328,416,284,52,44
1355137,59,14,1954,3,female,285,62,44,507,74,0,39,507,35
1331960,23,22,1990,11,female,221,63,25,509,111,163,74,346,37
1566222,21,26,1992,4,female,12,64,60,498,323,317,76,181,247
1904682,67,8,1946,5,male,772,64,39,486,274,486,175,0,99
1400702,50,22,1963,3,female,85,64,54,498,370,498,279,0,91
1872236,26,1,1987,8,female,318,63,23,539,157,62,53,477,104
2042491,29,8,1984,4,female,40,62,52,532,495,495,371,37,124
1056505,25,8,1988,2,female,250,63,50,534,314,531,125,3,189
1570289,37,27,1976,2,female,306,62,53,530,9,530,4,0,5
1121199,103,5,1910,6,male,666,63,21,531,99,531,86,0,13
1337927,60,17,1953,1,female,962,62,26,573,107,1,48,572,59
1057574,30,7,1983,5,male,320,62,44,583,31,582,24,1,7
1005046,48,30,1965,8,female,165,63,44,609,47,609,16,0,31
1588573,33,5,1980,12,female,160,62,46,662,199,27,114,635,85
2119021,41,24,1972,4,female,438,62,22,620,247,567,155,53,92
1776639,62,5,1951,2,female,517,62,35,616,558,532,481,84,77
1495786,19,26,1994,7,female,33,62,20,629,1077,555,338,74,739
1113344,23,22,1990,1,male,486,64,43,626,624,626,462,0,162
2142012,16,22,1997,5,female,255,64,53,664,188,549,85,115,103
1244356,17,18,1996,9,male,691,64,57,681,25,681,16,0,9
1506139,31,21,1982,5,male,653,64,47,670,24,670,20,0,4
1112751,46,14,1967,4,female,936,62,19,690,118,690,84,0,34
1226420,51,26,1962,9,female,132,64,47,717,300,717,176,0,124
2100993,69,26,1944,5,female,314,63,49,694,147,694,126,0,21
1127552,18,4,1995,1,female,350,63,48,751,75,264,46,487,29
1799457,34,22,1979,10,female,286,64,40,737,262,644,140,93,122
1066954,40,15,1973,9,female,482,64,27,739,686,739,596,0,90
1865949,52,22,1961,9,female,170,63,16,840,628,0,64,840,564
2115239,58,15,1955,10,female,378,63,45,818,703,807,371,11,332
1670640,58,2,1955,2,male,139,62,57,833,145,833,121,0,24
1091755,67,9,1946,1,female,261,63,41,953,5,0,0,953,5
1097247,21,11,1992,7,female,514,64,34,943,911,186,399,757,512
1624689,38,18,1975,6,female,577,63,47,978,144,923,40,55,104
1525570,21,12,1992,6,female,209,64,39,901,443,900,163,1,280
1626129,19,18,1994,9,female,421,62,35,953,1170,953,790,0,380
1828006,40,27,1973,3,female,39,63,46,961,1074,961,482,0,592
2053466,67,5,1946,5,female,658,63,59,1109,115,0,13,1109,102
1222696,16,16,1997,4,female,67,62,39,1062,450,1062,370,0,80
1462884,43,19,1970,6,male,389,63,33,990,396,990,299,0,97
2190694,35,29,1978,4,female,261,64,39,1145,37,1145,2,0,35
1131672,63,28,1950,7,female,283,62,49,1157,117,1157,53,0,64
1780480,58,3,1955,12,female,1276,63,20,1157,439,1157,319,0,120
1334719,71,7,1942,5,male,23,62,57,1507,18,0,4,1507,14
1400314,28,5,1985,2,female,230,63,37,1776,1033,0,393,1776,640
1841060,17,29,1996,7,female,611,63,16,1773,1286,1768,565,5,721
1347167,17,13,1996,3,female,297,62,33,1585,0,1585,0,0,0
1391428,14,24,1999,10,female,27,64,53,2131,326,1405,104,726,222
1723867,40,11,1973,10,female,525,62,29,3556,1234,489,146,3067,1088
1944893,19,3,1994,9,female,99,64,58,3002,466,2957,194,45,272
1571338,33,3,1980,7,female,194,63,36,2463,105,2463,60,0,45
1427614,25,12,1988,3,male,176,64,34,3761,135,3757,64,4,71
2059818,69,20,1944,6,female,305,64,54,5621,66,5621,43,0,23
2096014,28,11,1985,12,male,892,65,51,6,17,6,17,0,0
1368242,29,2,1984,11,female,436,65,34,6,24,6,15,0,9
1981171,29,10,1984,7,female,282,65,38,6,13,6,12,0,1
1836004,33,16,1980,8,male,330,65,35,6,28,6,14,0,14
1499681,36,10,1977,10,female,164,65,17,6,54,6,7,0,47
1258463,55,15,1958,11,male,992,66,15,6,27,6,12,0,15
1567294,18,5,1995,4,female,261,66,45,7,0,1,0,6,0
1208345,26,1,1987,1,female,485,65,47,7,15,0,7,7,8
1766997,27,12,1986,4,male,93,66,38,7,14,0,6,7,8
1501769,19,26,1994,3,male,575,66,36,7,0,2,0,5,0
1636094,46,27,1967,2,male,398,66,53,7,3,3,3,4,0
2017988,14,10,1999,11,male,163,66,39,7,19,3,5,4,14
1735941,57,8,1956,3,male,291,66,45,7,71,3,41,4,30
1686347,33,11,1980,1,female,173,66,51,7,83,6,25,1,58
1113499,67,1,1946,1,male,1843,65,28,7,1,7,0,0,1
1869528,25,11,1988,12,male,1265,66,35,7,8,7,6,0,2
2004846,33,27,1980,2,female,868,65,32,7,7,7,7,0,0
1703316,51,18,1962,12,male,223,66,33,7,7,7,4,0,3
1775965,13,10,2000,5,female,55,65,52,7,18,7,13,0,5
1540138,18,4,1995,10,male,267,66,48,7,12,7,12,0,0
1289042,19,3,1994,4,female,37,65,53,7,28,7,25,0,3
1056379,33,1,1980,1,female,523,66,47,7,11,7,11,0,0
1656008,39,6,1974,7,male,826,65,22,7,33,7,21,0,12
1172655,20,18,1993,8,male,168,65,41,8,1,0,0,8,1
1730325,62,1,1951,9,female,811,65,41,8,10,0,8,8,2
1246225,49,14,1964,7,male,181,65,49,8,20,4,11,4,9
1319125,25,16,1988,2,male,410,65,16,8,0,8,0,0,0
1167099,25,31,1988,7,male,468,66,29,8,1,8,1,0,0
2134767,39,22,1974,3,male,353,65,29,8,1,8,1,0,0
1181336,31,23,1982,3,male,438,66,45,8,4,8,4,0,0
1338907,39,12,1974,4,male,418,66,33,8,4,8,4,0,0
1036980,66,24,1947,5,male,2148,66,45,8,3,8,3,0,0
2049637,25,18,1988,4,female,65,66,51,8,5,8,2,0,3
1477172,23,15,1990,4,male,560,65,41,8,38,8,28,0,10
1068342,45,10,1968,10,male,1208,66,35,8,16,8,3,0,13
1991722,62,6,1951,10,female,302,65,55,8,51,8,17,0,34
2038885,103,7,1910,10,male,782,66,33,8,17,8,11,0,6
1141034,21,3,1992,7,male,383,66,17,9,2,0,2,9,0
1369180,19,18,1994,12,male,422,66,59,9,32,0,11,9,21
1804540,47,16,1966,3,female,370,66,29,9,18,0,7,9,11
1402000,49,27,1964,11,female,325,65,29,9,15,1,4,8,11
1999377,22,4,1991,9,female,200,66,54,9,20,2,1,7,19
1414254,47,5,1966,9,male,209,66,35,9,21,4,18,5,3
1274454,22,28,1991,2,male,888,66,47,9,5,8,3,1,2
1434726,16,16,1997,5,male,470,66,49,9,0,9,0,0,0
2122136,18,22,1995,6,male,106,65,59,9,0,9,0,0,0
1941884,23,1,1990,8,male,412,65,55,9,0,9,0,0,0
1486240,29,21,1984,4,male,271,66,48,9,0,9,0,0,0
1878576,23,6,1990,12,male,554,65,48,9,10,9,10,0,0
1819352,24,21,1989,4,male,601,65,15,9,17,9,17,0,0
2033033,33,4,1980,9,female,504,65,26,9,40,9,40,0,0
1079417,56,2,1957,4,male,467,65,46,10,2,0,0,10,2
1322047,56,6,1957,8,male,64,65,44,10,4,0,0,10,4
2054846,32,21,1981,2,female,352,66,32,10,39,5,28,5,11
1542581,20,5,1993,1,female,57,65,53,10,4,9,2,1,2
1389977,21,3,1992,12,male,1036,65,29,10,11,8,5,2,6
1810371,29,1,1984,2,female,318,65,41,10,10,8,5,2,5
1658361,33,25,1980,5,female,178,66,47,10,0,10,0,0,0
1143515,17,2,1996,3,male,243,65,44,10,2,10,2,0,0
1118522,26,7,1987,8,female,210,65,35,10,5,10,2,0,3
1107802,46,21,1967,7,female,231,66,34,10,10,10,3,0,7
1999630,17,13,1996,12,female,720,66,39,10,32,10,20,0,12
1170025,31,16,1982,8,female,862,66,27,10,25,10,6,0,19
1079655,43,24,1970,8,male,555,66,48,10,25,10,11,0,14
1949108,66,26,1947,8,male,1638,66,51,11,4,0,2,11,2
2045896,59,23,1954,6,male,1150,65,20,11,11,5,6,6,5
1403052,15,21,1998,3,male,417,65,39,11,0,8,0,3,0
1783013,52,8,1961,5,male,17,66,35,11,3,8,1,3,2
1723351,15,29,1998,10,male,208,65,16,11,12,9,9,2,3
1400320,54,18,1959,3,male,1130,66,25,11,34,9,16,2,18
1305244,29,22,1984,1,female,228,66,44,11,9,11,6,0,3
1766935,35,12,1978,8,female,599,66,29,11,7,11,7,0,0
1228164,68,17,1945,6,male,1331,65,34,11,9,11,9,0,0
1162560,20,8,1993,1,male,500,66,10,11,25,11,15,0,10
2014403,113,16,1900,2,female,1624,65,39,12,16,2,9,10,7
1483192,58,1,1955,2,female,215,65,33,12,45,0,8,12,37
1294784,28,16,1985,11,male,360,65,33,12,1,4,0,8,1
1919204,27,20,1986,4,male,516,66,33,12,44,11,27,1,17
2153995,19,15,1994,6,male,438,65,49,12,2,12,0,0,2
1512704,103,6,1910,5,male,691,66,24,12,7,12,2,0,5
1457640,27,15,1986,7,male,296,66,42,12,10,12,8,0,2
2169922,29,24,1984,3,female,380,66,53,12,14,12,9,0,5
1826690,31,4,1982,3,male,653,65,38,12,13,12,13,0,0
1927838,21,8,1992,1,female,536,65,25,12,22,12,19,0,3
1848058,24,3,1989,10,female,10,66,17,12,235,12,234,0,1
1568080,26,3,1987,11,female,415,66,21,12,45,12,41,0,4
2128758,18,16,1995,7,male,493,65,40,13,1,0,1,13,0
1643998,43,28,1970,10,female,196,66,48,13,1,0,1,13,0
1334267,62,17,1951,1,male,531,66,35,13,14,0,9,13,5
1735721,108,1,1905,3,male,1582,65,6,13,54,2,18,11,36
1244756,39,23,1974,11,male,121,66,66,13,2,5,2,8,0
1474553,26,17,1987,9,male,663,65,46,13,29,3,18,10,11
2055993,16,29,1997,7,male,141,65,39,13,0,13,0,0,0
1249981,55,11,1958,10,male,472,66,19,13,11,13,10,0,1
1957512,17,16,1996,3,male,390,65,33,13,47,13,21,0,26
1517872,20,16,1993,1,female,1092,65,27,13,106,13,63,0,43
1852147,44,16,1969,9,female,278,66,32,13,30,13,30,0,0
1913067,33,5,1980,7,female,508,66,42,14,0,0,0,14,0
2179323,50,25,1963,12,male,321,65,53,14,4,4,3,10,1
1063041,23,3,1990,1,female,286,66,44,14,9,6,2,8,7
1114089,13,2,2000,1,female,117,65,45,14,7,14,7,0,0
2141340,28,24,1985,4,male,866,65,54,14,4,14,4,0,0
1443410,29,19,1984,10,female,618,66,44,14,12,14,8,0,4
1096468,60,26,1953,1,male,740,65,16,14,15,14,14,0,1
2103471,16,3,1997,4,female,220,66,61,14,25,14,20,0,5
1249341,21,7,1992,7,male,270,66,48,15,0,0,0,15,0
1024291,35,18,1978,9,male,929,66,34,15,29,14,15,1,14
2122151,17,26,1996,2,male,287,65,52,15,1,15,1,0,0
1885285,45,15,1968,2,male,440,65,13,15,3,15,2,0,1
2073206,52,24,1961,2,female,1758,65,31,15,17,15,13,0,4
1715033,28,26,1985,7,male,103,66,56,15,27,15,22,0,5
1450407,40,26,1973,7,male,469,66,42,15,59,15,53,0,6
1021982,18,18,1995,8,male,226,65,20,16,3,0,2,16,1
1936791,40,18,1973,4,female,205,65,31,16,16,15,9,1,7
1176670,16,14,1997,4,male,401,66,27,16,1,16,0,0,1
1844762,28,4,1985,2,male,640,65,47,16,2,16,2,0,0
1220134,25,12,1988,1,male,387,65,54,16,6,16,3,0,3
1098793,57,24,1956,7,female,1589,66,38,16,3,16,3,0,0
1962845,49,22,1964,5,female,230,65,26,16,16,16,4,0,12
1858060,36,22,1977,1,male,146,66,56,16,35,16,33,0,2
1375243,23,7,1990,10,male,122,66,44,17,5,4,3,13,2
1910078,22,10,1991,4,male,265,66,32,17,14,11,12,6,2
1600946,49,5,1964,5,female,106,66,53,17,79,12,39,5,40
2045631,16,17,1997,7,female,176,66,39,17,0,17,0,0,0
1888539,18,3,1995,6,male,41,65,52,17,9,17,8,0,1
1351171,42,19,1971,1,male,830,65,40,17,7,17,2,0,5
1911519,64,5,1949,1,male,239,65,57,17,4,17,4,0,0
2025542,39,3,1974,1,male,412,66,39,18,1,0,0,18,1
1878196,52,18,1961,4,male,1338,65,44,18,8,0,0,18,8
1838209,15,18,1998,1,male,392,65,27,18,14,0,7,18,7
1508205,43,28,1970,11,male,325,65,52,18,26,1,10,17,16
1811850,101,9,1912,9,male,773,66,18,18,22,0,7,18,15
1854605,51,17,1962,2,female,522,66,45,18,41,5,25,13,16
1755611,108,1,1905,1,male,959,66,41,18,1,14,1,4,0
1210864,22,25,1991,1,male,263,66,44,18,8,14,4,4,4
2084334,62,13,1951,1,female,407,66,38,18,0,18,0,0,0
1391070,14,1,1999,6,male,237,66,27,18,4,18,4,0,0
1799750,25,1,1988,1,male,299,66,31,18,34,18,34,0,0
2042440,57,31,1956,12,female,926,65,26,19,13,3,5,16,8
1590028,36,12,1977,5,female,1347,66,29,19,25,7,12,12,13
2123435,14,21,1999,3,male,3,66,61,19,31,17,13,2,18
1399818,13,11,2000,6,male,140,66,43,19,2,19,1,0,1
1327924,19,17,1994,1,male,327,66,56,19,8,19,7,0,1
1648183,30,20,1983,3,male,142,66,45,19,8,19,3,0,5
1557840,31,10,1982,12,female,464,65,54,19,15,19,14,0,1
2186645,48,4,1965,11,female,378,65,45,19,28,19,22,0,6
1141545,50,4,1963,12,female,1389,65,17,19,18,19,16,0,2
1335706,32,5,1981,5,female,582,66,53,20,11,14,9,6,2
1064522,30,14,1983,12,male,370,65,38,20,46,14,18,6,28
1576461,34,3,1979,6,male,891,66,18,20,39,18,35,2,4
1457948,61,20,1952,3,female,2271,65,33,20,38,18,21,2,17
1528247,15,11,1998,3,male,430,65,27,20,3,20,3,0,0
1574547,46,8,1967,3,male,88,66,62,20,1,20,1,0,0
2188714,41,16,1972,10,female,343,66,49,20,11,20,1,0,10
1320357,28,4,1985,5,male,334,65,36,20,19,20,11,0,8
1048122,67,5,1946,5,female,1600,66,21,20,39,20,27,0,12
1166326,72,17,1941,5,male,1089,65,36,21,15,0,2,21,13
1339171,76,1,1937,5,male,2276,65,6,21,37,0,18,21,19
1683865,28,26,1985,9,female,564,66,49,21,101,20,60,1,41
1560319,19,1,1994,1,male,31,66,56,21,6,21,5,0,1
1803823,23,27,1990,1,male,220,65,45,21,4,21,4,0,0
1753115,25,22,1988,8,male,322,65,46,21,18,21,16,0,2
1623128,32,21,1981,6,female,536,65,34,21,141,21,138,0,3
2030504,23,1,1990,1,male,1512,66,44,22,0,0,0,22,0
1550072,70,14,1943,4,female,1014,65,21,22,1,0,1,22,0
1697130,108,1,1905,1,male,1098,65,38,22,13,0,5,22,8
2148714,48,19,1965,3,male,1003,65,20,22,59,20,25,2,34
1930004,23,24,1990,12,male,359,65,61,22,12,22,8,0,4
1181996,69,28,1944,3,female,1565,65,34,22,5,22,3,0,2
1874452,19,11,1994,7,male,167,66,58,22,27,22,17,0,10
2044721,38,4,1975,1,male,558,65,40,23,12,1,8,22,4
1043259,33,30,1980,7,male,890,66,50,23,2,23,1,0,1
1323689,24,8,1989,8,male,421,66,43,23,8,23,7,0,1
1756174,28,15,1985,4,male,296,65,55,23,9,23,7,0,2
1613264,60,13,1953,3,female,128,66,36,24,478,0,84,24,394
2088268,18,18,1995,10,male,23,65,39,24,2,24,2,0,0
1799856,14,4,1999,5,male,81,66,40,24,13,24,10,0,3
1089273,29,30,1984,4,male,596,65,48,24,13,24,4,0,9
1865803,38,6,1975,6,female,421,65,51,24,10,24,7,0,3
1112694,106,5,1907,3,female,32,65,59,24,21,24,15,0,6
1042165,26,22,1987,4,NA,240,65,33,24,62,24,57,0,5
1367051,58,2,1955,10,female,1122,65,21,25,122,5,92,20,30
1232888,29,4,1984,1,male,215,66,57,25,14,25,5,0,9
2103136,50,15,1963,10,male,1348,65,32,25,51,25,45,0,6
1921147,54,22,1959,6,male,128,65,65,26,3,0,0,26,3
1650102,64,20,1949,1,female,578,65,51,26,10,0,8,26,2
1182377,68,1,1945,8,male,1729,66,32,26,19,0,0,26,19
1883246,103,1,1910,1,male,1486,66,24,26,32,0,13,26,19
1345384,36,29,1977,6,female,830,65,24,26,9,26,9,0,0
1946862,58,25,1955,3,female,838,65,40,26,17,26,12,0,5
1659001,60,16,1953,7,female,237,66,57,26,19,26,4,0,15
1267789,13,2,2000,4,male,149,65,42,27,4,0,2,27,2
1225545,69,11,1944,5,male,866,65,19,27,122,0,62,27,60
2011511,52,4,1961,10,female,82,66,49,27,101,8,14,19,87
1822247,25,8,1988,6,male,128,65,43,27,8,27,6,0,2
1764783,34,9,1979,9,male,388,66,48,27,31,27,29,0,2
1640464,47,19,1966,3,female,1271,65,17,28,26,0,11,28,15
1729184,20,18,1993,6,female,386,65,50,28,50,20,20,8,30
1039320,15,9,1998,11,male,334,66,38,28,2,25,0,3,2
1844488,18,8,1995,9,male,567,66,51,28,40,23,35,5,5
1057408,55,22,1958,12,male,1091,65,56,28,38,24,14,4,24
1584882,61,24,1952,1,female,1637,66,14,28,10,28,6,0,4
1475647,20,2,1993,11,female,463,66,20,28,39,28,37,0,2
1745334,33,8,1980,4,female,626,65,38,29,4,2,1,27,3
1862965,61,24,1952,1,male,610,65,32,29,21,1,9,28,12
1623872,62,23,1951,10,female,2244,66,32,29,37,0,14,29,23
2083244,65,27,1948,5,female,1601,66,12,29,75,0,33,29,42
1537739,27,15,1986,7,male,132,65,57,29,8,8,5,21,3
1452801,17,18,1996,7,male,282,65,21,29,5,29,5,0,0
1291663,19,20,1994,11,female,93,66,19,29,198,29,158,0,40
1915880,97,10,1916,2,male,759,66,40,30,1,0,0,30,1
1615561,42,21,1971,8,male,790,65,8,30,13,0,6,30,7
1209463,26,28,1987,9,male,196,65,45,30,66,16,16,14,50
2147252,42,11,1971,1,male,766,66,45,30,60,15,27,15,33
1400089,20,24,1993,3,male,332,66,54,31,11,25,3,6,8
1502159,27,5,1986,4,male,426,66,45,30,11,26,2,4,9
1976687,42,10,1971,11,male,412,66,43,30,2,30,2,0,0
1270493,24,7,1989,3,male,496,66,13,31,11,31,10,0,1
1749146,36,8,1977,2,female,481,65,52,32,0,2,0,30,0
2135171,17,19,1996,6,female,510,65,49,32,24,12,0,20,24
2014674,26,7,1987,12,male,784,66,43,32,2,32,2,0,0
1690794,29,29,1984,2,male,551,65,51,32,17,32,6,0,11
1198792,45,10,1968,6,male,1344,66,32,32,17,32,13,0,4
1903875,33,25,1980,6,female,231,65,61,32,40,32,36,0,4
2091029,58,19,1955,7,male,111,65,48,32,59,32,30,0,29
1117587,79,18,1934,9,female,1491,65,30,33,25,0,8,33,17
1072806,14,18,1999,3,female,196,65,30,33,31,10,12,23,19
1288024,19,7,1994,3,female,360,66,48,33,40,32,29,1,11
1648791,18,20,1995,2,male,323,65,29,33,1,33,1,0,0
1547661,20,10,1993,4,female,102,66,46,33,18,33,15,0,3
1313718,32,6,1981,4,male,542,66,31,33,16,33,15,0,1
1738634,29,26,1984,6,male,633,65,21,33,122,33,92,0,30
1668881,52,20,1961,7,male,301,66,19,33,67,33,43,0,24
1684833,62,10,1951,4,female,1136,65,32,34,121,4,10,30,111
1212157,58,14,1955,7,female,167,66,53,35,37,5,22,30,15
1998015,51,17,1962,6,female,994,66,56,36,138,20,103,16,35
1423098,51,26,1962,1,female,492,65,35,36,11,36,6,0,5
1663766,18,9,1995,5,male,162,66,58,36,36,36,23,0,13
1285367,51,8,1962,11,female,498,65,22,37,39,37,16,0,23
1332976,32,24,1981,10,female,453,65,34,37,109,37,98,0,11
1872252,52,10,1961,3,female,44,65,60,37,89,37,41,0,48
1595620,15,27,1998,3,female,39,65,30,38,78,19,42,19,36
1292555,27,19,1986,12,male,305,66,56,38,0,33,0,5,0
2133772,47,31,1966,5,male,299,66,51,38,31,35,6,3,25
1883122,42,22,1971,2,female,540,65,38,38,17,38,13,0,4
1387421,87,9,1926,4,female,1795,66,27,39,19,39,8,0,11
2086213,45,30,1968,11,male,234,66,35,39,24,39,18,0,6
2042245,23,12,1990,6,male,178,65,48,39,73,39,47,0,26
1197423,56,17,1957,10,female,702,66,53,39,69,39,62,0,7
1883544,29,4,1984,12,female,244,66,8,40,38,2,11,38,27
1495854,23,20,1990,5,male,315,65,34,40,23,30,10,10,13
1996376,44,14,1969,1,male,896,65,24,40,6,40,3,0,3
2093492,39,15,1974,4,female,525,65,25,40,33,40,13,0,20
1122834,47,11,1966,4,female,621,66,32,40,49,40,41,0,8
2053701,51,4,1962,2,male,522,66,55,42,7,0,0,42,7
1218441,39,24,1974,5,female,526,65,29,41,21,12,16,29,5
1451342,45,1,1968,8,male,220,66,53,41,0,38,0,3,0
1705922,53,6,1960,6,male,526,65,53,42,19,42,4,0,15
1476513,107,5,1906,2,male,1451,65,10,43,1,2,1,41,0
1609803,48,30,1965,12,female,462,65,44,43,60,0,23,43,37
1781050,21,19,1992,8,male,73,65,60,44,30,20,17,24,13
1144183,33,20,1980,5,male,754,65,34,44,89,27,39,17,50
1640461,23,8,1990,10,male,213,65,38,44,8,44,7,0,1
1033002,27,12,1986,1,male,484,65,17,44,11,44,7,0,4
2035450,24,7,1989,5,female,433,65,44,44,61,44,42,0,19
1787861,54,1,1959,9,male,113,65,62,43,78,43,22,0,56
1735371,72,4,1941,11,female,1750,66,26,45,30,45,5,0,25
1551763,28,18,1985,3,male,576,66,48,46,2,4,0,42,2
1536960,62,30,1951,7,female,416,66,33,47,18,5,5,42,13
1138743,44,18,1969,8,male,734,66,19,46,28,11,23,35,5
1075660,45,25,1968,6,male,537,66,49,46,47,29,22,17,25
1537284,55,3,1958,3,female,108,66,33,47,40,38,11,9,29
1546208,52,15,1961,2,male,586,66,29,48,2,0,1,48,1
1700385,20,22,1993,1,NA,242,65,35,49,14,2,11,47,3
1380762,17,11,1996,2,male,167,65,59,48,1,48,1,0,0
1377126,18,5,1995,3,female,161,65,40,49,29,49,10,0,19
1274302,24,16,1989,10,female,209,66,40,49,24,49,22,0,2
1789703,28,19,1985,12,male,54,66,52,49,15,49,13,0,2
1133183,35,22,1978,6,female,370,65,25,48,55,48,50,0,5
1367535,58,1,1955,5,male,21,66,14,49,35,49,28,0,7
2012176,25,10,1988,9,male,330,65,60,48,84,48,79,0,5
1628981,51,5,1962,7,male,1114,65,24,48,99,48,84,0,15
1548831,105,28,1908,1,male,227,66,35,50,65,0,12,50,53
1044604,20,29,1993,1,female,263,66,53,50,75,41,28,9,47
1034229,47,8,1966,7,female,289,65,23,50,77,50,26,0,51
2018391,53,14,1960,8,female,114,66,44,53,46,0,9,53,37
1958967,32,19,1981,2,female,411,66,46,53,3,53,2,0,1
1777047,33,16,1980,10,female,557,65,60,53,3,53,3,0,0
1656682,64,18,1949,1,male,554,66,49,52,7,52,5,0,2
1555333,19,6,1994,4,female,192,66,12,53,28,53,24,0,4
2027474,15,20,1998,6,male,271,66,40,55,20,0,4,55,16
1969900,59,10,1954,6,female,1385,65,25,55,16,13,11,42,5
1251057,60,10,1953,3,female,1864,65,35,54,91,52,55,2,36
1075815,29,26,1984,9,female,68,66,63,55,33,55,15,0,18
1510135,108,24,1905,9,male,122,66,42,55,18,55,12,0,6
1614716,20,16,1993,2,male,569,66,61,57,2,0,2,57,0
1371731,25,25,1988,3,male,780,65,44,56,6,0,1,56,5
2088855,43,1,1970,11,female,974,66,30,58,64,4,22,54,42
1919902,65,15,1948,3,male,216,65,46,57,5,57,4,0,1
1390716,25,4,1988,10,male,365,65,40,57,34,57,15,0,19
1741972,29,13,1984,2,female,502,65,29,58,95,58,42,0,53
1357203,55,14,1958,5,female,194,65,37,58,91,58,90,0,1
1893656,62,24,1951,10,female,310,65,40,60,40,3,24,57,16
2032238,21,24,1992,5,female,462,65,48,59,3,28,0,31,3
1465948,35,19,1978,3,male,103,65,62,59,37,37,27,22,10
1446626,32,21,1981,11,female,744,66,50,59,5,58,4,1,1
1159461,18,30,1995,3,female,242,65,35,60,30,60,17,0,13
1422700,48,25,1965,7,female,2146,65,31,59,65,59,46,0,19
1928139,37,25,1976,7,female,506,65,28,60,298,60,147,0,151
1131999,19,8,1994,5,male,401,65,40,63,70,20,43,43,27
1505866,22,16,1991,8,female,284,66,32,63,105,40,46,23,59
1323044,70,12,1943,7,female,919,66,22,63,16,52,7,11,9
2152717,26,13,1987,3,male,423,65,45,62,63,53,37,9,26
1257311,34,14,1979,5,male,402,66,48,62,2,62,2,0,0
1270515,22,6,1991,2,male,103,66,61,62,11,62,10,0,1
1906501,28,1,1985,10,male,351,65,31,62,25,62,8,0,17
2184106,66,14,1947,4,male,60,66,42,63,16,63,13,0,3
1951804,22,17,1991,3,male,696,65,56,63,43,63,35,0,8
1293511,63,1,1950,1,male,1747,66,41,64,95,41,73,23,22
1195923,23,17,1990,10,male,1185,66,32,65,5,65,2,0,3
1957252,36,6,1977,6,female,281,65,57,65,10,65,10,0,0
1193057,23,14,1990,8,male,183,66,31,65,33,65,15,0,18
1121415,26,8,1987,9,female,131,66,30,65,52,65,33,0,19
1711623,29,22,1984,6,male,550,65,55,66,4,66,4,0,0
1312814,53,3,1960,9,female,1606,65,26,68,22,68,20,0,2
2170532,23,21,1990,8,female,351,66,29,66,72,66,71,0,1
1543112,40,12,1973,7,female,622,66,38,67,87,67,40,0,47
1734890,32,30,1981,11,male,89,65,52,66,609,66,608,0,1
1664524,62,24,1951,1,female,513,66,56,71,32,0,19,71,13
1803132,60,11,1953,6,female,283,65,55,69,172,0,35,69,137
1223196,41,18,1972,11,female,522,66,24,71,57,66,33,5,24
2070266,56,21,1957,10,female,280,66,42,71,124,62,58,9,66
2113499,23,19,1990,2,male,235,65,41,71,2,71,2,0,0
1179379,19,24,1994,8,male,136,65,56,69,14,69,13,0,1
1484498,43,3,1970,6,male,859,66,31,70,46,70,45,0,1
1831674,47,5,1966,6,male,374,66,57,73,97,0,5,73,92
1933106,53,26,1960,10,female,522,65,48,72,48,11,19,61,29
2083457,36,28,1977,6,female,2157,65,50,73,91,40,70,33,21
1539243,38,13,1975,3,female,230,66,39,73,3,59,0,14,3
1896455,44,21,1969,6,male,318,65,51,74,43,64,20,10,23
1517885,66,1,1947,9,male,66,66,27,73,5,73,5,0,0
2097116,108,9,1905,6,female,235,66,15,72,12,72,8,0,4
1021939,53,11,1960,4,female,530,66,50,75,12,7,1,68,11
1888269,63,17,1950,7,female,550,66,43,77,15,41,7,36,8
2065354,108,9,1905,11,male,986,65,37,76,9,76,7,0,2
1309734,29,25,1984,12,male,56,66,49,76,29,76,26,0,3
1459692,57,14,1956,1,female,535,66,29,80,28,1,7,79,21
1010087,38,5,1975,7,female,461,65,30,80,102,80,37,0,65
1699890,50,8,1963,4,female,137,65,33,78,88,78,28,0,60
1761592,62,22,1951,11,female,1833,66,20,84,27,63,13,21,14
1814371,18,16,1995,9,male,170,65,57,82,35,82,32,0,3
2149711,25,7,1988,8,female,132,65,50,81,31,81,14,0,17
2030040,57,13,1956,6,female,1651,65,30,84,31,84,24,0,7
1392432,33,1,1980,3,male,164,65,32,84,90,84,79,0,11
1979281,35,8,1978,12,female,191,65,44,82,69,82,64,0,5
1831509,34,15,1979,6,male,201,66,54,83,57,83,3,0,54
1827077,51,27,1962,4,female,371,66,26,83,125,83,28,0,97
1442813,54,5,1959,7,female,413,66,24,85,64,13,23,72,41
1618503,35,19,1978,9,male,28,66,64,85,9,85,4,0,5
1174507,24,6,1989,9,female,503,66,31,86,129,86,126,0,3
1076636,55,16,1958,9,male,496,66,22,89,23,0,3,89,20
1905757,20,2,1993,7,male,1200,65,55,91,76,65,58,26,18
1451648,19,3,1994,3,male,242,66,37,91,26,91,13,0,13
1286783,26,1,1987,1,female,135,66,59,89,15,89,11,0,4
1825192,33,31,1980,5,male,190,65,60,89,47,89,27,0,20
2091614,22,12,1991,5,female,590,65,19,90,84,90,69,0,15
1857966,55,5,1958,3,female,1171,65,43,92,7,0,2,92,5
1302984,35,27,1978,2,female,308,65,54,94,35,0,1,94,34
1411014,43,29,1970,3,female,755,66,52,95,89,94,85,1,4
1687017,42,5,1971,5,male,1357,66,34,93,4,93,3,0,1
1986913,23,8,1990,7,female,207,65,40,95,31,95,26,0,5
1959494,99,12,1914,2,female,422,65,34,95,34,95,32,0,2
1712700,28,1,1985,1,male,106,65,8,95,104,95,66,0,38
2096490,43,20,1970,8,male,300,66,36,93,89,93,64,0,25
1179861,45,24,1968,3,female,1493,65,15,93,97,93,47,0,50
1451227,25,19,1988,3,male,148,66,51,99,33,99,30,0,3
2160732,38,23,1975,6,male,513,66,49,98,31,98,17,0,14
1069259,54,4,1959,7,male,679,66,38,100,14,0,5,100,9
2163564,30,11,1983,11,male,300,66,13,104,3,103,2,1,1
1380080,108,11,1905,8,male,284,65,30,100,48,99,33,1,15
1330925,33,19,1980,6,male,270,66,40,102,8,102,5,0,3
1290377,50,26,1963,6,male,809,66,32,109,144,0,69,109,75
2049043,62,20,1951,11,female,997,65,43,105,73,6,56,99,17
1648638,24,5,1989,2,male,278,66,56,106,0,106,0,0,0
1396978,43,5,1970,7,female,422,65,38,109,63,109,38,0,25
1361499,71,27,1942,1,male,1327,65,25,108,49,108,31,0,18
1182766,25,12,1988,8,female,174,65,56,113,77,112,57,1,20
1219202,36,4,1977,8,male,704,66,45,115,129,0,15,115,114
2175341,108,16,1905,12,female,924,66,32,117,85,1,49,116,36
1207152,23,13,1990,5,male,211,65,55,116,4,43,0,73,4
2117040,63,11,1950,10,female,1623,66,28,118,22,116,17,2,5
1431786,17,1,1996,3,male,236,65,57,115,22,114,15,1,7
1705060,57,28,1956,2,female,1087,65,21,114,19,114,13,0,6
1922664,48,19,1965,3,female,712,66,25,123,23,23,9,100,14
1070044,24,22,1989,3,female,844,65,35,124,154,11,25,113,129
1912690,46,23,1967,6,female,68,65,52,121,73,83,53,38,20
1728151,20,20,1993,7,female,125,65,49,120,177,83,39,37,138
1337795,22,13,1991,1,female,536,66,42,127,0,120,0,7,0
1287953,23,4,1990,4,male,131,66,36,126,72,126,14,0,58
1855825,29,9,1984,11,female,227,66,44,129,33,129,9,0,24
1582557,45,18,1968,5,female,248,66,53,127,41,127,26,0,15
1106679,34,29,1979,11,male,321,65,61,126,148,126,137,0,11
1514033,59,21,1954,7,male,41,66,64,132,9,1,0,131,9
1813144,43,19,1970,3,female,361,66,45,134,74,0,20,134,54
1460175,64,25,1949,10,female,918,66,34,135,35,0,1,135,34
1358487,24,6,1989,9,male,156,66,60,134,44,134,33,0,11
1444222,45,3,1968,2,male,1177,66,42,142,137,91,85,51,52
1841233,19,17,1994,10,male,447,65,37,137,51,134,39,3,12
1842258,65,14,1948,8,female,1947,66,28,146,214,17,46,129,168
1001316,68,1,1945,1,male,54,66,64,146,4,146,4,0,0
1959720,56,5,1957,8,female,339,66,22,155,1,0,0,155,1
2068684,23,21,1990,10,female,50,66,57,151,94,151,94,0,0
1949222,54,6,1959,3,female,317,66,39,159,48,0,22,159,26
1130472,56,11,1957,3,male,1314,66,24,162,62,0,19,162,43
1698216,28,25,1985,1,male,275,66,49,159,8,144,5,15,3
2115060,50,28,1963,8,female,749,65,42,158,57,139,33,19,24
1353979,58,24,1955,11,female,609,65,48,159,88,144,43,15,45
1330490,65,23,1948,5,male,272,65,52,159,82,157,32,2,50
1265681,55,6,1958,6,female,986,66,50,162,127,158,70,4,57
1147600,13,6,2000,6,male,455,66,55,159,23,159,20,0,3
1519156,20,3,1993,10,male,349,65,41,161,52,161,37,0,15
2099106,65,26,1948,3,female,1662,65,31,170,24,58,7,112,17
1240013,54,25,1959,6,female,1798,65,29,171,131,166,66,5,65
1285235,77,26,1936,10,female,1764,65,19,166,242,162,124,4,118
1953396,34,19,1979,2,male,369,65,40,166,77,166,63,0,14
2061787,51,24,1962,6,male,159,65,52,166,87,166,74,0,13
1640463,55,27,1958,9,female,421,65,48,166,30,166,12,0,18
1246263,29,12,1984,1,female,503,66,29,179,175,178,113,1,62
2085910,23,1,1990,9,male,76,66,32,181,361,181,333,0,28
1782612,63,16,1950,4,female,78,66,55,181,300,181,289,0,11
1539203,14,4,1999,4,female,305,66,50,187,6,176,3,11,3
1908248,51,9,1962,3,female,311,66,41,189,80,189,42,0,38
2020436,23,8,1990,4,female,310,65,45,191,39,33,23,158,16
2148608,24,26,1989,2,female,273,65,48,194,14,169,9,25,5
1653363,25,24,1988,1,male,202,65,32,199,122,171,39,28,83
2063008,19,6,1994,6,female,398,65,41,192,399,192,91,0,308
1026455,57,4,1956,3,female,718,66,41,209,52,209,20,0,32
1786470,66,5,1947,12,female,560,65,34,203,50,203,25,0,25
2156247,33,1,1980,1,male,142,65,34,218,76,175,65,43,11
2009244,23,22,1990,2,male,431,66,41,214,0,214,0,0,0
1097880,53,20,1960,6,male,195,65,42,226,91,0,34,226,57
1148188,72,21,1941,8,female,1144,65,39,226,119,0,59,226,60
1431712,31,10,1982,10,female,2217,65,39,226,208,98,104,128,104
1768886,39,9,1974,2,male,1356,65,37,225,13,224,7,1,6
1498040,21,26,1992,1,male,53,66,38,222,97,222,74,0,23
1776136,58,5,1955,2,female,1721,66,8,253,28,0,15,253,13
1613051,36,31,1977,7,female,270,65,43,256,258,17,134,239,124
1009779,23,25,1990,11,female,31,65,51,256,339,177,66,79,273
1441549,66,14,1947,1,female,596,66,51,259,116,259,100,0,16
1736051,46,30,1967,6,male,82,65,56,255,186,255,78,0,108
1838374,51,25,1962,7,female,364,66,48,273,218,79,93,194,125
1177732,72,14,1941,12,female,1564,66,21,265,195,135,161,130,34
1602264,14,12,1999,1,male,258,65,33,263,169,211,121,52,48
1797340,53,3,1960,1,female,92,65,58,285,58,1,25,284,33
1211012,67,16,1946,7,female,1883,65,17,283,75,0,7,283,68
1594213,23,3,1990,7,female,567,66,45,291,268,101,95,190,173
1535996,52,18,1961,10,male,162,66,44,289,295,60,197,229,98
2106386,65,10,1948,6,female,845,66,36,289,89,225,41,64,48
1471758,23,10,1990,1,male,294,65,38,287,172,287,142,0,30
1519878,26,5,1987,5,female,246,65,35,287,66,287,61,0,5
1574089,73,6,1940,8,female,62,66,48,302,128,0,9,302,119
1013756,82,21,1931,3,female,176,65,46,297,78,297,47,0,31
2061396,42,5,1971,3,female,637,66,40,301,185,301,150,0,35
1125297,50,29,1963,1,male,153,65,36,317,86,0,13,317,73
1102229,67,3,1946,9,female,1185,65,36,319,130,16,62,303,68
1295384,66,3,1947,4,female,2126,65,35,313,108,287,35,26,73
1038290,19,1,1994,1,male,80,66,32,323,145,323,93,0,52
1754242,27,30,1986,6,male,362,65,54,317,56,317,52,0,4
2146454,93,17,1920,9,female,1455,65,43,329,67,0,50,329,17
2112627,65,6,1948,3,female,1380,66,30,331,212,0,39,331,173
1237531,59,4,1954,2,female,399,65,52,342,16,279,12,63,4
1569059,29,4,1984,7,male,31,65,49,346,262,346,172,0,90
1842875,56,10,1957,4,female,313,65,29,359,231,15,155,344,76
2001529,66,5,1947,3,female,1572,66,32,366,252,314,156,52,96
1017181,37,30,1976,9,female,180,66,40,364,121,364,115,0,6
1793500,54,5,1959,4,female,550,66,49,384,41,0,19,384,22
1187100,18,1,1995,6,male,15,65,58,379,371,264,206,115,165
2063284,51,23,1962,9,female,130,66,47,371,414,371,380,0,34
1009832,99,13,1914,2,male,985,65,53,410,123,0,28,410,95
1999523,48,30,1965,11,female,975,66,14,409,159,230,85,179,74
1965380,27,17,1986,8,male,173,66,51,421,51,420,50,1,1
2001382,27,11,1986,12,male,622,66,62,437,97,0,63,437,34
1720473,47,9,1966,5,male,504,66,44,444,93,377,58,67,35
1478525,34,18,1979,7,female,301,66,47,433,35,433,24,0,11
1576047,50,9,1963,4,male,464,65,49,433,0,433,0,0,0
1102297,55,31,1958,8,female,543,66,36,458,264,322,182,136,82
2049188,53,30,1960,9,female,455,65,30,497,111,0,34,497,77
1895428,60,13,1953,5,male,203,65,53,506,297,0,73,506,224
1016037,62,12,1951,7,female,1382,66,37,489,174,48,103,441,71
1473511,48,10,1965,6,female,574,65,53,512,67,280,46,232,21
1397985,17,9,1996,10,female,588,65,24,536,339,251,281,285,58
1301280,103,18,1910,8,female,734,66,46,522,297,520,216,2,81
1035469,41,27,1972,11,female,825,65,22,525,270,525,190,0,80
1669208,72,20,1941,2,female,333,66,46,538,181,538,119,0,62
1361430,67,23,1946,7,female,818,65,18,588,276,87,93,501,183
1950316,19,10,1994,12,female,234,65,45,563,654,563,266,0,388
1409407,37,20,1976,12,female,219,65,57,592,535,592,284,0,251
1201579,17,18,1996,7,female,32,66,42,647,39,130,12,517,27
1719423,34,9,1979,3,male,231,65,56,616,1,236,0,380,1
1919781,37,10,1976,8,male,573,65,51,658,9,658,4,0,5
1751191,52,3,1961,1,female,430,65,35,662,179,662,67,0,112
1204840,15,12,1998,8,female,346,66,41,659,612,659,279,0,333
2084052,46,12,1967,5,female,792,65,39,611,852,611,802,0,50
1289277,15,27,1998,3,female,23,66,56,717,259,76,166,641,93
1387942,65,1,1948,1,female,551,65,54,713,1244,580,341,133,903
2154923,56,8,1957,9,female,357,66,45,680,194,680,155,0,39
2066807,73,23,1940,7,male,1233,65,38,746,43,0,23,746,20
1375674,19,24,1994,10,male,259,66,14,784,527,398,188,386,339
1930251,35,30,1978,1,female,92,66,56,727,231,726,180,1,51
1846447,17,14,1996,12,female,42,65,54,762,65,762,41,0,24
1792380,24,23,1989,11,female,321,66,38,732,255,732,140,0,115
1293758,71,27,1942,1,female,1152,66,28,813,787,421,310,392,477
2115095,57,17,1956,7,female,1044,65,29,805,185,805,126,0,59
1922487,59,21,1954,9,female,146,65,32,858,202,858,167,0,35
1738854,24,27,1989,4,female,322,65,16,974,64,974,51,0,13
1554805,59,1,1954,4,male,267,66,45,953,413,953,282,0,131
1543342,41,14,1972,11,female,276,65,53,1012,196,1012,145,0,51
2170219,34,12,1979,3,female,619,66,47,1276,798,685,527,591,271
1281512,50,14,1963,6,female,221,65,37,1159,240,1117,179,42,61
1427644,40,6,1973,12,female,873,65,43,1225,561,1217,177,8,384
1289375,23,4,1990,10,female,686,65,20,1434,1140,1434,771,0,369
1662002,33,12,1980,7,female,324,66,32,1775,356,1775,347,0,9
1436101,37,17,1976,9,female,522,65,29,1580,302,1580,86,0,216
1586861,63,18,1950,3,female,1562,65,33,2514,309,2497,256,17,53
1919415,33,14,1980,3,male,233,67,36,2,11,2,10,0,1
1559663,46,1,1967,8,male,362,67,65,2,5,2,5,0,0
1819359,53,22,1960,1,male,1050,67,24,2,15,2,7,0,8
1155437,60,12,1953,10,male,312,68,36,2,3,2,1,0,2
1032569,99,27,1914,12,male,994,68,26,2,13,2,11,0,2
1888398,16,22,1997,3,female,356,68,43,3,0,0,0,3,0
1524619,105,5,1908,7,male,90,68,65,3,0,0,0,3,0
1968286,65,29,1948,3,female,1405,67,27,3,1,0,0,3,1
1514598,81,7,1932,4,female,1952,67,32,3,4,0,3,3,1
2032015,57,5,1956,2,male,82,68,52,3,6,0,0,3,6
2007581,68,10,1945,6,male,1430,67,8,3,46,0,6,3,40
1646642,74,5,1939,12,male,108,67,51,3,19,0,10,3,9
1141321,27,18,1986,9,male,311,67,64,3,0,2,0,1,0
2078266,39,11,1974,7,female,197,68,40,3,2,1,2,2,0
1119533,26,9,1987,3,male,157,67,49,3,10,2,8,1,2
1947725,28,20,1985,5,male,552,67,42,3,75,2,35,1,40
1212065,28,28,1985,10,male,351,67,39,3,35,1,35,2,0
1911053,50,21,1963,1,female,683,67,32,3,16,2,8,1,8
1638324,64,11,1949,6,NA,2103,68,28,3,155,2,84,1,71
1453210,19,22,1994,8,male,295,67,60,3,0,3,0,0,0
1637870,21,9,1992,6,male,80,67,55,3,0,3,0,0,0
1808127,25,1,1988,1,male,243,67,56,3,0,3,0,0,0
1748818,27,22,1986,3,male,328,68,55,3,0,3,0,0,0
1900338,32,15,1981,10,female,370,68,60,3,0,3,0,0,0
1202791,26,1,1987,1,male,259,67,53,3,1,3,0,0,1
1362144,18,31,1995,1,male,350,68,44,3,2,3,2,0,0
1586842,28,17,1985,2,male,144,67,65,3,4,3,3,0,1
1742930,31,1,1982,9,male,1814,68,5,3,4,3,0,0,4
1465110,59,15,1954,2,female,1692,67,29,3,2,3,2,0,0
1878481,18,13,1995,10,female,389,67,22,3,11,3,11,0,0
1269443,26,12,1987,10,female,493,68,25,3,8,3,8,0,0
2145337,29,3,1984,9,male,606,67,15,3,24,3,24,0,0
1750873,58,26,1955,9,female,663,67,19,3,15,3,15,0,0
1431904,103,27,1910,8,female,829,68,36,3,29,3,16,0,13
1625314,16,15,1997,3,male,302,68,45,4,0,0,0,4,0
1109613,20,1,1993,1,male,637,67,57,4,0,0,0,4,0
2000394,30,6,1983,1,male,162,67,66,4,1,0,1,4,0
1510012,56,11,1957,2,female,89,68,38,4,9,0,7,4,2
2169326,57,5,1956,6,female,1930,68,50,4,6,0,4,4,2
1839875,65,17,1948,4,male,1454,68,23,4,12,0,5,4,7
1338929,65,6,1948,1,male,1429,68,25,4,0,2,0,2,0
2100636,36,25,1977,4,male,1314,67,17,4,6,2,2,2,4
1776263,64,13,1949,8,male,1902,67,30,4,2,3,0,1,2
2162845,14,4,1999,5,male,364,67,21,4,0,4,0,0,0
2186718,18,2,1995,5,male,596,67,22,4,0,4,0,0,0
1559537,31,18,1982,8,male,533,68,62,4,0,4,0,0,0
1079230,34,7,1979,12,female,411,67,51,4,0,4,0,0,0
1295926,17,21,1996,9,male,51,67,54,4,1,4,1,0,0
1347379,18,9,1995,6,male,180,67,54,4,1,4,1,0,0
1571979,34,24,1979,8,male,704,68,48,4,1,4,1,0,0
1418730,15,14,1998,9,male,301,67,42,4,4,4,1,0,3
1928922,17,23,1996,12,female,24,68,62,4,5,4,5,0,0
1114026,25,31,1988,5,female,77,67,44,4,3,4,3,0,0
1954569,21,4,1992,7,male,463,67,49,4,26,4,12,0,14
1097912,28,15,1985,5,male,607,68,33,4,13,4,12,0,1
1777022,29,13,1984,5,male,382,67,48,4,7,4,6,0,1
1232173,43,5,1970,10,female,686,67,33,4,25,4,17,0,8
2069806,49,27,1964,12,male,355,67,47,4,14,4,14,0,0
1100564,108,21,1905,2,male,175,67,48,5,0,0,0,5,0
1452434,49,22,1964,11,female,1390,67,34,5,3,0,0,5,3
1831723,57,23,1956,10,male,439,68,10,5,30,0,7,5,23
1977901,31,18,1982,4,male,183,67,62,5,20,2,2,3,18
1162867,29,28,1984,6,male,533,67,64,5,2,4,0,1,2
2018265,22,21,1991,10,male,415,68,66,5,0,5,0,0,0
1518785,30,7,1983,4,male,278,68,49,5,0,5,0,0,0
1585357,40,20,1973,8,female,558,67,36,5,0,5,0,0,0
1434563,28,11,1985,1,male,644,67,36,5,2,5,1,0,1
1898343,29,12,1984,3,male,552,67,22,5,2,5,1,0,1
1735917,18,1,1995,7,male,267,68,34,5,5,5,3,0,2
1488118,19,30,1994,7,male,196,68,18,5,6,5,6,0,0
1892524,34,12,1979,11,male,274,68,60,5,4,5,4,0,0
1800756,60,21,1953,3,female,589,68,61,5,7,5,7,0,0
1156502,18,8,1995,4,female,151,68,36,5,17,5,15,0,2
1562402,21,23,1992,11,male,88,68,52,5,29,5,8,0,21
2141170,22,29,1991,11,female,101,68,26,5,36,5,35,0,1
1657942,26,1,1987,1,male,332,67,14,5,13,5,13,0,0
1951736,33,29,1980,2,male,1180,68,34,5,10,5,7,0,3
2008811,53,17,1960,11,male,142,68,57,5,26,5,20,0,6
1300401,19,9,1994,10,female,539,67,38,6,3,1,3,5,0
1677741,15,26,1998,11,female,434,67,42,6,4,0,1,6,3
1708154,64,4,1949,3,female,1230,67,40,6,2,3,0,3,2
1402443,34,29,1979,12,male,570,67,42,6,6,3,4,3,2
2138365,37,7,1976,4,male,341,67,30,6,16,2,8,4,8
1068369,51,26,1962,6,male,1773,67,38,6,16,2,1,4,15
1795642,64,22,1949,3,male,2243,68,56,6,13,4,9,2,4
1420870,20,25,1993,7,male,752,68,27,6,3,5,0,1,3
2101492,20,11,1993,8,male,406,67,56,6,6,5,4,1,2
1846508,16,30,1997,11,female,68,68,63,6,0,6,0,0,0
1123862,31,30,1982,4,male,233,67,42,6,0,6,0,0,0
1359212,42,18,1971,4,male,564,68,46,6,0,6,0,0,0
1151166,20,17,1993,11,male,336,68,47,6,25,6,17,0,8
1486472,53,13,1960,10,female,626,68,51,6,37,6,35,0,2
1384955,20,15,1993,10,female,281,68,51,7,0,0,0,7,0
1680204,37,3,1976,9,female,593,68,31,7,0,0,0,7,0
1374019,16,23,1997,3,male,940,68,35,7,22,0,8,7,14
1875008,17,2,1996,5,female,200,67,50,7,1,7,1,0,0
1886144,28,13,1985,2,male,336,67,35,7,1,7,1,0,0
1300522,39,22,1974,8,male,462,68,60,7,0,7,0,0,0
1562131,57,5,1956,1,male,824,68,44,7,3,7,2,0,1
1312020,18,2,1995,1,male,281,68,27,7,5,7,4,0,1
2028370,18,21,1995,3,female,476,68,47,8,1,0,1,8,0
1184094,57,5,1956,5,male,1734,67,28,8,0,0,0,8,0
1862978,66,21,1947,5,male,212,68,21,8,2,0,0,8,2
1029155,17,5,1996,7,male,324,68,50,8,0,8,0,0,0
1171138,19,28,1994,6,male,84,68,62,8,0,8,0,0,0
1073144,25,7,1988,6,female,356,67,19,8,0,8,0,0,0
1384116,31,13,1982,5,male,461,68,39,8,0,8,0,0,0
2059030,108,1,1905,1,male,1513,67,29,8,0,8,0,0,0
2085618,60,19,1953,8,female,1644,67,23,8,4,8,1,0,3
1772205,22,10,1991,8,female,148,68,44,8,10,8,3,0,7
1362447,22,6,1991,11,male,47,68,63,8,16,8,10,0,6
1487558,24,12,1989,5,female,420,68,39,8,14,8,14,0,0
1418164,28,8,1985,5,male,1667,67,29,8,19,8,9,0,10
1238936,63,20,1950,4,female,1480,68,30,8,19,8,9,0,10
1191922,34,26,1979,8,male,406,68,46,9,6,0,1,9,5
1967910,36,31,1977,10,male,473,67,39,9,17,0,9,9,8
1309022,24,6,1989,12,female,178,67,43,9,16,3,7,6,9
1901880,18,17,1995,5,male,239,67,16,9,0,9,0,0,0
2148675,45,2,1968,7,male,2329,68,23,9,1,9,0,0,1
1833831,16,25,1997,5,female,446,67,30,9,5,9,2,0,3
1162008,21,14,1992,2,male,319,68,17,9,2,9,2,0,0
1711172,32,29,1981,5,female,540,67,30,9,4,9,3,0,1
1771109,24,15,1989,7,male,108,67,31,9,13,9,13,0,0
1927917,26,1,1987,1,male,216,68,52,9,7,9,4,0,3
1832697,30,1,1983,5,male,272,67,53,9,12,9,11,0,1
1214007,33,26,1980,5,female,95,68,53,9,32,9,21,0,11
1788159,52,1,1961,1,female,248,67,39,9,96,9,57,0,39
1036473,23,5,1990,5,male,541,68,61,10,1,0,0,10,1
1700557,24,7,1989,8,male,333,68,55,10,4,5,1,5,3
1624361,43,21,1970,10,male,1230,67,30,10,21,8,15,2,6
1213926,23,10,1990,10,male,171,68,59,10,0,10,0,0,0
2031321,27,7,1986,3,male,207,67,53,10,7,10,6,0,1
2091704,45,25,1968,1,male,540,68,52,10,10,10,6,0,4
1173494,23,7,1990,5,male,242,67,38,10,25,10,19,0,6
1021812,31,25,1982,2,male,710,67,41,10,61,10,48,0,13
1088607,38,6,1975,3,male,329,68,35,10,67,10,54,0,13
2062957,106,31,1907,1,male,2230,67,20,10,40,10,20,0,20
1426673,21,11,1992,3,male,385,68,36,11,1,0,0,11,1
1715224,22,20,1991,9,male,381,67,30,11,1,0,1,11,0
1218228,58,8,1955,9,male,830,68,23,11,8,0,1,11,7
1062050,22,14,1991,12,male,648,67,62,11,3,4,2,7,1
1495434,103,1,1910,1,female,1837,68,25,11,3,3,1,8,2
1941449,22,14,1991,2,female,519,68,36,11,0,11,0,0,0
1199790,43,21,1970,6,female,210,68,47,11,0,11,0,0,0
1726599,22,26,1991,3,male,369,67,54,11,6,11,6,0,0
1652095,24,17,1989,8,female,801,67,33,11,2,11,2,0,0
1865864,46,2,1967,2,male,600,68,50,11,3,11,3,0,0
1344437,23,22,1990,8,male,460,68,22,11,18,11,15,0,3
1299823,35,2,1978,10,male,57,68,64,11,17,11,7,0,10
1835320,21,27,1992,4,female,318,68,53,12,1,7,0,5,1
1223701,16,16,1997,2,male,402,67,23,12,0,12,0,0,0
1247407,25,19,1988,11,male,100,68,65,12,5,12,5,0,0
1907346,45,29,1968,11,female,1680,68,21,12,10,12,9,0,1
1687479,34,5,1979,1,male,683,68,20,12,33,12,12,0,21
1005050,68,4,1945,1,male,1655,67,53,13,0,0,0,13,0
1678686,83,19,1930,6,male,24,67,60,13,4,0,1,13,3
2030991,106,2,1907,6,NA,1962,68,41,13,8,0,1,13,7
1133641,51,25,1962,2,female,358,68,39,13,30,0,10,13,20
1005223,18,2,1995,6,male,497,67,48,13,7,13,7,0,0
1596930,25,10,1988,5,male,149,67,53,13,14,13,14,0,0
1227541,47,6,1966,6,male,662,67,26,13,49,13,27,0,22
1480430,26,13,1987,4,male,538,68,34,14,7,0,0,14,7
1624960,20,16,1993,12,male,44,67,63,14,0,14,0,0,0
1026283,29,11,1984,10,male,354,67,59,14,2,14,2,0,0
2092393,25,30,1988,12,male,649,68,62,14,12,14,12,0,0
1168942,56,18,1957,4,male,180,68,55,14,9,14,7,0,2
1377613,38,30,1975,1,male,340,67,38,14,21,14,19,0,2
2124335,50,5,1963,10,female,556,68,57,14,34,14,27,0,7
1273862,62,17,1951,10,male,346,68,65,15,3,0,0,15,3
1835416,25,13,1988,3,female,464,67,50,15,15,0,7,15,8
1294094,61,25,1952,5,female,1538,68,34,15,69,0,12,15,57
1606178,62,4,1951,8,female,1210,67,40,15,52,0,33,15,19
2164730,28,5,1985,1,female,366,68,34,15,42,7,18,8,24
1036102,27,11,1986,12,male,527,68,20,15,43,11,43,4,0
1768843,108,17,1905,6,male,150,68,62,15,1,15,0,0,1
1102950,24,27,1989,2,male,299,68,45,15,3,15,3,0,0
1531493,45,10,1968,1,female,316,68,48,15,6,15,6,0,0
2007402,36,23,1977,10,male,759,68,42,15,15,15,14,0,1
2080550,41,18,1972,4,female,289,68,17,15,42,15,39,0,3
1635634,21,16,1992,3,male,185,68,40,16,2,1,1,15,1
1803269,48,28,1965,4,female,355,68,37,16,0,0,0,16,0
2127394,53,20,1960,3,female,510,67,41,16,20,0,3,16,17
1376222,26,1,1987,1,male,369,68,43,16,2,16,0,0,2
1516300,103,12,1910,7,male,1396,68,52,16,1,16,1,0,0
1502357,17,2,1996,9,female,28,67,47,16,6,16,3,0,3
1919817,25,12,1988,9,female,1008,68,39,16,20,16,16,0,4
1417620,30,16,1983,9,female,676,68,58,16,12,16,2,0,10
1492659,54,15,1959,7,female,160,67,58,16,12,16,5,0,7
1254453,59,9,1954,11,female,1247,67,33,17,14,0,1,17,13
2082217,14,23,1999,3,male,553,67,28,17,16,10,8,7,8
1169970,23,30,1990,10,male,564,67,61,17,3,17,3,0,0
1049349,62,14,1951,7,male,320,68,59,17,10,17,4,0,6
1033745,44,3,1969,10,female,330,67,58,18,9,1,1,17,8
1227293,22,29,1991,4,male,69,68,61,18,5,18,2,0,3
1124062,22,22,1991,9,female,240,67,42,18,4,18,4,0,0
1388348,51,26,1962,9,male,203,68,48,18,8,18,8,0,0
1838656,24,17,1989,2,female,654,67,36,18,21,18,21,0,0
1066813,41,30,1972,6,female,362,67,40,18,176,18,126,0,50
1416677,18,2,1995,5,male,97,68,66,19,0,0,0,19,0
1211458,58,29,1955,6,male,1344,68,17,19,0,0,0,19,0
1664404,53,25,1960,12,male,421,68,60,19,60,0,31,19,29
1558007,23,1,1990,7,male,303,67,40,19,3,8,3,11,0
1105678,45,15,1968,6,male,483,67,50,19,2,16,2,3,0
1170012,62,11,1951,7,male,797,68,28,19,3,19,1,0,2
1537613,29,14,1984,8,male,450,67,39,19,8,19,7,0,1
1066983,44,3,1969,12,male,338,67,66,19,7,19,5,0,2
1589877,55,31,1958,12,male,688,67,31,19,22,19,4,0,18
1663571,16,5,1997,9,male,407,67,41,19,102,19,85,0,17
1953934,36,23,1977,3,male,29,68,63,20,3,20,3,0,0
1940805,32,20,1981,2,female,308,68,37,20,5,20,5,0,0
1155269,64,8,1949,10,female,421,67,57,20,13,20,7,0,6
1786461,26,27,1987,4,female,398,68,44,20,71,20,38,0,33
1194821,39,3,1974,3,male,17,67,43,20,40,20,20,0,20
1044459,108,15,1905,3,male,528,67,41,20,74,20,35,0,39
2158387,44,18,1969,11,female,333,67,50,21,2,21,2,0,0
1818187,19,31,1994,8,male,565,68,59,21,9,21,8,0,1
1793087,25,23,1988,1,male,76,68,56,21,6,21,5,0,1
1049632,26,22,1987,1,male,360,68,54,21,5,21,5,0,0
1767450,33,9,1980,7,male,274,67,51,21,5,21,5,0,0
1313649,17,26,1996,8,male,293,67,47,21,13,21,3,0,10
1870797,31,19,1982,10,male,553,67,42,22,0,0,0,22,0
1856106,36,24,1977,12,female,548,67,46,22,56,5,36,17,20
2125128,60,21,1953,12,female,1296,67,37,22,10,21,5,1,5
1230160,24,2,1989,1,female,360,67,29,22,29,20,15,2,14
1009052,34,20,1979,5,male,399,68,42,22,0,22,0,0,0
1907912,23,1,1990,6,male,407,68,53,22,13,22,13,0,0
1331455,23,14,1990,6,female,279,67,33,22,26,22,19,0,7
1279592,71,29,1942,7,male,1558,67,42,22,14,22,13,0,1
1678151,17,1,1996,3,male,138,67,46,23,2,2,0,21,2
1342787,50,28,1963,6,female,789,67,13,23,18,13,15,10,3
1253382,61,23,1952,6,male,614,67,48,23,3,23,3,0,0
1591529,22,10,1991,10,male,208,67,56,23,12,23,12,0,0
1344508,40,28,1973,8,male,1096,68,44,23,34,23,21,0,13
1161423,61,1,1952,1,male,422,68,57,23,64,23,19,0,45
1226988,16,18,1997,9,male,380,68,26,24,0,4,0,20,0
2191527,67,2,1946,12,female,620,68,62,24,34,3,8,21,26
1909354,18,7,1995,3,male,259,67,64,24,24,24,0,0,24
1114669,26,2,1987,3,male,535,68,44,24,50,24,46,0,4
2064490,69,16,1944,6,male,330,67,46,25,20,0,11,25,9
1813227,58,28,1955,11,female,2289,67,43,25,82,2,40,23,42
2022091,55,10,1958,8,male,338,67,37,25,11,7,2,18,9
1463416,34,10,1979,10,female,391,67,53,25,30,16,21,9,9
1858189,23,18,1990,5,female,463,68,43,25,6,25,3,0,3
2133285,19,21,1994,10,female,434,68,54,26,21,25,12,1,9
2094598,43,15,1970,9,female,444,67,19,26,10,26,9,0,1
1115311,51,20,1962,1,male,289,68,51,26,41,26,28,0,13
1966000,41,12,1972,2,male,229,67,60,27,9,11,9,16,0
1310213,54,21,1959,6,male,1385,67,23,27,12,19,5,8,7
1885341,20,21,1993,11,female,746,67,35,27,82,7,70,20,12
1680565,17,25,1996,11,male,33,67,51,27,1,27,1,0,0
1480676,48,28,1965,11,female,921,68,20,27,25,27,6,0,19
1542419,62,19,1951,3,female,1101,67,43,28,5,0,2,28,3
1211015,21,4,1992,5,male,383,68,44,28,13,18,1,10,12
1923886,25,22,1988,9,female,570,67,27,28,11,28,10,0,1
1417182,53,3,1960,4,male,163,67,53,28,6,28,6,0,0
1836634,28,18,1985,7,male,526,68,49,28,44,28,38,0,6
1961886,53,23,1960,1,female,318,67,45,28,48,28,48,0,0
1713822,51,29,1962,8,female,1870,68,28,29,56,27,34,2,22
1489778,27,23,1986,7,female,332,67,55,29,29,29,22,0,7
1307419,51,14,1962,11,female,1197,68,38,29,24,29,9,0,15
1355752,106,4,1907,8,male,1132,67,51,30,5,0,5,30,0
1329014,103,11,1910,1,female,1927,67,35,30,1,21,1,9,0
1640991,61,23,1952,8,female,682,67,30,31,45,25,30,6,15
1621352,17,15,1996,9,female,1008,68,23,30,79,26,50,4,29
1349613,69,13,1944,6,male,1358,67,37,30,53,24,24,6,29
2024713,15,6,1998,8,male,765,68,35,31,0,31,0,0,0
2136591,23,1,1990,1,female,348,67,17,31,5,31,5,0,0
1180502,29,15,1984,11,female,311,68,46,30,2,30,0,0,2
1274716,35,31,1978,5,female,421,68,21,30,0,30,0,0,0
1874165,27,19,1986,6,male,176,68,49,31,9,31,7,0,2
1351231,46,5,1967,3,female,539,67,28,30,10,30,5,0,5
1185324,15,23,1998,12,male,174,68,36,31,31,31,15,0,16
1748474,15,22,1998,1,female,34,67,38,30,20,30,18,0,2
2138786,25,8,1988,9,female,414,67,20,31,19,31,19,0,0
1117614,89,7,1924,8,male,876,68,48,32,10,3,3,29,7
1633075,24,8,1989,1,female,93,68,53,32,29,3,8,29,21
2045329,24,7,1989,12,male,382,67,62,32,0,32,0,0,0
2085785,27,21,1986,6,male,1173,67,42,32,2,32,1,0,1
1539424,53,30,1960,10,female,1538,67,11,32,57,32,44,0,13
2174070,58,5,1955,9,female,553,67,55,33,6,20,5,13,1
1194301,18,4,1995,2,male,415,67,45,33,6,32,6,1,0
1246831,36,12,1977,5,male,261,68,43,33,171,33,65,0,106
1655811,47,18,1966,3,male,843,67,20,33,54,33,41,0,13
2078088,16,12,1997,10,male,324,67,52,34,0,5,0,29,0
1270920,24,14,1989,7,male,493,68,48,34,45,33,37,1,8
2159904,26,20,1987,11,female,591,67,56,34,57,33,40,1,17
1020619,15,16,1998,11,female,94,67,48,34,0,34,0,0,0
1261141,108,25,1905,3,female,1353,67,11,36,23,26,15,10,8
1331668,26,8,1987,2,female,119,67,20,36,44,33,21,3,23
1835118,38,7,1975,7,female,494,67,45,36,53,34,28,2,25
1100808,47,3,1966,6,male,177,67,16,35,54,30,34,5,20
1048385,56,26,1957,5,female,76,67,62,36,5,36,3,0,2
1358031,64,15,1949,2,male,1919,67,36,36,5,36,3,0,2
1837949,31,20,1982,10,male,414,68,29,35,16,35,13,0,3
1278037,25,5,1988,5,male,106,67,47,37,16,13,5,24,11
1161023,51,27,1962,10,female,281,68,35,37,121,24,65,13,56
1183479,28,26,1985,11,female,464,68,43,37,39,37,25,0,14
1003323,55,15,1958,10,male,683,68,20,39,12,0,1,39,11
2031922,65,6,1948,9,female,1302,68,16,38,23,0,2,38,21
1492822,72,3,1941,6,female,1598,67,34,38,16,1,7,37,9
1039160,31,22,1982,5,female,557,68,27,39,25,0,2,39,23
1456045,50,5,1963,3,female,336,68,37,38,1,28,0,10,1
1667166,22,20,1991,4,female,204,67,30,39,12,39,12,0,0
1331301,19,12,1994,2,male,381,68,48,38,26,38,15,0,11
1693478,103,20,1910,6,female,489,67,40,39,74,39,33,0,41
1788849,24,1,1989,5,male,766,68,21,40,107,0,7,40,100
1270855,58,2,1955,8,female,1318,67,25,40,23,17,1,23,22
2000150,58,3,1955,2,female,1592,67,34,40,0,40,0,0,0
1751914,27,3,1986,12,male,491,68,39,40,49,40,37,0,12
1135249,33,20,1980,3,male,292,68,25,40,78,40,56,0,22
1728326,17,1,1996,8,male,404,67,21,41,15,6,9,35,6
1952578,59,4,1954,9,female,427,67,56,42,12,0,3,42,9
1172760,20,2,1993,6,male,233,68,26,42,34,0,29,42,5
1592032,56,8,1957,12,female,389,68,46,42,46,5,18,37,28
1181679,66,19,1947,9,female,1035,68,32,42,15,15,0,27,15
1349067,51,4,1962,2,male,1640,67,23,42,26,28,17,14,9
2134743,30,2,1983,5,female,191,68,42,42,56,35,33,7,23
1643065,35,18,1978,5,female,275,67,34,41,25,40,12,1,13
1410615,24,14,1989,9,male,315,68,23,41,90,37,28,4,62
2187011,18,20,1995,4,male,180,68,49,41,0,41,0,0,0
1972612,23,23,1990,3,male,453,68,46,42,16,42,10,0,6
1959256,30,20,1983,5,female,505,67,42,42,8,42,1,0,7
1744596,40,8,1973,10,male,381,68,43,42,16,42,14,0,2
1759785,25,16,1988,9,female,216,68,28,42,68,42,55,0,13
1889261,40,13,1973,1,female,289,67,50,44,6,0,5,44,1
1198495,30,11,1983,7,male,771,67,34,44,16,43,14,1,2
1557711,48,20,1965,10,female,19,68,57,43,146,41,120,2,26
1747752,15,21,1998,11,male,377,67,42,43,4,43,3,0,1
1229902,28,26,1985,6,male,456,67,24,44,40,44,31,0,9
2102778,52,4,1961,9,male,1725,67,16,44,35,44,30,0,5
2011611,100,2,1913,6,NA,1764,68,21,44,35,44,27,0,8
1670823,65,30,1948,1,male,1076,67,32,45,59,0,23,45,36
1900888,51,21,1962,2,male,481,67,32,45,50,43,39,2,11
1923072,22,12,1991,3,male,500,67,37,46,4,0,1,46,3
2157448,108,28,1905,4,female,1176,67,49,46,64,3,32,43,32
1527682,24,8,1989,2,male,262,68,54,47,2,47,2,0,0
1143562,26,13,1987,8,female,915,67,19,46,17,46,16,0,1
1770181,47,25,1966,11,male,116,68,15,47,22,47,12,0,10
2004035,29,6,1984,11,male,250,68,29,46,62,46,61,0,1
1557915,30,18,1983,8,male,653,67,35,46,161,46,155,0,6
1818114,75,29,1938,4,male,90,67,61,48,1,0,0,48,1
1122008,56,13,1957,7,male,1748,67,23,48,15,19,6,29,9
2060046,68,1,1945,7,male,1839,67,30,48,14,11,9,37,5
1876273,54,19,1959,6,male,525,67,59,48,7,46,7,2,0
1526065,19,19,1994,2,female,246,67,49,49,47,36,29,13,18
1899490,45,11,1968,1,female,207,68,55,48,27,48,20,0,7
1598972,51,4,1962,4,female,48,67,60,51,16,1,4,50,12
1583618,19,28,1994,11,male,553,68,31,50,52,31,26,19,26
1535700,48,28,1965,11,female,561,68,42,51,41,46,29,5,12
1951891,19,26,1994,11,male,644,67,47,50,24,50,15,0,9
1310665,43,18,1970,8,female,39,67,39,51,470,51,441,0,29
1956690,58,1,1955,4,female,1103,68,28,53,46,0,27,53,19
2186053,35,3,1978,7,female,351,67,43,53,1,53,1,0,0
1327772,25,8,1988,10,NA,202,67,33,52,40,52,13,0,27
2133311,46,15,1967,2,female,451,68,31,54,20,54,14,0,6
2087095,24,1,1989,10,male,191,67,53,58,11,2,3,56,8
1830645,108,7,1905,9,female,2278,67,35,56,37,34,23,22,14
1369409,16,31,1997,7,female,377,67,28,56,15,42,5,14,10
1757350,49,24,1964,10,female,632,68,41,57,76,56,51,1,25
1389229,44,8,1969,12,female,565,67,13,57,11,57,11,0,0
1131392,108,2,1905,6,female,1233,67,35,58,34,58,29,0,5
1269242,28,17,1985,5,female,323,68,53,56,103,56,88,0,15
1155773,26,29,1987,12,female,479,67,58,59,39,20,34,39,5
1172482,23,1,1990,1,male,61,67,38,60,5,60,3,0,2
1347309,73,24,1940,2,female,1597,67,41,59,6,59,5,0,1
1021859,47,22,1966,10,female,399,67,53,60,82,60,57,0,25
1194944,38,5,1975,4,male,300,68,44,59,100,59,88,0,12
1011753,54,1,1959,11,female,965,67,43,62,51,7,10,55,41
1692475,28,4,1985,2,male,212,67,37,62,7,62,5,0,2
1602052,41,18,1972,12,male,120,68,65,65,5,0,3,65,2
1864761,63,12,1950,12,female,1769,68,31,65,18,0,4,65,14
1994221,63,17,1950,1,male,158,68,65,65,46,65,32,0,14
2003304,59,27,1954,7,female,463,67,26,68,17,0,0,68,17
1484831,71,11,1942,4,female,1145,68,30,66,30,65,15,1,15
2172678,53,22,1960,7,female,532,67,49,67,70,65,47,2,23
1369684,17,14,1996,6,male,258,68,35,66,107,66,40,0,67
1812617,24,10,1989,10,male,491,67,23,71,4,12,2,59,2
1234661,73,17,1940,12,male,275,67,59,70,84,0,61,70,23
1304562,100,1,1913,5,NA,1528,68,43,70,25,70,20,0,5
1483509,34,19,1979,6,female,193,68,40,71,79,71,69,0,10
2148517,42,11,1971,2,female,421,68,38,69,82,69,55,0,27
1036955,33,14,1980,8,male,78,67,51,69,142,69,105,0,37
1851933,71,31,1942,12,male,166,68,41,72,5,0,4,72,1
1031254,14,23,1999,8,female,208,68,26,74,214,0,21,74,193
1888839,18,26,1995,2,female,195,67,55,73,60,44,16,29,44
1507131,38,27,1975,8,female,294,67,31,74,132,51,111,23,21
1282660,52,4,1961,8,male,1697,68,27,72,2,72,2,0,0
1498767,54,25,1959,5,female,698,67,21,73,24,73,15,0,9
1882426,23,1,1990,1,female,550,67,41,73,132,73,123,0,9
1005135,50,8,1963,4,female,776,68,33,74,161,74,83,0,78
1432310,71,15,1942,12,female,2030,67,40,75,13,48,9,27,4
1593486,22,22,1991,3,male,651,67,50,76,142,44,104,32,38
2140977,66,14,1947,6,female,767,67,14,75,30,66,17,9,13
1679360,48,20,1965,2,male,193,68,39,77,45,77,30,0,15
1863680,28,1,1985,3,male,237,67,54,75,55,75,35,0,20
2034916,48,1,1965,9,female,209,67,50,75,101,75,99,0,2
1285083,29,5,1984,12,male,423,68,43,79,148,3,68,76,80
1376745,43,15,1970,3,male,650,68,38,78,42,38,30,40,12
1559050,29,16,1984,1,female,441,68,52,78,52,74,28,4,24
1802527,25,22,1988,11,female,333,67,41,80,4,80,2,0,2
1626788,33,27,1980,9,female,394,68,47,81,45,0,15,81,30
1575747,45,2,1968,9,male,348,67,37,84,50,3,24,81,26
1417741,69,10,1944,3,female,1805,67,22,82,36,13,3,69,33
1769311,19,16,1994,8,male,213,67,35,84,141,12,96,72,45
1325832,16,3,1997,11,female,278,68,33,81,17,80,10,1,7
1361859,27,12,1986,10,male,32,67,54,82,42,82,33,0,9
1845191,66,18,1947,3,female,1398,68,35,86,141,76,104,10,37
2055371,57,29,1956,2,female,1210,67,26,85,7,85,6,0,1
2034031,59,24,1954,2,male,948,68,35,87,19,87,9,0,10
2138084,33,20,1980,8,female,136,68,47,85,60,85,48,0,12
1726239,18,8,1995,7,female,231,67,30,90,16,0,6,90,10
1922773,23,23,1990,12,male,379,68,40,89,21,89,13,0,8
1084100,46,5,1967,9,female,446,67,23,91,33,91,19,0,14
1368384,26,2,1987,2,female,243,68,47,90,82,90,39,0,43
2031180,47,21,1966,6,male,955,67,23,90,84,90,72,0,12
1631701,54,4,1959,8,female,681,68,45,94,34,94,23,0,11
1486466,66,10,1947,3,female,138,67,38,92,27,92,25,0,2
1830800,44,13,1969,7,female,233,67,58,92,57,92,31,0,26
2165125,30,27,1983,7,male,118,68,52,96,29,92,11,4,18
2050909,33,4,1980,1,male,390,68,46,97,8,97,7,0,1
1493401,27,10,1986,10,female,476,68,38,98,51,98,44,0,7
1348238,22,23,1991,8,female,645,68,37,99,95,99,56,0,39
2156370,44,7,1969,8,female,141,68,30,97,63,97,58,0,5
1250504,54,15,1959,7,male,266,68,19,96,68,96,35,0,33
1777821,69,12,1944,5,female,379,67,26,102,52,5,27,97,25
1134015,21,12,1992,10,female,625,67,47,100,649,82,359,18,290
1099575,57,26,1956,3,female,1933,68,26,100,115,99,49,1,66
2185730,22,12,1991,7,male,115,68,45,100,4,100,0,0,4
1939266,57,6,1956,12,female,373,68,54,102,2,102,1,0,1
1197088,52,12,1961,5,male,330,67,49,101,72,101,35,0,37
1991007,63,8,1950,7,female,1509,68,25,105,143,16,91,89,52
2006825,108,8,1905,9,female,1687,68,53,107,67,11,43,96,24
1216530,72,6,1941,2,female,893,67,49,108,32,90,13,18,19
1524106,46,19,1967,2,female,85,67,66,108,72,106,51,2,21
1173512,61,16,1952,9,female,109,67,54,108,35,108,22,0,13
1572851,72,8,1941,9,male,1701,68,28,106,108,106,84,0,24
2168633,34,17,1979,8,female,478,68,37,110,17,63,10,47,7
1873480,28,2,1985,2,male,617,67,49,113,215,85,141,28,74
1661283,21,30,1992,11,male,223,67,45,111,11,111,8,0,3
2002451,25,5,1988,5,female,448,68,37,113,135,113,113,0,22
1964561,35,26,1978,8,female,381,67,35,113,341,113,253,0,88
1098229,49,23,1964,5,female,1986,67,31,118,153,29,45,89,108
1704394,22,11,1991,1,male,347,67,55,114,5,114,4,0,1
1169101,27,1,1986,1,female,577,68,40,118,63,118,54,0,9
1578170,40,1,1973,2,male,302,68,47,114,41,114,17,0,24
1973479,33,29,1980,6,female,434,68,31,118,317,118,303,0,14
1857222,20,10,1993,12,female,587,68,36,122,49,0,35,122,14
2096531,30,8,1983,1,female,234,68,29,123,55,5,15,118,40
1815865,34,23,1979,8,female,388,68,37,120,86,12,37,108,49
1337206,18,18,1995,10,female,69,68,46,122,173,80,143,42,30
1466751,38,26,1975,9,female,219,67,44,122,62,122,45,0,17
1742034,59,2,1954,5,male,113,68,63,121,29,121,17,0,12
1802632,33,12,1980,4,male,48,67,65,124,119,124,116,0,3
1096768,69,16,1944,6,female,1129,68,46,121,141,121,86,0,55
1142044,17,18,1996,4,male,56,67,63,125,4,125,3,0,1
1823506,20,6,1993,1,male,435,67,8,132,124,125,107,7,17
1680513,29,25,1984,8,male,704,68,41,135,131,129,101,6,30
1031914,19,4,1994,12,male,598,67,29,132,9,132,9,0,0
1910999,54,27,1959,2,female,1937,67,40,136,73,136,51,0,22
2002234,63,6,1950,8,female,1681,67,28,138,48,97,38,41,10
1494202,32,21,1981,3,female,471,68,38,140,142,137,118,3,24
1020643,47,22,1966,5,male,420,68,51,139,17,139,8,0,9
1448521,57,19,1956,4,female,973,67,52,146,87,15,40,131,47
1880850,59,15,1954,4,female,319,67,43,146,2,146,2,0,0
1070849,108,6,1905,2,female,1431,68,33,150,49,150,40,0,9
1023372,15,15,1998,9,male,313,68,64,154,2,0,0,154,2
1509058,42,4,1971,10,female,484,68,24,161,49,9,11,152,38
2148795,60,5,1953,3,male,442,67,44,162,70,86,40,76,30
2085014,35,18,1978,10,male,467,68,46,160,125,134,95,26,30
1651869,41,16,1972,12,male,714,68,33,163,55,163,48,0,7
1462909,29,23,1984,2,male,582,67,60,158,239,158,183,0,56
1974717,24,25,1989,4,female,297,67,39,165,93,141,74,24,19
1397578,31,13,1982,2,male,415,67,53,165,9,165,5,0,4
2118062,18,22,1995,12,male,210,68,63,170,96,170,69,0,27
1756348,42,11,1971,4,female,615,68,49,168,42,168,40,0,2
1448873,65,8,1948,9,female,534,68,20,176,71,0,18,176,53
1874424,52,24,1961,12,female,1741,67,16,180,110,26,73,154,37
2026958,22,8,1991,3,female,855,68,40,174,152,155,49,19,103
1842395,39,2,1974,6,male,767,68,52,176,88,176,78,0,10
1083324,29,1,1984,12,female,326,68,43,177,196,177,168,0,28
1173177,56,22,1957,6,female,562,67,33,186,49,0,29,186,20
1955537,46,16,1967,5,male,869,67,66,187,14,172,4,15,10
2095425,45,12,1968,4,male,443,67,51,185,152,157,118,28,34
1179981,25,9,1988,5,female,258,68,22,189,25,189,7,0,18
1879034,49,7,1964,8,female,303,67,36,185,31,185,27,0,4
1313345,108,1,1905,1,male,138,67,56,182,107,182,81,0,26
1824136,60,10,1953,9,male,313,67,33,185,506,185,306,0,200
1583073,57,10,1956,11,female,1415,67,42,196,102,63,43,133,59
1573115,25,10,1988,11,male,104,67,41,192,29,192,18,0,11
1442973,59,25,1954,7,female,437,67,59,200,45,200,26,0,19
1036880,39,25,1974,5,female,720,68,43,202,75,66,34,136,41
2135577,52,29,1961,7,female,120,67,36,211,109,208,77,3,32
1911164,74,9,1939,11,female,1118,67,50,203,27,203,16,0,11
1295088,26,14,1987,7,male,437,67,41,207,59,207,48,0,11
1503292,34,2,1979,8,male,450,68,27,208,161,208,136,0,25
1437479,37,13,1976,5,female,77,67,45,206,215,206,136,0,79
1417664,21,11,1992,7,female,333,68,41,221,131,221,61,0,70
1680720,37,9,1976,10,female,228,68,32,213,83,213,69,0,14
1177663,28,1,1985,1,female,317,67,39,213,278,213,208,0,70
1270209,53,9,1960,12,male,128,68,39,233,35,0,2,233,33
1677842,66,8,1947,9,female,695,68,60,233,9,4,4,229,5
1044306,50,31,1963,8,female,1375,68,40,225,141,0,20,225,121
1333272,42,18,1971,8,female,524,68,38,233,88,228,68,5,20
2017088,58,8,1955,8,male,360,68,18,230,79,219,20,11,59
2073684,31,30,1982,8,female,508,68,28,229,229,229,200,0,29
1798414,25,8,1988,10,female,197,68,50,223,427,223,322,0,105
2163215,64,23,1949,12,male,82,67,45,236,15,216,7,20,8
1661302,51,7,1962,4,male,986,67,41,248,2,0,2,248,0
2009583,46,22,1967,5,female,612,67,49,258,123,0,55,258,68
1625223,18,23,1995,10,female,49,68,20,252,100,107,77,145,23
1971902,80,27,1933,8,female,948,68,31,253,14,246,8,7,6
1183365,22,10,1991,11,female,402,68,54,259,263,249,78,10,185
2016178,34,1,1979,12,male,630,67,56,249,37,249,26,0,11
1826113,14,16,1999,5,female,341,67,35,261,73,0,34,261,39
2181951,44,20,1969,5,female,733,68,51,268,234,153,168,115,66
2034716,39,5,1974,9,female,497,67,37,271,57,250,45,21,12
1689345,48,30,1965,10,female,215,67,45,261,107,261,67,0,40
1128010,55,13,1958,7,female,184,67,48,269,150,269,97,0,53
1212075,68,12,1945,2,female,230,68,22,266,426,266,215,0,211
1571680,66,12,1947,7,male,827,67,38,279,198,0,60,279,138
1269011,28,10,1985,7,female,322,68,37,287,89,236,16,51,73
1273744,64,8,1949,11,female,309,67,56,295,57,0,17,295,40
1956436,81,7,1932,6,female,622,68,22,305,61,0,7,305,54
1517626,35,1,1978,8,female,420,68,50,299,32,299,26,0,6
1045098,53,15,1960,1,female,466,68,21,308,41,308,22,0,19
1948863,36,21,1977,11,female,267,67,41,299,119,299,91,0,28
1163102,49,3,1964,9,male,525,67,46,325,188,4,48,321,140
1747046,35,10,1978,3,male,164,68,65,326,20,279,8,47,12
1088827,75,19,1938,4,female,1147,67,31,310,76,252,38,58,38
1696912,108,16,1905,1,male,1039,68,46,330,43,250,37,80,6
1577685,45,20,1968,12,female,536,67,30,328,189,290,162,38,27
1367239,65,20,1948,5,female,96,68,48,345,240,345,212,0,28
1890584,70,31,1943,7,male,1177,68,19,365,38,0,5,365,33
1863495,108,8,1905,12,female,1486,68,48,368,65,0,41,368,24
1476278,15,18,1998,8,male,482,67,41,366,254,343,223,23,31
1011611,63,23,1950,12,female,530,68,52,392,42,0,33,392,9
1987991,24,12,1989,8,male,56,68,51,374,23,374,19,0,4
1882350,48,29,1965,4,female,571,67,57,418,61,39,11,379,50
1784864,64,30,1949,6,female,1341,68,41,413,15,410,8,3,7
1132731,52,26,1961,12,male,199,68,44,439,3,11,1,428,2
1699886,53,4,1960,3,female,16,67,57,434,148,0,22,434,126
1308834,18,6,1995,3,female,51,67,45,448,212,438,131,10,81
1035794,70,20,1943,1,female,1171,67,18,471,108,0,27,471,81
1409738,74,4,1939,12,female,1735,68,20,453,87,4,18,449,69
1123631,103,1,1910,3,male,1169,68,48,462,364,5,152,457,212
1895030,46,27,1967,5,female,784,68,39,462,598,240,324,222,274
1280137,19,1,1994,5,male,17,67,60,470,547,428,403,42,144
1060999,62,13,1951,10,female,743,68,41,455,269,451,220,4,49
1317788,65,2,1948,1,female,792,67,37,459,28,459,14,0,14
1256771,21,13,1992,2,female,425,68,42,469,276,469,190,0,86
1109595,51,20,1962,6,female,61,68,49,468,376,468,326,0,50
1958934,38,29,1975,11,male,302,68,45,520,75,238,42,282,33
2058436,22,7,1991,7,female,684,67,45,601,24,601,24,0,0
1001691,33,24,1980,12,male,187,68,55,608,52,608,44,0,8
1492705,18,15,1995,5,female,380,68,49,613,72,601,38,12,34
1443870,97,1,1916,5,female,293,68,40,672,60,0,9,672,51
1133369,22,10,1991,6,female,67,68,52,681,1025,181,470,500,555
1667075,42,21,1971,8,female,1549,67,62,719,770,648,614,71,156
1173953,55,11,1958,3,female,645,67,30,688,117,688,94,0,23
2169017,25,3,1988,3,female,157,68,39,731,653,107,197,624,456
1368444,29,11,1984,2,female,326,67,29,761,915,294,131,467,784
1017354,66,14,1947,5,male,1509,67,20,732,115,579,74,153,41
1926971,28,9,1985,3,female,359,67,14,770,317,770,274,0,43
1226956,85,25,1928,12,female,2372,67,50,864,385,0,185,864,200
1222891,54,1,1959,4,female,169,68,65,828,1293,14,191,814,1102
1530938,31,6,1982,3,male,27,68,42,861,357,861,170,0,187
1341971,47,1,1966,9,male,497,68,46,797,161,797,141,0,20
1353822,62,27,1951,5,female,510,67,45,920,76,918,65,2,11
2132454,20,1,1993,9,female,139,68,55,1027,977,105,152,922,825
1963893,70,24,1943,9,male,1564,67,45,1015,213,997,58,18,155
1188623,63,4,1950,6,male,973,67,53,1028,662,1028,538,0,124
1507702,53,26,1960,2,female,338,67,50,1270,209,2,57,1268,152
2092279,19,10,1994,5,female,136,67,45,1223,235,1155,203,68,32
2090982,19,10,1994,6,female,450,68,45,1172,218,987,130,185,88
1757233,29,13,1984,7,female,380,68,46,1234,1217,920,661,314,556
2083555,28,17,1985,7,female,948,67,40,1458,1152,221,351,1237,801
1066444,24,22,1989,4,male,558,68,33,1815,904,0,286,1815,618
1152052,65,31,1948,7,female,890,68,47,1708,815,171,126,1537,689
1173749,50,11,1963,2,female,451,67,52,1642,1150,872,380,770,770
1373451,27,1,1986,1,male,224,67,47,1800,152,1800,108,0,44
1001641,55,17,1958,11,female,275,68,32,3679,143,3679,110,0,33
1985044,14,26,1999,1,female,173,69,67,2,23,0,11,2,12
1910610,16,13,1997,12,male,412,69,22,2,4,0,1,2,3
1421706,22,16,1991,12,male,1042,70,32,2,57,0,14,2,43
2073187,22,18,1991,12,female,546,69,35,2,11,0,7,2,4
1311701,50,12,1963,1,male,393,69,57,2,4,0,2,2,2
1855859,52,14,1961,8,male,541,70,31,2,15,0,10,2,5
1746477,55,10,1958,12,female,397,69,50,2,8,0,5,2,3
1766177,56,12,1957,10,female,1757,69,21,2,38,0,22,2,16
1689582,59,4,1954,10,female,1515,70,15,2,8,0,3,2,5
1337932,62,2,1951,2,female,1762,70,39,2,9,0,6,2,3
1866689,71,12,1942,9,female,1173,70,32,2,6,0,2,2,4
1268339,22,17,1991,2,male,274,70,36,2,29,1,12,1,17
1754491,50,26,1963,5,male,20,70,59,2,5,1,2,1,3
1412103,19,13,1994,11,male,563,70,68,2,0,2,0,0,0
1711805,24,11,1989,12,female,278,69,33,2,0,2,0,0,0
1984700,26,1,1987,1,male,126,70,63,2,0,2,0,0,0
1192350,28,20,1985,10,male,56,70,53,2,0,2,0,0,0
1612344,35,12,1978,6,male,299,69,21,2,0,2,0,0,0
1189740,37,16,1976,1,male,617,69,60,2,0,2,0,0,0
1930225,45,11,1968,10,male,269,70,63,2,0,2,0,0,0
1553832,16,18,1997,1,female,231,70,61,2,1,2,0,0,1
1078350,17,14,1996,4,male,291,70,57,2,1,2,1,0,0
2020469,21,1,1992,1,male,514,70,24,2,1,2,0,0,1
1117520,33,3,1980,8,male,583,70,56,2,1,2,1,0,0
1936090,34,31,1979,8,male,161,70,57,2,1,2,1,0,0
1769342,15,16,1998,3,female,253,69,58,2,2,2,2,0,0
1354215,56,11,1957,1,male,205,69,55,2,2,2,1,0,1
1940261,103,26,1910,2,female,308,69,34,2,2,2,2,0,0
1624051,17,15,1996,5,male,446,70,54,2,9,2,4,0,5
1196599,19,16,1994,4,male,356,69,48,2,6,2,3,0,3
1097394,22,15,1991,9,male,222,69,50,2,71,2,49,0,22
1669983,23,4,1990,5,female,316,69,37,2,25,2,21,0,4
1730442,26,12,1987,4,male,356,70,47,2,18,2,13,0,5
1428161,28,2,1985,3,male,291,70,16,2,8,2,4,0,4
1122084,32,20,1981,2,female,295,69,37,2,8,2,6,0,2
1351460,35,17,1978,8,female,706,70,31,2,6,2,5,0,1
1831001,43,2,1970,3,male,2301,69,15,2,6,2,3,0,3
1164420,43,15,1970,10,female,476,69,52,2,7,2,5,0,2
1497511,47,14,1966,11,female,230,69,31,2,12,2,8,0,4
1792794,51,17,1962,5,female,358,70,64,2,27,2,23,0,4
1248039,51,16,1962,10,female,473,70,60,2,9,2,9,0,0
1512908,63,1,1950,8,male,233,69,56,2,27,2,9,0,18
1633128,69,31,1944,5,female,1671,69,34,2,3,2,1,0,2
1549178,21,4,1992,6,female,322,70,42,3,0,0,0,3,0
2073019,55,11,1958,1,female,1328,69,15,3,1,0,0,3,1
1042424,14,18,1999,11,female,301,70,32,3,2,0,0,3,2
1256394,26,30,1987,9,male,309,70,63,3,2,0,1,3,1
1708460,36,1,1977,8,male,603,70,21,3,22,0,14,3,8
2075445,92,13,1921,2,female,1524,69,33,3,6,0,0,3,6
1540861,36,4,1977,5,male,532,69,59,3,0,2,0,1,0
2183080,37,14,1976,7,male,345,69,29,3,1,2,1,1,0
1822105,21,16,1992,10,male,779,69,31,3,14,1,8,2,6
1476803,33,22,1980,6,female,129,70,65,3,29,1,11,2,18
1864831,57,14,1956,10,male,1369,70,36,3,5,1,3,2,2
2123115,23,3,1990,3,female,47,69,59,3,0,3,0,0,0
1143665,38,17,1975,7,male,341,70,50,3,0,3,0,0,0
1328751,33,3,1980,11,male,709,70,51,3,1,3,1,0,0
1825389,33,1,1980,1,female,710,69,43,3,1,3,0,0,1
1162590,35,17,1978,5,female,474,69,50,3,1,3,1,0,0
2003766,14,10,1999,12,female,67,69,38,3,2,3,1,0,1
1664066,15,14,1998,9,male,169,70,57,3,3,3,3,0,0
2014447,29,13,1984,10,female,625,69,46,3,2,3,1,0,1
1206896,32,11,1981,11,male,829,69,46,3,3,3,3,0,0
1896374,52,12,1961,9,male,1515,70,30,3,4,3,4,0,0
1248563,103,9,1910,7,female,1457,69,40,3,2,3,2,0,0
1244119,16,5,1997,1,male,148,70,49,3,11,3,11,0,0
1651189,18,24,1995,11,female,27,70,52,3,7,3,6,0,1
1391257,18,20,1995,4,male,77,69,62,3,6,3,6,0,0
1293693,20,13,1993,1,male,264,69,26,3,8,3,2,0,6
1956036,20,5,1993,5,male,144,70,47,3,7,3,3,0,4
1614008,25,9,1988,10,female,354,70,23,3,29,3,20,0,9
2013108,25,20,1988,10,male,113,69,65,3,62,3,32,0,30
1118065,26,12,1987,10,male,166,69,36,3,6,3,1,0,5
1057013,38,19,1975,10,female,63,69,28,3,13,3,11,0,2
1536176,45,19,1968,7,female,250,69,62,3,10,3,0,0,10
2107568,51,28,1962,10,male,746,70,47,3,22,3,10,0,12
1238849,72,7,1941,7,male,750,70,59,3,8,3,5,0,3
2037247,25,14,1988,11,male,395,70,56,4,0,0,0,4,0
1549159,53,18,1960,3,male,40,69,60,4,0,0,0,4,0
1554482,36,3,1977,9,male,700,69,43,4,1,0,0,4,1
1515200,94,19,1919,1,male,1894,70,31,4,1,0,1,4,0
1027472,45,27,1968,8,female,555,69,34,4,6,0,0,4,6
1164391,64,12,1949,11,female,1132,69,30,4,9,0,3,4,6
1809603,14,19,1999,3,male,182,69,36,4,0,4,0,0,0
2062955,21,19,1992,11,male,391,70,67,4,0,4,0,0,0
2083015,28,1,1985,7,female,572,69,19,4,0,4,0,0,0
1474963,31,13,1982,11,male,871,69,39,4,0,4,0,0,0
1514754,13,18,2000,7,male,78,69,58,4,2,4,2,0,0
1919870,25,11,1988,5,female,614,70,29,4,2,4,2,0,0
2136120,32,5,1981,5,male,310,69,12,4,1,4,0,0,1
1330658,32,12,1981,5,female,162,69,55,4,2,4,2,0,0
1741974,74,3,1939,12,male,138,70,32,4,2,4,2,0,0
1539450,20,24,1993,7,female,444,70,28,4,3,4,3,0,0
1474093,27,19,1986,10,male,292,69,46,4,5,4,5,0,0
1045089,42,24,1971,6,male,1409,70,24,4,4,4,1,0,3
1227460,21,21,1992,6,male,171,70,54,4,36,4,21,0,15
1671208,22,1,1991,2,female,471,70,25,4,11,4,11,0,0
1159780,24,11,1989,1,male,610,70,30,4,10,4,6,0,4
1128072,24,7,1989,9,female,376,70,18,4,7,4,6,0,1
1027572,25,29,1988,9,male,431,69,36,4,26,4,15,0,11
2062562,26,20,1987,8,male,754,69,32,4,6,4,5,0,1
1263054,37,13,1976,6,male,546,70,61,4,6,4,5,0,1
1654344,38,1,1975,4,male,184,70,25,4,10,4,8,0,2
1532368,59,7,1954,10,female,677,70,40,5,0,0,0,5,0
1305485,51,5,1962,8,female,364,70,44,5,2,0,0,5,2
1494161,63,15,1950,8,male,175,69,45,5,1,0,0,5,1
2009035,23,22,1990,5,male,563,69,31,5,6,0,5,5,1
1349980,18,19,1995,12,male,426,70,56,5,0,1,0,4,0
1936525,16,20,1997,8,male,90,70,45,5,4,2,0,3,4
1848014,28,29,1985,9,female,464,70,23,5,34,2,22,3,12
1689869,72,24,1941,12,male,13,70,12,5,11,1,7,4,4
1557364,106,16,1907,11,male,2071,69,27,5,29,3,22,2,7
1197930,14,24,1999,10,male,364,70,63,5,0,4,0,1,0
1771758,23,4,1990,9,male,216,69,12,5,14,4,6,1,8
1016389,19,11,1994,2,male,229,69,66,5,0,5,0,0,0
1374239,28,19,1985,9,male,193,70,47,5,0,5,0,0,0
1864067,36,24,1977,2,male,429,70,49,5,0,5,0,0,0
1570062,19,1,1994,1,male,245,70,63,5,3,5,3,0,0
1150398,32,3,1981,11,female,211,70,55,5,4,5,4,0,0
1171915,54,19,1959,6,female,1517,70,48,5,6,5,4,0,2
1871737,23,13,1990,10,female,509,70,18,5,24,5,20,0,4
2060686,27,2,1986,5,male,299,69,47,5,25,5,17,0,8
1940133,43,18,1970,11,male,60,69,61,5,17,5,12,0,5
1793121,42,7,1971,2,male,599,70,50,5,35,5,12,0,23
1761539,20,18,1993,10,male,679,70,45,6,0,0,0,6,0
2059761,45,5,1968,2,female,718,70,54,6,1,0,1,6,0
1749023,33,19,1980,11,male,133,70,32,6,16,0,4,6,12
1436596,62,7,1951,4,female,1895,69,25,6,31,0,4,6,27
1544647,64,28,1949,7,female,888,70,29,6,23,0,13,6,10
1011108,108,3,1905,6,female,1788,70,14,6,1,4,0,2,1
1033761,44,26,1969,10,male,676,69,51,6,5,4,4,2,1
1875284,52,11,1961,2,male,1096,69,38,6,4,2,3,4,1
1931383,17,28,1996,8,male,614,69,51,6,29,5,19,1,10
1081221,26,25,1987,12,male,541,70,29,6,21,5,9,1,12
1380824,26,29,1987,9,male,668,69,38,6,0,6,0,0,0
2090004,31,14,1982,10,female,784,69,54,6,0,6,0,0,0
1009814,35,10,1978,1,male,223,69,64,6,0,6,0,0,0
1212489,38,9,1975,12,male,1018,70,34,6,0,6,0,0,0
1938080,21,26,1992,4,male,221,69,51,6,3,6,3,0,0
1556124,30,1,1983,9,male,319,70,50,6,2,6,2,0,0
1020260,22,5,1991,6,male,303,69,31,6,51,6,44,0,7
1764206,24,28,1989,4,female,68,69,43,6,19,6,8,0,11
1751962,27,1,1986,2,female,429,69,50,6,18,6,15,0,3
1755372,29,23,1984,12,male,1522,69,44,6,11,6,3,0,8
1385473,39,24,1974,10,male,25,69,68,6,14,6,10,0,4
1508536,50,27,1963,9,female,737,70,45,6,12,6,10,0,2
1238797,14,17,1999,10,male,20,70,8,7,9,1,7,6,2
1204886,33,5,1980,7,male,459,69,52,7,7,0,0,7,7
2148054,51,15,1962,12,male,399,69,51,7,8,1,2,6,6
1214250,69,13,1944,10,male,2432,70,29,7,15,0,9,7,6
1950495,23,12,1990,8,male,507,69,51,7,2,3,1,4,1
2133420,17,19,1996,6,male,80,69,65,7,0,7,0,0,0
1335484,25,12,1988,4,female,479,70,30,7,0,7,0,0,0
1668143,59,5,1954,6,male,755,70,49,7,1,7,1,0,0
1171645,21,24,1992,6,male,185,69,64,7,2,7,2,0,0
1648764,99,26,1914,3,male,23,69,37,7,4,7,4,0,0
2062421,108,20,1905,3,male,708,69,41,7,2,7,1,0,1
1399273,19,23,1994,12,male,244,70,44,7,9,7,8,0,1
1885256,25,28,1988,1,male,59,69,62,7,9,7,5,0,4
1399982,50,8,1963,2,male,292,70,66,7,6,7,6,0,0
2039787,21,29,1992,10,male,1043,70,28,7,27,7,22,0,5
2096333,25,6,1988,8,male,471,69,53,7,17,7,15,0,2
1486081,32,10,1981,12,male,241,69,61,7,33,7,30,0,3
2138402,36,6,1977,10,male,726,70,54,7,26,7,13,0,13
1932221,42,21,1971,12,male,479,70,44,7,16,7,16,0,0
1039657,94,19,1919,5,male,323,70,53,7,11,7,6,0,5
1931458,77,15,1936,8,male,869,69,38,8,1,1,1,7,0
2111569,21,2,1992,5,female,463,69,31,8,4,0,2,8,2
1169510,14,4,1999,11,male,247,69,60,8,7,0,3,8,4
2004638,57,27,1956,11,male,17,69,58,8,9,1,1,7,8
1790717,71,17,1942,3,female,978,69,52,8,7,0,5,8,2
1938874,110,21,1903,5,female,1862,69,31,8,8,0,3,8,5
1766329,62,28,1951,10,male,1264,70,21,8,14,0,10,8,4
1713713,22,12,1991,11,female,403,70,46,8,24,3,4,5,20
1149210,27,5,1986,10,male,33,70,42,8,74,2,32,6,42
1044018,24,1,1989,3,female,380,70,66,8,1,6,0,2,1
1103000,18,14,1995,4,female,81,69,60,8,0,8,0,0,0
1078829,27,30,1986,3,male,452,69,57,8,0,8,0,0,0
1634086,33,1,1980,1,male,408,69,39,8,1,8,0,0,1
1683926,31,22,1982,8,female,500,69,51,8,3,8,3,0,0
1838730,68,8,1945,5,male,1713,70,25,8,2,8,1,0,1
1857187,90,12,1923,4,female,659,70,37,8,4,8,2,0,2
1484636,17,27,1996,2,female,224,69,46,8,10,8,10,0,0
1539337,18,12,1995,9,male,70,70,26,8,6,8,5,0,1
2069766,20,10,1993,12,male,97,69,45,8,5,8,3,0,2
1017091,45,3,1968,1,female,243,69,45,8,5,8,5,0,0
1191871,53,7,1960,9,female,864,69,51,9,10,7,3,2,7
1161818,36,19,1977,10,female,827,70,24,9,36,8,15,1,21
1150200,27,11,1986,5,male,727,70,31,9,0,9,0,0,0
1318128,99,29,1914,4,male,849,69,37,9,0,9,0,0,0
1197763,18,9,1995,7,male,76,69,50,9,5,9,4,0,1
2097995,60,30,1953,12,male,1187,70,26,9,4,9,3,0,1
2109180,18,9,1995,10,male,127,69,62,9,8,9,3,0,5
1479984,29,13,1984,6,female,362,69,50,9,13,9,8,0,5
1974932,17,17,1996,2,male,315,70,59,9,25,9,10,0,15
1264375,21,25,1992,2,male,22,70,66,9,52,9,25,0,27
1770135,33,1,1980,3,male,986,69,28,9,80,9,25,0,55
1902810,49,15,1964,2,male,743,70,29,9,96,9,88,0,8
1526734,49,18,1964,8,female,145,70,43,9,28,9,10,0,18
2116849,29,18,1984,2,male,607,69,31,10,7,0,0,10,7
1334558,19,30,1994,4,male,351,70,35,10,1,10,1,0,0
2191927,23,18,1990,1,male,1355,70,29,10,1,10,1,0,0
1301743,58,23,1955,2,male,848,69,42,10,1,10,1,0,0
1677207,23,5,1990,8,male,77,69,32,10,4,10,4,0,0
1277570,21,11,1992,10,female,349,70,37,10,14,10,14,0,0
1444234,78,22,1935,4,female,912,69,28,10,13,10,3,0,10
1649821,17,8,1996,6,male,96,69,64,10,18,10,10,0,8
1619803,18,14,1995,7,female,17,69,25,10,23,10,13,0,10
2147846,27,18,1986,2,male,108,69,63,10,28,10,12,0,16
1486132,25,9,1988,1,male,752,70,53,11,8,0,2,11,6
2192741,58,14,1955,10,female,862,70,22,11,7,0,0,11,7
1969934,18,7,1995,1,male,271,70,25,11,46,0,14,11,32
1648044,31,24,1982,2,male,236,70,50,11,33,5,15,6,18
1878867,61,15,1952,5,female,1102,69,38,11,22,6,5,5,17
2091803,62,11,1951,6,male,1793,70,27,11,8,8,2,3,6
1837492,14,20,1999,3,male,167,70,25,11,1,11,1,0,0
2180635,29,23,1984,7,female,296,69,42,11,1,11,1,0,0
1763590,22,27,1991,6,female,174,69,38,11,3,11,3,0,0
1927729,35,5,1978,5,male,394,70,69,11,2,11,2,0,0
2131202,22,15,1991,6,female,241,69,45,11,25,11,25,0,0
1656837,27,28,1986,10,female,241,70,33,11,19,11,18,0,1
1315303,30,23,1983,4,male,165,69,57,11,24,11,14,0,10
1139076,60,2,1953,10,male,349,69,24,11,19,11,18,0,1
1154105,17,1,1996,9,male,470,69,56,12,0,0,0,12,0
1668986,22,19,1991,10,male,540,69,46,12,13,0,6,12,7
2072511,22,28,1991,9,male,39,70,68,12,6,6,4,6,2
1870601,47,28,1966,10,female,195,69,55,12,87,4,19,8,68
1726850,23,22,1990,9,male,766,70,31,12,47,12,45,0,2
1162037,43,15,1970,11,male,134,69,46,12,29,12,16,0,13
2002086,47,18,1966,3,female,197,69,35,12,20,12,15,0,5
1584797,19,15,1994,11,male,345,69,40,13,0,0,0,13,0
2011876,59,29,1954,5,male,1098,69,49,13,1,0,0,13,1
1890848,43,15,1970,12,male,280,69,39,13,2,4,2,9,0
2056608,57,7,1956,9,female,1034,69,31,13,3,3,3,10,0
1314349,24,1,1989,8,male,536,69,26,13,13,12,10,1,3
1451834,18,23,1995,7,male,959,69,43,13,0,13,0,0,0
1041335,20,7,1993,7,male,310,69,42,13,1,13,0,0,1
2020703,20,23,1993,8,male,562,70,17,13,0,13,0,0,0
1538623,15,9,1998,6,female,241,70,24,13,13,13,5,0,8
1454784,16,9,1997,8,female,253,70,26,13,12,13,12,0,0
1783022,21,7,1992,9,female,165,69,44,13,8,13,7,0,1
1813771,50,10,1963,9,female,1395,69,14,13,9,13,7,0,2
1497991,65,29,1948,9,female,375,69,20,13,14,13,14,0,0
1373626,66,14,1947,10,female,1581,69,39,14,4,1,1,13,3
1028984,60,13,1953,5,female,117,70,42,14,10,0,3,14,7
1099063,47,30,1966,10,male,318,69,54,14,22,0,6,14,16
1382409,24,10,1989,1,male,810,69,32,14,7,13,5,1,2
1410639,26,1,1987,1,male,371,70,55,14,13,14,6,0,7
1420404,27,5,1986,1,female,679,69,35,14,21,14,12,0,9
1235626,29,26,1984,11,male,154,70,66,15,1,0,1,15,0
1082756,52,3,1961,12,female,601,69,54,15,18,0,2,15,16
1879020,76,21,1937,11,male,564,70,43,15,37,0,13,15,24
1904396,26,20,1987,2,male,551,69,56,15,0,15,0,0,0
1036953,23,8,1990,7,male,47,70,53,15,8,15,2,0,6
2037607,25,2,1988,8,female,760,70,44,15,6,15,1,0,5
1020312,43,26,1970,7,male,501,69,30,15,37,15,24,0,13
1743700,65,11,1948,2,female,567,70,22,15,48,15,22,0,26
1670790,27,12,1986,12,male,383,70,63,16,4,0,1,16,3
1379165,14,26,1999,1,female,108,69,20,16,2,16,0,0,2
1718202,20,28,1993,4,female,436,69,37,16,0,16,0,0,0
1263849,26,15,1987,3,male,552,70,62,16,0,16,0,0,0
1234028,53,1,1960,1,female,384,69,44,16,21,16,12,0,9
1144682,83,19,1930,6,male,1587,70,26,16,18,16,14,0,4
1436720,36,10,1977,9,female,528,70,57,16,163,16,145,0,18
1083725,39,23,1974,8,female,752,69,23,16,26,16,15,0,11
1221591,40,4,1973,12,female,120,70,65,17,23,16,17,1,6
1687473,56,9,1957,11,female,127,69,44,17,0,17,0,0,0
1730031,14,17,1999,5,male,323,69,41,17,4,17,4,0,0
1680848,32,25,1981,8,male,353,70,64,17,9,17,8,0,1
1420590,63,30,1950,7,male,852,70,35,17,29,17,26,0,3
2171353,43,10,1970,7,female,460,70,48,18,4,2,0,16,4
2105409,16,7,1997,3,male,399,70,45,18,2,17,0,1,2
1244698,18,6,1995,3,male,9,69,62,18,19,17,17,1,2
2104933,20,6,1993,12,female,507,70,33,18,32,18,32,0,0
1882545,66,4,1947,4,female,490,70,44,19,19,0,8,19,11
1531071,20,20,1993,4,female,80,70,27,19,20,19,20,0,0
1060512,20,29,1993,10,female,177,69,30,19,16,19,10,0,6
1697267,47,16,1966,6,female,574,70,50,19,16,19,4,0,12
1587428,41,30,1972,6,male,167,69,52,19,42,19,28,0,14
1975219,17,29,1996,2,male,269,70,42,20,19,3,2,17,17
1736475,20,27,1993,5,male,495,70,46,20,23,3,11,17,12
1726527,29,24,1984,7,female,707,69,28,20,82,10,58,10,24
1673576,17,17,1996,8,male,22,70,68,20,16,20,12,0,4
1620269,53,18,1960,6,female,286,70,59,20,23,20,16,0,7
1895041,15,16,1998,11,female,50,69,46,20,40,20,23,0,17
2028152,40,16,1973,8,male,303,70,34,20,85,20,7,0,78
1426973,103,2,1910,9,male,919,70,44,20,53,20,36,0,17
1996752,14,7,1999,3,female,84,69,47,21,28,21,23,0,5
1664395,55,2,1958,7,male,186,69,33,22,18,0,7,22,11
2148754,40,5,1973,8,female,484,70,22,22,114,0,95,22,19
1719388,25,27,1988,7,male,450,70,45,22,12,19,7,3,5
1138929,19,26,1994,10,male,478,69,55,22,28,20,5,2,23
1748854,58,20,1955,3,male,1930,69,25,22,18,21,9,1,9
1164371,23,1,1990,1,male,91,69,44,22,2,22,2,0,0
1137536,39,2,1974,12,male,261,69,66,22,1,22,1,0,0
1106825,34,2,1979,2,male,420,70,51,22,13,22,2,0,11
1183760,16,16,1997,12,male,276,69,50,22,98,22,58,0,40
1818267,72,23,1941,3,male,619,69,34,23,0,0,0,23,0
1975785,47,28,1966,3,female,100,70,55,23,7,22,5,1,2
1900630,26,19,1987,1,female,568,70,29,23,3,23,2,0,1
2157720,40,20,1973,3,male,995,69,26,23,3,23,1,0,2
1461441,24,31,1989,7,male,250,70,50,23,50,23,27,0,23
1960986,33,10,1980,5,male,300,69,29,23,45,23,9,0,36
1695010,40,15,1973,7,male,251,69,21,23,63,23,37,0,26
1685442,17,12,1996,4,male,116,70,35,24,3,24,2,0,1
2183743,54,1,1959,1,male,182,69,66,24,0,24,0,0,0
1527930,46,24,1967,10,male,600,69,35,24,27,24,17,0,10
1705055,45,29,1968,3,female,912,69,23,24,100,24,56,0,44
1552043,81,20,1932,4,female,74,70,67,25,11,25,11,0,0
1924299,46,6,1967,5,male,638,69,18,25,33,25,30,0,3
1691519,24,9,1989,4,female,496,70,51,25,38,25,27,0,11
1208442,16,17,1997,10,male,894,69,48,26,2,14,1,12,1
1400753,24,31,1989,8,male,219,69,64,26,5,13,2,13,3
1022547,29,8,1984,9,male,216,69,47,26,11,10,5,16,6
1856661,28,31,1985,7,male,412,70,45,26,3,26,3,0,0
1576199,60,14,1953,10,male,79,69,54,26,46,26,21,0,25
1941662,58,18,1955,5,female,534,69,55,27,90,0,49,27,41
1816744,25,1,1988,2,male,42,69,17,27,0,27,0,0,0
1813077,37,1,1976,1,female,171,69,37,27,41,27,40,0,1
1716561,50,2,1963,12,female,268,69,37,27,79,27,63,0,16
1279636,15,1,1998,2,female,272,69,48,28,3,28,3,0,0
1905206,38,5,1975,4,male,751,70,16,28,15,28,14,0,1
1154010,24,6,1989,11,male,85,70,52,29,16,29,11,0,5
1188049,57,29,1956,2,male,1198,69,36,29,17,29,17,0,0
1684433,40,3,1973,9,female,588,69,47,30,42,2,31,28,11
1922709,36,10,1977,2,male,284,69,51,30,41,29,27,1,14
1744244,41,11,1972,1,male,456,69,43,30,0,30,0,0,0
1201173,19,29,1994,4,female,398,69,37,31,70,31,54,0,16
1732083,21,2,1992,3,female,1033,70,31,32,234,19,40,13,194
2175915,52,5,1961,9,female,619,69,51,32,27,27,10,5,17
2120088,22,5,1991,2,male,723,69,56,32,4,32,2,0,2
1360743,59,10,1954,5,female,170,69,57,32,5,32,4,0,1
1749464,108,25,1905,4,female,158,70,40,32,18,32,7,0,11
1613346,29,1,1984,9,male,137,70,42,32,21,32,9,0,12
1646347,26,8,1987,5,female,452,70,25,32,69,32,64,0,5
1472515,43,8,1970,8,male,1313,70,30,33,42,28,32,5,10
1458954,94,5,1919,12,male,262,69,51,33,15,33,6,0,9
2135100,21,27,1992,11,female,427,70,26,33,34,33,10,0,24
1212463,39,3,1974,9,male,224,70,42,34,5,33,2,1,3
1682265,42,19,1971,1,female,342,69,48,35,16,3,7,32,9
1428386,61,30,1952,9,male,1751,69,21,36,14,0,0,36,14
2123305,64,7,1949,11,male,669,70,53,35,6,0,3,35,3
1852585,60,31,1953,12,female,1715,70,32,36,45,14,23,22,22
1168852,53,19,1960,9,female,85,69,57,36,157,9,59,27,98
1805912,22,22,1991,8,male,285,69,44,35,5,30,3,5,2
1763417,61,3,1952,5,female,469,69,36,36,10,36,6,0,4
1090218,51,28,1962,8,male,240,70,51,35,43,35,31,0,12
1988429,19,25,1994,11,female,142,70,63,36,60,36,49,0,11
1203129,27,7,1986,10,female,586,70,26,37,32,37,29,0,3
2008017,21,9,1992,9,male,379,69,43,38,16,1,4,37,12
1558723,29,11,1984,1,female,290,69,45,38,10,0,1,38,9
1178263,60,28,1953,6,female,538,69,31,39,30,5,15,34,15
1583627,27,30,1986,8,male,283,70,50,39,21,28,17,11,4
1396249,55,7,1958,1,male,2279,69,19,39,18,29,15,10,3
1702226,98,13,1915,7,female,1772,70,30,39,16,36,12,3,4
2069295,26,29,1987,10,female,72,70,29,39,12,39,4,0,8
1822750,36,25,1977,7,male,270,69,43,38,9,38,9,0,0
1686245,42,10,1971,12,female,486,69,51,38,44,38,43,0,1
1751098,43,19,1970,7,male,288,69,22,38,26,38,16,0,10
1835325,59,6,1954,8,female,810,69,32,40,24,3,18,37,6
1835048,47,20,1966,8,male,823,69,64,40,20,32,13,8,7
1142748,18,10,1995,10,female,330,69,45,40,42,40,41,0,1
2142291,21,14,1992,10,male,383,69,49,40,39,40,20,0,19
1917584,33,15,1980,11,female,171,70,40,40,62,40,48,0,14
1143955,62,15,1951,1,female,917,70,19,41,10,0,6,41,4
2148667,27,5,1986,12,female,228,69,19,42,35,0,4,42,31
1376735,91,28,1922,8,female,288,70,36,41,16,41,14,0,2
2153525,14,1,1999,1,female,97,69,25,42,90,42,52,0,38
2047965,56,14,1957,9,female,458,70,39,43,28,0,8,43,20
1894496,46,2,1967,7,female,1262,70,22,44,37,29,32,15,5
1652633,16,21,1997,8,female,30,69,54,43,11,43,10,0,1
2143491,20,20,1993,1,male,356,69,30,45,3,3,0,42,3
1427886,46,23,1967,5,female,146,69,34,45,49,44,35,1,14
1385187,34,1,1979,1,male,38,69,58,45,21,45,16,0,5
1974373,64,10,1949,7,female,341,69,56,45,8,45,8,0,0
1321751,48,21,1965,11,female,839,70,48,45,33,45,26,0,7
2058263,44,4,1969,2,female,396,70,53,46,3,0,0,46,3
1068224,59,14,1954,10,female,549,69,24,46,33,0,5,46,28
1150232,48,2,1965,1,male,317,69,19,47,129,0,24,47,105
1935064,61,20,1952,5,male,793,70,34,46,4,46,3,0,1
1583527,27,20,1986,2,male,254,69,59,46,14,46,14,0,0
1402535,16,24,1997,3,female,90,70,56,46,58,46,53,0,5
2005325,41,22,1972,10,female,312,70,54,49,8,32,4,17,4
1921331,56,21,1957,6,female,415,70,62,48,16,13,8,35,8
1774637,18,10,1995,9,female,111,69,36,48,83,44,38,4,45
1844073,17,8,1996,9,male,377,70,57,51,13,6,4,45,9
1253942,39,11,1974,7,male,175,69,45,51,4,26,1,25,3
2055749,17,26,1996,5,male,36,69,58,50,139,42,62,8,77
1785960,31,30,1982,4,female,474,70,50,51,3,51,3,0,0
1623638,52,14,1961,12,male,617,69,51,50,13,50,8,0,5
1579797,41,15,1972,9,female,745,70,50,52,19,30,9,22,10
1186031,22,28,1991,5,male,291,70,57,53,29,53,18,0,11
1914298,22,11,1991,8,male,428,70,54,53,66,53,35,0,31
2175132,49,4,1964,3,female,163,69,38,54,30,0,9,54,21
1145527,32,17,1981,8,female,332,69,26,55,35,55,29,0,6
1905843,38,17,1975,2,male,1104,69,25,58,12,0,11,58,1
1750734,73,9,1940,12,female,972,69,47,56,28,0,4,56,24
1780559,42,21,1971,1,female,303,69,47,58,45,0,13,58,32
1821923,45,23,1968,11,male,200,70,53,56,6,56,4,0,2
1759775,40,20,1973,5,male,217,70,51,58,13,58,12,0,1
2072687,45,10,1968,7,female,255,69,42,57,80,57,42,0,38
1865269,58,19,1955,10,female,1335,69,45,56,52,56,39,0,13
1310095,34,16,1979,8,female,204,69,51,59,16,0,8,59,8
1834921,27,30,1986,10,male,301,69,24,59,58,14,23,45,35
1153855,38,24,1975,8,female,438,69,59,59,1,47,1,12,0
1913022,33,2,1980,11,male,653,69,57,60,27,58,22,2,5
1396306,23,16,1990,5,male,851,70,35,61,6,7,2,54,4
1843491,50,29,1963,10,female,96,70,46,63,37,60,27,3,10
1168190,28,19,1985,1,male,303,70,38,63,19,63,13,0,6
1612853,51,11,1962,12,female,247,69,33,61,32,61,21,0,11
1689229,103,12,1910,8,female,1534,69,28,61,23,61,6,0,17
1002756,36,17,1977,7,male,285,69,47,63,68,63,54,0,14
1520216,67,8,1946,6,female,1463,70,41,65,134,0,30,65,104
1838334,18,8,1995,4,male,112,69,52,65,46,30,33,35,13
1273639,35,13,1978,5,female,195,70,51,64,39,37,2,27,37
1470477,47,19,1966,2,female,400,70,43,65,52,63,20,2,32
1585678,21,7,1992,7,male,123,69,49,67,136,41,113,26,23
1017343,51,8,1962,9,male,503,69,33,67,117,15,53,52,64
1160953,35,26,1978,12,female,277,69,50,67,8,58,7,9,1
1370037,31,7,1982,11,female,509,70,53,66,32,66,17,0,15
1621803,45,2,1968,4,male,451,70,42,68,41,68,39,0,2
2083058,63,23,1950,3,female,1631,70,26,68,29,68,16,0,13
1238914,21,28,1992,8,female,14,70,66,66,64,66,54,0,10
1696822,33,6,1980,3,female,400,70,63,66,51,66,35,0,16
1353220,23,10,1990,10,female,239,69,38,71,6,71,6,0,0
1686954,34,25,1979,12,female,1000,69,53,71,90,71,70,0,20
1211019,59,26,1954,3,male,381,70,65,72,9,9,4,63,5
1354852,64,6,1949,8,female,2045,69,39,73,16,0,12,73,4
1696081,71,1,1942,12,female,487,70,41,74,26,0,15,74,11
1289978,76,12,1937,1,female,1105,69,21,72,56,0,33,72,23
1537032,23,25,1990,11,male,827,69,19,72,25,18,4,54,21
1421617,63,26,1950,4,female,530,69,32,72,155,70,67,2,88
1786158,55,9,1958,9,female,200,70,47,74,15,74,14,0,1
1692286,58,5,1955,2,female,232,70,42,72,24,72,19,0,5
1446318,23,30,1990,8,female,208,70,58,72,70,72,65,0,5
1802307,42,14,1971,9,male,124,70,11,74,58,74,41,0,17
2173683,55,14,1958,11,female,1551,69,30,74,149,74,121,0,28
2162923,57,10,1956,4,female,226,70,35,77,33,0,14,77,19
2026246,50,21,1963,8,male,279,69,53,77,24,75,13,2,11
1674077,55,2,1958,6,female,2163,69,42,77,82,62,67,15,15
1871847,19,8,1994,2,female,192,70,58,78,66,47,11,31,55
1305871,32,10,1981,6,female,905,69,25,78,67,32,35,46,32
2100985,49,22,1964,7,male,301,69,22,78,75,49,55,29,20
1100996,20,17,1993,4,male,23,70,61,78,46,78,39,0,7
2125511,32,6,1981,12,female,284,69,37,79,53,79,53,0,0
1917798,27,2,1986,2,female,20,70,32,80,180,80,47,0,133
1007435,68,11,1945,5,male,1276,69,10,83,20,0,8,83,12
1988303,47,20,1966,10,female,389,69,29,81,62,0,18,81,44
1728493,69,13,1944,7,male,2108,69,41,82,39,21,22,61,17
1541722,23,28,1990,4,female,583,69,55,84,41,84,38,0,3
1972406,27,12,1986,2,female,572,69,50,83,20,83,15,0,5
1520670,31,15,1982,11,male,384,69,20,82,66,82,57,0,9
1854631,63,27,1950,7,male,291,69,43,87,14,0,5,87,9
1717370,81,30,1932,7,female,1348,69,28,85,34,1,13,84,21
1867154,108,8,1905,11,female,1287,70,40,85,26,0,9,85,17
1544415,18,24,1995,1,female,454,70,41,86,120,30,58,56,62
1315770,41,15,1972,1,male,41,70,64,86,398,43,142,43,256
2016480,58,8,1955,3,female,1448,69,37,85,102,77,74,8,28
1310519,24,4,1989,1,female,470,69,32,85,52,85,49,0,3
1951285,34,6,1979,10,female,1476,70,49,88,115,86,96,2,19
2175928,38,15,1975,8,male,522,69,45,89,58,89,40,0,18
1190279,41,20,1972,4,male,984,69,25,88,79,88,64,0,15
1499471,83,16,1930,4,female,1345,70,29,88,63,88,35,0,28
1727113,28,9,1985,10,male,88,70,65,92,2,0,1,92,1
1943857,55,5,1958,5,female,180,70,49,93,23,1,2,92,21
1170583,32,13,1981,11,female,197,69,56,95,162,93,100,2,62
1944427,29,17,1984,7,male,164,69,53,93,42,93,39,0,3
1681475,58,14,1955,7,female,360,69,29,97,134,0,31,97,103
2014718,78,4,1935,11,male,1448,70,22,99,116,34,11,65,105
1599952,18,30,1995,6,female,31,70,52,96,81,86,38,10,43
2191837,26,25,1987,11,female,866,70,41,96,65,86,55,10,10
1065078,33,28,1980,10,female,390,70,49,96,50,96,37,0,13
1813318,34,29,1979,9,female,782,70,27,97,30,97,21,0,9
2155714,33,18,1980,8,male,874,69,40,104,100,104,72,0,28
1490851,57,8,1956,12,female,537,70,50,109,70,0,3,109,67
1528839,71,26,1942,5,male,729,69,45,113,82,0,20,113,62
1658123,33,24,1980,8,female,208,70,50,112,50,58,30,54,20
1481233,33,2,1980,6,male,529,70,54,112,32,107,21,5,11
1524841,37,24,1976,1,female,281,69,45,112,41,111,33,1,8
1534110,31,16,1982,1,male,414,69,44,112,0,112,0,0,0
1486457,25,2,1988,2,female,611,69,31,113,19,113,11,0,8
1711441,38,22,1975,1,female,344,69,49,112,53,112,53,0,0
1212704,46,24,1967,7,male,422,69,64,112,55,112,34,0,21
1206254,15,6,1998,7,female,82,70,40,113,222,113,107,0,115
1928457,58,22,1955,4,female,89,70,42,117,12,0,4,117,8
1643427,53,24,1960,2,female,664,70,28,119,32,0,6,119,26
1924575,54,9,1959,10,female,47,70,57,119,20,119,15,0,5
1980271,47,23,1966,4,female,1127,69,33,114,162,114,54,0,108
1815803,41,21,1972,9,female,652,69,35,114,183,114,91,0,92
1981085,57,21,1956,4,male,52,69,21,120,1,19,1,101,0
2134225,52,9,1961,7,male,752,69,22,123,153,122,135,1,18
1437673,22,13,1991,5,female,326,70,24,124,50,124,38,0,12
2132440,26,16,1987,9,female,93,70,57,121,72,121,24,0,48
1896482,64,4,1949,6,female,860,70,48,130,70,0,38,130,32
2126928,25,8,1988,3,male,164,69,63,127,1,40,1,87,0
1551166,56,23,1957,2,female,998,70,38,129,65,129,31,0,34
2012068,22,11,1991,5,male,613,69,47,133,65,56,24,77,41
2067274,32,3,1981,7,female,228,69,25,135,43,135,20,0,23
1980941,52,29,1961,10,female,444,70,41,135,368,135,321,0,47
1139499,21,21,1992,3,male,650,70,42,139,1,35,0,104,1
1757627,20,16,1993,5,female,21,69,62,139,162,137,124,2,38
1597260,54,1,1959,1,female,308,70,33,149,122,149,62,0,60
2014783,57,30,1956,5,male,1280,70,45,150,131,150,51,0,80
1936618,94,28,1919,9,male,205,69,51,155,52,0,19,155,33
1504363,31,23,1982,10,female,80,70,16,157,151,0,48,157,103
2162583,18,1,1995,1,male,383,70,62,151,84,95,18,56,66
1806430,31,15,1982,5,male,102,69,56,152,117,152,96,0,21
1934340,61,4,1952,6,female,323,69,30,159,15,0,10,159,5
1327229,23,4,1990,7,male,563,69,47,162,20,117,7,45,13
1182519,51,3,1962,4,male,244,70,50,158,51,157,40,1,11
1882033,21,20,1992,10,female,306,70,33,158,174,158,71,0,103
1774092,37,15,1976,6,female,393,69,56,170,131,164,80,6,51
1689248,32,1,1981,9,female,99,69,61,167,252,167,203,0,49
1592500,56,20,1957,10,female,1300,70,17,178,46,0,21,178,25
1620907,57,23,1956,10,female,2112,69,38,175,122,22,32,153,90
1432345,40,22,1973,8,male,463,70,19,180,215,178,189,2,26
2087492,22,19,1991,11,male,1007,70,41,180,2,180,0,0,2
1133804,23,9,1990,12,female,278,69,49,174,79,174,56,0,23
1355274,74,15,1939,12,female,1645,69,40,173,89,173,56,0,33
2170633,27,31,1986,7,male,877,69,20,181,136,181,60,0,76
2151026,38,12,1975,8,female,601,70,45,178,174,178,88,0,86
1674845,23,16,1990,6,female,448,70,27,189,36,0,9,189,27
1148481,59,29,1954,1,female,1777,69,20,189,58,0,10,189,48
1426810,50,25,1963,12,female,365,70,45,187,114,5,70,182,44
2134819,22,5,1991,1,male,522,69,7,184,91,116,44,68,47
1203787,40,13,1973,4,male,391,69,36,189,71,187,55,2,16
1590517,56,26,1957,2,female,1385,70,18,186,22,186,16,0,6
1096423,79,3,1934,4,female,467,70,36,196,23,88,12,108,11
1569419,16,9,1997,9,female,366,69,44,191,3,144,1,47,2
1238216,33,21,1980,5,male,142,70,62,198,25,198,10,0,15
1125470,26,18,1987,2,female,562,70,17,194,187,194,80,0,107
1508797,45,1,1968,1,male,534,70,36,206,14,0,1,206,13
1534787,47,18,1966,8,female,250,69,40,209,389,151,126,58,263
1675255,26,10,1987,9,male,282,70,43,210,30,208,29,2,1
1712179,30,12,1983,2,male,213,70,31,203,47,203,33,0,14
2002541,19,23,1994,1,female,644,70,41,221,150,40,16,181,134
1659211,46,8,1967,6,male,528,69,21,217,37,58,28,159,9
1022892,15,9,1998,4,male,39,70,65,214,20,213,8,1,12
1154695,18,6,1995,1,male,402,70,6,213,1,213,1,0,0
2003404,23,24,1990,6,female,146,69,31,216,77,216,71,0,6
1018523,28,2,1985,9,male,130,70,48,220,94,220,55,0,39
1248677,31,1,1982,3,female,127,69,38,215,74,215,45,0,29
2160137,35,20,1978,5,female,296,70,56,224,51,0,6,224,45
1409968,67,9,1946,10,female,540,70,22,225,51,0,31,225,20
1169509,40,15,1973,10,female,656,70,56,228,82,70,14,158,68
1571382,66,30,1947,6,female,1818,70,58,224,241,218,120,6,121
1252253,43,22,1970,4,female,609,69,44,223,534,223,182,0,352
2144616,18,6,1995,1,male,177,70,46,246,259,218,145,28,114
1875823,18,22,1995,10,female,255,70,32,252,34,0,3,252,31
1489306,37,29,1976,4,male,86,69,58,257,57,224,47,33,10
1690872,16,12,1997,6,male,510,69,40,254,10,254,9,0,1
2138965,62,21,1951,9,male,425,69,36,255,217,255,136,0,81
1658798,21,21,1992,2,female,115,69,61,270,157,49,72,221,85
1909193,59,16,1954,5,female,206,70,64,265,71,0,9,265,62
1673754,63,30,1950,3,female,630,69,39,261,160,11,67,250,93
1667928,50,17,1963,2,male,528,69,44,265,63,83,37,182,26
1438304,52,9,1961,3,female,723,69,57,271,172,130,118,141,54
1729555,30,25,1983,1,female,169,69,21,266,19,266,14,0,5
1192656,54,29,1959,12,male,602,69,50,265,19,265,9,0,10
1559277,38,8,1975,4,female,337,69,55,290,156,290,135,0,21
1738196,64,16,1949,7,male,934,70,51,296,51,49,32,247,19
1647458,108,10,1905,4,female,143,69,29,300,33,296,31,4,2
1980663,33,6,1980,6,male,622,70,43,301,186,301,158,0,28
1334129,51,23,1962,4,female,172,69,46,321,70,0,21,321,49
1277137,45,9,1968,10,female,672,70,46,322,298,177,251,145,47
1680013,32,11,1981,9,female,903,70,35,311,72,307,47,4,25
1103529,42,4,1971,4,male,605,69,41,309,21,309,17,0,4
1003465,43,20,1970,1,male,78,69,67,333,30,50,22,283,8
1433381,19,21,1994,10,female,589,69,57,346,322,31,68,315,254
1930449,39,2,1974,6,female,314,69,54,332,143,270,88,62,55
1744190,62,12,1951,1,female,1347,70,57,341,61,340,48,1,13
2103801,18,19,1995,11,female,288,69,58,330,18,330,18,0,0
1768200,113,18,1900,10,female,1547,70,39,377,337,332,149,45,188
2193278,23,26,1990,10,female,603,69,60,385,38,385,21,0,17
1036679,33,21,1980,1,male,274,70,49,417,27,417,24,0,3
1691524,59,2,1954,3,female,1576,69,40,442,290,0,82,442,208
1387677,25,20,1988,9,male,755,70,27,450,38,450,37,0,1
2058533,64,6,1949,5,female,774,70,48,512,256,0,11,512,245
1645778,23,10,1990,3,male,118,69,43,509,70,498,63,11,7
1928089,19,16,1994,4,female,938,69,59,511,66,509,61,2,5
1270406,49,8,1964,10,male,283,69,18,552,368,552,290,0,78
2139551,69,16,1944,3,female,1482,69,12,597,195,0,48,597,147
1725860,26,6,1987,5,male,352,70,58,569,109,541,73,28,36
1416207,60,18,1953,3,female,370,69,43,581,214,581,99,0,115
1782575,63,11,1950,2,female,216,69,41,578,133,578,54,0,79
1527421,26,26,1987,6,male,233,69,35,640,0,640,0,0,0
1314374,43,28,1970,11,female,315,70,29,698,631,32,374,666,257
1658575,16,10,1997,6,female,459,70,40,701,215,364,18,337,197
1384944,23,23,1990,11,female,707,69,28,726,93,726,56,0,37
2099731,47,2,1966,2,female,311,69,42,782,40,0,12,782,28
1419108,65,27,1948,5,male,1544,69,20,735,145,239,41,496,104
1368211,41,11,1972,1,male,335,69,52,741,434,692,423,49,11
1173549,38,28,1975,9,female,436,70,60,732,207,726,148,6,59
2064816,28,20,1985,3,female,882,70,9,776,1072,776,939,0,133
1803369,33,17,1980,1,male,564,70,47,852,532,83,321,769,211
2154485,49,24,1964,5,female,647,70,34,984,274,284,101,700,173
2138732,39,1,1974,6,female,190,69,49,918,391,873,139,45,252
1101813,51,1,1962,7,male,449,69,21,1055,430,150,299,905,131
2053368,69,1,1944,1,male,323,70,47,998,476,0,189,998,287
1071901,51,17,1962,6,male,545,70,45,1033,88,944,67,89,21
2169198,53,4,1960,6,male,1134,69,54,1030,21,999,7,31,14
1639092,31,5,1982,6,female,1191,70,63,1072,1203,1063,932,9,271
1674048,47,3,1966,6,female,262,69,57,994,196,994,152,0,44
1692580,57,18,1956,2,male,508,70,45,1356,415,0,78,1356,337
1163366,54,14,1959,10,female,311,70,38,1381,960,0,119,1381,841
1251375,55,16,1958,3,female,415,70,45,1345,125,1337,68,8,57
1799311,53,12,1960,5,female,1402,70,49,1437,187,1437,129,0,58
2017383,23,22,1990,8,female,258,69,49,1855,245,1855,81,0,164
1396674,45,13,1968,12,female,272,70,45,1681,64,1681,31,0,33
1886130,42,19,1971,3,female,27,69,22,2150,858,180,94,1970,764
1278132,42,24,1971,5,female,1412,70,31,1983,65,1828,40,155,25
1557009,68,5,1945,1,female,256,69,56,2219,123,2219,100,0,23
1055801,73,29,1940,7,female,97,69,43,2482,295,0,184,2482,111
1207075,58,17,1955,3,female,1481,69,25,2480,1653,0,366,2480,1287
2050320,60,29,1953,4,female,1216,70,18,3236,1995,791,276,2445,1719
1232842,108,19,1905,12,male,1202,69,39,3203,3454,2836,976,367,2478
1459490,40,11,1973,9,female,478,70,60,2385,119,2385,83,0,36
1121159,18,25,1995,11,female,135,69,33,6943,814,6943,704,0,110
1679684,26,1,1987,1,male,320,70,19,3661,391,3661,320,0,71
1144890,58,16,1955,11,male,139,70,34,4280,558,4280,391,0,167
1912326,33,17,1980,8,male,234,72,39,4,6,4,2,0,4
2011373,38,6,1975,5,male,659,71,24,4,6,4,3,0,3
2026067,40,28,1973,6,male,368,71,58,4,80,4,56,0,24
1857532,26,11,1987,2,female,452,73,27,5,0,0,0,5,0
1822529,38,15,1975,6,female,1194,71,44,5,1,0,0,5,1
1551856,70,24,1943,8,female,1501,71,23,5,1,0,0,5,1
1892928,72,3,1941,10,male,756,71,33,5,6,0,3,5,3
1087817,23,17,1990,3,male,413,71,27,5,0,3,0,2,0
2055875,17,24,1996,9,male,585,72,58,5,1,2,1,3,0
1716755,19,12,1994,1,female,278,71,38,5,14,2,0,3,14
1816957,57,8,1956,8,male,718,72,46,5,8,4,5,1,3
1985104,26,30,1987,1,male,513,73,28,5,0,5,0,0,0
1280604,26,13,1987,6,male,430,72,52,5,0,5,0,0,0
1471240,67,11,1946,11,male,934,71,42,5,0,5,0,0,0
1630333,23,11,1990,11,male,306,72,68,5,1,5,1,0,0
1492849,25,2,1988,2,male,258,73,50,5,3,5,3,0,0
1947886,27,28,1986,3,male,106,71,45,5,1,5,1,0,0
1751503,28,27,1985,10,female,337,72,46,5,5,5,5,0,0
2112411,30,10,1983,8,female,530,71,8,5,5,5,5,0,0
1080113,64,2,1949,9,male,331,73,5,5,4,5,3,0,1
1919182,101,18,1912,1,NA,2097,72,34,5,6,5,4,0,2
1012166,15,1,1998,1,male,21,72,68,5,13,5,7,0,6
2114975,21,12,1992,7,female,228,71,30,5,16,5,8,0,8
1187887,22,2,1991,10,female,186,71,48,5,25,5,23,0,2
1079069,33,13,1980,2,male,257,72,31,5,29,5,16,0,13
2048567,13,7,2000,6,male,48,73,71,6,1,0,0,6,1
1173119,80,3,1933,3,male,449,71,49,6,1,0,0,6,1
2186863,66,10,1947,1,male,63,71,54,6,6,0,3,6,3
1615516,94,7,1919,3,female,1299,72,25,6,8,0,1,6,7
2099967,57,26,1956,4,female,829,72,22,6,27,1,10,5,17
1741089,18,26,1995,1,male,437,71,51,6,1,3,1,3,0
1585068,66,26,1947,3,female,1440,72,28,6,1,2,0,4,1
1768852,68,29,1945,7,female,1869,73,20,6,8,4,2,2,6
1810957,24,7,1989,9,male,361,71,65,6,9,3,1,3,8
1946268,64,24,1949,10,male,1661,71,39,6,6,5,4,1,2
1492485,23,13,1990,12,male,545,72,40,6,0,6,0,0,0
1068673,30,10,1983,4,female,297,73,23,6,0,6,0,0,0
1364732,54,2,1959,8,male,127,73,47,6,0,6,0,0,0
1445445,17,10,1996,10,male,533,73,61,6,1,6,1,0,0
1584297,22,3,1991,11,female,476,72,44,6,3,6,0,0,3
1490817,25,4,1988,2,female,128,71,68,6,3,6,3,0,0
1782195,26,1,1987,1,female,375,71,40,6,2,6,0,0,2
1589590,20,13,1993,11,male,157,72,40,6,7,6,4,0,3
1031182,30,13,1983,3,male,389,72,42,6,7,6,3,0,4
1428708,101,18,1912,10,female,668,71,53,6,6,6,5,0,1
2088013,22,21,1991,5,male,596,73,37,6,27,6,17,0,10
2044091,26,2,1987,6,male,377,71,43,6,46,6,19,0,27
2021430,27,6,1986,7,male,341,71,43,6,15,6,8,0,7
1829386,28,6,1985,7,male,469,72,62,6,14,6,11,0,3
1102201,53,24,1960,3,female,1175,72,50,6,12,6,10,0,2
1072833,15,29,1998,10,male,213,73,56,7,0,0,0,7,0
1154412,19,27,1994,8,male,967,73,43,7,1,1,1,6,0
1051068,28,4,1985,7,male,485,73,45,7,1,0,0,7,1
1388652,18,3,1995,8,male,297,72,28,7,4,0,1,7,3
1338849,43,1,1970,10,female,301,71,55,7,3,0,2,7,1
1336345,64,9,1949,7,female,715,73,41,7,4,0,2,7,2
1994175,68,8,1945,3,female,1879,71,33,7,3,0,1,7,2
2131472,48,18,1965,5,male,588,73,17,7,5,0,0,7,5
1892350,108,7,1905,8,male,1507,72,38,7,6,0,3,7,3
1435682,53,15,1960,6,female,31,72,69,7,25,0,11,7,14
1527911,33,15,1980,1,female,271,72,34,7,4,4,1,3,3
1910721,36,15,1977,11,male,1046,73,39,7,2,2,0,5,2
1876451,26,23,1987,7,male,284,71,68,7,10,2,3,5,7
1330568,35,19,1978,10,female,436,72,38,7,11,5,7,2,4
1220983,103,8,1910,11,male,1195,73,48,7,16,4,11,3,5
1757694,14,18,1999,6,male,498,71,45,7,1,7,0,0,1
1843074,21,14,1992,2,male,532,72,10,7,1,7,1,0,0
1040321,25,13,1988,8,female,456,71,38,7,0,7,0,0,0
1038817,28,20,1985,1,male,1002,71,54,7,0,7,0,0,0
1032790,30,23,1983,5,male,1326,73,35,7,0,7,0,0,0
1290479,34,10,1979,7,male,933,72,40,7,1,7,1,0,0
1800326,49,19,1964,5,male,520,72,67,7,0,7,0,0,0
2048219,52,21,1961,9,male,1333,72,30,7,0,7,0,0,0
1403507,108,12,1905,12,male,486,72,41,7,0,7,0,0,0
1601311,23,26,1990,6,male,221,72,68,7,4,7,2,0,2
1347140,19,15,1994,4,male,426,72,41,7,7,7,7,0,0
1918225,23,15,1990,6,male,421,71,34,7,9,7,8,0,1
1593202,29,20,1984,6,female,636,72,35,7,44,7,44,0,0
1425300,17,5,1996,8,male,170,73,40,8,1,0,0,8,1
1176751,46,4,1967,8,male,334,73,54,8,1,0,0,8,1
1187379,52,14,1961,9,male,460,71,53,8,1,0,0,8,1
2181502,60,1,1953,12,male,1832,71,13,8,3,0,1,8,2
1162297,32,9,1981,6,female,393,73,48,8,11,0,4,8,7
1639213,46,4,1967,8,male,460,71,17,8,23,0,16,8,7
1919838,57,10,1956,1,female,1217,72,28,8,13,0,5,8,8
1729169,61,28,1952,9,male,141,71,43,8,13,0,7,8,6
1935669,61,15,1952,4,female,245,72,48,8,4,5,2,3,2
1978548,27,30,1986,8,male,761,71,29,8,104,3,73,5,31
1121042,17,1,1996,11,male,713,71,37,8,1,6,1,2,0
1482941,28,31,1985,10,male,304,73,55,8,0,8,0,0,0
1079713,35,15,1978,6,male,687,71,38,8,0,8,0,0,0
1278856,21,3,1992,11,male,152,73,68,8,2,8,0,0,2
2112235,24,11,1989,3,female,505,73,55,8,2,8,2,0,0
1108283,25,1,1988,1,male,82,73,49,8,2,8,2,0,0
1656329,33,3,1980,9,male,232,72,57,8,2,8,2,0,0
1624021,30,16,1983,1,male,786,71,20,8,10,8,8,0,2
1073183,74,20,1939,10,female,242,72,44,8,11,8,2,0,9
1780440,18,11,1995,10,female,30,73,44,8,552,8,415,0,137
1989843,23,1,1990,1,male,179,73,32,8,13,8,10,0,3
1970148,23,4,1990,2,female,151,72,40,8,17,8,14,0,3
1544536,23,22,1990,4,male,337,73,40,8,45,8,24,0,21
1413417,50,17,1963,1,male,899,73,12,8,13,8,10,0,3
1953398,53,21,1960,5,male,629,72,15,9,1,0,0,9,1
1963918,100,10,1913,12,male,460,72,6,9,5,0,3,9,2
2004717,28,10,1985,7,male,337,72,23,9,8,0,2,9,6
1827553,67,7,1946,12,female,1639,73,20,9,18,0,13,9,5
1264451,20,7,1993,1,male,4,72,72,9,0,3,0,6,0
1276797,18,24,1995,10,female,418,72,53,9,5,2,3,7,2
2098118,29,27,1984,5,male,544,73,53,9,4,8,1,1,3
1993584,71,18,1942,4,female,1502,71,54,9,4,8,4,1,0
2116879,16,8,1997,5,male,166,73,56,9,0,9,0,0,0
1006841,37,13,1976,11,female,230,71,50,9,1,9,1,0,0
1645832,14,15,1999,3,female,331,71,35,9,8,9,6,0,2
1333953,19,23,1994,5,male,77,71,46,9,7,9,5,0,2
2121040,20,14,1993,10,male,758,73,28,9,12,9,11,0,1
1284433,31,28,1982,11,male,559,71,63,9,7,9,5,0,2
1207598,33,27,1980,10,male,244,72,62,9,9,9,7,0,2
1884830,60,1,1953,6,female,640,72,17,9,16,9,10,0,6
1711913,108,7,1905,12,male,1897,73,12,9,14,9,8,0,6
2055955,31,19,1982,12,male,369,73,72,10,0,0,0,10,0
1282487,17,27,1996,9,male,224,73,54,10,4,0,1,10,3
2109944,23,6,1990,7,male,374,73,46,10,2,0,2,10,0
1829554,73,23,1940,7,female,284,73,43,10,2,0,0,10,2
1999963,78,19,1935,1,male,1742,71,53,10,1,5,0,5,1
1813058,23,27,1990,1,male,581,71,31,10,12,4,6,6,6
1394971,56,17,1957,9,male,1512,71,33,10,72,5,57,5,15
1767728,18,27,1995,1,male,208,71,27,10,46,9,24,1,22
1712647,24,5,1989,9,male,1300,72,21,10,2,10,1,0,1
1971515,34,23,1979,2,male,456,73,62,10,4,10,4,0,0
1464420,37,23,1976,2,male,426,71,49,10,4,10,0,0,4
1740871,52,7,1961,12,male,1722,72,32,10,5,10,3,0,2
1385359,27,6,1986,6,male,413,73,54,10,10,10,10,0,0
1993494,28,2,1985,4,male,364,73,52,10,13,10,13,0,0
2057081,28,28,1985,12,male,427,73,62,10,20,10,18,0,2
1699997,35,24,1978,12,male,654,71,67,10,17,10,17,0,0
1939088,37,1,1976,9,male,706,73,42,10,38,10,33,0,5
1677199,40,30,1973,1,male,39,73,27,10,37,10,20,0,17
1824931,103,20,1910,8,male,945,71,43,10,18,10,12,0,6
1537569,21,24,1992,10,male,292,72,67,11,2,2,0,9,2
1871380,19,22,1994,10,male,424,72,50,11,12,1,2,10,10
1362280,56,20,1957,5,female,112,71,29,11,7,0,5,11,2
1780950,22,5,1991,5,male,872,72,58,11,2,9,2,2,0
1220254,20,5,1993,10,female,526,72,37,11,0,11,0,0,0
2096693,24,7,1989,1,female,300,71,65,11,1,11,1,0,0
1618316,28,21,1985,5,male,355,73,68,11,0,11,0,0,0
1588839,20,28,1993,3,male,269,72,54,11,5,11,4,0,1
1607401,25,18,1988,10,female,328,71,3,11,3,11,3,0,0
1317420,19,11,1994,5,male,384,73,50,11,8,11,6,0,2
1655997,23,14,1990,9,female,581,71,39,11,9,11,4,0,5
1341198,33,18,1980,2,female,316,72,49,11,17,11,5,0,12
1040064,26,21,1987,1,male,402,73,61,12,4,0,1,12,3
1320594,37,27,1976,8,female,403,72,29,12,4,0,4,12,0
1217701,49,10,1964,4,male,1877,71,52,12,3,0,0,12,3
1871371,71,23,1942,12,male,1474,73,10,12,4,0,1,12,3
2106111,55,1,1958,12,female,186,71,51,12,9,0,3,12,6
1035040,78,25,1935,3,male,2330,73,24,12,20,0,6,12,14
1620122,16,16,1997,5,male,317,71,41,12,3,3,2,9,1
1320698,31,3,1982,2,male,321,71,67,12,2,11,1,1,1
1819060,81,13,1932,6,female,381,72,55,12,2,11,2,1,0
1884867,19,15,1994,4,female,164,73,26,12,0,12,0,0,0
2124323,28,7,1985,7,male,611,71,53,12,0,12,0,0,0
1877751,14,5,1999,3,male,232,72,24,12,7,12,5,0,2
1907212,60,6,1953,1,female,400,73,36,12,17,12,0,0,17
2091169,28,12,1985,10,male,266,71,51,12,141,12,108,0,33
1558130,41,17,1972,9,female,188,72,58,12,30,12,20,0,10
1107662,46,17,1967,9,male,1025,71,46,13,0,0,0,13,0
1215150,89,8,1924,9,female,1439,72,34,13,4,0,1,13,3
1379750,13,15,2000,2,female,280,72,51,13,61,0,18,13,43
1790573,56,5,1957,9,female,1538,72,36,13,40,1,12,12,28
1308507,27,28,1986,9,male,455,71,54,13,16,8,14,5,2
1600137,19,2,1994,12,male,320,72,56,13,4,11,0,2,4
1875509,61,18,1952,5,female,873,72,51,13,19,12,5,1,14
2054193,64,26,1949,8,male,2273,73,32,13,17,12,16,1,1
1580270,53,28,1960,2,male,1163,73,33,13,21,10,15,3,6
1113233,34,22,1979,2,male,201,71,43,13,1,13,1,0,0
1105466,26,30,1987,6,male,248,73,68,13,7,13,6,0,1
1635972,28,12,1985,12,male,529,71,35,13,5,13,5,0,0
1461244,28,19,1985,7,female,202,71,42,13,7,13,5,0,2
1692578,39,22,1974,9,male,873,71,34,13,5,13,5,0,0
1825066,103,27,1910,2,female,690,71,48,13,12,13,8,0,4
1071654,18,17,1995,7,male,43,73,48,13,23,13,19,0,4
1386607,15,16,1998,7,male,354,71,53,14,1,0,0,14,1
1029829,19,17,1994,12,male,550,72,63,14,5,0,0,14,5
1608070,21,18,1992,6,male,220,73,53,14,3,0,0,14,3
1204758,33,21,1980,1,male,414,73,47,14,2,9,0,5,2
2019162,61,22,1952,3,female,660,72,31,14,7,4,4,10,3
2021764,28,28,1985,4,male,526,72,56,14,12,13,10,1,2
1391615,22,1,1991,6,male,523,72,38,14,1,14,1,0,0
1584682,24,3,1989,3,male,368,72,46,14,0,14,0,0,0
1094652,30,9,1983,4,male,46,71,66,14,1,14,1,0,0
1104798,30,9,1983,8,male,93,71,60,14,0,14,0,0,0
1088941,83,4,1930,9,female,655,71,61,14,0,14,0,0,0
1394735,30,1,1983,6,male,382,71,55,14,5,14,5,0,0
2101703,26,7,1987,7,male,643,73,55,14,22,14,11,0,11
1055608,29,29,1984,4,female,709,72,20,14,21,14,20,0,1
1003641,29,30,1984,10,female,278,71,29,14,29,14,2,0,27
1352280,35,10,1978,10,female,506,73,31,15,3,0,0,15,3
1694349,50,1,1963,10,male,571,73,35,15,26,0,4,15,22
2092553,57,22,1956,11,male,662,72,17,15,7,7,5,8,2
1613657,56,19,1957,5,female,383,72,35,15,9,8,6,7,3
1377129,55,23,1958,1,female,519,72,29,15,7,11,4,4,3
1496072,31,5,1982,12,female,289,71,38,15,49,13,31,2,18
1665251,16,10,1997,2,female,206,71,20,15,8,15,8,0,0
1651685,43,25,1970,9,male,718,73,40,15,4,15,3,0,1
1082976,16,13,1997,8,female,18,71,64,15,17,15,17,0,0
1373129,39,23,1974,7,male,997,73,38,15,17,15,14,0,3
1527018,44,9,1969,9,male,700,72,51,15,18,15,5,0,13
1109102,30,24,1983,3,male,218,71,46,16,9,0,1,16,8
1265423,55,6,1958,4,female,1121,72,47,16,14,0,1,16,13
1355686,27,12,1986,6,male,304,73,37,16,1,4,1,12,0
1344670,23,5,1990,2,female,355,73,52,16,18,10,5,6,13
1785866,20,21,1993,8,male,625,71,35,16,2,16,2,0,0
1249867,33,20,1980,8,male,224,72,72,16,0,16,0,0,0
1572887,17,26,1996,10,male,403,72,26,16,6,16,6,0,0
2031018,17,2,1996,7,female,375,71,9,16,16,16,16,0,0
1001755,53,28,1960,10,female,1415,71,29,16,13,16,12,0,1
1910910,38,7,1975,1,male,222,73,45,16,24,16,14,0,10
1376425,39,2,1974,11,female,187,72,65,17,9,0,6,17,3
1413872,15,28,1998,5,male,149,73,59,17,11,0,1,17,10
1899870,29,4,1984,5,male,503,71,55,17,1,4,0,13,1
1629008,33,2,1980,1,male,511,73,61,17,7,5,5,12,2
1816380,54,4,1959,5,male,557,73,64,17,4,16,2,1,2
1751837,37,31,1976,5,female,1421,71,19,17,52,15,22,2,30
1560105,66,10,1947,11,female,1759,71,34,17,31,14,12,3,19
1272238,26,2,1987,2,male,531,72,71,17,1,17,1,0,0
1260130,74,29,1939,9,male,339,73,61,17,3,17,1,0,2
1435255,18,18,1995,3,male,680,71,29,17,14,17,2,0,12
1957516,54,19,1959,6,male,164,71,33,17,17,17,12,0,5
2172310,22,16,1991,4,female,625,71,34,17,37,17,30,0,7
1992917,19,26,1994,11,male,441,71,60,18,1,4,0,14,1
1662153,35,8,1978,4,female,487,73,34,18,7,4,2,14,5
1841039,22,1,1991,10,female,526,73,26,18,131,8,60,10,71
2153816,59,20,1954,1,female,2300,71,51,18,0,16,0,2,0
2097297,15,2,1998,10,male,38,71,52,18,2,18,2,0,0
1751581,16,30,1997,10,male,128,71,62,18,8,18,7,0,1
1863062,66,25,1947,10,male,408,71,44,18,4,18,1,0,3
1610216,31,16,1982,2,male,300,73,50,18,11,18,5,0,6
1474990,44,3,1969,3,male,918,73,38,18,13,18,12,0,1
1958384,44,23,1969,3,female,370,72,46,18,67,18,27,0,40
1233998,62,12,1951,1,female,1144,72,15,18,77,18,58,0,19
1413049,29,15,1984,12,male,351,73,49,19,0,0,0,19,0
1178876,52,10,1961,9,female,636,72,60,19,1,0,0,19,1
1295286,23,27,1990,7,female,125,73,64,19,6,0,2,19,4
1169020,24,24,1989,1,female,548,72,41,19,6,1,2,18,4
1916716,53,10,1960,12,male,224,72,48,19,6,0,4,19,2
1341898,27,1,1986,4,male,379,72,50,19,16,11,2,8,14
1998872,24,28,1989,2,male,595,72,50,19,2,19,0,0,2
1781834,24,17,1989,2,female,305,73,45,19,0,19,0,0,0
1026790,31,5,1982,9,male,1036,72,43,19,2,19,0,0,2
1221859,57,27,1956,9,male,1009,71,47,19,2,19,2,0,0
1529023,57,8,1956,4,male,1200,73,29,20,32,0,15,20,17
2057050,26,30,1987,1,male,342,73,49,20,8,8,5,12,3
1723362,57,10,1956,3,female,1670,73,49,20,24,6,14,14,10
2175005,21,10,1992,8,male,108,72,49,20,5,20,5,0,0
1565951,19,27,1994,5,male,405,71,48,20,28,20,26,0,2
1753763,27,2,1986,2,male,304,71,49,20,27,20,21,0,6
2071731,100,1,1913,12,male,1671,72,26,20,22,20,19,0,3
1241104,51,2,1962,8,male,965,71,38,21,0,0,0,21,0
1509208,54,19,1959,10,male,641,72,40,21,11,0,1,21,10
1368759,67,21,1946,8,male,890,71,39,21,95,1,55,20,40
1618733,106,29,1907,12,male,348,73,68,21,3,14,2,7,1
1159547,18,29,1995,8,male,95,71,47,21,0,21,0,0,0
1844988,23,2,1990,9,male,114,72,41,21,21,21,19,0,2
1318151,46,6,1967,12,female,442,72,30,21,29,21,20,0,9
2106631,50,4,1963,6,female,714,72,53,22,1,0,1,22,0
1267236,42,7,1971,7,male,243,73,47,22,10,0,8,22,2
1580932,44,20,1969,4,female,1276,72,38,22,21,3,8,19,13
1983898,27,12,1986,12,male,289,71,30,22,29,21,15,1,14
1592672,20,2,1993,10,male,154,73,66,22,27,22,16,0,11
1431586,27,5,1986,12,male,377,71,35,22,15,22,13,0,2
1887489,30,17,1983,7,male,427,71,39,22,16,22,13,0,3
1630760,20,16,1993,12,female,233,73,45,22,44,22,30,0,14
1325297,108,24,1905,8,NA,2594,72,38,23,8,0,1,23,7
1430267,76,10,1937,1,female,2078,73,28,23,30,12,5,11,25
1994068,46,30,1967,6,male,99,73,41,23,17,21,14,2,3
1820304,57,17,1956,4,male,66,73,63,23,1,23,1,0,0
1201399,22,9,1991,9,male,742,73,30,23,8,23,5,0,3
1551680,58,29,1955,3,male,1159,73,56,23,7,23,6,0,1
1313016,15,9,1998,3,male,738,71,52,23,17,23,10,0,7
1990288,51,15,1962,11,female,321,73,57,24,0,0,0,24,0
1314249,30,5,1983,9,male,731,72,21,24,1,24,1,0,0
1126258,18,7,1995,10,female,301,71,56,24,25,24,9,0,16
1599553,27,10,1986,9,female,436,71,44,24,33,24,32,0,1
1984071,40,20,1973,9,male,254,72,33,24,54,24,42,0,12
1004640,27,3,1986,5,male,383,72,48,25,16,0,5,25,11
2034463,48,20,1965,1,male,359,73,38,25,8,21,4,4,4
1507049,23,4,1990,2,male,313,72,54,25,21,24,4,1,17
1933638,66,15,1947,8,male,1698,72,14,25,92,24,55,1,37
1499811,20,1,1993,5,male,143,73,25,25,8,25,3,0,5
1867908,30,16,1983,5,female,513,71,25,25,34,25,26,0,8
1383035,98,29,1915,8,female,510,72,53,25,20,25,20,0,0
1438395,45,7,1968,11,male,758,73,30,26,11,3,6,23,5
1176228,45,17,1968,10,female,529,71,34,26,11,0,5,26,6
1848239,60,24,1953,2,female,429,71,26,26,7,1,4,25,3
1629962,75,26,1938,4,female,950,71,34,26,5,0,4,26,1
1171096,42,11,1971,10,male,310,71,37,26,39,17,5,9,34
1984687,28,9,1985,9,male,1693,72,29,26,26,22,14,4,12
1128309,32,26,1981,9,male,333,72,68,26,25,25,12,1,13
1248766,75,18,1938,12,female,685,72,45,26,2,26,2,0,0
1878689,38,1,1975,1,female,326,71,47,26,9,26,6,0,3
2059267,16,29,1997,10,male,253,73,38,26,17,26,15,0,2
1381434,28,20,1985,10,male,236,73,39,26,16,26,7,0,9
1140641,54,2,1959,3,female,768,72,37,26,72,26,38,0,34
1799130,63,4,1950,11,female,692,73,30,26,56,26,26,0,30
2012404,31,1,1982,1,male,324,71,22,27,2,0,0,27,2
1016694,19,24,1994,4,male,239,71,58,27,7,11,3,16,4
2144880,21,13,1992,2,male,574,72,47,27,16,26,11,1,5
1935560,22,28,1991,2,male,171,72,50,27,21,25,15,2,6
1237931,44,19,1969,11,female,193,71,31,27,8,27,4,0,4
1400578,33,19,1980,5,female,395,72,44,27,39,27,19,0,20
1700538,43,1,1970,4,male,139,71,26,27,25,27,20,0,5
1070493,68,3,1945,7,female,1580,71,23,28,3,0,2,28,1
1877473,18,7,1995,9,male,534,71,44,28,9,2,3,26,6
1292951,32,26,1981,11,male,575,71,59,28,0,28,0,0,0
1176572,36,7,1977,8,male,45,73,64,28,0,28,0,0,0
1601113,14,11,1999,11,male,24,73,71,28,23,28,15,0,8
2082301,19,12,1994,9,female,81,73,51,28,36,28,13,0,23
1413373,26,5,1987,5,male,321,72,64,29,65,2,28,27,37
1288435,39,7,1974,11,male,510,71,51,29,64,15,33,14,31
1581047,23,9,1990,6,female,660,72,45,29,26,22,24,7,2
1423328,60,11,1953,5,male,1255,71,25,29,114,28,78,1,36
1012517,24,26,1989,10,female,283,73,30,29,26,29,26,0,0
1163844,33,6,1980,12,female,821,72,32,29,98,29,79,0,19
1506618,61,21,1952,6,female,1668,73,18,31,3,4,2,27,1
1059840,63,24,1950,1,male,1526,72,42,31,16,0,2,31,14
2150733,27,30,1986,4,female,385,71,31,30,20,16,6,14,14
1121343,59,1,1954,1,female,283,71,60,30,45,23,19,7,26
2064914,31,19,1982,12,female,249,71,57,30,2,30,1,0,1
1767217,31,17,1982,4,female,961,71,35,30,15,30,11,0,4
1806791,31,1,1982,1,female,212,72,53,30,23,30,14,0,9
1097725,35,13,1978,4,male,460,71,58,31,28,31,27,0,1
1555395,22,7,1991,5,female,708,71,51,30,55,30,42,0,13
1383248,70,22,1943,11,female,2325,73,55,32,25,0,15,32,10
2162168,22,12,1991,3,male,23,71,60,32,16,22,10,10,6
1974197,16,17,1997,9,female,55,71,45,32,9,30,3,2,6
1923513,40,21,1973,2,male,235,73,48,32,32,32,29,0,3
1702300,21,19,1992,1,female,439,71,35,33,9,4,2,29,7
1229982,39,28,1974,10,female,545,71,16,33,18,23,15,10,3
1330143,78,16,1935,7,female,121,71,57,33,19,16,13,17,6
1961609,42,8,1971,1,male,589,73,62,33,44,16,18,17,26
2056278,67,23,1946,6,female,1387,72,19,33,4,25,4,8,0
1426052,16,22,1997,6,male,588,71,47,33,8,25,7,8,1
1451450,36,16,1977,10,male,413,72,62,33,14,33,10,0,4
1668980,42,20,1971,10,female,212,71,43,34,19,0,12,34,7
1062680,69,4,1944,4,male,789,73,58,34,27,0,6,34,21
1717235,83,18,1930,2,female,1636,72,15,34,50,0,19,34,31
1989331,28,27,1985,8,female,451,71,35,34,58,0,22,34,36
1584384,53,31,1960,1,male,1030,71,29,34,35,29,31,5,4
1553997,57,15,1956,4,male,579,73,43,34,29,30,14,4,15
2191188,23,9,1990,7,male,252,72,51,34,3,34,2,0,1
1850595,44,29,1969,9,male,240,72,52,34,9,34,7,0,2
1217932,60,22,1953,11,female,1605,71,35,34,10,34,8,0,2
1038253,18,14,1995,9,male,414,71,62,35,1,0,1,35,0
1084521,22,22,1991,4,male,159,72,61,36,0,1,0,35,0
1688615,50,1,1963,1,male,378,71,40,36,4,6,1,30,3
1325463,70,26,1943,7,female,710,73,19,36,48,0,17,36,31
2031804,106,1,1907,1,male,928,72,16,36,53,3,33,33,20
2132007,58,9,1955,6,female,276,71,32,35,27,18,13,17,14
1745769,59,17,1954,7,male,336,71,14,36,141,30,81,6,60
1090833,63,2,1950,9,male,1222,72,18,36,3,36,2,0,1
1957526,29,7,1984,12,male,45,73,50,36,12,36,10,0,2
2025360,31,5,1982,5,male,192,71,34,35,26,35,25,0,1
1762250,31,20,1982,3,female,60,71,49,36,74,36,62,0,12
1636723,49,9,1964,11,female,1135,72,48,35,54,35,22,0,32
1215745,53,7,1960,2,female,405,73,55,37,10,10,2,27,8
1695847,14,3,1999,6,male,734,71,34,37,3,32,0,5,3
1632581,57,27,1956,7,female,742,71,44,37,46,28,33,9,13
2190366,54,5,1959,1,female,309,73,54,37,0,37,0,0,0
1693484,25,1,1988,1,male,125,71,60,37,10,37,8,0,2
1648507,40,12,1973,11,female,686,72,48,37,206,37,184,0,22
1902652,71,9,1942,6,male,1190,71,37,38,47,0,19,38,28
2139325,25,1,1988,9,male,476,71,47,39,18,15,2,24,16
1589549,33,11,1980,4,male,326,72,53,38,9,8,3,30,6
1135122,69,29,1944,1,female,1745,71,28,38,19,17,13,21,6
1554988,55,9,1958,1,male,192,73,42,39,100,35,52,4,48
1466976,23,2,1990,3,male,334,71,35,38,3,38,2,0,1
1541206,25,1,1988,1,female,287,72,43,38,20,38,20,0,0
1390113,29,11,1984,7,male,357,73,33,39,34,39,30,0,4
1189798,43,1,1970,6,female,629,73,34,39,31,39,23,0,8
1213418,113,18,1900,1,female,1172,73,40,38,27,38,24,0,3
1445693,67,20,1946,9,female,1742,72,29,40,4,19,2,21,2
1539705,24,14,1989,3,female,213,71,39,40,32,38,32,2,0
1390085,36,11,1977,9,female,376,73,51,40,15,40,13,0,2
1130677,46,27,1967,12,female,420,71,62,40,11,40,8,0,3
1167894,57,8,1956,9,male,676,71,12,40,19,40,17,0,2
1235353,14,2,1999,12,female,242,73,47,40,71,40,23,0,48
1375903,24,17,1989,1,female,389,71,17,40,86,40,53,0,33
2053793,16,3,1997,6,female,437,73,46,42,17,1,2,41,15
2032699,16,24,1997,9,male,5,72,62,41,55,2,10,39,45
1043176,49,10,1964,9,male,484,72,45,42,69,6,20,36,49
1769240,60,15,1953,8,female,636,71,48,41,6,18,5,23,1
1676364,17,14,1996,4,female,505,71,43,41,29,23,25,18,4
1203981,41,3,1972,8,male,165,72,61,41,84,16,19,25,65
1208125,62,18,1951,10,female,153,72,61,42,276,27,140,15,136
1802797,47,25,1966,8,male,2321,72,37,41,4,39,4,2,0
1975002,19,4,1994,4,female,260,71,62,41,5,41,5,0,0
1410637,21,1,1992,3,male,403,72,39,41,10,41,5,0,5
1511641,27,22,1986,1,male,733,72,27,42,14,42,8,0,6
2012991,50,19,1963,8,male,612,73,43,41,25,41,14,0,11
1646821,49,11,1964,10,male,527,72,58,43,29,0,7,43,22
1870183,71,11,1942,6,male,1500,71,22,44,118,0,16,44,102
1327679,78,5,1935,12,female,1515,73,38,44,122,1,81,43,41
1354651,26,26,1987,3,male,353,71,65,44,27,18,23,26,4
1518891,28,14,1985,5,male,562,73,52,44,10,44,6,0,4
1157960,29,27,1984,6,female,491,72,31,43,11,43,8,0,3
2111900,48,7,1965,1,female,555,71,49,44,22,44,14,0,8
1029282,37,20,1976,12,male,1013,72,36,43,52,43,46,0,6
2024029,33,9,1980,8,female,252,72,39,44,123,44,114,0,9
1742770,69,25,1944,5,female,1764,71,34,45,14,0,1,45,13
2118570,57,7,1956,3,male,484,71,62,45,38,0,5,45,33
1735637,18,15,1995,10,female,559,73,27,45,146,25,71,20,75
1201499,25,11,1988,11,male,106,73,71,45,24,45,22,0,2
2127443,29,19,1984,5,female,105,72,53,45,50,45,42,0,8
2148978,44,25,1969,10,male,187,71,31,45,108,45,100,0,8
1297559,33,16,1980,2,male,183,71,51,47,3,4,0,43,3
1947636,18,25,1995,5,male,760,71,20,46,25,0,4,46,21
1878696,57,20,1956,3,male,572,73,56,46,23,7,18,39,5
1796935,22,15,1991,6,female,51,71,49,46,18,32,4,14,14
1006866,16,26,1997,3,male,108,73,58,46,4,46,3,0,1
1405371,16,10,1997,10,female,301,72,38,47,5,47,4,0,1
2013699,108,18,1905,3,male,1023,73,38,47,0,47,0,0,0
1586726,19,10,1994,3,female,397,72,31,46,22,46,20,0,2
1162228,47,22,1966,7,female,251,71,58,47,26,47,21,0,5
1824566,22,1,1991,1,male,360,73,25,46,59,46,59,0,0
1044481,18,15,1995,2,male,81,72,70,48,16,0,1,48,15
1230541,64,28,1949,12,male,998,73,16,48,12,0,7,48,5
1722544,24,14,1989,7,female,1172,73,11,48,54,3,8,45,46
1028792,66,17,1947,3,male,1651,72,33,49,8,23,1,26,7
1771921,18,5,1995,7,female,96,71,1,48,504,47,346,1,158
1875567,15,21,1998,11,female,363,72,43,49,10,49,9,0,1
1105248,31,26,1982,10,female,183,72,35,49,21,49,14,0,7
1209810,47,7,1966,7,male,515,72,28,50,14,0,10,50,4
1706380,23,13,1990,6,male,435,72,33,50,17,37,7,13,10
1142569,37,9,1976,2,male,465,72,37,50,53,44,40,6,13
1514553,13,1,2000,7,female,14,72,37,50,189,49,105,1,84
1214229,18,1,1995,2,male,222,73,68,50,5,50,4,0,1
1568404,16,21,1997,1,male,356,72,50,51,56,51,54,0,2
1289413,24,30,1989,11,female,224,72,46,51,38,51,35,0,3
1572805,18,27,1995,3,male,374,72,51,53,11,0,1,53,10
1140668,19,30,1994,4,male,125,73,66,52,2,37,0,15,2
1352013,103,30,1910,12,male,1759,73,44,52,19,15,3,37,16
1301319,25,1,1988,1,male,262,72,18,53,15,53,15,0,0
2135058,83,22,1930,10,male,71,71,46,53,24,53,15,0,9
2098276,71,28,1942,1,female,1810,71,39,54,5,0,0,54,5
1234677,103,29,1910,3,male,356,73,56,55,67,38,54,17,13
1632341,20,8,1993,11,male,84,73,55,55,156,37,54,18,102
1747088,23,10,1990,3,male,560,71,53,54,11,54,11,0,0
1038340,30,6,1983,1,female,286,73,45,54,28,54,15,0,13
1022140,49,17,1964,9,male,715,71,53,54,63,54,36,0,27
1073670,25,8,1988,11,female,549,72,20,58,46,1,14,57,32
1411212,37,24,1976,10,male,905,71,40,57,38,28,18,29,20
1323185,53,20,1960,2,female,1456,73,30,58,106,26,84,32,22
1716441,31,24,1982,10,male,302,72,55,56,18,56,14,0,4
1246678,25,12,1988,1,male,57,72,66,58,215,58,186,0,29
1462846,27,23,1986,10,female,216,73,38,56,138,56,100,0,38
2001473,15,14,1998,8,male,182,71,65,59,0,0,0,59,0
1684580,21,15,1992,7,female,173,73,32,60,46,60,24,0,22
1521143,36,10,1977,7,male,1124,73,43,62,23,0,9,62,14
1690810,53,25,1960,9,male,185,71,51,62,119,13,54,49,65
1019158,62,20,1951,7,female,789,73,50,63,9,56,8,7,1
1335108,18,9,1995,6,male,183,71,53,61,30,54,13,7,17
1005621,39,25,1974,1,female,566,73,48,63,34,48,13,15,21
1392438,52,11,1961,2,female,1164,72,38,61,8,61,6,0,2
1209960,31,1,1982,1,male,264,71,41,61,68,61,51,0,17
1003723,19,1,1994,1,male,328,73,54,63,140,63,135,0,5
1578407,27,28,1986,11,female,252,73,44,63,114,63,90,0,24
1218980,19,2,1994,2,male,337,71,38,64,15,0,4,64,11
1543530,25,13,1988,2,male,1660,71,31,65,215,11,85,54,130
1761934,60,11,1953,11,female,1536,72,29,65,29,33,14,32,15
1769412,44,10,1969,3,male,406,72,72,64,17,61,12,3,5
1145115,56,28,1957,5,female,971,73,40,65,11,65,9,0,2
1847026,69,7,1944,9,female,96,72,56,64,31,64,12,0,19
1531376,48,19,1965,3,female,159,72,54,67,115,0,17,67,98
1965742,24,19,1989,5,male,252,72,50,68,36,66,15,2,21
1288003,19,23,1994,10,male,46,71,52,67,58,64,23,3,35
2012359,32,23,1981,1,male,525,73,38,68,76,60,35,8,41
1610654,36,3,1977,2,male,434,72,48,68,5,68,4,0,1
2188702,38,5,1975,1,male,364,72,70,67,13,67,7,0,6
1582601,70,20,1943,7,female,1697,72,41,68,14,68,8,0,6
1307550,40,9,1973,4,female,124,73,62,68,79,68,73,0,6
2057950,49,11,1964,7,female,474,72,53,70,28,0,5,70,23
1814760,62,15,1951,3,female,551,72,35,69,53,13,34,56,19
1771928,64,7,1949,8,female,2043,71,42,70,50,3,19,67,31
1403146,100,7,1913,9,female,459,71,36,70,3,70,3,0,0
1309010,17,8,1996,6,male,431,72,30,71,34,71,24,0,10
1999127,25,20,1988,6,female,459,71,14,71,46,71,46,0,0
1612164,51,3,1962,7,male,674,73,35,71,74,71,43,0,31
1471377,43,10,1970,4,male,304,73,37,73,76,4,30,69,46
1587839,57,18,1956,7,female,1225,73,45,74,141,0,5,74,136
1502975,61,3,1952,11,female,666,71,60,73,18,50,8,23,10
1134619,54,21,1959,10,female,1558,71,27,74,24,65,20,9,4
1911098,25,16,1988,10,female,152,72,41,72,18,72,9,0,9
1228446,74,22,1939,12,female,1625,71,32,76,18,8,10,68,8
2172500,34,1,1979,12,female,442,73,28,77,55,44,15,33,40
1586331,52,30,1961,12,male,560,71,58,76,53,54,36,22,17
1306334,19,24,1994,7,male,383,72,37,75,3,75,2,0,1
1940842,25,14,1988,2,female,500,72,18,77,58,77,53,0,5
1780563,29,18,1984,6,female,322,72,41,80,99,18,17,62,82
1642404,58,1,1955,3,male,203,71,68,79,101,79,42,0,59
1286487,74,24,1939,2,female,214,73,52,84,19,0,12,84,7
1409160,25,15,1988,7,female,269,73,55,81,52,54,29,27,23
2005692,28,31,1985,3,female,97,71,70,82,106,38,52,44,54
2171795,18,3,1995,8,female,131,72,41,81,174,80,51,1,123
1004315,28,15,1985,4,female,556,71,23,82,5,82,5,0,0
1585010,30,30,1983,9,female,538,73,21,84,2,84,2,0,0
1574544,17,29,1996,7,female,170,72,39,84,61,84,12,0,49
1277718,27,18,1986,10,male,638,72,48,81,58,81,42,0,16
1443493,57,30,1956,12,female,1096,72,48,84,231,84,224,0,7
2138364,56,7,1957,2,female,441,71,41,85,51,0,14,85,37
1673552,20,2,1993,7,female,252,72,53,88,111,1,25,87,86
1639788,50,9,1963,11,male,684,73,19,91,86,1,29,90,57
2015098,30,6,1983,5,female,599,73,36,90,39,89,36,1,3
2135722,27,17,1986,7,male,43,71,60,89,18,89,15,0,3
2040452,108,28,1905,6,female,1026,72,49,88,38,88,32,0,6
1870966,25,10,1988,8,female,397,73,37,89,88,89,55,0,33
2032643,34,26,1979,1,male,379,71,48,89,76,89,75,0,1
1275155,53,14,1960,4,female,255,72,45,89,57,89,37,0,20
1865751,59,30,1954,6,female,736,72,44,93,1,0,1,93,0
1370690,30,22,1983,6,male,458,71,31,92,28,0,5,92,23
1996205,44,12,1969,10,female,421,72,46,94,132,0,43,94,89
1038751,43,9,1970,4,female,489,72,32,95,48,41,17,54,31
1786190,53,18,1960,2,female,1544,71,26,92,41,72,19,20,22
1842593,52,30,1961,4,male,263,71,43,95,72,83,43,12,29
1730659,15,29,1998,5,male,573,73,50,92,25,92,19,0,6
1640997,28,17,1985,1,male,384,72,49,94,39,94,24,0,15
1847477,33,1,1980,1,male,327,72,57,95,17,95,5,0,12
1849669,57,15,1956,12,female,1663,73,28,94,71,94,30,0,41
1633749,50,6,1963,3,male,215,73,69,93,353,93,231,0,122
1341338,19,3,1994,1,male,121,72,54,97,64,8,37,89,27
1188810,54,7,1959,9,male,1758,72,42,99,16,78,11,21,5
1932341,16,10,1997,3,female,214,71,49,97,1,97,1,0,0
1440905,51,24,1962,2,female,100,73,57,97,435,97,358,0,77
1315190,71,22,1942,9,female,1398,73,47,102,19,0,7,102,12
1974024,30,16,1983,6,female,286,73,43,102,157,7,37,95,120
1026339,92,26,1921,4,female,2022,71,23,100,56,81,40,19,16
1626419,45,22,1968,9,male,635,72,55,100,12,100,6,0,6
1962023,44,13,1969,8,female,540,72,41,103,37,103,30,0,7
2143414,66,20,1947,12,male,955,71,42,102,88,102,67,0,21
1500187,17,28,1996,4,female,208,71,54,109,91,0,31,109,60
1083173,60,25,1953,2,male,419,71,38,107,148,0,30,107,118
1527335,65,7,1948,2,female,938,73,45,107,5,33,4,74,1
1785686,49,2,1964,9,male,885,73,35,105,63,104,46,1,17
1887053,66,11,1947,11,female,942,71,25,108,77,107,50,1,27
1753850,32,4,1981,4,female,612,71,26,106,76,106,48,0,28
1555673,51,26,1962,12,male,179,71,37,105,66,105,56,0,10
1441603,51,16,1962,3,female,1187,73,14,105,113,105,96,0,17
1097515,56,1,1957,1,male,57,71,56,107,77,107,66,0,11
1747921,113,10,1900,9,female,1487,72,23,109,231,109,99,0,132
1524061,57,20,1956,6,male,733,73,53,110,17,0,8,110,9
1488343,58,23,1955,4,female,260,72,32,113,93,0,3,113,90
1028700,25,16,1988,3,female,375,73,34,110,12,83,7,27,5
1554807,16,23,1997,7,female,226,71,37,110,2,110,1,0,1
1731365,22,7,1991,1,male,469,71,24,110,61,110,33,0,28
1571984,36,22,1977,8,female,334,73,17,110,32,110,28,0,4
1151054,23,28,1990,6,female,263,71,55,112,187,112,114,0,73
1836498,74,26,1939,4,male,78,71,71,115,62,1,17,114,45
1990381,33,19,1980,12,female,357,71,31,116,33,42,3,74,30
1669065,55,1,1958,8,female,1611,73,33,114,39,44,26,70,13
1465732,70,10,1943,2,female,865,72,31,116,140,64,52,52,88
1924060,24,17,1989,8,male,483,72,58,114,137,114,115,0,22
1959765,49,12,1964,2,female,259,73,55,119,77,119,71,0,6
1053505,53,28,1960,2,male,304,73,27,117,219,117,165,0,54
1947409,55,22,1958,10,female,938,73,49,123,56,26,12,97,44
1169459,14,27,1999,7,female,64,73,67,124,90,71,53,53,37
1371448,18,11,1995,6,male,108,72,60,124,4,124,1,0,3
1485273,22,25,1991,3,male,303,72,38,120,18,120,14,0,4
1218444,31,17,1982,12,male,601,73,44,124,0,124,0,0,0
1035739,32,9,1981,8,female,335,72,35,122,50,122,41,0,9
1103344,37,25,1976,11,female,352,71,21,121,49,121,25,0,24
1900524,61,6,1952,2,female,1258,71,28,130,9,0,2,130,7
1288062,27,1,1986,2,female,532,73,28,128,131,128,120,0,11
1009154,50,31,1963,1,male,442,72,15,136,80,0,27,136,53
1683728,21,1,1992,1,male,175,72,51,136,123,108,69,28,54
1836490,31,30,1982,12,female,587,72,46,131,348,114,331,17,17
1370434,20,19,1993,4,female,311,72,64,131,6,131,5,0,1
1151879,68,5,1945,8,male,1544,72,39,142,5,0,1,142,4
1742403,27,4,1986,10,female,385,71,25,139,43,13,6,126,37
1365051,51,20,1962,4,male,818,73,46,142,29,0,1,142,28
1187381,60,4,1953,1,female,290,71,47,140,180,91,148,49,32
1391661,44,21,1969,5,male,1766,72,43,139,118,115,75,24,43
2030783,25,10,1988,8,male,389,73,61,142,2,142,2,0,0
2120343,54,14,1959,12,male,86,72,63,142,10,142,6,0,4
1800951,62,30,1951,8,female,105,72,66,143,4,143,4,0,0
1055528,24,21,1989,5,female,207,72,50,139,24,139,15,0,9
1882318,22,12,1991,2,female,62,71,58,141,174,141,145,0,29
1939065,28,1,1985,8,male,806,71,26,146,51,8,42,138,9
1503472,34,2,1979,1,female,583,73,17,147,421,120,319,27,102
2087892,38,10,1975,11,female,274,72,64,144,7,144,2,0,5
2005421,46,25,1967,9,female,768,71,44,147,36,147,32,0,4
1542503,55,11,1958,2,female,368,72,55,156,17,0,4,156,13
1894269,62,1,1951,9,female,401,72,47,154,11,97,4,57,7
1955511,56,26,1957,8,female,1578,71,26,155,352,31,215,124,137
1074424,18,4,1995,11,male,450,73,54,156,1,156,1,0,0
1120173,31,24,1982,9,male,478,73,34,153,10,153,10,0,0
1416373,34,1,1979,1,male,1333,73,39,154,4,154,4,0,0
1237761,15,17,1998,4,female,157,72,48,164,52,5,15,159,37
2162620,36,19,1977,12,female,487,72,37,162,0,162,0,0,0
1699755,21,26,1992,6,male,155,72,68,160,69,160,45,0,24
1566719,27,26,1986,7,male,192,72,66,163,42,163,28,0,14
1464419,110,5,1903,11,female,1992,71,32,169,62,0,33,169,29
1231939,24,21,1989,9,female,724,71,36,165,97,115,50,50,47
1221713,21,19,1992,12,male,244,73,52,167,119,68,91,99,28
2124381,21,12,1992,1,female,645,71,32,167,82,165,67,2,15
1624680,100,14,1913,10,male,1160,71,24,172,32,170,32,2,0
1277682,45,1,1968,11,male,496,72,35,167,37,167,36,0,1
1233273,37,30,1976,1,female,136,71,31,169,175,169,123,0,52
1841248,61,9,1952,2,female,663,72,44,179,49,0,15,179,34
1217338,35,20,1978,4,female,274,72,52,174,143,0,42,174,101
1305848,30,21,1983,11,male,272,73,46,176,80,165,72,11,8
1720381,23,28,1990,12,male,259,73,39,174,19,174,15,0,4
1028050,49,5,1964,2,female,351,72,62,175,9,175,6,0,3
1119233,63,7,1950,3,female,984,71,46,189,81,0,18,189,63
1447110,24,3,1989,1,female,149,71,47,188,48,41,33,147,15
1890177,17,14,1996,8,male,404,73,49,183,8,179,7,4,1
1969590,61,26,1952,11,female,708,72,49,185,48,185,43,0,5
1320055,42,4,1971,5,female,571,73,24,193,4,0,1,193,3
1498657,41,4,1972,11,female,625,73,48,198,65,0,10,198,55
1116462,62,11,1951,9,female,234,71,18,195,95,33,64,162,31
1024707,17,13,1996,5,female,272,71,22,197,9,52,1,145,8
1519969,67,28,1946,7,male,1341,72,39,193,30,110,13,83,17
1216559,17,28,1996,7,male,497,73,42,191,95,51,36,140,59
1066966,27,17,1986,2,female,590,71,42,195,23,157,16,38,7
1000709,38,18,1975,11,female,524,72,45,193,203,193,193,0,10
1570196,30,20,1983,2,female,582,73,48,211,153,36,79,175,74
1701492,62,27,1951,12,female,1567,72,52,210,179,3,44,207,135
1979887,64,6,1949,5,female,487,73,19,211,141,1,27,210,114
1050499,63,5,1950,10,female,858,71,48,206,76,206,57,0,19
1964298,80,30,1933,4,male,472,71,20,212,23,0,8,212,15
1007699,22,10,1991,6,female,349,73,37,219,270,156,74,63,196
1901400,31,28,1982,7,male,293,73,53,217,94,203,62,14,32
1004537,28,12,1985,11,female,316,73,47,216,187,184,41,32,146
2026345,38,7,1975,4,male,100,72,35,218,27,218,12,0,15
1926164,28,30,1985,11,male,166,72,55,214,38,214,29,0,9
1231469,62,6,1951,10,female,1192,71,32,223,54,0,11,223,43
2179641,24,23,1989,1,female,90,72,42,228,193,102,108,126,85
1522867,37,16,1976,8,female,195,72,55,225,116,171,80,54,36
1032819,63,3,1950,2,female,200,72,54,232,19,232,19,0,0
1995260,36,11,1977,9,female,771,72,37,225,128,225,103,0,25
1285390,32,4,1981,11,female,426,73,50,224,138,224,84,0,54
1625105,33,24,1980,11,female,288,71,65,242,224,226,182,16,42
1148091,29,27,1984,12,female,392,71,33,241,50,241,32,0,18
1797666,45,24,1968,8,female,392,71,37,241,91,241,37,0,54
1597810,68,1,1945,6,male,322,71,52,244,130,244,86,0,44
1391004,18,17,1995,4,female,510,73,54,253,58,242,33,11,25
1342327,17,30,1996,11,female,268,73,31,258,19,258,16,0,3
1204940,44,15,1969,11,female,171,73,59,255,19,255,10,0,9
1357171,60,3,1953,10,male,826,73,41,254,11,254,10,0,1
1890893,25,27,1988,3,male,51,71,65,260,130,260,98,0,32
1793264,29,19,1984,10,female,168,72,49,247,86,247,83,0,3
1727862,45,24,1968,9,female,42,71,62,258,96,258,74,0,22
2078086,62,5,1951,12,female,311,71,39,252,124,252,87,0,37
2059204,68,4,1945,7,female,905,72,24,272,100,0,67,272,33
1149659,47,10,1966,9,female,1110,73,52,268,137,147,94,121,43
1173968,35,30,1978,9,female,464,73,57,269,126,238,34,31,92
1788304,55,3,1958,2,male,1229,71,21,269,75,261,56,8,19
1713786,25,8,1988,8,female,409,71,41,271,142,271,124,0,18
1282261,33,27,1980,8,female,231,73,62,267,168,267,64,0,104
1341520,62,16,1951,2,female,334,73,64,265,315,265,247,0,68
2107697,29,27,1984,3,female,630,72,28,290,169,3,20,287,149
2062669,56,19,1957,11,female,719,72,32,290,192,0,59,290,133
2149448,41,20,1972,2,male,122,71,63,289,12,286,6,3,6
1874682,48,20,1965,5,female,1868,73,40,282,227,251,149,31,78
2071628,57,15,1956,8,female,403,72,58,288,18,288,11,0,7
1787123,29,21,1984,11,male,428,71,61,287,109,287,95,0,14
1032975,20,12,1993,7,male,41,71,57,297,198,90,108,207,90
1040358,69,18,1944,9,male,2020,72,30,295,75,280,25,15,50
1415661,81,29,1932,3,female,1232,71,18,307,77,300,46,7,31
1043771,43,8,1970,7,female,800,72,65,296,235,264,85,32,150
1378982,36,2,1977,1,male,114,73,53,298,77,298,49,0,28
1875402,59,22,1954,4,female,378,71,64,327,121,0,76,327,45
1021321,61,30,1952,3,female,318,71,42,327,154,0,68,327,86
1067459,65,25,1948,4,male,565,72,30,324,146,0,53,324,93
1197438,16,8,1997,7,female,528,72,29,326,12,326,11,0,1
1149708,45,8,1968,7,female,21,71,55,317,258,317,240,0,18
1418039,19,19,1994,4,male,359,71,44,343,70,9,40,334,30
1828587,92,4,1921,1,NA,2303,73,28,339,350,266,240,73,110
1956944,32,26,1981,11,female,603,72,40,369,1147,132,479,237,668
2188589,47,11,1966,7,female,1461,72,17,348,73,337,60,11,13
1234366,47,2,1966,2,male,487,73,58,356,59,356,45,0,14
1605412,34,15,1979,8,female,491,72,34,358,114,358,104,0,10
1977958,48,30,1965,10,female,254,72,36,357,216,357,105,0,111
1303943,66,9,1947,10,male,663,71,46,385,13,0,2,385,11
1831286,57,18,1956,9,female,138,73,58,370,82,0,2,370,80
1651599,61,29,1952,11,female,370,72,38,389,107,0,27,389,80
1396013,65,4,1948,3,female,740,72,47,382,107,194,54,188,53
2107381,48,16,1965,3,male,644,71,38,372,1278,191,956,181,322
1147148,37,5,1976,5,female,353,72,42,371,241,357,177,14,64
1819422,27,17,1986,10,male,292,72,39,385,55,385,39,0,16
2070442,34,11,1979,4,female,557,73,42,390,219,390,167,0,52
1670996,28,22,1985,3,male,224,72,56,385,267,385,184,0,83
1584838,38,20,1975,3,female,1758,72,40,401,63,152,23,249,40
1288605,48,22,1965,12,male,250,71,65,407,299,114,134,293,165
1484870,18,1,1995,1,male,265,71,43,411,123,378,21,33,102
1035635,48,15,1965,3,female,954,71,34,412,41,412,27,0,14
1555367,25,26,1988,6,female,465,73,48,421,157,421,137,0,20
1131015,62,24,1951,10,male,347,71,28,442,65,48,52,394,13
1846104,28,10,1985,8,male,445,72,34,446,230,360,158,86,72
1881721,62,30,1951,7,female,145,72,54,451,270,347,226,104,44
1634476,68,10,1945,6,female,1153,72,36,445,97,346,59,99,38
1591780,37,21,1976,5,male,494,73,42,435,320,384,270,51,50
1262340,20,16,1993,4,female,490,72,54,428,215,428,112,0,103
1552785,24,26,1989,4,male,282,71,40,457,19,22,10,435,9
1869952,61,14,1952,10,female,473,73,65,452,11,0,6,452,5
1172987,50,4,1963,2,female,575,73,41,494,209,0,26,494,183
1896029,30,6,1983,9,female,418,71,21,507,337,0,41,507,296
2062166,63,19,1950,1,female,1480,72,36,490,54,455,13,35,41
1214420,73,19,1940,9,female,1269,72,34,493,83,485,39,8,44
2121533,52,28,1961,7,female,490,71,22,494,694,494,441,0,253
1050997,40,13,1973,8,female,668,72,39,539,256,85,164,454,92
1608494,39,19,1974,10,female,507,73,40,530,78,530,78,0,0
2172502,40,7,1973,12,female,174,71,60,521,98,521,76,0,22
1847030,26,1,1987,5,female,352,73,21,544,876,544,424,0,452
1859584,13,8,2000,8,male,58,71,59,584,35,0,9,584,26
1920039,18,29,1995,6,female,76,73,70,601,178,431,75,170,103
1537815,58,30,1955,5,male,317,73,35,605,400,487,106,118,294
1564012,43,6,1970,10,female,1626,72,50,574,483,570,168,4,315
1901968,39,6,1974,9,female,450,71,33,564,246,564,156,0,90
1045818,20,20,1993,8,male,193,71,17,566,673,566,643,0,30
1077551,18,31,1995,10,female,289,73,32,620,240,615,190,5,50
1438039,20,14,1993,1,female,134,71,48,625,260,625,179,0,81
1557001,60,18,1953,3,female,1239,71,58,675,131,0,18,675,113
2072095,62,24,1951,7,female,333,71,53,668,232,44,6,624,226
1264705,56,24,1957,8,female,787,73,36,687,996,0,443,687,553
1651820,72,11,1941,11,female,1750,71,17,675,479,1,33,674,446
1476176,30,5,1983,7,female,412,71,45,724,130,724,122,0,8
1953666,55,20,1958,12,female,359,73,21,727,288,36,192,691,96
1543448,31,20,1982,7,female,218,71,39,769,779,769,360,0,419
1472157,33,5,1980,5,female,43,72,43,828,143,828,142,0,1
2187225,36,19,1977,12,male,316,72,54,869,264,869,209,0,55
2042482,38,11,1975,10,male,156,71,47,838,343,838,193,0,150
1739971,39,9,1974,3,female,291,72,51,976,530,22,202,954,328
1740056,17,14,1996,9,female,426,73,46,944,148,924,93,20,55
1924983,44,18,1969,9,female,270,71,53,890,903,810,612,80,291
2059498,40,3,1973,10,female,117,73,63,953,67,951,39,2,28
1905038,54,1,1959,5,female,414,72,45,946,130,946,91,0,39
2099657,72,29,1941,11,female,1909,73,19,1101,245,0,97,1101,148
2062123,19,18,1994,8,female,422,73,44,1009,441,268,317,741,124
1820503,16,15,1997,9,female,131,71,21,1104,1062,253,145,851,917
1024915,52,2,1961,12,female,124,73,64,1002,280,990,116,12,164
1015651,56,30,1957,12,female,529,72,27,1023,204,891,128,132,76
1019816,31,25,1982,1,female,304,72,48,1129,71,1128,43,1,28
1277577,53,28,1960,2,male,118,72,58,1115,3,1115,3,0,0
1490075,31,23,1982,2,female,252,72,13,1132,1245,2,413,1130,832
1326123,20,21,1993,5,female,322,71,30,1216,139,1216,20,0,119
1798493,19,20,1994,12,female,25,71,26,1209,318,1209,297,0,21
1240490,52,25,1961,5,female,1593,72,32,1479,532,918,64,561,468
2143361,56,16,1957,8,female,403,72,49,1376,1039,1376,675,0,364
1703236,70,30,1943,10,female,247,71,54,1751,525,0,166,1751,359
2045294,53,31,1960,10,NA,1346,73,25,1808,1566,1734,679,74,887
1024214,50,1,1963,8,male,1089,72,49,1725,36,1723,7,2,29
1027292,33,10,1980,12,female,395,71,49,1764,551,1753,394,11,157
1064399,38,20,1975,11,female,34,72,68,1717,222,1717,202,0,20
1110567,29,14,1984,7,male,102,72,44,1650,494,1650,488,0,6
2171887,48,12,1965,6,male,302,72,38,1532,3490,1532,3113,0,377
1908925,17,1,1996,1,female,93,72,45,2037,2236,578,428,1459,1808
1576350,41,11,1972,7,female,280,71,48,2017,161,2017,85,0,76
1557328,25,23,1988,3,male,523,72,56,1947,908,1947,853,0,55
1103614,20,4,1993,4,male,543,72,50,2304,1664,2304,987,0,677
1077096,50,18,1963,10,female,705,72,57,2432,201,2432,127,0,74
1807546,55,29,1958,7,female,426,72,23,5887,4499,11,930,5876,3569
1507101,36,5,1977,5,female,118,71,34,7345,240,7003,18,342,222
1217951,32,15,1981,7,female,278,72,27,3844,227,3821,111,23,116
1439182,63,7,1950,4,female,139,71,58,4019,541,4012,468,7,73
1041565,42,2,1971,8,female,239,73,25,6399,1494,6397,801,2,693
1918371,37,17,1976,2,female,326,76,60,1,31,1,10,0,21
1285106,40,21,1973,2,male,242,75,60,1,32,1,15,0,17
1973235,41,25,1972,10,female,208,76,35,1,14,1,12,0,2
1180115,42,9,1971,5,male,671,74,40,1,45,1,41,0,4
1689523,46,1,1967,3,male,414,76,42,1,2,1,1,0,1
1088513,50,22,1963,1,female,270,76,12,1,2,1,2,0,0
1563701,53,29,1960,9,female,119,76,62,1,6,1,5,0,1
1368814,61,24,1952,6,female,1324,75,22,1,11,1,7,0,4
1652681,63,30,1950,10,male,791,76,44,1,2,1,1,0,1
2124987,75,7,1938,11,male,380,75,38,1,20,1,16,0,4
1847751,99,26,1914,11,male,779,76,30,1,13,1,8,0,5
1073624,103,17,1910,2,male,691,74,54,1,2,1,1,0,1
1914542,103,20,1910,5,female,125,76,18,1,11,1,6,0,5
1785287,103,19,1910,9,male,428,75,49,1,3,1,3,0,0
1905678,17,17,1996,12,male,567,76,45,2,0,0,0,2,0
2008297,25,10,1988,5,female,348,76,35,2,0,0,0,2,0
1923293,32,6,1981,9,male,1595,75,51,2,0,0,0,2,0
1058355,21,28,1992,12,male,485,76,51,2,1,0,0,2,1
1066388,49,31,1964,10,male,309,76,51,2,1,0,0,2,1
2031407,54,2,1959,9,male,332,75,19,2,1,0,1,2,0
1322487,19,7,1994,7,male,193,76,18,2,2,0,0,2,2
1584421,23,29,1990,6,female,700,75,55,2,2,0,2,2,0
1103394,32,10,1981,11,male,307,74,49,2,2,0,0,2,2
1827039,31,26,1982,9,male,552,74,41,2,2,0,1,2,1
1704365,55,3,1958,4,female,1534,74,27,2,2,0,0,2,2
2080033,58,22,1955,5,male,928,76,52,2,2,0,0,2,2
1633915,14,23,1999,5,female,39,76,57,2,9,0,2,2,7
2083784,19,26,1994,11,male,536,74,60,2,7,0,4,2,3
1877937,18,12,1995,1,female,594,74,30,2,7,0,1,2,6
1107761,47,26,1966,11,male,232,75,35,2,5,0,5,2,0
1583822,64,15,1949,4,male,242,74,57,2,3,0,3,2,0
1733682,19,29,1994,7,male,630,75,36,2,0,1,0,1,0
1229397,38,17,1975,3,male,496,76,15,2,2,1,2,1,0
1744277,21,14,1992,12,female,246,76,52,2,64,1,31,1,33
1196180,24,20,1989,12,male,681,76,43,2,48,1,31,1,17
1389694,23,3,1990,4,male,243,75,63,2,28,1,23,1,5
1509823,29,24,1984,6,female,586,75,31,2,28,1,11,1,17
1776286,56,21,1957,12,female,1217,75,37,2,7,1,4,1,3
1350718,17,26,1996,10,male,304,75,63,2,0,2,0,0,0
1410974,18,18,1995,9,female,728,76,66,2,0,2,0,0,0
2092407,20,13,1993,6,female,149,75,63,2,0,2,0,0,0
1538963,21,29,1992,5,male,626,74,31,2,0,2,0,0,0
1620428,22,26,1991,3,male,349,74,68,2,0,2,0,0,0
1739217,23,30,1990,1,male,473,75,44,2,0,2,0,0,0
1815784,23,10,1990,8,male,298,74,61,2,0,2,0,0,0
1726731,26,30,1987,10,female,62,74,52,2,0,2,0,0,0
1248543,29,8,1984,1,female,394,76,59,2,0,2,0,0,0
1173591,29,4,1984,4,male,208,75,58,2,0,2,0,0,0
1384731,31,2,1982,4,male,293,74,26,2,0,2,0,0,0
1593901,34,10,1979,2,male,687,74,15,2,0,2,0,0,0
2026343,43,14,1970,2,male,856,74,67,2,0,2,0,0,0
2111614,45,29,1968,7,male,357,76,45,2,0,2,0,0,0
1711764,49,26,1964,1,female,331,76,28,2,0,2,0,0,0
2047364,68,10,1945,2,female,388,76,41,2,0,2,0,0,0
1979006,18,12,1995,5,male,74,74,66,2,1,2,1,0,0
2185328,24,8,1989,10,female,384,74,64,2,1,2,1,0,0
1269907,30,10,1983,12,male,269,76,58,2,1,2,0,0,1
2129825,38,1,1975,1,male,484,75,37,2,1,2,1,0,0
1478212,58,1,1955,4,male,1151,74,3,2,1,2,1,0,0
1141139,103,2,1910,3,female,785,75,32,2,1,2,1,0,0
2138276,107,18,1906,6,male,233,76,55,2,1,2,1,0,0
1761821,19,17,1994,8,male,145,76,58,2,2,2,2,0,0
2108118,20,25,1993,7,male,466,76,51,2,2,2,2,0,0
1112555,30,14,1983,2,female,559,74,24,2,2,2,2,0,0
2171957,15,8,1998,9,female,146,76,64,2,4,2,4,0,0
1506588,19,12,1994,12,female,281,76,38,2,21,2,20,0,1
1641230,18,24,1995,2,male,207,75,46,2,12,2,11,0,1
1431233,20,17,1993,2,male,385,76,44,2,3,2,0,0,3
1396177,23,7,1990,1,female,439,75,19,2,43,2,41,0,2
1750684,23,1,1990,1,male,234,74,61,2,8,2,7,0,1
1850147,24,10,1989,10,female,389,74,21,2,7,2,4,0,3
1898423,26,26,1987,11,male,285,75,37,2,5,2,4,0,1
1421212,25,1,1988,1,male,90,74,26,2,19,2,2,0,17
1614763,25,23,1988,10,male,997,75,43,2,4,2,3,0,1
1570620,26,26,1987,9,female,367,76,43,2,8,2,6,0,2
1628742,28,1,1985,1,male,312,75,51,2,20,2,8,0,12
1885921,28,26,1985,6,male,667,75,28,2,26,2,21,0,5
2168008,30,30,1983,8,male,342,76,42,2,5,2,0,0,5
2178865,32,6,1981,12,male,949,75,35,2,11,2,8,0,3
1622991,31,7,1982,3,female,247,74,32,2,9,2,9,0,0
1493255,34,25,1979,3,female,329,74,55,2,13,2,13,0,0
1485572,38,30,1975,9,male,371,76,35,2,11,2,9,0,2
1533668,41,11,1972,4,male,499,74,49,2,11,2,5,0,6
1294638,50,24,1963,12,male,751,76,42,2,4,2,3,0,1
1263697,58,7,1955,12,female,1346,74,19,2,5,2,3,0,2
1009312,66,12,1947,8,female,1701,74,8,2,12,2,11,0,1
1332642,108,3,1905,12,female,1418,75,20,2,6,2,6,0,0
1263087,108,8,1905,8,male,661,76,61,2,6,2,5,0,1
1818853,14,10,1999,12,male,176,74,64,3,0,0,0,3,0
2016278,17,8,1996,3,male,219,76,35,3,0,0,0,3,0
1650315,16,28,1997,2,female,272,75,62,3,1,0,0,3,1
1211513,25,28,1988,2,male,51,75,70,3,1,0,0,3,1
1489724,47,21,1966,7,male,601,76,26,3,45,0,28,3,17
2058864,51,13,1962,3,female,344,75,54,3,11,0,6,3,5
1431211,19,6,1994,7,male,549,75,44,3,1,1,0,2,1
1148595,54,26,1959,2,female,1010,76,18,3,3,2,1,1,2
1698482,18,15,1995,4,male,532,75,47,3,0,3,0,0,0
2102207,19,4,1994,3,male,559,74,63,3,0,3,0,0,0
1874980,26,1,1987,1,male,271,75,41,3,0,3,0,0,0
1498217,26,27,1987,4,male,322,74,69,3,0,3,0,0,0
1036876,38,19,1975,2,male,948,76,71,3,0,3,0,0,0
1647572,102,1,1911,1,male,383,74,47,3,0,3,0,0,0
1510339,66,2,1947,1,male,1475,76,34,3,1,3,1,0,0
2100732,15,20,1998,7,male,189,74,56,3,4,3,3,0,1
1787001,18,18,1995,11,female,216,74,55,3,2,3,2,0,0
1920820,19,4,1994,7,female,615,75,46,3,3,3,2,0,1
1075872,22,19,1991,5,female,47,76,64,3,2,3,2,0,0
1119398,23,1,1990,11,female,386,75,44,3,4,3,1,0,3
2180281,24,1,1989,4,female,602,76,60,3,3,3,3,0,0
1007013,15,1,1998,1,male,568,75,35,3,74,3,57,0,17
1119099,18,21,1995,11,male,255,75,55,3,5,3,3,0,2
1281706,20,11,1993,6,male,92,74,63,3,13,3,7,0,6
2021711,23,5,1990,2,male,176,76,30,3,5,3,5,0,0
1901855,24,16,1989,8,male,364,76,30,3,18,3,5,0,13
1769363,30,30,1983,6,female,208,74,47,3,73,3,34,0,39
1355435,76,2,1937,2,female,83,76,25,3,7,3,3,0,4
1930657,17,17,1996,5,male,628,76,46,4,2,0,1,4,1
2002617,22,5,1991,4,male,366,75,68,4,2,0,1,4,1
1553487,19,12,1994,8,male,34,76,65,4,17,0,5,4,12
1141183,35,3,1978,1,female,518,74,53,4,46,0,32,4,14
1989988,53,17,1960,4,male,1899,75,21,4,20,0,9,4,11
1984251,55,30,1958,3,female,621,74,35,4,9,0,4,4,5
1858143,69,7,1944,11,female,740,76,44,4,19,0,13,4,6
1032934,17,19,1996,4,male,559,75,42,4,0,2,0,2,0
1198096,24,10,1989,7,female,531,76,65,4,0,1,0,3,0
1688955,29,5,1984,1,male,549,75,22,4,0,1,0,3,0
1550220,25,30,1988,7,female,665,75,18,4,1,2,0,2,1
1031310,14,7,1999,1,male,112,74,63,4,4,1,0,3,4
1493033,24,17,1989,11,male,635,75,44,4,39,2,18,2,21
1043457,26,11,1987,1,male,742,74,52,4,6,2,5,2,1
1772963,49,17,1964,11,male,156,74,56,4,13,1,5,3,8
1997808,63,4,1950,9,male,1744,76,35,4,3,3,2,1,1
1912714,16,23,1997,8,male,308,75,33,4,0,4,0,0,0
1220862,16,29,1997,9,male,667,74,52,4,0,4,0,0,0
1296435,17,30,1996,3,male,591,76,58,4,0,4,0,0,0
1936833,18,13,1995,4,male,49,76,72,4,0,4,0,0,0
1433620,21,12,1992,12,male,291,76,67,4,0,4,0,0,0
1721290,21,7,1992,2,male,234,75,18,4,0,4,0,0,0
1209161,25,2,1988,2,male,496,74,38,4,0,4,0,0,0
2089942,31,3,1982,4,male,683,76,72,4,0,4,0,0,0
1598063,25,14,1988,9,male,252,74,60,4,2,4,2,0,0
1146772,47,27,1966,6,male,1782,74,10,4,1,4,1,0,0
1543951,18,22,1995,5,male,66,76,72,4,5,4,5,0,0
2168389,23,1,1990,1,male,349,74,70,4,5,4,4,0,1
1241356,27,28,1986,9,male,233,76,74,4,3,4,3,0,0
1034703,63,7,1950,4,female,211,76,53,4,5,4,5,0,0
2076304,17,7,1996,5,female,209,74,54,4,9,4,6,0,3
2006824,18,8,1995,5,male,357,76,57,4,6,4,6,0,0
1529534,22,16,1991,1,male,106,76,56,4,7,4,5,0,2
2134271,22,6,1991,5,male,511,76,64,4,13,4,13,0,0
1520081,24,3,1989,7,female,59,74,62,4,16,4,11,0,5
1785718,26,20,1987,8,male,477,74,44,4,6,4,6,0,0
1807279,36,28,1977,9,male,849,76,24,5,0,0,0,5,0
1546214,64,2,1949,7,male,479,76,18,5,0,0,0,5,0
2104298,15,4,1998,10,male,50,74,66,5,1,0,0,5,1
1985343,28,22,1985,1,male,233,75,50,5,1,0,1,5,0
1700928,40,15,1973,5,male,320,76,36,5,24,0,15,5,9
1064067,59,30,1954,12,female,485,74,58,5,26,0,12,5,14
1583638,60,17,1953,4,male,23,76,73,5,10,0,0,5,10
1340098,108,29,1905,12,male,1060,75,44,5,0,2,0,3,0
1690612,16,5,1997,9,female,88,74,64,5,6,1,1,4,5
1360953,67,30,1946,11,male,1779,75,49,5,6,1,4,4,2
1650235,24,1,1989,4,female,160,74,33,5,19,3,12,2,7
2116993,30,11,1983,1,female,745,74,31,5,39,3,4,2,35
1646616,57,6,1956,9,female,589,74,32,5,23,2,14,3,9
1498722,35,13,1978,5,male,277,75,30,5,2,4,1,1,1
1903581,25,25,1988,3,male,251,75,43,5,0,5,0,0,0
1624987,26,2,1987,2,female,478,75,66,5,0,5,0,0,0
1844430,23,12,1990,12,male,452,74,52,5,2,5,2,0,0
1513396,33,18,1980,2,male,635,75,18,5,1,5,1,0,0
1420473,108,6,1905,12,male,494,75,35,5,3,5,2,0,1
2158769,25,2,1988,2,male,624,76,29,5,5,5,3,0,2
2001931,27,28,1986,12,male,171,75,74,5,4,5,2,0,2
1177720,41,18,1972,12,female,489,74,38,5,6,5,5,0,1
1204133,16,28,1997,12,male,421,76,37,5,32,5,12,0,20
1899885,21,23,1992,12,male,224,75,51,5,14,5,10,0,4
2135754,22,1,1991,4,male,96,74,56,5,8,5,8,0,0
1250105,27,15,1986,8,male,748,76,72,5,11,5,10,0,1
1484505,33,6,1980,5,male,446,74,41,5,9,5,7,0,2
1081602,34,1,1979,1,male,318,75,65,5,49,5,32,0,17
1971396,40,13,1973,8,female,402,74,50,5,21,5,12,0,9
1411107,56,18,1957,5,female,175,74,56,5,21,5,15,0,6
1227686,27,29,1986,12,male,311,74,51,6,2,0,1,6,1
1717742,26,27,1987,7,male,338,76,53,6,7,0,2,6,5
1582651,13,1,2000,1,male,263,74,68,6,93,0,41,6,52
1107814,55,12,1958,10,female,931,74,20,6,27,0,10,6,17
1298945,59,12,1954,6,male,850,75,5,6,28,0,20,6,8
1838700,73,14,1940,2,female,270,74,48,6,17,0,1,6,16
1093053,16,2,1997,8,male,136,74,52,6,23,4,12,2,11
1021556,37,20,1976,5,male,382,76,61,6,20,5,4,1,16
1861735,16,13,1997,3,female,452,74,38,6,0,6,0,0,0
2130062,18,16,1995,8,female,357,74,33,6,0,6,0,0,0
1285681,22,24,1991,8,female,431,75,40,6,0,6,0,0,0
2130529,24,2,1989,4,male,668,76,55,6,0,6,0,0,0
1473570,46,3,1967,7,female,245,76,51,6,0,6,0,0,0
1221843,68,27,1945,11,male,663,74,40,6,0,6,0,0,0
1130226,18,28,1995,4,male,177,74,50,6,1,6,0,0,1
1829102,19,16,1994,4,male,718,75,66,6,3,6,3,0,0
1602787,30,21,1983,10,male,376,75,45,6,3,6,3,0,0
1583457,19,12,1994,4,female,261,74,29,6,6,6,5,0,1
2099110,37,29,1976,6,male,181,75,60,6,8,6,1,0,7
1093319,18,1,1995,2,male,171,75,50,6,14,6,14,0,0
1306764,19,27,1994,5,female,240,76,40,6,15,6,10,0,5
1260442,19,9,1994,5,male,159,74,47,6,19,6,17,0,2
1226722,20,2,1993,2,female,38,74,10,6,18,6,15,0,3
1909795,20,2,1993,3,male,302,75,36,6,9,6,6,0,3
1145748,33,1,1980,12,male,46,75,73,6,18,6,10,0,8
1422477,46,11,1967,8,male,1909,74,8,6,9,6,6,0,3
1536537,25,1,1988,1,male,43,76,59,7,0,0,0,7,0
1737129,66,16,1947,11,female,916,74,28,7,0,0,0,7,0
1475205,19,21,1994,2,male,385,75,49,7,3,0,1,7,2
1938944,54,6,1959,5,female,218,74,36,7,6,0,1,7,5
2050652,21,15,1992,9,male,232,74,43,7,11,0,6,7,5
2072277,55,2,1958,6,male,1435,74,49,7,0,2,0,5,0
1265347,30,24,1983,8,female,606,76,61,7,3,4,1,3,2
1728111,59,4,1954,7,male,376,75,54,7,3,4,3,3,0
1254856,19,6,1994,4,male,581,76,62,7,34,2,10,5,24
1858432,51,22,1962,9,female,1084,75,27,7,14,3,7,4,7
1401513,19,20,1994,9,male,732,76,45,7,1,6,1,1,0
1179056,38,9,1975,6,male,197,74,57,7,0,7,0,0,0
1971960,27,22,1986,6,female,396,75,27,7,2,7,1,0,1
2061524,15,20,1998,1,male,302,76,39,7,6,7,4,0,2
1508538,34,22,1979,1,female,374,74,59,7,5,7,5,0,0
1784022,25,10,1988,1,male,131,74,22,7,40,7,21,0,19
1821668,30,14,1983,7,male,1124,75,38,7,18,7,7,0,11
1165558,34,16,1979,7,male,125,74,29,7,13,7,10,0,3
1950370,14,17,1999,9,female,304,75,59,8,10,0,0,8,10
1087548,50,17,1963,1,male,76,76,36,8,8,0,4,8,4
1597901,20,7,1993,10,male,295,76,41,8,120,0,49,8,71
2174663,55,25,1958,9,female,185,75,50,8,26,0,15,8,11
1484459,67,13,1946,10,male,322,75,28,8,20,4,12,4,8
1719142,23,26,1990,8,male,295,76,29,8,0,6,0,2,0
1571169,16,20,1997,2,female,234,74,68,8,0,8,0,0,0
1682336,27,11,1986,5,male,970,76,47,8,1,8,1,0,0
1447633,28,16,1985,8,male,331,75,49,8,1,8,1,0,0
1442934,14,20,1999,9,male,182,76,74,8,2,8,2,0,0
1732849,21,21,1992,12,female,549,74,35,8,3,8,3,0,0
1290068,24,18,1989,4,female,29,75,46,8,6,8,3,0,3
1599065,30,2,1983,7,male,579,76,18,8,8,8,5,0,3
1473816,33,15,1980,1,female,398,74,37,8,7,8,4,0,3
2045385,20,6,1993,3,male,34,76,69,8,28,8,19,0,9
1292586,21,6,1992,6,male,566,76,50,8,13,8,2,0,11
1472338,25,18,1988,6,male,651,74,52,8,25,8,18,0,7
1030600,41,15,1972,9,male,227,76,52,8,28,8,22,0,6
1136189,15,20,1998,7,female,349,76,20,9,0,0,0,9,0
1637699,68,2,1945,6,female,449,76,32,9,23,0,3,9,20
2067538,76,10,1937,9,female,1934,76,41,9,20,0,8,9,12
1582633,33,4,1980,1,male,547,74,61,9,1,5,0,4,1
1935411,18,8,1995,12,female,188,75,35,9,37,7,26,2,11
1422528,17,29,1996,8,male,163,75,66,9,0,9,0,0,0
1444633,34,15,1979,6,female,503,74,40,9,0,9,0,0,0
1563596,57,17,1956,5,female,628,75,38,9,0,9,0,0,0
1335770,61,29,1952,6,female,1062,74,60,9,0,9,0,0,0
1499904,17,14,1996,8,male,371,74,62,9,4,9,4,0,0
1816510,103,24,1910,8,male,237,75,63,9,5,9,3,0,2
1281096,22,22,1991,5,female,419,76,26,9,14,9,14,0,0
1506089,40,30,1973,10,male,404,75,31,9,61,9,60,0,1
1177515,60,23,1953,6,male,2205,76,11,9,15,9,5,0,10
2055941,70,1,1943,8,male,22,76,66,10,2,0,0,10,2
1479782,28,6,1985,5,male,180,76,37,10,15,0,6,10,9
1494749,61,4,1952,7,female,140,76,40,10,23,0,8,10,15
1451949,29,11,1984,2,male,197,74,67,10,3,10,0,0,3
1290539,47,18,1966,12,male,766,74,25,10,2,10,2,0,0
1636884,21,16,1992,2,female,237,75,41,10,12,10,10,0,2
1882694,27,15,1986,4,male,383,74,23,10,14,10,14,0,0
1162296,72,1,1941,2,male,222,76,49,10,13,10,10,0,3
1442027,18,20,1995,4,male,211,76,23,10,188,10,138,0,50
1572471,25,19,1988,11,male,134,76,72,10,36,10,19,0,17
1748274,32,6,1981,8,female,437,75,31,10,20,10,13,0,7
1748266,50,8,1963,9,female,743,75,30,10,80,10,69,0,11
1923896,108,26,1905,8,male,1039,76,58,11,0,0,0,11,0
1354774,15,20,1998,3,male,78,75,56,11,4,2,0,9,4
1875703,108,6,1905,9,female,852,76,35,11,5,0,4,11,1
1175165,14,18,1999,4,female,13,74,16,11,37,0,17,11,20
1639887,39,19,1974,8,female,1228,75,28,11,5,10,2,1,3
1726637,23,24,1990,8,male,466,76,62,11,45,10,22,1,23
1336779,17,30,1996,7,male,223,75,67,11,0,11,0,0,0
1731502,22,2,1991,3,male,323,74,50,11,1,11,1,0,0
1583763,27,26,1986,7,female,536,74,51,11,0,11,0,0,0
1751449,30,26,1983,6,female,460,75,41,11,0,11,0,0,0
1015559,18,4,1995,2,male,231,75,63,11,5,11,3,0,2
1742277,19,20,1994,4,male,424,74,48,11,3,11,3,0,0
1270048,15,1,1998,12,male,106,75,61,11,40,11,37,0,3
1315055,30,11,1983,3,male,527,74,9,11,31,11,25,0,6
1587765,20,15,1993,7,male,456,76,40,12,0,0,0,12,0
2067957,45,8,1968,12,male,512,75,41,12,2,0,2,12,0
1750685,19,7,1994,9,female,242,76,36,12,50,1,27,11,23
1176348,22,4,1991,3,male,448,74,47,12,25,2,9,10,16
1320022,21,21,1992,6,female,286,74,23,12,4,12,4,0,0
1942549,36,20,1977,7,male,610,76,68,12,3,12,2,0,1
2060856,74,23,1939,9,male,1429,74,48,12,7,12,7,0,0
2057882,64,18,1949,7,female,165,74,68,12,16,12,10,0,6
1797545,19,27,1994,3,male,256,75,65,12,22,12,18,0,4
1695077,28,12,1985,5,female,499,76,54,12,65,12,35,0,30
1801528,36,14,1977,9,male,83,75,65,12,23,12,11,0,12
1898104,56,7,1957,4,male,1032,75,47,13,24,0,0,13,24
1072049,44,14,1969,5,female,605,74,61,13,17,9,9,4,8
1967065,56,4,1957,11,male,1364,76,29,13,8,5,4,8,4
2011271,15,2,1998,6,male,172,74,50,13,3,11,1,2,2
1975317,15,30,1998,4,male,485,74,43,13,2,13,1,0,1
1578198,29,22,1984,8,male,485,75,34,13,7,13,5,0,2
1416006,19,10,1994,10,male,383,74,52,13,10,13,4,0,6
1414295,15,5,1998,3,male,24,76,63,13,54,13,16,0,38
1937162,20,1,1993,2,male,355,74,48,13,24,13,11,0,13
1314301,28,25,1985,12,female,1364,74,38,13,115,13,96,0,19
1776127,14,24,1999,1,male,517,74,66,14,1,0,1,14,0
1766476,49,4,1964,9,female,250,76,64,14,1,1,1,13,0
1239911,59,28,1954,9,female,857,74,39,14,11,0,3,14,8
1252945,21,29,1992,6,male,285,76,47,14,1,14,1,0,0
1699964,102,4,1911,5,male,845,74,25,14,2,14,2,0,0
1202605,104,12,1909,1,male,51,75,69,14,1,14,1,0,0
1768657,32,1,1981,1,female,200,74,23,14,25,14,12,0,13
1424245,13,6,2000,6,female,316,74,40,15,12,0,4,15,8
1347008,19,7,1994,3,male,811,76,26,15,13,0,4,15,9
1709488,63,13,1950,6,female,688,74,42,15,18,0,1,15,17
1278809,84,17,1929,6,male,1920,76,21,15,12,10,9,5,3
1822520,59,11,1954,12,male,500,74,44,15,30,5,3,10,27
1318613,65,28,1948,11,female,1179,75,38,15,3,11,2,4,1
1470620,28,21,1985,3,male,242,74,70,15,2,15,2,0,0
1490832,22,17,1991,8,male,31,76,64,15,7,15,5,0,2
1587354,26,15,1987,12,female,188,76,67,15,7,15,4,0,3
1320866,56,18,1957,8,female,375,76,37,15,3,15,3,0,0
1478723,20,14,1993,10,male,438,74,64,15,13,15,10,0,3
1872910,24,22,1989,3,female,274,74,58,15,35,15,21,0,14
1237750,42,15,1971,12,male,1175,75,10,15,39,15,30,0,9
1578099,17,3,1996,11,male,469,76,70,16,2,0,0,16,2
1811454,92,1,1921,12,male,1311,76,25,16,5,0,0,16,5
1568115,49,26,1964,9,male,1608,74,62,16,63,0,49,16,14
1563059,24,20,1989,6,female,642,75,32,16,32,7,6,9,26
1063850,48,24,1965,3,male,356,74,22,16,8,14,3,2,5
1323025,27,12,1986,5,male,434,74,46,16,4,16,4,0,0
1651818,30,29,1983,4,male,1208,74,27,16,5,16,3,0,2
1916522,100,24,1913,11,male,58,74,71,16,3,16,3,0,0
1875455,23,8,1990,2,male,586,74,34,16,79,16,62,0,17
1231941,26,23,1987,4,female,443,74,27,16,27,16,24,0,3
1055144,57,1,1956,10,male,1377,75,40,16,27,16,22,0,5
1460853,21,12,1992,2,female,513,74,58,17,0,0,0,17,0
1336023,22,8,1991,11,male,412,76,59,17,5,1,1,16,4
1622768,58,18,1955,5,female,473,75,46,17,13,0,12,17,1
1141721,20,12,1993,10,female,237,76,56,17,6,17,5,0,1
1565674,59,19,1954,1,female,1682,76,20,17,6,17,5,0,1
1294156,28,23,1985,5,female,508,74,35,17,37,17,11,0,26
1294429,51,19,1962,5,male,128,74,33,17,48,17,35,0,13
1933862,18,21,1995,5,male,545,75,32,18,0,0,0,18,0
1857232,15,7,1998,2,male,264,76,48,18,6,5,4,13,2
1619542,49,25,1964,10,male,570,75,53,18,5,17,5,1,0
1938327,34,17,1979,5,female,97,75,62,18,26,17,13,1,13
2001507,17,13,1996,9,male,299,76,37,18,0,18,0,0,0
1818519,30,9,1983,3,male,273,76,67,18,0,18,0,0,0
1697351,43,30,1970,8,male,178,74,66,18,0,18,0,0,0
2092409,42,20,1971,5,female,177,76,70,18,3,18,2,0,1
1274402,45,14,1968,2,female,1299,76,42,18,9,18,5,0,4
1767682,27,23,1986,2,male,231,75,61,18,15,18,9,0,6
1853015,33,3,1980,11,male,190,74,36,18,50,18,20,0,30
1437949,100,15,1913,4,male,388,75,41,18,33,18,30,0,3
1367771,13,20,2000,3,male,186,74,30,19,3,0,2,19,1
1290941,59,13,1954,11,male,1200,74,27,19,2,0,0,19,2
1200587,60,25,1953,8,female,1135,75,22,19,1,1,0,18,1
1534250,53,20,1960,2,female,1574,76,38,19,18,0,4,19,14
1778262,59,11,1954,9,male,991,74,34,19,52,7,23,12,29
1005313,20,14,1993,1,male,332,75,50,19,0,19,0,0,0
1440027,24,25,1989,11,male,423,76,20,19,3,19,2,0,1
1605146,22,1,1991,1,male,233,75,67,19,9,19,5,0,4
2056434,29,7,1984,7,female,442,75,60,19,22,19,21,0,1
1452779,21,6,1992,8,female,485,75,54,19,64,19,59,0,5
1095964,47,7,1966,5,female,381,74,18,20,2,3,2,17,0
1073993,41,30,1972,6,male,100,75,53,20,4,0,2,20,2
1975731,57,19,1956,4,male,1383,74,33,20,8,0,7,20,1
1234602,58,21,1955,6,female,1621,75,19,20,11,0,9,20,2
1878528,58,2,1955,7,female,1443,76,45,20,8,0,0,20,8
1896486,108,26,1905,10,male,1102,75,33,20,12,0,1,20,11
1853399,22,27,1991,8,female,258,75,25,20,89,20,69,0,20
1491673,58,25,1955,2,female,1687,74,18,20,172,20,67,0,105
1661951,56,27,1957,10,male,556,75,24,21,10,1,5,20,5
2153910,40,26,1973,7,male,843,76,39,21,64,0,36,21,28
1641633,53,27,1960,9,female,502,76,27,21,2,10,0,11,2
1913840,32,3,1981,12,female,422,75,31,21,12,16,7,5,5
2179331,108,22,1905,9,female,1398,74,37,21,8,16,1,5,7
1738922,18,13,1995,1,male,293,75,58,21,3,21,3,0,0
1665161,25,1,1988,1,male,195,74,52,21,0,21,0,0,0
1564365,44,23,1969,1,male,293,74,50,21,3,21,1,0,2
1653234,14,1,1999,6,male,265,76,47,21,19,21,14,0,5
1931546,18,24,1995,9,female,198,74,41,22,0,0,0,22,0
1632595,19,3,1994,8,male,359,75,32,22,0,0,0,22,0
1210219,65,7,1948,7,male,1751,74,19,22,2,12,2,10,0
2171784,84,9,1929,1,female,1577,75,38,22,33,7,16,15,17
1248950,23,12,1990,12,male,80,75,49,22,16,17,4,5,12
1986081,49,26,1964,5,female,796,74,38,22,17,16,7,6,10
1388700,15,18,1998,4,male,856,76,34,22,2,22,2,0,0
1556319,15,25,1998,4,male,560,76,38,22,2,22,2,0,0
2015734,19,11,1994,7,male,119,75,37,22,0,22,0,0,0
1789090,30,19,1983,4,male,1112,76,66,22,3,22,2,0,1
1989055,50,21,1963,5,male,489,75,51,22,4,22,3,0,1
1132101,16,20,1997,2,male,419,74,41,22,16,22,15,0,1
1989465,21,8,1992,3,male,72,75,68,22,14,22,11,0,3
1075182,25,14,1988,8,female,170,76,56,23,75,17,41,6,34
1451215,17,11,1996,3,female,504,74,46,23,1,23,1,0,0
1662037,18,7,1995,7,male,79,75,44,23,7,23,5,0,2
1577083,22,19,1991,1,male,91,74,57,23,17,23,7,0,10
1411620,48,14,1965,11,female,1609,75,40,23,26,23,23,0,3
1191587,24,10,1989,6,female,681,74,48,23,87,23,52,0,35
1549778,25,8,1988,8,female,53,76,42,23,49,23,46,0,3
1287410,30,28,1983,1,male,406,76,49,23,190,23,78,0,112
1666583,63,25,1950,6,female,1338,74,28,24,3,0,3,24,0
1803061,94,19,1919,12,male,1652,76,35,24,14,3,2,21,12
2011468,25,14,1988,5,male,227,74,68,24,0,19,0,5,0
1096390,28,4,1985,3,female,285,74,46,24,0,24,0,0,0
1669869,62,10,1951,5,female,711,76,30,24,0,24,0,0,0
1243756,65,24,1948,5,female,1156,76,43,24,1,24,0,0,1
2187036,19,1,1994,1,male,426,74,53,24,5,24,5,0,0
1402989,31,8,1982,11,male,372,75,47,24,5,24,5,0,0
2112630,36,15,1977,1,male,349,74,62,24,15,24,14,0,1
1365940,50,8,1963,8,male,695,76,64,25,0,0,0,25,0
1106844,22,29,1991,3,male,432,76,39,25,1,24,1,1,0
1738525,33,4,1980,11,female,251,74,21,25,24,23,13,2,11
1918540,20,25,1993,1,female,160,74,55,25,15,25,14,0,1
1284059,25,14,1988,12,male,67,75,61,25,22,25,22,0,0
1683580,108,2,1905,6,male,885,76,59,25,18,25,15,0,3
2057150,14,7,1999,8,male,442,76,40,26,0,0,0,26,0
2051375,21,15,1992,4,male,543,74,53,26,10,4,6,22,4
1544879,61,21,1952,5,female,476,75,68,26,38,0,6,26,32
1177869,25,14,1988,2,male,192,75,71,26,2,26,2,0,0
1539948,23,15,1990,4,female,436,76,39,26,29,26,20,0,9
1329337,23,22,1990,10,female,58,76,63,26,42,26,22,0,20
1012316,15,1,1998,6,male,218,74,38,27,2,26,2,1,0
1259910,57,10,1956,3,female,555,74,44,27,74,20,20,7,54
1736576,28,9,1985,12,male,622,76,38,27,15,27,15,0,0
1671228,19,3,1994,2,male,362,74,41,27,39,27,32,0,7
1614136,42,7,1971,7,female,411,75,45,27,22,27,20,0,2
1407838,34,6,1979,3,male,264,75,54,27,62,27,46,0,16
1875351,57,5,1956,6,male,849,74,38,28,85,14,47,14,38
1071553,38,18,1975,1,female,320,75,36,28,8,28,3,0,5
1814914,45,8,1968,8,female,1520,75,41,28,8,28,1,0,7
1707518,74,14,1939,8,male,476,76,49,28,9,28,1,0,8
1926374,59,19,1954,3,female,227,76,64,29,8,25,4,4,4
1006913,64,3,1949,7,female,374,74,41,29,31,24,23,5,8
1960928,23,1,1990,1,male,231,76,50,29,45,28,38,1,7
2127294,66,7,1947,11,female,1915,74,20,29,97,29,83,0,14
1979735,16,25,1997,3,male,343,75,53,30,4,11,2,19,2
1876082,74,3,1939,12,male,835,75,51,31,10,13,2,18,8
1586932,35,1,1978,10,male,880,76,50,31,41,22,31,9,10
1453317,48,2,1965,9,male,2356,75,14,31,42,17,15,14,27
1065342,52,17,1961,12,male,264,74,25,31,32,15,14,16,18
1972081,20,8,1993,1,male,298,76,38,31,64,16,29,15,35
1277266,70,9,1943,10,female,273,75,49,30,54,9,30,21,24
1930843,17,12,1996,12,male,3,75,75,31,3,31,2,0,1
1547772,28,1,1985,1,male,620,75,24,31,14,31,11,0,3
1553451,40,22,1973,4,female,172,75,44,30,10,30,10,0,0
1319374,24,6,1989,4,male,419,75,62,31,22,31,22,0,0
1828423,30,2,1983,7,male,205,75,56,30,31,30,14,0,17
1163379,48,12,1965,1,female,1657,74,46,31,73,31,61,0,12
1623730,56,15,1957,9,male,770,75,29,32,12,0,5,32,7
1195807,45,27,1968,11,male,808,75,53,32,260,8,97,24,163
1926345,64,15,1949,7,female,1471,74,30,32,50,8,20,24,30
2159364,26,15,1987,1,female,195,74,62,32,3,32,1,0,2
1158672,43,31,1970,12,female,726,75,63,32,12,32,10,0,2
1637198,29,3,1984,12,male,358,75,49,32,32,32,30,0,2
1036832,60,5,1953,1,female,692,75,46,33,0,0,0,33,0
1246709,70,10,1943,6,female,808,74,33,33,28,0,8,33,20
1386980,53,4,1960,10,male,328,74,22,33,7,33,7,0,0
2121741,32,17,1981,5,male,103,75,59,33,64,33,18,0,46
1829977,108,19,1905,9,female,236,74,37,34,18,21,9,13,9
1159214,39,31,1974,10,female,119,75,53,34,39,22,17,12,22
1591769,31,9,1982,10,male,795,75,53,34,2,26,2,8,0
1059062,26,25,1987,9,male,279,76,41,34,10,34,9,0,1
2179227,33,15,1980,8,male,409,75,54,34,17,34,15,0,2
1963326,41,29,1972,3,male,270,75,49,34,25,34,13,0,12
2122813,62,28,1951,7,female,666,74,31,36,49,3,24,33,25
2110234,67,30,1946,5,male,2105,74,27,36,126,0,40,36,86
2169003,20,17,1993,11,male,310,75,27,35,17,13,15,22,2
1607557,24,27,1989,6,male,536,75,64,36,5,33,4,3,1
2152009,61,1,1952,6,female,1735,76,38,35,72,29,31,6,41
1165703,23,1,1990,1,male,66,76,69,36,3,36,3,0,0
1725100,51,31,1962,3,female,103,76,41,35,2,35,1,0,1
1148691,58,17,1955,9,female,1455,75,19,36,37,36,31,0,6
1357402,16,3,1997,9,female,423,76,51,36,83,36,59,0,24
1922275,19,29,1994,4,male,162,74,64,35,72,35,63,0,9
1645266,29,28,1984,8,male,274,76,39,36,95,36,56,0,39
1550937,65,2,1948,1,male,1693,76,45,37,4,0,2,37,2
1142563,48,2,1965,12,female,741,75,36,37,31,37,22,0,9
1296278,19,23,1994,7,female,659,75,49,37,116,37,98,0,18
1964428,60,4,1953,9,male,1248,76,19,39,23,0,11,39,12
1085620,72,16,1941,3,female,1545,76,26,39,8,3,5,36,3
1714758,82,7,1931,11,female,787,74,29,39,4,18,3,21,1
1018712,23,21,1990,2,female,523,75,43,38,17,21,5,17,12
1231531,37,26,1976,6,male,543,74,57,38,9,27,6,11,3
1453568,70,20,1943,8,female,1521,75,37,39,29,25,26,14,3
1821498,15,14,1998,8,female,503,74,20,38,0,38,0,0,0
1526057,15,23,1998,5,male,318,76,75,38,14,38,12,0,2
1569093,17,9,1996,7,female,89,76,24,38,9,38,9,0,0
1487525,43,19,1970,5,female,543,74,69,39,8,39,6,0,2
1166614,105,17,1908,4,male,130,75,44,38,9,38,7,0,2
1698729,19,16,1994,2,female,192,75,61,38,30,38,30,0,0
1947840,25,26,1988,7,female,361,74,25,39,63,39,44,0,19
1415002,55,24,1958,4,female,277,75,55,40,30,0,9,40,21
1023290,18,27,1995,11,male,56,74,66,40,45,24,29,16,16
1630260,33,14,1980,7,female,1871,74,29,40,40,30,33,10,7
1704254,32,31,1981,12,male,366,74,30,40,2,40,2,0,0
1470565,19,28,1994,11,male,397,74,33,40,18,40,11,0,7
1924362,36,16,1977,4,female,1459,76,32,40,18,40,12,0,6
1803050,55,13,1958,1,male,300,76,59,40,8,40,6,0,2
1277579,103,10,1910,2,female,45,76,62,40,31,40,29,0,2
2130053,60,23,1953,3,male,369,74,63,41,3,0,1,41,2
1614030,81,12,1932,6,male,1804,74,39,41,6,8,2,33,4
1450186,61,27,1952,5,female,112,76,56,42,16,5,7,37,9
1443395,18,6,1995,2,male,745,74,54,42,25,35,6,7,19
1885271,49,8,1964,11,male,222,75,42,42,17,38,3,4,14
1555638,43,18,1970,9,male,443,74,55,41,7,41,4,0,3
1872185,36,21,1977,3,female,332,76,8,42,140,42,130,0,10
1083898,65,21,1948,6,male,709,75,49,43,6,4,1,39,5
2010218,103,29,1910,8,female,1957,76,39,44,24,0,1,44,23
1055131,28,20,1985,7,male,554,75,34,43,27,31,15,12,12
1993642,13,26,2000,6,female,125,74,52,43,152,34,92,9,60
1144635,53,18,1960,7,female,192,74,53,43,17,43,5,0,12
1794386,47,16,1966,3,female,638,75,60,45,19,0,13,45,6
1462442,31,27,1982,3,male,209,75,69,45,8,45,7,0,1
1982899,70,15,1943,9,female,477,75,36,46,10,0,8,46,2
1618569,113,1,1900,3,female,1639,74,5,46,60,0,15,46,45
1500939,22,22,1991,10,female,469,74,56,47,1,12,1,35,0
1798783,47,10,1966,4,female,879,74,40,47,2,42,2,5,0
1004775,51,2,1962,9,female,533,76,44,46,35,34,17,12,18
1132549,67,1,1946,8,male,1359,75,48,46,25,46,18,0,7
1360403,18,6,1995,3,female,671,75,62,47,35,47,30,0,5
1525483,53,21,1960,12,female,956,76,33,48,14,0,7,48,7
1351089,108,28,1905,2,female,2271,76,28,48,11,5,8,43,3
2173748,20,11,1993,4,male,521,74,67,49,21,48,9,1,12
2175774,20,31,1993,5,male,659,75,46,48,43,44,26,4,17
1213025,20,9,1993,11,male,672,75,37,49,26,49,10,0,16
2014273,30,13,1983,7,female,222,74,26,49,12,49,12,0,0
1123901,43,28,1970,1,female,826,76,24,48,23,48,9,0,14
1280634,46,5,1967,10,male,566,74,63,48,18,48,17,0,1
1878397,64,3,1949,6,female,1499,74,31,48,13,48,13,0,0
1212705,16,16,1997,5,male,252,74,52,51,1,0,0,51,1
1339307,68,11,1945,1,female,1463,74,16,50,5,0,4,50,1
1206224,42,10,1971,12,female,301,76,61,50,12,22,3,28,9
1042907,25,30,1988,9,male,144,75,70,51,7,51,7,0,0
1391249,60,25,1953,8,female,1762,76,29,50,32,50,16,0,16
1426413,62,28,1951,11,male,393,75,70,51,56,51,45,0,11
1686444,31,29,1982,11,male,331,74,30,52,18,5,10,47,8
1361776,60,11,1953,1,female,677,74,48,52,33,0,24,52,9
1000693,52,20,1961,9,female,687,74,39,53,97,3,52,50,45
1664474,17,22,1996,10,male,206,75,32,53,17,35,8,18,9
1643603,61,3,1952,4,male,1572,76,50,52,13,26,3,26,10
1015147,34,12,1979,4,female,828,74,33,52,70,49,34,3,36
1611888,49,27,1964,4,female,654,74,34,53,56,53,46,0,10
1204456,23,12,1990,6,male,266,75,28,54,33,43,12,11,21
1876719,53,2,1960,4,female,1610,76,27,55,116,52,107,3,9
1506389,13,2,2000,1,male,192,74,49,54,6,54,4,0,2
2039692,57,1,1956,11,female,1311,76,17,54,16,54,10,0,6
1205204,27,8,1986,11,male,415,76,39,55,73,55,57,0,16
2077305,19,6,1994,1,female,230,76,55,57,15,0,2,57,13
1405705,23,29,1990,3,female,153,76,54,56,44,53,25,3,19
1021620,13,30,2000,4,female,215,76,46,58,147,46,75,12,72
1131834,26,15,1987,1,male,890,76,28,56,4,56,1,0,3
2140537,48,30,1965,3,female,181,75,41,56,18,56,4,0,14
2181010,49,10,1964,9,female,1193,75,53,56,27,56,19,0,8
1525724,58,27,1955,12,male,335,76,56,58,10,58,10,0,0
1833253,57,20,1956,10,female,1454,75,20,57,23,57,23,0,0
1917279,107,27,1906,11,female,755,76,39,56,22,56,17,0,5
1953103,33,15,1980,6,female,1209,76,23,56,72,56,62,0,10
1707922,19,23,1994,1,female,523,74,40,58,95,58,79,0,16
1609451,29,1,1984,8,female,553,75,31,57,133,57,128,0,5
2038359,27,4,1986,1,male,208,76,56,60,9,0,2,60,7
1145816,78,11,1935,12,female,1939,76,43,60,23,0,10,60,13
1560744,78,7,1935,7,male,1546,76,47,59,21,0,6,59,15
1281596,25,1,1988,1,male,272,75,42,59,59,47,25,12,34
1765251,27,30,1986,4,female,338,75,49,60,18,60,15,0,3
1595352,38,17,1975,4,male,252,75,41,60,120,60,71,0,49
1448454,26,28,1987,10,male,392,75,39,61,92,52,45,9,47
1718752,37,21,1976,6,female,283,75,59,63,19,63,12,0,7
1755269,62,6,1951,5,female,1150,76,46,62,15,62,14,0,1
1670626,28,8,1985,1,female,601,76,37,63,74,63,67,0,7
1917727,53,18,1960,3,male,38,76,69,63,81,63,46,0,35
1821839,32,30,1981,9,female,499,74,16,62,98,62,82,0,16
1119504,36,20,1977,10,male,1093,75,32,63,229,63,211,0,18
1033939,19,30,1994,3,female,420,76,61,64,42,14,5,50,37
1304762,32,17,1981,2,female,496,75,39,65,49,37,23,28,26
1537931,18,17,1995,2,female,36,76,26,65,28,64,28,1,0
1886712,100,13,1913,1,female,1606,74,31,65,5,65,5,0,0
1533632,15,8,1998,8,female,50,74,19,65,88,65,58,0,30
1042385,62,16,1951,4,female,318,75,62,65,55,65,52,0,3
1129195,33,16,1980,12,male,223,75,62,67,35,4,7,63,28
1638664,45,2,1968,11,female,143,76,57,66,38,0,7,66,31
1064846,75,1,1938,2,male,601,76,59,67,36,0,17,67,19
1921649,18,20,1995,10,female,67,76,39,68,56,1,6,67,50
1853882,50,2,1963,12,female,964,74,25,67,51,0,13,67,38
1624599,20,14,1993,8,male,256,74,57,67,19,66,15,1,4
1618270,19,4,1994,9,female,347,74,49,68,15,68,12,0,3
1778588,25,1,1988,1,male,611,74,51,67,18,67,10,0,8
1325780,29,23,1984,7,female,347,76,63,68,24,68,16,0,8
1572326,55,14,1958,6,female,1487,74,44,70,18,38,17,32,1
1054410,63,1,1950,6,female,1612,75,33,70,14,70,10,0,4
1791052,17,28,1996,11,female,313,74,27,73,8,0,6,73,2
1463506,64,9,1949,4,male,615,75,44,74,6,0,2,74,4
1729125,18,29,1995,1,female,269,75,61,72,1,40,1,32,0
1981258,23,8,1990,8,female,355,76,27,72,104,71,75,1,29
1637489,45,24,1968,6,female,491,74,41,72,9,72,8,0,1
1982790,38,26,1975,12,male,561,75,42,73,30,73,24,0,6
1221251,63,1,1950,10,male,456,75,52,76,35,0,14,76,21
1476744,53,12,1960,7,male,279,75,63,77,218,0,43,77,175
1702813,42,17,1971,9,male,558,74,57,75,41,21,8,54,33
1767437,29,11,1984,4,female,531,75,44,76,92,52,47,24,45
1490224,64,8,1949,6,male,1102,74,57,75,110,51,25,24,85
1401413,26,19,1987,5,male,307,75,62,75,14,75,12,0,2
1688644,62,18,1951,11,female,1604,74,37,76,107,76,67,0,40
1744898,65,31,1948,8,male,1602,75,35,80,274,15,60,65,214
1369551,56,28,1957,5,female,1178,74,43,80,54,29,52,51,2
2029247,49,18,1964,10,male,596,74,60,79,37,78,7,1,30
1370159,47,16,1966,9,female,503,75,34,79,169,78,54,1,115
1499902,21,29,1992,5,female,461,74,44,78,1,78,1,0,0
1159569,26,1,1987,2,male,600,76,63,79,46,79,36,0,10
1075530,25,27,1988,1,female,285,74,59,79,61,79,24,0,37
1096828,72,27,1941,4,female,649,76,71,83,23,0,3,83,20
1289683,50,24,1963,2,female,272,76,59,83,72,0,24,83,48
1757460,52,11,1961,9,male,1934,76,22,84,126,0,98,84,28
1015075,34,18,1979,11,female,16,75,33,83,24,63,13,20,11
1347894,59,8,1954,5,female,1574,74,11,81,7,81,5,0,2
2155232,105,8,1908,10,male,1670,74,23,83,10,83,2,0,8
1209227,35,1,1978,2,female,216,76,46,84,50,84,40,0,10
1816765,50,24,1963,2,female,696,74,44,82,71,82,56,0,15
2174856,36,1,1977,7,male,264,75,50,85,60,85,35,0,25
1111678,20,13,1993,8,female,376,76,21,91,101,8,42,83,59
1769431,23,1,1990,1,female,1301,75,26,91,9,63,4,28,5
2053043,47,24,1966,10,male,335,75,49,88,49,61,32,27,17
1392488,34,31,1979,12,female,478,76,68,91,72,29,58,62,14
2138067,35,23,1978,6,female,489,74,27,89,91,85,71,4,20
1456035,56,15,1957,9,NA,1538,75,50,91,73,85,64,6,9
1619377,43,13,1970,9,female,493,74,25,90,139,83,33,7,106
1107088,36,22,1977,10,male,822,75,60,88,51,88,36,0,15
1645754,42,19,1971,10,male,657,75,49,90,20,90,20,0,0
1881472,18,19,1995,9,female,397,76,61,92,8,0,4,92,4
1551660,30,1,1983,11,male,307,74,41,94,154,55,50,39,104
2092981,61,15,1952,9,male,1311,74,60,95,47,74,22,21,25
2146518,49,26,1964,4,female,1356,76,36,95,142,89,73,6,69
1282129,24,22,1989,4,female,383,74,35,94,47,94,30,0,17
1025548,64,25,1949,4,female,1807,75,16,92,28,92,21,0,7
1406895,34,6,1979,9,male,447,76,46,93,84,93,75,0,9
1760713,47,22,1966,9,female,727,75,45,92,218,92,87,0,131
1803756,58,6,1955,12,female,879,75,40,96,35,0,13,96,22
1291035,77,19,1936,10,female,629,74,37,97,155,0,13,97,142
1042663,13,22,2000,2,male,73,75,45,98,11,97,10,1,1
1745234,53,6,1960,12,male,280,76,38,99,196,96,110,3,86
1766792,20,1,1993,1,male,473,75,64,98,12,98,3,0,9
1057377,33,5,1980,4,male,936,74,62,98,67,98,43,0,24
2053647,66,4,1947,10,female,1519,74,43,101,72,72,36,29,36
1363965,27,3,1986,10,male,632,75,57,102,12,80,4,22,8
1966259,23,3,1990,1,female,346,75,55,102,34,78,16,24,18
1601928,45,10,1968,7,female,547,76,45,100,50,99,29,1,21
1016288,18,2,1995,2,male,196,76,57,103,0,103,0,0,0
1666459,21,30,1992,8,female,495,76,42,104,37,104,18,0,19
1876789,25,7,1988,8,female,118,75,50,102,76,102,47,0,29
1280567,32,22,1981,10,male,147,75,45,100,74,100,69,0,5
1946631,44,14,1969,8,female,500,74,50,100,71,100,30,0,41
1218031,113,16,1900,12,female,1520,74,49,105,28,0,7,105,21
1822542,67,30,1946,3,female,1868,75,46,106,17,46,11,60,6
1640567,48,21,1965,10,female,166,74,46,108,17,107,12,1,5
1338128,28,8,1985,11,male,267,76,33,108,15,108,14,0,1
1227562,113,1,1900,1,NA,1579,76,28,108,148,108,86,0,62
1389409,30,31,1983,5,female,630,74,32,112,172,107,138,5,34
1338423,28,14,1985,3,male,180,75,45,113,162,113,146,0,16
1371609,54,29,1959,7,female,671,75,16,113,87,113,72,0,15
1845761,16,5,1997,11,male,715,74,42,118,6,21,5,97,1
1865957,59,25,1954,1,female,1061,76,47,114,107,111,57,3,50
1091220,31,16,1982,9,male,275,75,63,114,255,112,233,2,22
1563198,24,17,1989,5,female,31,74,64,117,14,116,9,1,5
1060600,61,20,1952,9,male,710,74,24,116,7,116,5,0,2
1755472,20,19,1993,10,female,625,76,49,119,23,119,23,0,0
1817116,25,14,1988,2,female,341,74,53,115,225,115,187,0,38
1674448,17,26,1996,11,male,37,76,60,123,0,2,0,121,0
1314485,70,13,1943,2,female,1726,76,26,124,79,0,27,124,52
1095267,51,12,1962,5,female,95,74,55,124,113,25,48,99,65
1527895,100,21,1913,11,male,122,75,54,120,47,113,38,7,9
1706234,16,30,1997,5,male,284,76,27,122,22,121,8,1,14
1699712,28,14,1985,2,female,28,76,27,121,187,121,167,0,20
1398251,58,12,1955,7,male,420,75,58,130,32,26,15,104,17
1878426,30,10,1983,5,female,901,75,46,129,51,123,27,6,24
1177483,18,6,1995,7,male,328,75,44,125,14,125,14,0,0
1258832,25,19,1988,8,male,501,75,53,128,8,128,4,0,4
1092657,28,1,1985,1,male,220,74,65,130,35,130,25,0,10
1022783,105,13,1908,9,male,886,75,56,129,179,129,2,0,177
2137627,58,27,1955,7,female,1267,75,15,132,44,56,26,76,18
2049792,97,29,1916,2,male,1809,75,41,131,123,83,57,48,66
1994198,42,15,1971,4,female,925,74,47,136,20,111,11,25,9
1697918,18,14,1995,12,male,39,74,69,133,31,133,27,0,4
1756758,30,20,1983,10,female,537,76,16,132,45,132,43,0,2
1686692,47,17,1966,7,female,773,76,41,136,161,136,137,0,24
1936996,43,21,1970,6,male,1206,75,64,141,18,140,11,1,7
1613395,18,15,1995,5,male,228,74,62,143,0,143,0,0,0
1706215,24,21,1989,3,female,565,74,43,137,42,137,32,0,10
1221107,26,31,1987,10,male,209,75,34,138,145,138,110,0,35
2016869,51,5,1962,5,female,428,76,44,149,30,12,25,137,5
1497853,108,3,1905,10,female,1051,75,30,148,180,0,48,148,132
1620306,43,2,1970,7,female,810,76,37,146,73,144,58,2,15
1269375,21,27,1992,7,male,259,75,34,149,126,149,122,0,4
1357601,32,22,1981,9,female,64,75,61,152,54,8,36,144,18
1988438,54,23,1959,6,female,183,74,48,154,87,0,23,154,64
1546823,113,31,1900,12,female,1302,76,28,151,58,0,12,151,46
1285964,20,17,1993,1,female,494,75,57,152,77,46,14,106,63
1556230,48,17,1965,1,female,517,74,37,152,148,73,63,79,85
1075667,22,31,1991,10,male,433,76,40,161,45,0,10,161,35
1513351,50,23,1963,10,male,972,76,29,158,34,0,17,158,17
1195545,51,25,1962,1,female,187,75,42,162,96,0,12,162,84
1615755,106,15,1907,2,male,18,76,54,159,36,0,10,159,26
2024266,18,6,1995,5,female,131,74,28,158,49,158,40,0,9
2132147,70,5,1943,8,male,588,76,50,170,32,0,8,170,24
2003899,39,5,1974,6,male,325,76,35,172,86,68,51,104,35
1561166,96,7,1917,9,female,1949,75,48,169,215,69,116,100,99
1505149,27,6,1986,9,female,906,76,27,165,98,165,37,0,61
1176390,62,12,1951,12,female,1083,76,30,179,53,22,2,157,51
1354771,29,24,1984,7,female,300,76,41,173,44,51,23,122,21
1809877,65,30,1948,12,male,1600,75,31,175,80,58,51,117,29
1517637,36,25,1977,8,female,435,74,34,178,24,178,9,0,15
1064221,19,25,1994,3,female,176,74,51,179,33,179,29,0,4
1068097,31,19,1982,9,female,456,76,40,181,84,181,32,0,52
1961433,58,28,1955,7,female,703,74,22,182,47,0,22,182,25
2192479,44,29,1969,3,female,615,74,27,185,229,6,91,179,138
1484201,31,14,1982,11,male,293,76,41,183,26,183,18,0,8
1794414,18,7,1995,5,female,196,75,29,182,85,182,72,0,13
1690801,37,24,1976,2,female,559,74,48,187,105,187,105,0,0
1219421,29,23,1984,2,female,528,75,41,186,197,186,158,0,39
1376530,52,9,1961,5,female,1156,74,24,186,188,186,161,0,27
1343892,37,17,1976,8,female,309,74,62,185,292,185,179,0,113
2150392,28,27,1985,2,female,356,76,56,198,38,0,17,198,21
1955503,53,28,1960,5,female,892,74,38,200,63,9,27,191,36
1279066,108,16,1905,11,female,1309,76,48,195,146,0,45,195,101
1809095,76,21,1937,3,female,45,74,53,191,113,184,75,7,38
1774314,60,17,1953,11,female,650,74,25,200,58,199,35,1,23
1526898,62,10,1951,7,female,1638,74,30,193,35,193,28,0,7
1231408,55,18,1958,7,male,335,74,46,202,62,0,27,202,35
1804748,26,26,1987,4,female,1012,75,45,211,375,193,304,18,71
1385390,44,17,1969,1,female,279,75,24,202,117,202,58,0,59
1655146,52,10,1961,11,female,260,74,62,202,143,202,93,0,50
1544178,57,13,1956,1,female,1403,76,39,203,135,203,75,0,60
1643358,113,25,1900,10,male,1586,75,37,212,28,107,9,105,19
1191402,18,20,1995,10,male,86,74,59,220,127,114,81,106,46
1477864,14,1,1999,11,male,119,75,37,219,459,48,208,171,251
1200263,68,29,1945,4,female,1511,75,25,225,34,15,23,210,11
1930092,35,24,1978,6,female,33,76,28,224,327,174,186,50,141
1702223,54,16,1959,7,female,798,75,48,224,141,184,109,40,32
2010929,25,20,1988,6,female,392,74,61,227,10,225,1,2,9
1289847,84,9,1929,2,female,1797,74,22,226,10,226,5,0,5
1292615,27,15,1986,11,female,437,75,41,224,65,224,54,0,11
1809463,31,1,1982,1,male,78,76,50,233,123,233,107,0,16
1912808,79,3,1934,2,male,919,76,60,234,41,0,0,234,41
1875539,22,5,1991,7,male,514,76,64,234,82,93,35,141,47
1800621,47,19,1966,3,male,507,75,57,240,14,234,13,6,1
1597156,22,4,1991,4,female,463,75,35,243,66,243,50,0,16
1531918,31,23,1982,6,female,212,75,37,238,185,238,86,0,99
1363045,50,16,1963,12,female,884,74,37,242,177,242,75,0,102
1517156,52,24,1961,12,male,146,76,49,250,269,0,180,250,89
1370801,56,3,1957,1,female,691,76,36,256,45,178,19,78,26
1675323,39,15,1974,12,female,480,74,64,267,28,0,5,267,23
1087731,44,23,1969,3,female,634,75,29,267,219,61,149,206,70
1335175,49,25,1964,1,female,1475,76,25,265,97,265,49,0,48
1256698,55,21,1958,2,female,293,76,48,269,57,269,46,0,11
1728276,20,15,1993,8,female,281,75,37,272,308,272,137,0,171
1209440,54,15,1959,10,male,277,74,24,274,254,274,126,0,128
2151007,58,11,1955,10,female,206,74,32,285,51,0,7,285,44
2141463,53,14,1960,4,female,835,75,40,285,209,41,149,244,60
1716819,18,3,1995,5,female,42,76,52,286,122,286,82,0,40
1596867,23,1,1990,5,female,23,74,67,279,169,279,89,0,80
1117421,25,2,1988,1,male,494,75,29,279,144,279,128,0,16
1989448,26,26,1987,8,female,355,76,61,280,160,280,138,0,22
1405926,35,7,1978,8,female,418,74,48,290,50,290,34,0,16
1706230,103,3,1910,12,female,416,76,38,284,138,284,133,0,5
2149167,54,28,1959,12,female,496,76,47,305,81,21,28,284,53
1102503,56,17,1957,8,female,1275,76,50,300,136,30,57,270,79
2120719,69,15,1944,2,male,725,76,49,304,271,0,52,304,219
1037860,29,3,1984,10,female,196,75,52,307,591,0,204,307,387
1617663,21,12,1992,9,female,342,76,27,308,48,268,19,40,29
1716493,31,31,1982,3,female,315,74,52,303,42,302,37,1,5
2037161,20,16,1993,1,male,221,75,40,300,107,300,31,0,76
1059848,16,22,1997,5,male,248,75,27,324,49,2,17,322,32
1004074,57,5,1956,6,male,486,74,30,309,137,0,20,309,117
2081610,66,16,1947,6,male,853,75,39,327,162,1,54,326,108
1305106,38,15,1975,8,female,847,74,13,317,176,184,161,133,15
1944712,18,13,1995,2,female,365,76,66,323,316,171,98,152,218
2139978,28,20,1985,9,female,794,74,41,312,425,289,309,23,116
1563975,58,29,1955,3,female,1663,75,39,325,452,301,339,24,113
1941643,100,17,1913,11,female,1229,75,18,311,14,311,10,0,4
1780890,52,3,1961,5,male,785,74,31,311,185,311,89,0,96
1906848,58,5,1955,5,female,522,75,53,310,55,310,12,0,43
1152883,19,9,1994,6,female,51,75,60,313,203,313,78,0,125
1570512,51,10,1962,10,female,270,74,39,315,201,315,107,0,94
1881577,59,22,1954,7,female,1651,76,27,328,110,0,68,328,42
1261696,113,27,1900,5,female,1432,74,31,339,157,11,66,328,91
1221404,58,28,1955,8,female,614,75,54,331,136,110,69,221,67
1296573,13,24,2000,4,male,130,75,47,346,6,339,5,7,1
2020414,71,22,1942,11,female,356,76,49,346,46,325,29,21,17
1626988,47,22,1966,10,male,922,75,33,336,65,334,60,2,5
1259418,23,13,1990,7,male,25,75,72,330,188,330,188,0,0
1869244,43,29,1970,4,female,332,74,39,363,46,285,24,78,22
1437302,55,1,1958,11,male,581,74,46,359,40,359,22,0,18
1124177,40,19,1973,12,female,235,76,29,348,330,348,116,0,214
1699703,103,18,1910,3,male,1666,74,40,376,95,63,21,313,74
1418971,50,20,1963,3,female,1478,75,49,393,139,393,99,0,40
1182481,50,20,1963,7,female,647,75,46,370,124,370,101,0,23
1184968,19,14,1994,4,female,328,75,42,400,271,264,108,136,163
1019900,30,7,1983,3,male,328,74,47,416,228,350,202,66,26
1770729,26,7,1987,7,male,379,75,61,404,347,296,199,108,148
1823598,24,15,1989,10,female,228,76,39,434,127,414,63,20,64
2032808,26,1,1987,1,male,230,76,66,442,39,442,27,0,12
1612311,59,10,1954,4,female,919,74,31,467,221,3,92,464,129
1465481,66,9,1947,5,male,1407,76,50,455,339,0,72,455,267
1711591,31,10,1982,3,female,375,76,31,474,113,474,93,0,20
1921715,52,6,1961,5,male,858,76,74,455,131,455,67,0,64
2111696,23,12,1990,9,female,399,75,70,484,96,16,17,468,79
1904826,45,2,1968,4,female,259,74,26,497,168,3,7,494,161
1121296,72,8,1941,8,female,1722,74,53,507,39,507,25,0,14
1269193,47,4,1966,11,female,677,75,21,519,156,519,113,0,43
1324549,54,25,1959,8,female,299,76,63,508,259,508,181,0,78
1850659,53,30,1960,9,female,1272,76,43,545,136,25,39,520,97
2005631,50,1,1963,3,male,182,76,35,530,1911,0,307,530,1604
1211603,20,14,1993,7,male,433,76,62,550,29,465,27,85,2
2136401,22,3,1991,11,female,496,76,41,532,79,532,57,0,22
1455343,22,28,1991,6,female,486,76,35,523,514,523,421,0,93
1119229,19,1,1994,10,female,426,74,35,587,759,0,69,587,690
1785701,106,1,1907,12,female,186,75,57,584,330,223,201,361,129
1679218,25,18,1988,3,female,93,74,24,565,839,374,484,191,355
1048557,85,3,1928,7,female,1195,75,37,565,142,495,17,70,125
1327651,18,1,1995,12,female,56,74,70,586,260,586,242,0,18
1526949,61,8,1952,11,female,749,74,56,627,195,0,19,627,176
1721842,22,26,1991,9,male,394,75,40,625,160,299,103,326,57
1981752,46,20,1967,6,female,1342,74,56,655,202,480,150,175,52
1893998,46,29,1967,11,male,478,75,39,629,23,625,6,4,17
1536812,22,24,1991,11,female,305,75,34,629,202,629,89,0,113
1135289,29,12,1984,9,female,133,75,26,651,123,651,95,0,28
1423270,35,11,1978,10,female,761,74,42,629,109,629,76,0,33
2109184,58,26,1955,12,female,1384,76,43,621,282,621,206,0,76
1591836,20,25,1993,10,male,832,74,16,703,329,258,165,445,164
1940366,22,22,1991,1,female,173,74,21,724,66,667,21,57,45
1159788,23,18,1990,3,female,48,75,48,715,605,643,361,72,244
1013257,28,15,1985,9,female,470,75,38,698,2,698,2,0,0
1541645,70,31,1943,10,female,73,75,43,676,104,676,76,0,28
1458309,64,7,1949,1,female,347,75,53,780,19,0,6,780,13
1848474,18,22,1995,8,female,269,74,44,763,305,3,96,760,209
1868493,61,23,1952,7,female,726,76,27,776,421,2,189,774,232
1429692,38,5,1975,5,female,277,75,24,745,523,5,20,740,503
1965206,49,12,1964,5,female,551,76,21,744,25,668,22,76,3
1746167,25,20,1988,2,female,145,75,38,773,949,746,525,27,424
1658065,38,26,1975,10,female,260,74,35,738,430,738,294,0,136
1258891,43,4,1970,3,male,413,76,49,745,366,745,237,0,129
1179653,27,13,1986,10,female,426,75,33,822,253,18,88,804,165
2112232,25,31,1988,7,male,385,75,63,865,753,537,87,328,666
1023688,20,8,1993,4,female,249,74,35,827,79,672,69,155,10
1852155,18,23,1995,2,female,896,76,38,818,658,818,622,0,36
1644203,26,20,1987,5,female,315,76,53,972,148,939,93,33,55
1648709,51,23,1962,6,female,823,76,26,952,92,770,59,182,33
2187635,50,21,1963,9,female,447,75,43,905,29,905,20,0,9
1370998,54,3,1959,11,male,54,76,70,974,142,974,122,0,20
1536450,57,23,1956,8,female,1649,75,29,979,496,979,328,0,168
1476123,72,28,1941,10,male,401,75,53,1037,519,0,56,1037,463
2082102,66,11,1947,1,female,1492,76,42,1142,121,78,25,1064,96
1558483,54,11,1959,6,female,374,74,48,1159,59,613,26,546,33
1728759,52,10,1961,11,female,566,74,34,1204,432,1075,161,129,271
1056292,16,3,1997,11,female,130,75,22,1202,199,1202,171,0,28
1002023,19,16,1994,2,female,107,75,47,1355,1288,214,376,1141,912
2087042,27,28,1986,1,female,44,75,71,1512,1152,592,440,920,712
1669515,63,25,1950,3,female,542,75,43,1436,303,1436,160,0,143
1474564,26,3,1987,4,female,396,74,48,1693,132,1693,72,0,60
2059313,69,31,1944,7,female,1585,76,39,2198,241,239,40,1959,201
1342749,65,17,1948,2,female,291,74,56,2055,1054,1966,204,89,850
1246935,20,25,1993,6,female,115,75,56,2306,1584,1746,1139,560,445
1430524,32,26,1981,6,female,540,75,50,2333,1440,1802,1083,531,357
1270035,47,10,1966,8,male,184,74,48,2006,187,2006,170,0,17
1894649,46,20,1967,1,male,405,76,41,2066,674,2066,587,0,87
1358937,59,29,1954,8,female,1259,76,41,2822,368,2822,235,0,133
1147450,19,7,1994,7,female,463,75,47,5242,1785,2527,922,2715,863
1059237,43,3,1970,2,female,162,76,32,3696,785,3694,385,2,400
1380022,51,28,1962,9,female,1439,74,31,4858,1122,4858,712,0,410
1722591,29,12,1984,3,female,101,78,67,1,27,1,25,0,2
1685752,31,18,1982,2,male,554,77,16,1,5,1,2,0,3
1805796,32,17,1981,10,female,437,77,40,1,56,1,52,0,4
1628059,33,12,1980,4,male,437,78,38,1,36,1,35,0,1
1601725,33,9,1980,9,male,271,77,58,1,4,1,3,0,1
1188960,34,23,1979,8,male,855,77,44,1,4,1,4,0,0
1296450,35,8,1978,1,female,263,78,53,1,2,1,1,0,1
1898539,37,26,1976,8,female,340,78,43,1,2,1,2,0,0
1254605,47,30,1966,8,male,896,78,63,1,5,1,4,0,1
1539978,54,11,1959,12,male,860,77,33,1,58,1,34,0,24
2134354,58,30,1955,11,male,100,77,45,1,3,1,1,0,2
1804478,23,10,1990,3,male,806,77,54,2,0,0,0,2,0
1205123,66,8,1947,2,male,1025,78,54,2,0,0,0,2,0
1946574,66,13,1947,5,female,802,77,29,2,1,0,0,2,1
1725854,16,14,1997,11,female,303,78,54,2,2,0,0,2,2
1351142,18,28,1995,10,male,219,77,61,2,50,0,24,2,26
1032852,19,13,1994,10,female,583,77,43,2,16,0,9,2,7
1109871,26,2,1987,5,female,330,78,53,2,3,0,3,2,0
2023268,48,8,1965,4,male,674,77,34,2,17,0,4,2,13
1124364,59,7,1954,4,male,1590,78,6,2,2,1,2,1,0
1654142,31,11,1982,3,female,302,78,23,2,16,1,15,1,1
1603850,47,3,1966,12,female,607,78,75,2,9,1,1,1,8
1332401,18,19,1995,8,female,469,78,34,2,0,2,0,0,0
2069425,61,18,1952,11,male,222,77,50,2,0,2,0,0,0
1287551,68,16,1945,8,male,886,77,40,2,0,2,0,0,0
1417923,103,4,1910,10,male,467,77,53,2,0,2,0,0,0
1903162,18,8,1995,3,male,19,77,72,2,1,2,1,0,0
2010402,58,8,1955,11,female,806,78,32,2,1,2,0,0,1
1750302,28,23,1985,10,male,413,77,53,2,2,2,2,0,0
1578118,108,31,1905,12,male,2296,78,40,2,2,2,2,0,0
1404940,21,20,1992,4,female,432,77,67,2,4,2,4,0,0
1665543,23,1,1990,6,male,13,77,71,2,4,2,1,0,3
2079963,24,30,1989,10,female,698,77,37,2,12,2,2,0,10
1069264,27,10,1986,10,male,347,78,24,2,20,2,12,0,8
1724730,29,14,1984,5,male,178,78,57,2,5,2,5,0,0
1186625,30,10,1983,10,male,235,77,27,2,28,2,28,0,0
1844218,32,1,1981,11,female,436,78,24,2,5,2,4,0,1
2145693,43,18,1970,11,male,270,77,47,2,36,2,14,0,22
1434360,60,17,1953,5,male,1317,77,28,2,3,2,3,0,0
1631509,67,18,1946,9,male,294,77,51,2,14,2,8,0,6
1962413,17,19,1996,1,male,398,77,48,3,0,0,0,3,0
1972903,23,10,1990,1,female,234,78,46,3,0,0,0,3,0
1044140,33,24,1980,4,male,548,77,21,3,1,0,1,3,0
1958962,43,3,1970,11,male,291,77,50,3,3,0,2,3,1
2089917,63,20,1950,7,female,398,78,25,3,3,0,3,3,0
1606930,108,2,1905,2,male,50,77,73,3,3,0,0,3,3
2181486,37,5,1976,7,male,27,77,55,3,11,0,3,3,8
2169258,39,21,1974,3,male,873,78,28,3,33,0,9,3,24
2062857,45,29,1968,4,male,436,77,43,3,36,0,7,3,29
1861743,57,13,1956,6,female,376,77,60,3,11,0,8,3,3
1850476,58,29,1955,9,female,143,78,67,3,30,0,0,3,30
1634872,72,25,1941,5,female,1650,77,20,3,5,0,2,3,3
1612123,77,11,1936,6,female,753,78,47,3,29,0,5,3,24
1423114,18,29,1995,3,male,193,77,67,3,0,2,0,1,0
1729327,24,3,1989,3,male,1503,78,8,3,0,2,0,1,0
1768356,49,30,1964,3,male,304,78,57,3,3,1,3,2,0
1848363,38,6,1975,5,male,72,77,23,3,14,2,11,1,3
2058422,23,16,1990,2,male,465,77,64,3,0,3,0,0,0
1385669,59,8,1954,2,male,207,77,45,3,0,3,0,0,0
1606986,108,31,1905,12,male,288,77,64,3,0,3,0,0,0
2042658,46,4,1967,8,male,1923,78,43,3,1,3,0,0,1
1409178,60,25,1953,6,male,650,78,41,3,1,3,1,0,0
1935108,66,2,1947,11,male,1643,77,52,3,1,3,0,0,1
1203902,103,24,1910,11,female,423,77,44,3,1,3,1,0,0
1741885,25,28,1988,3,male,239,78,57,3,4,3,4,0,0
1757190,19,23,1994,10,male,324,77,31,3,9,3,6,0,3
1293564,21,11,1992,2,female,231,78,62,3,53,3,23,0,30
1202742,25,13,1988,8,male,877,77,65,3,92,3,34,0,58
1148795,30,30,1983,6,female,203,77,13,3,7,3,4,0,3
1453515,39,7,1974,11,male,410,77,67,3,8,3,3,0,5
1317269,39,15,1974,1,male,684,77,20,3,6,3,4,0,2
1174427,57,23,1956,5,female,1581,78,27,3,5,3,1,0,4
1390807,60,16,1953,5,male,99,77,52,3,14,3,11,0,3
1094799,38,29,1975,10,female,660,78,9,4,3,0,0,4,3
1160989,18,7,1995,10,male,586,77,56,4,50,0,44,4,6
1115129,33,17,1980,2,male,1194,78,32,4,13,0,10,4,3
1842750,20,20,1993,3,male,364,78,61,4,0,4,0,0,0
1963102,20,30,1993,7,male,136,77,70,4,0,4,0,0,0
2173772,23,30,1990,11,male,705,77,2,4,0,4,0,0,0
2067680,27,5,1986,2,male,250,78,69,4,0,4,0,0,0
1586579,33,16,1980,4,male,281,78,70,4,0,4,0,0,0
1291680,17,19,1996,1,male,80,77,62,4,2,4,1,0,1
1613419,21,13,1992,4,male,517,78,64,4,1,4,1,0,0
1359534,30,15,1983,6,male,392,77,67,4,2,4,2,0,0
1299309,31,4,1982,6,male,758,78,34,4,1,4,1,0,0
1445123,40,19,1973,3,male,639,77,28,4,1,4,1,0,0
1618307,57,25,1956,2,male,1131,78,17,4,1,4,1,0,0
2182992,19,25,1994,10,male,913,77,40,4,154,4,109,0,45
1045380,22,9,1991,8,male,104,77,61,4,243,4,210,0,33
1871242,29,22,1984,8,female,257,78,44,4,6,4,5,0,1
1982525,68,1,1945,1,male,53,77,38,4,14,4,10,0,4
1026933,69,11,1944,3,female,1250,77,47,4,8,4,5,0,3
1307891,36,1,1977,7,male,264,78,38,5,0,0,0,5,0
1541324,24,10,1989,7,male,718,78,39,5,53,0,3,5,50
1102570,54,12,1959,11,female,430,77,43,5,26,0,7,5,19
1172878,27,3,1986,10,male,333,78,60,5,23,2,12,3,11
1758647,59,1,1954,7,male,725,77,45,5,8,3,4,2,4
1765671,17,22,1996,4,male,567,78,14,5,0,5,0,0,0
1919251,14,26,1999,3,female,1024,77,46,5,3,5,3,0,0
1474113,25,23,1988,2,female,574,78,42,5,15,5,7,0,8
1956090,21,10,1992,5,female,385,77,57,6,0,0,0,6,0
2100307,29,26,1984,4,male,507,78,57,6,1,0,0,6,1
1637253,55,25,1958,1,female,826,77,49,6,3,0,2,6,1
1150492,108,28,1905,3,female,1131,77,27,6,5,0,1,6,4
1230920,48,19,1965,2,female,456,78,46,6,10,4,6,2,4
1368874,74,12,1939,5,male,513,78,35,6,42,3,17,3,25
2002862,23,14,1990,6,male,334,77,52,6,0,6,0,0,0
1966326,19,5,1994,1,male,312,78,62,6,3,6,2,0,1
1955903,27,24,1986,9,male,321,77,55,6,2,6,2,0,0
1763267,30,16,1983,6,male,608,78,28,6,1,6,1,0,0
2077242,40,17,1973,11,male,244,77,74,6,2,6,2,0,0
1714262,63,4,1950,11,female,1242,78,30,6,2,6,2,0,0
1859421,14,18,1999,1,male,239,78,39,6,4,6,2,0,2
2165956,17,1,1996,5,male,134,78,73,6,6,6,6,0,0
1670493,18,16,1995,3,female,182,78,38,6,4,6,1,0,3
2025884,22,4,1991,10,male,52,78,40,6,5,6,5,0,0
1798827,38,15,1975,9,female,178,78,60,6,8,6,4,0,4
1139979,14,9,1999,12,female,91,77,39,6,12,6,8,0,4
1344368,22,30,1991,11,male,198,77,35,6,18,6,17,0,1
1104754,21,25,1992,8,male,381,77,38,6,12,6,2,0,10
1648837,24,4,1989,12,male,200,77,68,6,16,6,11,0,5
1074484,47,24,1966,10,female,422,77,54,7,7,0,0,7,7
2176026,84,14,1929,6,male,1832,78,41,7,1,5,1,2,0
1629661,21,12,1992,2,male,184,77,30,7,3,6,1,1,2
1484415,23,15,1990,5,male,199,77,71,7,19,6,11,1,8
1438890,21,2,1992,8,male,251,77,58,7,1,7,1,0,0
2015498,27,7,1986,7,female,592,78,47,7,1,7,1,0,0
2154103,30,27,1983,12,male,489,77,12,7,1,7,1,0,0
1803290,32,17,1981,4,male,817,78,49,7,3,7,3,0,0
1775202,32,25,1981,10,male,120,77,49,7,3,7,3,0,0
1772298,22,12,1991,8,female,456,77,37,7,10,7,3,0,7
1383623,24,24,1989,6,male,501,78,67,7,9,7,0,0,9
1243091,30,13,1983,9,male,74,77,51,7,13,7,4,0,9
1436557,57,16,1956,5,male,126,77,68,7,25,7,22,0,3
2108808,51,10,1962,6,male,758,78,37,8,4,7,2,1,2
1152532,19,7,1994,10,male,581,78,31,8,23,6,5,2,18
1136241,28,23,1985,2,female,798,77,37,8,23,7,2,1,21
1899780,21,1,1992,1,male,611,78,63,8,1,8,0,0,1
1463916,37,4,1976,3,male,316,78,69,8,0,8,0,0,0
1187420,26,16,1987,9,male,475,78,5,8,4,8,0,0,4
1297146,95,21,1918,5,female,190,78,52,8,3,8,3,0,0
1629215,17,6,1996,3,male,229,78,58,8,9,8,9,0,0
1333207,38,8,1975,9,male,121,77,64,8,5,8,5,0,0
1442713,39,1,1974,1,male,1071,78,28,8,18,8,10,0,8
1160037,63,12,1950,10,male,536,77,27,8,66,8,43,0,23
1172466,29,9,1984,4,male,414,77,42,9,1,0,0,9,1
1798350,29,1,1984,7,male,519,77,67,9,3,0,2,9,1
1461566,52,2,1961,9,female,182,78,55,9,11,0,3,9,8
1818343,64,9,1949,12,female,964,78,67,9,107,0,75,9,32
1418782,19,30,1994,9,male,206,77,63,9,5,2,2,7,3
2092072,29,27,1984,11,female,300,77,70,9,0,9,0,0,0
1076536,85,20,1928,9,male,469,78,26,9,0,9,0,0,0
1949343,20,1,1993,12,female,207,78,52,9,4,9,3,0,1
1635243,39,16,1974,6,male,646,77,61,9,5,9,3,0,2
1528701,14,1,1999,7,female,42,78,32,9,7,9,7,0,0
1112513,41,27,1972,2,male,402,78,64,9,10,9,9,0,1
1661294,25,6,1988,11,female,98,77,70,9,39,9,19,0,20
2104780,63,1,1950,9,female,649,77,24,10,8,0,3,10,5
1019744,17,12,1996,7,male,196,78,36,10,85,1,54,9,31
2157107,61,31,1952,12,female,443,78,37,10,18,0,5,10,13
1747273,68,20,1945,9,female,886,77,39,10,26,0,5,10,21
1159712,19,30,1994,5,female,191,77,53,10,13,8,7,2,6
1768416,59,23,1954,6,male,924,78,31,10,9,9,1,1,8
1600011,24,17,1989,5,male,202,78,63,10,1,10,0,0,1
1914738,19,15,1994,6,male,685,77,31,10,2,10,2,0,0
1574241,43,30,1970,5,female,802,77,20,10,2,10,1,0,1
2089080,16,11,1997,5,male,489,78,57,10,9,10,5,0,4
2033516,42,31,1971,5,female,654,77,46,10,12,10,9,0,3
1797186,24,15,1989,2,male,405,78,46,10,47,10,29,0,18
1359505,25,1,1988,7,female,257,78,46,10,17,10,16,0,1
1173291,113,3,1900,6,female,1640,77,18,11,4,0,0,11,4
1930034,18,19,1995,7,male,138,78,63,11,56,6,42,5,14
1806016,36,24,1977,9,female,416,78,61,11,17,8,7,3,10
1241995,18,27,1995,2,female,335,77,68,11,0,11,0,0,0
1781499,63,13,1950,10,female,1533,77,29,11,3,11,3,0,0
1035744,25,30,1988,10,female,354,77,44,11,7,11,7,0,0
2101654,28,27,1985,7,male,628,78,45,11,8,11,7,0,1
1407792,15,2,1998,8,female,810,78,59,12,5,0,1,12,4
2150207,39,10,1974,10,female,308,78,34,12,3,0,1,12,2
1935986,47,19,1966,3,male,2276,77,37,12,5,0,3,12,2
1085700,15,19,1998,4,male,350,77,28,12,16,10,2,2,14
2037589,41,1,1972,2,male,360,77,59,12,0,12,0,0,0
1442694,16,2,1997,2,male,196,78,69,12,3,12,3,0,0
2160751,29,6,1984,6,female,496,77,33,12,6,12,6,0,0
1910994,48,3,1965,3,female,188,77,63,12,15,12,14,0,1
1516252,84,16,1929,7,male,1337,78,27,13,13,0,9,13,4
1488951,16,27,1997,12,male,535,78,37,13,0,5,0,8,0
1418340,54,3,1959,12,male,395,77,65,13,12,8,11,5,1
1434523,20,15,1993,1,female,310,77,55,13,0,13,0,0,0
1394686,64,13,1949,7,female,1870,77,45,13,0,13,0,0,0
1311868,21,12,1992,10,male,170,78,26,13,8,13,8,0,0
2188732,34,8,1979,3,male,308,77,51,13,33,13,29,0,4
1564808,43,10,1970,9,male,945,78,48,14,4,0,1,14,3
1475410,66,13,1947,12,female,1671,77,36,14,15,0,8,14,7
1284146,65,29,1948,2,male,312,78,41,14,13,2,5,12,8
1075084,26,22,1987,10,male,71,77,73,14,14,14,8,0,6
1330733,27,2,1986,8,male,93,77,59,14,9,14,8,0,1
1365587,26,28,1987,7,male,81,78,71,14,21,14,16,0,5
1749490,24,20,1989,7,male,158,77,72,15,1,0,0,15,1
1940280,71,15,1942,9,male,1787,78,57,15,1,0,1,15,0
1238879,108,4,1905,8,female,243,77,48,15,17,0,4,15,13
1964984,39,28,1974,5,male,938,77,43,15,258,5,180,10,78
1086931,45,25,1968,11,male,1589,77,24,15,3,15,3,0,0
1635896,64,5,1949,11,female,639,77,17,15,9,15,9,0,0
1647299,26,8,1987,10,male,513,77,45,15,11,15,7,0,4
1910052,29,8,1984,1,female,493,78,32,15,12,15,7,0,5
1897412,30,28,1983,6,male,217,78,73,15,19,15,16,0,3
2142577,67,27,1946,8,female,48,77,58,15,18,15,15,0,3
1570280,50,20,1963,5,male,242,77,52,15,30,15,19,0,11
1480695,30,13,1983,12,female,573,78,51,16,1,2,0,14,1
1248434,27,1,1986,10,male,270,77,76,16,3,0,1,16,2
1238471,42,28,1971,8,female,507,77,37,16,3,0,3,16,0
1000541,22,5,1991,2,male,244,77,46,16,45,3,44,13,1
1721363,29,17,1984,12,female,146,78,66,16,48,3,14,13,34
1028434,16,30,1997,4,male,180,77,61,16,5,13,5,3,0
1992040,45,16,1968,9,male,241,77,45,16,18,15,13,1,5
1483545,29,1,1984,1,male,56,78,55,16,233,12,81,4,152
1195659,49,24,1964,1,male,285,78,20,16,8,16,5,0,3
1629972,24,19,1989,12,male,88,77,5,16,31,16,6,0,25
1947417,25,10,1988,5,female,456,78,25,16,33,16,26,0,7
1914835,82,4,1931,12,male,1020,78,17,17,1,0,1,17,0
1448155,63,1,1950,7,female,200,78,74,17,21,0,7,17,14
1997798,35,23,1978,12,male,646,77,48,17,32,11,4,6,28
1617020,25,2,1988,7,female,509,78,48,17,20,17,17,0,3
1312940,21,1,1992,1,female,70,78,60,17,71,17,68,0,3
1848817,53,23,1960,4,male,1300,78,37,17,30,17,19,0,11
1553946,71,13,1942,9,male,464,78,50,18,139,0,61,18,78
1710311,22,13,1991,9,male,451,77,33,18,18,7,14,11,4
1430829,24,2,1989,7,male,602,78,33,18,0,18,0,0,0
1932129,29,28,1984,10,male,109,77,72,18,22,18,20,0,2
1873518,26,10,1987,11,male,707,78,37,19,3,0,1,19,2
1931562,26,7,1987,8,female,413,78,57,19,8,0,4,19,4
1468906,61,7,1952,4,female,257,78,53,19,29,0,9,19,20
2048064,41,23,1972,6,male,1466,77,34,19,0,19,0,0,0
1219390,67,15,1946,6,female,305,77,44,19,11,19,5,0,6
1180995,16,1,1997,8,female,11,77,46,20,168,14,139,6,29
2138328,21,25,1992,10,female,359,78,67,20,96,8,31,12,65
2165958,32,14,1981,5,male,282,77,69,20,58,4,18,16,40
1683472,61,3,1952,12,male,1596,78,28,20,14,20,10,0,4
1672776,25,24,1988,5,female,61,78,68,20,63,20,34,0,29
1409540,31,13,1982,10,male,78,77,65,20,33,20,9,0,24
1212212,21,1,1992,1,male,363,77,34,21,34,3,22,18,12
1081341,19,30,1994,9,male,235,77,62,21,1,21,1,0,0
1543212,45,30,1968,8,male,377,77,51,21,3,21,1,0,2
2042902,33,30,1980,3,male,364,78,65,22,0,0,0,22,0
1592498,20,26,1993,8,male,192,78,65,22,14,1,14,21,0
2003825,26,18,1987,2,male,253,77,77,22,5,12,0,10,5
1401418,54,8,1959,3,male,485,77,60,22,5,20,4,2,1
1496845,67,6,1946,1,female,778,77,21,22,8,22,7,0,1
1647526,21,31,1992,5,male,346,78,54,22,26,22,17,0,9
1272528,37,2,1976,8,female,249,77,37,22,32,22,13,0,19
2054817,42,25,1971,1,male,604,77,50,22,28,22,15,0,13
1870964,24,11,1989,1,female,324,78,60,22,45,22,35,0,10
1751032,33,18,1980,4,male,287,77,54,23,20,0,2,23,18
1191860,32,10,1981,3,male,308,78,65,23,42,23,27,0,15
2055602,49,9,1964,9,male,222,78,63,24,1,0,1,24,0
1095976,34,11,1979,9,female,522,78,28,24,0,24,0,0,0
1941579,60,17,1953,7,female,1818,77,16,24,3,24,2,0,1
1868112,22,16,1991,12,male,213,78,53,24,8,24,6,0,2
1287695,15,9,1998,8,female,136,77,49,24,22,24,19,0,3
1465516,21,15,1992,1,male,103,77,25,24,40,24,26,0,14
1014180,50,29,1963,8,male,1016,77,32,25,11,14,10,11,1
1061227,55,14,1958,2,female,993,77,62,25,19,20,12,5,7
2143464,80,3,1933,2,female,1619,77,51,26,15,0,9,26,6
1438335,28,14,1985,2,female,356,77,35,26,19,2,14,24,5
1132906,23,30,1990,11,male,467,78,30,26,0,26,0,0,0
1159714,43,20,1970,12,female,590,78,47,27,4,27,1,0,3
1818046,18,10,1995,11,male,633,77,59,27,11,27,9,0,2
1307588,25,21,1988,6,female,96,77,50,27,137,27,93,0,44
2039261,70,17,1943,9,female,1938,78,11,28,10,0,1,28,9
1944391,26,26,1987,2,female,668,78,41,28,68,25,30,3,38
1403315,56,27,1957,10,female,1276,77,27,28,6,28,6,0,0
1484841,17,12,1996,2,male,238,78,30,28,47,28,45,0,2
1026117,22,15,1991,12,male,485,77,34,28,101,28,35,0,66
1660223,21,13,1992,9,female,264,78,26,28,92,28,62,0,30
1979435,69,31,1944,12,female,534,77,48,29,109,0,24,29,85
1412425,18,1,1995,10,male,34,77,41,29,35,17,18,12,17
1161758,29,20,1984,9,male,459,77,40,29,4,28,3,1,1
1873782,22,25,1991,12,female,399,77,44,29,32,29,28,0,4
2117537,19,22,1994,2,female,64,78,35,29,79,29,79,0,0
1019431,50,21,1963,8,male,189,77,60,29,49,29,43,0,6
1006623,53,25,1960,6,male,490,78,63,30,3,0,0,30,3
2082226,62,20,1951,4,female,240,77,66,31,2,9,1,22,1
1677681,31,6,1982,2,male,335,77,36,30,33,30,28,0,5
1180907,62,10,1951,4,female,1472,77,39,32,74,30,50,2,24
1053207,17,10,1996,2,female,109,78,46,32,21,32,20,0,1
1805879,19,26,1994,3,male,113,78,65,32,115,32,103,0,12
1618388,17,7,1996,2,male,460,77,41,33,35,30,21,3,14
1369217,34,28,1979,9,male,318,78,44,33,44,33,41,0,3
2038556,14,23,1999,1,male,365,78,39,34,1,0,0,34,1
1974465,26,8,1987,7,male,625,77,43,34,5,34,5,0,0
1523675,15,6,1998,3,male,156,77,51,36,9,0,1,36,8
2160511,23,22,1990,5,female,173,77,63,35,33,35,19,0,14
1709482,56,13,1957,6,male,877,77,41,36,25,36,5,0,20
1587889,18,4,1995,8,male,1294,77,71,37,1,0,0,37,1
1320338,19,6,1994,12,male,88,78,46,37,53,23,13,14,40
1008983,23,27,1990,11,male,684,77,53,37,27,37,19,0,8
1830637,21,8,1992,8,male,182,78,48,38,3,0,0,38,3
1603249,27,1,1986,1,male,556,78,55,39,5,0,0,39,5
1063746,108,15,1905,12,female,77,77,66,39,21,17,11,22,10
1970359,60,10,1953,9,male,1569,77,40,38,33,32,24,6,9
2033859,33,13,1980,1,male,445,77,52,39,189,36,113,3,76
1394662,15,29,1998,8,female,198,78,14,38,1,38,1,0,0
1784149,20,29,1993,12,male,52,77,71,38,4,38,4,0,0
1333484,42,8,1971,7,female,805,77,30,38,10,38,7,0,3
1184734,26,31,1987,8,female,628,78,39,39,32,39,31,0,1
1855959,59,24,1954,8,male,547,77,57,40,21,23,14,17,7
1925585,76,20,1937,6,female,10,77,60,40,66,33,12,7,54
1441427,31,5,1982,6,female,385,77,31,40,2,40,2,0,0
2073702,18,3,1995,10,male,38,78,68,40,34,40,34,0,0
1308414,19,19,1994,1,female,504,78,56,40,46,40,43,0,3
1750118,80,23,1933,3,female,477,78,47,42,91,0,19,42,72
1189457,32,16,1981,5,female,288,78,58,41,20,41,20,0,0
1565046,103,31,1910,12,female,34,78,77,42,44,42,40,0,4
1234992,18,30,1995,3,male,216,77,54,41,73,41,54,0,19
1765259,52,30,1961,12,female,1525,78,36,42,86,42,39,0,47
2109131,53,9,1960,7,female,868,78,51,44,46,41,15,3,31
2133286,18,6,1995,1,female,93,78,6,43,12,43,8,0,4
2050642,33,22,1980,8,female,933,77,54,43,34,43,21,0,13
1220497,59,29,1954,1,female,751,78,47,45,25,0,8,45,17
1011726,47,25,1966,1,female,608,77,43,45,48,0,15,45,33
1642212,94,19,1919,2,female,1894,78,40,45,29,34,21,11,8
1979135,45,25,1968,12,female,388,78,70,45,1,45,0,0,1
2120290,102,11,1911,11,male,648,78,68,47,6,9,3,38,3
1752289,64,1,1949,9,female,1596,77,10,46,84,3,61,43,23
2051902,80,22,1933,12,male,622,77,45,46,38,41,20,5,18
1400616,34,17,1979,11,male,220,78,62,46,2,46,1,0,1
2041451,32,9,1981,8,male,242,78,55,47,17,47,12,0,5
2018589,52,18,1961,12,male,233,78,58,46,28,46,4,0,24
2021587,33,8,1980,6,female,258,77,45,47,220,47,163,0,57
2086571,17,27,1996,9,male,48,78,50,48,39,46,36,2,3
1240671,31,13,1982,10,female,140,77,53,48,60,46,43,2,17
2191811,17,23,1996,8,male,698,77,24,49,3,49,3,0,0
1539411,24,5,1989,6,male,545,77,38,49,17,49,16,0,1
1644109,48,9,1965,3,male,226,77,73,51,3,0,1,51,2
2155701,59,24,1954,10,male,343,78,61,51,2,51,2,0,0
1814240,102,10,1911,11,male,2050,78,45,52,32,0,24,52,8
1442061,23,1,1990,5,female,607,78,19,53,114,32,22,21,92
1595165,28,5,1985,8,male,287,78,76,52,8,52,8,0,0
1462968,22,23,1991,3,female,344,78,45,53,65,53,63,0,2
1288648,37,15,1976,8,male,394,77,46,52,44,52,11,0,33
2090119,40,13,1973,8,male,83,78,58,53,64,53,57,0,7
1268253,78,2,1935,10,male,952,78,45,54,4,0,2,54,2
1903035,17,14,1996,1,male,654,78,55,55,8,38,1,17,7
2095536,21,28,1992,2,male,377,77,45,55,47,45,22,10,25
1170612,26,15,1987,6,male,281,78,69,56,8,0,1,56,7
1232798,69,6,1944,10,female,603,77,39,57,34,24,16,33,18
2165785,21,20,1992,11,female,280,78,44,57,103,25,83,32,20
2031097,22,11,1991,1,male,128,78,38,56,5,42,4,14,1
2124518,17,6,1996,5,male,303,77,59,58,2,58,2,0,0
2087989,65,4,1948,3,female,1032,78,53,57,7,57,6,0,1
1679895,18,10,1995,1,female,159,77,14,57,17,57,13,0,4
1689761,28,30,1985,6,male,329,78,50,57,34,57,31,0,3
1411932,55,8,1958,10,female,784,77,45,56,87,56,76,0,11
1185173,64,5,1949,2,female,1734,78,53,59,95,9,52,50,43
1226273,46,6,1967,5,female,249,77,41,59,34,59,17,0,17
1278466,16,15,1997,5,female,310,78,58,60,90,60,80,0,10
1254888,25,3,1988,6,male,234,78,49,62,32,62,30,0,2
1262236,34,27,1979,4,male,186,78,27,63,37,63,24,0,13
1553633,53,1,1960,1,male,1624,78,65,65,2,65,1,0,1
1135091,38,26,1975,8,female,651,78,18,65,25,65,8,0,17
1583489,43,24,1970,9,male,486,77,39,64,22,64,18,0,4
1393102,22,22,1991,11,female,544,77,44,65,73,65,61,0,12
1708674,68,28,1945,8,male,66,77,75,65,96,65,88,0,8
1126831,33,1,1980,5,female,507,78,42,68,1,0,1,68,0
1138158,74,3,1939,3,male,1168,78,21,67,6,0,5,67,1
1961642,56,26,1957,7,female,814,78,43,67,182,31,155,36,27
1947083,26,30,1987,9,female,1124,77,51,68,233,60,95,8,138
1712334,30,11,1983,9,male,1344,77,47,68,19,68,14,0,5
1871264,40,17,1973,4,female,275,77,34,66,37,66,23,0,14
1137806,13,7,2000,3,male,174,77,71,70,0,6,0,64,0
1714965,40,18,1973,4,male,115,77,65,70,59,31,12,39,47
1356090,61,20,1952,11,female,1483,77,29,71,14,63,10,8,4
1622012,51,9,1962,3,male,385,77,34,69,86,56,69,13,17
1906023,27,10,1986,6,male,616,77,38,71,5,71,4,0,1
1844322,19,1,1994,8,male,255,77,32,71,31,71,12,0,19
2184713,23,10,1990,5,male,60,77,67,70,54,70,40,0,14
2144045,17,19,1996,7,female,102,78,47,74,22,74,2,0,20
1664703,21,7,1992,10,male,115,78,13,72,29,72,17,0,12
2172169,55,14,1958,7,NA,2013,78,19,72,33,72,11,0,22
1010385,71,1,1942,1,male,621,78,54,75,7,0,0,75,7
1084967,17,26,1996,1,male,231,77,56,75,41,75,31,0,10
1068578,35,1,1978,1,male,123,78,59,76,23,76,22,0,1
1589262,76,1,1937,11,female,1947,77,50,79,7,0,3,79,4
1645037,57,11,1956,5,female,564,78,72,79,25,77,17,2,8
1595633,30,19,1983,6,male,664,77,40,78,2,78,2,0,0
1402731,21,8,1992,11,male,878,77,53,79,29,79,26,0,3
1542633,31,21,1982,1,male,304,77,60,83,20,42,17,41,3
1592865,19,12,1994,12,female,243,78,15,81,2,76,2,5,0
1177614,43,17,1970,7,male,433,77,24,82,2,75,2,7,0
1465898,72,17,1941,2,female,1514,78,48,83,43,64,9,19,34
1721263,18,4,1995,4,male,174,77,28,81,6,81,6,0,0
1443926,17,5,1996,6,male,347,78,32,82,91,82,70,0,21
1907780,22,2,1991,8,male,271,77,67,85,4,0,3,85,1
2175522,57,9,1956,9,female,349,78,42,86,49,0,19,86,30
1764639,51,11,1962,5,female,519,77,45,87,78,0,52,87,26
1861934,57,21,1956,10,female,162,77,66,86,114,0,12,86,102
1642032,70,21,1943,4,female,374,77,49,86,197,0,14,86,183
1937465,43,21,1970,2,male,980,78,38,89,87,87,63,2,24
1851150,18,29,1995,5,male,217,78,65,89,24,89,23,0,1
1000154,24,18,1989,3,female,536,78,29,89,163,89,132,0,31
1194333,57,15,1956,3,male,488,78,35,93,63,8,22,85,41
2142706,42,5,1971,10,male,370,77,28,94,70,19,41,75,29
1289629,31,26,1982,9,male,154,78,70,92,12,92,6,0,6
1997832,23,4,1990,5,male,84,77,70,97,5,97,3,0,2
1710255,32,14,1981,9,female,438,78,64,99,80,99,76,0,4
1468786,53,25,1960,12,female,250,78,34,101,2,0,1,101,1
1403479,74,7,1939,8,female,124,78,60,100,4,0,2,100,2
1776798,65,7,1948,7,female,1494,78,42,100,203,98,123,2,80
1214690,48,9,1965,6,female,344,78,43,104,19,104,9,0,10
1278969,40,24,1973,8,female,526,78,40,104,143,104,126,0,17
1542609,30,1,1983,7,male,607,78,35,106,41,64,16,42,25
1170151,24,25,1989,9,male,444,77,65,107,6,95,4,12,2
1176593,53,29,1960,12,female,1006,77,58,105,14,100,7,5,7
1550780,17,1,1996,9,male,312,78,69,107,20,107,17,0,3
1095116,24,17,1989,9,male,285,77,57,106,23,106,22,0,1
2076609,46,18,1967,6,female,974,77,33,110,92,79,52,31,40
1636720,23,30,1990,8,female,382,78,40,113,32,113,14,0,18
1642420,15,14,1998,12,male,670,77,36,111,71,111,29,0,42
1344484,64,3,1949,11,female,440,77,48,115,46,0,13,115,33
1832184,26,14,1987,7,male,203,77,41,117,52,117,49,0,3
1107881,23,15,1990,5,male,694,77,55,120,58,7,22,113,36
2192818,18,5,1995,1,female,99,77,57,122,34,118,28,4,6
2153608,42,10,1971,9,female,369,77,38,124,48,99,34,25,14
1668128,52,10,1961,3,NA,2062,77,65,124,68,124,28,0,40
2028336,44,4,1969,2,male,153,77,38,122,111,122,42,0,69
1240982,19,20,1994,2,male,5,78,78,130,47,130,26,0,21
2022172,57,5,1956,6,male,825,78,68,126,28,126,25,0,3
2060036,44,13,1969,6,female,131,77,60,128,125,128,28,0,97
1266241,75,8,1938,10,female,1750,77,31,129,244,129,180,0,64
1623135,55,24,1958,11,male,233,77,22,135,10,0,0,135,10
2117456,75,14,1938,7,male,319,77,58,131,19,0,16,131,3
2190271,20,21,1993,6,male,283,77,58,132,155,0,15,132,140
2156933,17,21,1996,9,male,160,78,67,131,316,33,47,98,269
1495516,58,22,1955,10,male,788,78,17,136,235,45,82,91,153
1305150,24,12,1989,4,female,312,78,39,131,67,117,50,14,17
1567256,19,23,1994,12,male,62,77,65,132,143,120,84,12,59
1663073,35,18,1978,10,male,557,77,55,136,185,136,61,0,124
1709664,61,25,1952,6,female,329,77,43,134,101,134,70,0,31
2083654,65,30,1948,7,female,1517,77,56,133,111,133,103,0,8
1315509,47,7,1966,1,male,362,78,42,137,37,0,12,137,25
2141078,60,7,1953,7,male,651,78,51,142,26,1,11,141,15
1949208,71,11,1942,8,female,625,77,49,141,51,0,16,141,35
1140095,25,5,1988,8,female,679,77,30,142,47,135,15,7,32
2130422,32,13,1981,3,female,556,77,54,141,175,131,141,10,34
1238531,33,1,1980,3,female,226,77,53,139,182,128,90,11,92
1093634,32,20,1981,8,male,376,78,59,138,46,138,42,0,4
2187939,39,21,1974,6,male,616,77,46,139,61,139,53,0,8
1867583,57,1,1956,3,female,1536,77,28,149,126,63,64,86,62
2028317,65,15,1948,8,female,1717,77,46,150,177,150,91,0,86
2178973,14,9,1999,7,female,158,78,44,153,62,127,23,26,39
1095916,37,23,1976,2,female,306,78,64,156,105,150,71,6,34
1549741,28,10,1985,9,male,167,77,39,154,18,154,16,0,2
1999025,29,22,1984,8,female,490,78,41,157,8,157,4,0,4
2073745,63,26,1950,10,female,304,77,39,156,11,156,11,0,0
1983843,67,28,1946,3,female,1004,78,44,159,27,0,1,159,26
1818238,27,25,1986,4,male,345,78,58,162,186,83,156,79,30
2103324,45,2,1968,7,male,491,77,45,160,3,160,3,0,0
1778481,20,19,1993,8,female,429,77,43,162,80,162,28,0,52
1523910,25,18,1988,12,female,294,77,45,164,32,164,25,0,7
1713984,17,25,1996,1,male,419,78,59,158,299,158,223,0,76
1492614,40,1,1973,3,female,556,78,17,171,162,171,117,0,45
1027421,50,5,1963,4,male,377,77,54,173,121,0,69,173,52
1070989,46,7,1967,6,male,338,77,32,173,28,147,23,26,5
1486233,28,22,1985,10,male,865,77,62,179,57,179,56,0,1
1374824,81,10,1932,6,female,380,77,60,174,59,174,35,0,24
1616319,31,16,1982,4,female,406,77,59,182,100,182,100,0,0
2040001,29,13,1984,2,male,391,78,73,195,0,190,0,5,0
1030167,43,26,1970,9,male,302,78,77,191,1,180,1,11,0
1681818,18,17,1995,12,male,371,78,27,196,35,190,28,6,7
1126195,66,8,1947,1,male,1523,78,28,193,121,173,55,20,66
2180945,38,11,1975,11,female,371,78,64,200,98,200,82,0,16
1271829,53,24,1960,5,female,785,77,23,220,128,209,105,11,23
1044657,32,23,1981,11,male,269,77,76,215,27,215,26,0,1
2012698,30,17,1983,11,female,522,78,57,217,55,217,51,0,4
1811272,108,1,1905,7,female,250,78,52,223,152,41,37,182,115
1802176,54,1,1959,12,female,1538,78,13,233,331,108,275,125,56
1364148,18,29,1995,1,female,142,77,46,225,118,225,78,0,40
1987740,33,13,1980,1,female,1210,77,63,233,123,233,94,0,29
1149642,18,8,1995,2,male,517,77,59,240,4,16,2,224,2
1593712,113,29,1900,9,female,1137,77,25,238,128,0,30,238,98
1398683,52,21,1961,11,female,1718,77,48,245,92,167,40,78,52
1288675,14,23,1999,7,female,167,77,64,248,48,221,45,27,3
1105299,100,26,1913,4,male,899,78,56,249,254,199,157,50,97
1101738,113,12,1900,8,female,1200,78,42,257,28,257,25,0,3
2129392,19,19,1994,6,male,13,77,50,251,44,251,36,0,8
2009008,23,30,1990,4,female,444,77,48,255,81,255,63,0,18
1315551,16,11,1997,4,female,271,77,70,273,160,54,57,219,103
1105114,69,22,1944,7,female,1171,78,50,276,207,0,25,276,182
1840392,22,2,1991,7,female,305,78,38,268,105,210,20,58,85
1800242,23,28,1990,6,female,1014,78,53,272,201,272,138,0,63
1647515,24,2,1989,8,male,73,78,70,282,115,282,73,0,42
1952049,40,1,1973,7,female,254,78,48,286,110,286,91,0,19
1545509,54,12,1959,6,female,762,77,28,285,596,285,358,0,238
1753823,62,22,1951,9,female,1686,78,17,294,220,4,155,290,65
1142741,70,13,1943,7,female,33,77,46,315,117,0,36,315,81
1401064,46,10,1967,8,female,83,77,53,310,18,90,9,220,9
2085682,49,2,1964,3,female,1565,78,36,311,439,179,258,132,181
1059143,27,24,1986,12,female,16,77,55,319,177,278,153,41,24
1077347,26,11,1987,6,female,404,78,49,325,122,325,84,0,38
1735656,57,6,1956,1,female,951,77,11,320,91,320,68,0,23
1471676,34,23,1979,6,male,31,77,65,328,58,328,37,0,21
1384110,67,28,1946,6,female,896,78,40,335,177,335,111,0,66
2115205,28,17,1985,8,female,138,77,46,346,758,346,319,0,439
1460095,55,4,1958,10,female,866,78,49,348,39,237,35,111,4
1145165,23,13,1990,6,female,452,78,22,351,81,351,65,0,16
1314642,50,1,1963,1,female,227,77,67,362,109,362,87,0,22
1997894,35,3,1978,5,female,381,77,51,394,294,394,218,0,76
1022655,19,26,1994,8,female,514,77,60,419,147,336,79,83,68
2058742,57,10,1956,12,female,254,77,43,441,285,6,150,435,135
1669636,62,11,1951,3,female,212,78,38,482,6,480,4,2,2
1612278,62,20,1951,4,female,102,78,62,466,182,466,107,0,75
2156669,26,3,1987,9,female,457,77,52,501,361,145,253,356,108
1111954,54,16,1959,3,female,2083,78,34,508,1371,127,54,381,1317
1875606,28,1,1985,1,male,382,77,55,496,13,496,9,0,4
1181676,23,15,1990,4,male,41,77,60,543,136,4,34,539,102
1794169,34,11,1979,8,male,1196,77,38,537,344,2,83,535,261
1293121,52,27,1961,2,female,1058,77,25,527,520,0,171,527,349
1199445,49,16,1964,12,female,468,78,42,538,342,523,208,15,134
1829360,27,17,1986,2,female,1468,77,33,603,451,443,228,160,223
1130046,54,2,1959,6,female,1674,78,44,580,142,580,96,0,46
2025427,69,13,1944,9,female,1403,77,9,640,122,166,63,474,59
1361914,38,10,1975,12,male,197,78,64,628,387,460,166,168,221
2089244,42,17,1971,11,male,293,78,59,630,563,600,421,30,142
1729559,50,11,1963,9,female,1636,78,41,675,511,235,330,440,181
1936372,19,5,1994,10,female,230,77,46,769,1151,732,441,37,710
2015619,42,10,1971,1,male,371,77,35,747,356,747,252,0,104
1600821,108,1,1905,1,male,175,78,65,800,60,0,18,800,42
2159648,14,3,1999,2,female,343,77,54,828,144,229,60,599,84
1669845,22,30,1991,6,female,9,78,66,841,698,841,562,0,136
1832123,30,24,1983,8,female,448,77,39,932,565,5,292,927,273
1687489,65,13,1948,9,female,521,78,32,934,268,231,133,703,135
1844638,63,26,1950,5,male,186,78,68,885,77,883,51,2,26
2155329,44,25,1969,7,female,183,78,25,954,283,954,199,0,84
1101691,66,15,1947,7,female,1556,78,44,1068,137,8,49,1060,88
1125020,56,22,1957,12,female,782,78,41,1051,228,0,34,1051,194
1719916,16,8,1997,2,male,529,77,31,1091,901,447,62,644,839
1458036,93,1,1920,12,female,579,77,59,1109,513,1109,319,0,194
1787210,41,28,1972,5,female,211,78,44,1250,1457,1250,783,0,674
1242134,18,7,1995,12,female,40,78,73,1453,645,746,464,707,181
1376241,54,3,1959,8,female,1568,77,30,1510,167,1510,113,0,54
1449064,64,13,1949,6,female,2155,78,19,1643,225,0,70,1643,155
1490537,58,2,1955,7,female,275,77,61,1832,374,1832,85,0,289
2096667,58,14,1955,8,female,1022,78,47,2141,1435,1741,177,400,1258
1054849,28,11,1985,9,male,404,78,66,1990,947,1990,896,0,51
1800728,20,18,1993,4,female,106,77,58,3830,1136,3830,697,0,439
1702283,58,27,1955,11,female,1365,80,21,26,7,26,5,0,2
2127896,22,23,1991,9,male,246,79,60,26,59,26,27,0,32
1732163,25,28,1988,9,male,442,80,6,26,65,26,47,0,18
2090120,36,5,1977,11,female,1016,80,53,27,8,26,2,1,6
1144405,48,26,1965,8,female,809,81,68,27,22,27,19,0,3
1715935,31,21,1982,5,female,202,81,42,28,25,2,16,26,9
1413582,26,18,1987,12,female,409,80,39,28,12,6,8,22,4
1496919,28,24,1985,3,female,282,80,30,28,11,14,10,14,1
1619052,44,1,1969,6,female,847,79,57,28,11,26,9,2,2
1793428,67,20,1946,7,male,1726,80,12,28,39,25,16,3,23
1865521,18,10,1995,9,male,249,81,45,28,1,28,1,0,0
1667848,27,20,1986,7,female,233,79,42,28,16,28,11,0,5
1550405,53,30,1960,11,female,69,79,50,28,9,28,8,0,1
1688661,74,19,1939,5,female,554,79,77,28,16,28,9,0,7
1491415,42,19,1971,7,male,672,79,63,28,30,28,28,0,2
1799030,26,16,1987,8,male,120,80,71,28,57,28,30,0,27
1124611,68,25,1945,6,female,1465,80,45,28,48,28,43,0,5
1900968,95,14,1918,5,male,1493,81,48,29,10,0,7,29,3
1825886,39,30,1974,9,female,254,81,68,29,48,0,10,29,38
1760241,20,26,1993,4,female,410,81,44,29,27,13,17,16,10
1221814,77,16,1936,7,male,1549,79,30,29,20,15,13,14,7
1516234,19,21,1994,11,female,199,79,49,29,12,28,7,1,5
1857984,106,19,1907,7,male,1419,79,60,29,7,28,2,1,5
1136266,29,28,1984,3,female,253,79,71,29,8,29,2,0,6
1575605,18,30,1995,12,male,73,79,45,29,33,29,30,0,3
1547985,34,16,1979,2,female,423,80,48,29,22,29,9,0,13
1823571,16,7,1997,2,male,587,81,52,31,5,0,3,31,2
2120555,44,15,1969,7,female,447,80,54,30,4,2,2,28,2
2130430,69,25,1944,10,female,471,80,39,31,7,0,5,31,2
2132424,35,8,1978,9,female,176,81,66,30,29,7,21,23,8
1399360,20,6,1993,6,male,188,80,42,30,153,27,48,3,105
1485962,61,26,1952,4,female,1743,80,33,31,49,27,32,4,17
1309871,26,25,1987,6,male,250,80,64,31,20,31,13,0,7
1684547,16,26,1997,8,female,242,80,49,31,81,31,54,0,27
1355406,20,6,1993,6,male,19,79,50,31,49,31,47,0,2
1462554,43,24,1970,7,male,568,81,55,32,18,1,10,31,8
1589062,47,18,1966,11,male,247,79,31,32,9,0,1,32,8
1783302,80,16,1933,10,female,357,79,68,32,31,0,9,32,22
1076963,103,31,1910,10,male,1658,79,7,32,28,0,11,32,17
1182350,55,5,1958,5,male,432,80,12,32,71,0,44,32,27
1630647,40,22,1973,3,male,76,80,72,32,20,7,5,25,15
1821367,34,30,1979,6,male,329,79,64,32,4,32,3,0,1
1182187,51,23,1962,5,female,133,79,68,32,49,32,18,0,31
2170628,103,2,1910,10,female,1333,80,22,33,15,5,11,28,4
2155876,32,20,1981,5,male,249,79,67,33,28,32,24,1,4
1783003,43,10,1970,8,female,132,81,72,33,16,33,6,0,10
1730846,24,15,1989,5,male,202,79,67,33,34,33,29,0,5
1991280,31,6,1982,2,male,193,80,50,33,85,33,49,0,36
1800493,15,24,1998,11,male,565,81,24,34,50,20,18,14,32
1396485,20,3,1993,6,female,234,81,60,34,32,31,23,3,9
1026462,57,23,1956,6,male,1504,80,33,35,51,0,12,35,39
1030785,104,19,1909,2,female,1081,79,41,37,12,2,11,35,1
1513580,26,1,1987,1,male,35,81,78,37,15,33,5,4,10
1121503,52,19,1961,1,male,1290,80,49,37,21,34,13,3,8
1066247,25,1,1988,1,male,111,79,72,37,5,37,3,0,2
1816594,26,12,1987,10,female,431,81,53,37,9,37,4,0,5
1722933,24,9,1989,3,male,553,80,16,37,29,37,29,0,0
2094298,33,13,1980,6,female,201,80,53,37,38,37,35,0,3
1865868,56,26,1957,11,female,527,81,52,37,37,37,28,0,9
1557937,64,27,1949,12,female,967,80,37,39,12,0,4,39,8
1711971,79,19,1934,3,female,1528,79,38,39,20,0,1,39,19
1604450,57,24,1956,6,female,440,80,54,38,37,0,16,38,21
1029942,66,25,1947,8,male,620,81,66,38,27,17,0,21,27
1355524,57,17,1956,11,female,953,80,44,38,54,32,42,6,12
1914567,31,14,1982,12,male,289,81,65,38,37,38,31,0,6
1133440,38,19,1975,4,male,91,79,48,39,43,39,18,0,25
1918260,60,9,1953,2,male,307,79,65,40,31,0,8,40,23
2105059,22,14,1991,2,male,105,79,58,40,22,40,21,0,1
1965354,30,29,1983,12,male,223,79,55,40,51,40,30,0,21
1149939,23,8,1990,8,male,181,80,60,40,78,40,21,0,57
1261731,29,10,1984,3,male,470,81,74,42,1,0,0,42,1
1211299,53,23,1960,11,female,1712,81,59,41,4,0,0,41,4
1812674,22,6,1991,1,male,3,80,72,42,18,0,7,42,11
1509919,30,19,1983,8,male,37,81,75,41,59,14,28,27,31
2073245,32,7,1981,12,female,840,79,41,42,47,12,10,30,37
2175161,31,16,1982,2,female,884,80,51,42,48,25,21,17,27
2106044,66,11,1947,7,female,222,79,52,42,43,12,16,30,27
2158823,19,13,1994,7,male,346,81,51,41,64,40,53,1,11
1719744,39,10,1974,5,male,915,80,61,41,66,36,35,5,31
1946784,17,4,1996,11,female,82,80,36,42,5,42,5,0,0
2157124,40,19,1973,11,male,284,81,50,41,36,41,18,0,18
1937379,52,19,1961,11,female,1516,80,23,42,41,42,32,0,9
1448652,26,12,1987,3,male,559,81,24,42,94,42,72,0,22
1084888,33,14,1980,10,male,137,80,69,41,68,41,18,0,50
2113967,38,18,1975,11,male,749,79,38,41,72,41,40,0,32
1089112,20,29,1993,9,male,473,80,50,44,13,0,4,44,9
2117684,49,11,1964,8,male,662,81,43,44,38,1,9,43,29
1274975,62,24,1951,11,male,2291,80,48,44,40,31,20,13,20
1087151,66,24,1947,10,NA,2231,80,43,44,221,19,110,25,111
1794619,26,5,1987,10,male,960,80,60,44,3,44,3,0,0
1056961,30,4,1983,2,male,199,81,69,44,0,44,0,0,0
1307294,28,1,1985,4,female,458,80,54,44,38,44,31,0,7
1110537,52,15,1961,6,female,746,80,70,47,19,0,3,47,16
1405019,26,13,1987,2,male,435,80,50,47,42,5,14,42,28
2001184,27,18,1986,2,male,606,79,74,47,3,47,1,0,2
2044214,27,27,1986,10,male,449,79,50,48,18,48,13,0,5
1938544,35,8,1978,12,male,54,79,71,48,14,48,8,0,6
1444216,32,26,1981,4,female,505,79,37,48,230,48,171,0,59
1462416,33,28,1980,4,male,339,79,66,49,115,49,85,0,30
1672766,108,9,1905,11,female,896,80,46,50,19,0,8,50,11
1405464,30,30,1983,12,female,279,81,62,51,50,28,15,23,35
1854927,60,15,1953,12,female,2111,79,53,50,13,44,8,6,5
2119902,63,19,1950,7,male,1638,80,46,50,66,49,30,1,36
1507810,62,23,1951,12,male,204,81,51,50,6,50,5,0,1
2006796,64,5,1949,1,female,126,79,65,50,4,50,1,0,3
1274180,24,4,1989,8,male,715,79,43,51,36,51,34,0,2
1983826,18,28,1995,11,female,198,79,24,50,186,50,138,0,48
1053167,69,26,1944,12,female,1174,80,31,52,26,0,21,52,5
1636278,103,26,1910,4,male,1337,81,48,53,64,5,33,48,31
2134171,18,10,1995,11,female,24,81,59,52,99,23,31,29,68
1592420,30,9,1983,1,male,559,80,55,52,20,43,20,9,0
1115821,54,1,1959,11,male,1737,80,39,52,14,51,8,1,6
1019180,15,9,1998,4,female,453,80,10,52,0,52,0,0,0
1635193,24,17,1989,8,male,707,80,60,52,1,52,1,0,0
1613205,26,24,1987,5,female,522,79,45,53,27,53,17,0,10
1475386,55,14,1958,8,male,265,81,51,53,11,53,9,0,2
1101182,27,2,1986,9,female,368,81,32,52,83,52,39,0,44
1003609,63,1,1950,8,female,686,80,70,54,29,5,6,49,23
1414716,23,7,1990,8,male,404,80,29,54,6,50,3,4,3
1056817,51,6,1962,1,female,1052,81,40,54,49,43,40,11,9
1269504,24,23,1989,9,female,569,81,54,54,22,54,9,0,13
1006403,19,30,1994,5,male,42,80,73,58,102,30,58,28,44
1576024,52,15,1961,11,female,350,81,53,56,30,54,21,2,9
1474247,53,25,1960,1,female,968,79,42,58,35,58,29,0,6
1142685,54,25,1959,3,male,1356,81,45,58,11,58,1,0,10
1059185,47,27,1966,9,female,343,79,21,57,225,57,148,0,77
1161500,108,11,1905,9,male,1392,79,39,59,21,0,15,59,6
1202290,46,5,1967,1,male,273,80,51,62,26,0,20,62,6
1981576,18,10,1995,1,male,331,80,30,61,0,13,0,48,0
1383829,68,13,1945,8,male,1851,80,19,63,54,28,38,35,16
2117328,23,5,1990,11,female,1013,80,20,63,96,30,88,33,8
1040468,24,24,1989,4,female,419,79,43,63,1,57,1,6,0
1659374,15,5,1998,3,female,585,81,9,61,11,57,11,4,0
2106924,27,27,1986,9,female,532,80,60,62,52,54,27,8,25
1000530,37,29,1976,9,female,269,79,50,63,72,56,59,7,13
1659107,52,11,1961,10,female,1327,81,19,62,60,47,32,15,28
2170576,20,26,1993,10,male,413,79,55,63,8,63,8,0,0
1651280,23,11,1990,4,male,266,81,43,61,5,61,2,0,3
1291732,27,7,1986,5,female,743,81,41,62,2,62,1,0,1
1539184,63,25,1950,8,female,268,81,45,62,7,62,5,0,2
1063470,20,3,1993,3,male,652,80,37,61,27,61,24,0,3
1735145,22,5,1991,5,male,13,81,75,63,19,63,9,0,10
1992733,73,10,1940,2,male,1591,80,52,61,149,61,83,0,66
1719613,62,27,1951,1,male,492,79,26,64,142,0,30,64,112
1027840,37,13,1976,8,female,661,80,32,65,448,64,253,1,195
2037391,48,29,1965,9,female,439,80,40,64,10,64,8,0,2
1728437,47,16,1966,10,female,883,80,22,64,74,64,43,0,31
1866830,28,19,1985,9,female,413,81,56,64,188,64,188,0,0
1724517,23,12,1990,12,male,472,81,67,68,4,7,1,61,3
1738940,37,27,1976,11,male,101,81,45,67,217,35,167,32,50
1217064,18,9,1995,9,male,152,79,75,66,33,64,23,2,10
1325105,33,26,1980,12,male,672,80,36,66,31,60,12,6,19
1201587,14,20,1999,3,female,137,79,46,67,3,67,3,0,0
1231860,14,8,1999,3,female,69,80,66,67,14,67,14,0,0
1333120,22,7,1991,9,female,347,80,50,66,34,66,19,0,15
1220790,28,9,1985,3,female,367,81,67,67,96,67,81,0,15
1361893,37,25,1976,4,male,413,80,53,71,25,30,15,41,10
1086292,57,16,1956,3,female,1647,80,57,71,13,38,8,33,5
1419920,22,19,1991,9,male,26,80,75,69,1,65,1,4,0
1147012,55,30,1958,10,male,705,81,46,71,21,71,17,0,4
1936728,76,20,1937,2,female,806,79,37,73,9,0,1,73,8
1934020,15,21,1998,10,female,277,80,42,73,21,24,12,49,9
2064071,61,28,1952,1,female,1815,81,40,74,26,24,17,50,9
1443253,39,2,1974,4,male,208,81,60,74,44,65,25,9,19
1045340,31,20,1982,1,male,274,81,55,74,29,74,29,0,0
2054747,18,12,1995,8,male,34,79,71,72,70,72,67,0,3
1859378,27,10,1986,6,female,187,81,66,73,49,73,28,0,21
1512403,19,3,1994,1,male,224,81,60,75,7,1,3,74,4
1365488,108,20,1905,3,female,1992,81,42,76,43,4,20,72,23
1746856,58,30,1955,3,female,1449,80,31,77,12,40,12,37,0
1119612,52,6,1961,6,male,567,81,71,76,27,27,10,49,17
1949460,65,16,1948,8,male,1762,80,57,77,23,29,17,48,6
1131652,18,8,1995,8,male,103,81,68,79,19,0,0,79,19
1657058,53,13,1960,8,male,2124,81,40,80,68,51,44,29,24
1756077,22,17,1991,11,female,255,79,48,79,149,52,21,27,128
2124071,56,13,1957,8,female,1729,80,34,78,4,73,0,5,4
1914429,31,8,1982,9,male,227,80,63,79,39,72,17,7,22
1647630,51,22,1962,8,female,1039,81,33,78,52,60,28,18,24
1859871,32,31,1981,1,male,191,81,72,78,213,69,49,9,164
1814260,16,5,1997,9,female,539,79,50,78,3,78,3,0,0
2114618,27,27,1986,12,male,418,80,40,79,3,79,3,0,0
1139507,15,8,1998,5,female,280,79,37,79,20,79,16,0,4
1308029,33,16,1980,12,female,493,81,64,78,29,78,20,0,9
1779214,38,29,1975,11,female,66,81,25,79,27,79,26,0,1
1036424,39,16,1974,1,male,1115,80,55,78,23,78,13,0,10
1084412,73,20,1940,12,male,1778,81,46,79,29,79,20,0,9
1063318,67,24,1946,11,female,1019,81,45,82,134,1,39,81,95
1728615,22,14,1991,2,male,145,81,66,82,36,59,22,23,14
1836212,30,28,1983,9,male,208,80,61,82,32,42,10,40,22
2049432,19,27,1994,12,female,1184,79,53,81,147,51,106,30,41
1091414,18,1,1995,12,female,182,79,58,84,1,83,1,1,0
1895292,32,2,1981,4,male,1404,79,38,84,47,78,30,6,17
2012889,16,2,1997,11,male,420,81,42,84,45,84,36,0,9
1514081,17,8,1996,6,female,248,81,49,83,15,83,14,0,1
1888682,18,1,1995,3,male,472,79,51,83,34,83,25,0,9
2009000,51,4,1962,10,female,135,79,45,81,16,81,4,0,12
2169336,20,18,1993,7,male,704,81,36,86,48,85,42,1,6
1624562,22,3,1991,7,male,262,79,47,87,15,86,10,1,5
1941763,52,4,1961,5,female,858,81,49,85,42,85,31,0,11
1709362,69,11,1944,2,female,2007,81,49,90,140,89,96,1,44
1301970,18,15,1995,4,male,422,81,46,91,28,91,6,0,22
1280628,62,28,1951,10,female,1608,79,59,88,26,88,17,0,9
1009183,32,18,1981,4,male,355,80,51,93,30,93,25,0,5
1791000,55,8,1958,11,male,330,80,50,96,39,0,23,96,16
2154304,30,23,1983,10,female,337,81,42,96,50,95,27,1,23
1150079,17,11,1996,11,male,109,81,66,99,10,99,9,0,1
1747282,42,4,1971,5,male,337,81,70,98,12,98,12,0,0
1748672,43,30,1970,4,female,529,81,18,98,50,98,15,0,35
1950757,30,27,1983,7,female,486,81,55,96,93,96,47,0,46
1761889,25,2,1988,2,male,139,79,40,97,162,97,129,0,33
1595210,59,8,1954,8,female,588,79,52,104,123,15,89,89,34
1301106,17,1,1996,1,male,442,81,69,104,34,34,9,70,25
1258008,39,27,1974,4,female,737,80,9,101,45,30,12,71,33
1779873,60,28,1953,7,female,526,80,59,102,2,100,2,2,0
1721768,30,25,1983,10,male,430,79,46,100,5,100,3,0,2
1896228,28,15,1985,12,female,274,81,40,103,26,103,24,0,2
1349421,32,2,1981,9,female,260,81,68,100,94,100,43,0,51
1163422,52,8,1961,7,male,374,79,36,101,136,101,135,0,1
1965845,35,29,1978,1,female,408,79,28,107,31,65,18,42,13
2074328,17,8,1996,8,female,175,81,64,107,99,106,88,1,11
1397180,24,10,1989,6,male,34,81,78,106,10,106,6,0,4
1211091,30,28,1983,11,female,312,81,43,107,62,107,40,0,22
1606812,28,24,1985,1,male,242,80,52,107,113,107,107,0,6
2063237,52,9,1961,11,female,224,79,50,113,61,0,12,113,49
1879663,21,8,1992,7,female,366,80,39,110,41,39,25,71,16
2027739,57,10,1956,6,male,527,79,48,112,1,112,1,0,0
2143380,14,11,1999,6,female,122,80,63,111,36,111,9,0,27
2193485,31,24,1982,12,male,598,80,30,111,32,111,17,0,15
1806586,80,12,1933,8,male,1264,81,39,117,14,21,6,96,8
1443291,56,11,1957,4,female,548,80,72,116,241,0,95,116,146
2033326,58,29,1955,9,male,897,81,41,118,66,28,44,90,22
1522391,25,16,1988,12,male,343,81,56,117,13,117,6,0,7
1313326,38,8,1975,4,female,368,80,36,114,5,114,5,0,0
1999738,18,1,1995,1,male,117,79,37,119,67,119,33,0,34
1326008,32,22,1981,5,female,231,80,52,115,30,115,30,0,0
1174268,36,7,1977,1,female,187,81,28,116,55,116,45,0,10
1901637,54,28,1959,10,male,212,81,49,115,56,115,52,0,4
1452030,68,28,1945,12,female,627,79,56,120,53,2,22,118,31
1118177,15,24,1998,9,female,266,79,58,122,207,2,35,120,172
1133797,19,19,1994,12,female,702,80,39,124,59,91,33,33,26
2127925,59,19,1954,8,male,649,79,48,121,71,111,11,10,60
1535062,32,23,1981,1,male,299,81,40,124,87,118,72,6,15
1025456,84,28,1929,9,male,1296,81,32,124,15,124,11,0,4
1707908,21,26,1992,9,female,362,81,38,120,32,120,32,0,0
1252764,52,3,1961,1,female,254,80,54,121,57,121,37,0,20
1870450,46,15,1967,2,female,445,79,42,122,166,122,63,0,103
1317812,25,2,1988,2,female,245,80,30,128,68,0,19,128,49
1081270,56,24,1957,9,male,1312,79,29,125,44,121,34,4,10
2108385,19,5,1994,11,female,112,81,43,129,89,112,52,17,37
1059396,21,21,1992,5,female,173,79,58,127,233,125,189,2,44
2034374,60,16,1953,1,female,837,79,54,129,21,129,20,0,1
1598041,57,16,1956,12,female,1259,79,52,132,32,18,11,114,21
1756911,25,4,1988,4,female,359,79,48,135,81,60,68,75,13
1550943,49,9,1964,8,female,306,81,59,134,23,62,21,72,2
1424410,20,7,1993,7,female,226,81,52,132,111,33,41,99,70
1402660,38,28,1975,5,male,328,79,42,136,17,129,4,7,13
1091254,48,3,1965,3,male,1085,80,23,140,57,4,42,136,15
1429778,19,13,1994,3,female,430,80,34,143,170,0,64,143,106
1061215,63,20,1950,12,female,1349,79,40,139,84,109,43,30,41
1695726,16,10,1997,10,female,35,80,52,141,141,115,74,26,67
2067655,15,8,1998,10,male,543,81,53,142,100,142,71,0,29
1540661,82,6,1931,7,female,1563,79,18,145,23,0,7,145,16
1637950,20,19,1993,10,male,645,80,59,150,34,126,31,24,3
1483367,33,19,1980,2,male,253,81,54,147,84,139,77,8,7
1953312,44,31,1969,8,female,425,80,59,149,11,149,10,0,1
1617504,51,8,1962,11,female,761,79,46,156,26,155,17,1,9
1961552,56,1,1957,3,male,599,80,55,156,22,156,19,0,3
2027528,63,30,1950,8,male,63,80,68,155,58,155,49,0,9
1939500,18,2,1995,5,female,263,81,46,158,72,1,7,157,65
2052736,37,23,1976,3,female,2238,81,59,160,364,142,317,18,47
1594796,72,23,1941,7,female,708,80,45,163,36,163,24,0,12
1351842,28,16,1985,6,female,33,79,48,162,143,162,132,0,11
1335544,64,16,1949,12,female,754,81,49,166,17,72,10,94,7
2077990,19,23,1994,7,male,152,79,64,169,13,139,8,30,5
2088575,63,5,1950,5,male,285,81,56,171,108,171,45,0,63
1657235,45,3,1968,2,male,312,81,58,169,338,169,139,0,199
1436116,25,6,1988,11,male,244,81,34,178,45,56,22,122,23
1276386,19,17,1994,3,male,191,80,63,179,74,179,39,0,35
1098129,36,12,1977,10,male,670,80,44,180,81,180,68,0,13
1170234,27,10,1986,10,female,407,80,55,175,157,175,134,0,23
1117819,65,26,1948,5,female,838,81,45,186,67,5,42,181,25
1324836,80,5,1933,6,female,109,81,67,184,2,183,1,1,1
1902809,42,20,1971,2,male,283,80,16,189,59,189,29,0,30
1590066,53,8,1960,12,female,260,80,61,182,47,182,24,0,23
1757459,21,9,1992,10,female,273,81,27,182,234,182,177,0,57
1404379,35,12,1978,3,female,353,81,33,183,212,183,177,0,35
1061313,40,7,1973,10,male,469,81,55,182,155,182,102,0,53
1899400,21,2,1992,2,female,339,79,31,197,159,1,27,196,132
1437476,37,3,1976,11,male,60,80,74,194,141,37,64,157,77
1611087,36,9,1977,2,female,402,81,42,196,186,1,123,195,63
1742253,22,26,1991,3,female,645,79,69,200,102,114,57,86,45
1123797,16,26,1997,8,female,234,81,55,200,303,128,147,72,156
1622936,30,4,1983,2,female,633,79,39,200,2,200,2,0,0
1390925,55,7,1958,9,female,420,81,48,192,50,192,28,0,22
1612385,46,11,1967,4,female,221,79,38,203,285,0,100,203,185
1353783,74,4,1939,12,female,1517,79,31,205,43,202,12,3,31
1143549,21,29,1992,8,male,391,80,60,202,5,202,3,0,2
1084633,60,19,1953,6,female,1196,80,33,210,10,210,4,0,6
1492934,62,3,1951,12,male,295,79,33,206,4,206,2,0,2
1654552,18,22,1995,9,female,137,80,54,206,331,206,187,0,144
1353851,67,4,1946,8,female,125,80,56,219,54,0,34,219,20
1088361,40,20,1973,10,female,334,79,62,217,173,38,52,179,121
2159144,70,15,1943,5,male,664,79,42,212,178,0,129,212,49
1246304,40,30,1973,1,female,740,81,42,214,35,80,28,134,7
1400499,41,2,1972,10,male,565,81,55,214,30,48,24,166,6
1776188,45,20,1968,10,female,335,81,62,212,825,99,401,113,424
1258257,42,10,1971,10,female,325,79,64,218,17,218,16,0,1
1455589,43,29,1970,3,female,416,81,68,214,35,214,35,0,0
1368258,29,17,1984,1,female,509,80,22,219,57,219,55,0,2
1898593,41,15,1972,9,male,556,79,42,214,76,214,70,0,6
1214845,53,3,1960,4,male,925,81,26,220,99,220,55,0,44
1250204,23,7,1990,8,female,338,79,41,218,134,218,73,0,61
1535975,70,4,1943,5,female,1756,79,37,213,164,213,86,0,78
1612719,26,6,1987,11,female,50,81,56,226,690,102,178,124,512
2123091,19,20,1994,3,male,275,80,53,230,36,229,20,1,16
1237636,26,5,1987,1,female,617,80,33,224,25,224,18,0,7
1732964,23,3,1990,4,female,235,81,71,233,216,233,216,0,0
2142513,65,4,1948,7,male,1325,81,22,234,61,0,18,234,43
1001262,47,18,1966,5,female,289,80,28,236,223,0,70,236,153
2155540,103,2,1910,5,female,1754,81,36,245,124,72,19,173,105
2043226,80,7,1933,8,female,26,81,72,243,236,243,212,0,24
1232228,56,22,1957,1,female,943,81,31,254,175,38,55,216,120
1655952,47,22,1966,9,female,405,79,43,255,17,255,11,0,6
1397144,37,26,1976,10,female,192,79,62,265,19,246,9,19,10
1037793,27,14,1986,8,male,1009,81,37,275,0,275,0,0,0
1939845,33,25,1980,2,male,205,81,43,268,12,268,11,0,1
1731667,22,15,1991,1,male,127,79,34,286,77,0,36,286,41
1086351,23,11,1990,1,male,324,79,53,286,180,233,71,53,109
2085395,28,15,1985,9,male,643,80,40,291,317,285,173,6,144
1130495,64,10,1949,1,female,1072,80,64,287,21,286,6,1,15
1595082,38,31,1975,10,female,450,80,66,281,104,281,67,0,37
1933370,16,7,1997,7,female,269,79,68,279,349,279,190,0,159
1055108,38,20,1975,7,female,437,81,38,305,201,282,151,23,50
1349083,25,1,1988,1,female,288,79,25,300,39,300,16,0,23
1958194,27,26,1986,2,male,179,79,56,294,56,294,28,0,28
1709812,65,2,1948,9,male,680,79,62,297,129,297,73,0,56
1611376,53,25,1960,7,female,427,79,67,308,354,308,261,0,93
2003531,18,19,1995,6,male,89,81,41,322,405,15,165,307,240
1908300,48,4,1965,12,male,212,79,26,324,170,91,89,233,81
2143761,33,20,1980,5,female,338,79,49,312,106,303,92,9,14
1363581,52,21,1961,5,male,797,81,66,317,111,317,45,0,66
1934229,69,28,1944,4,male,1709,80,43,331,13,5,4,326,9
1185061,58,14,1955,1,female,1329,80,40,328,152,0,40,328,112
1954346,56,13,1957,4,female,415,79,73,340,24,340,12,0,12
2115780,31,3,1982,10,male,209,80,48,338,137,338,121,0,16
1270277,60,3,1953,6,female,698,80,57,331,180,331,122,0,58
2154067,64,5,1949,7,female,1706,80,42,358,99,10,51,348,48
1712067,27,2,1986,8,female,122,81,53,347,147,157,75,190,72
1621269,18,9,1995,8,male,151,79,56,351,170,344,40,7,130
1145431,20,19,1993,1,male,306,80,62,362,204,361,114,1,90
1631996,25,24,1988,11,male,261,79,30,352,43,352,41,0,2
2143886,26,1,1987,1,female,216,79,65,349,117,349,112,0,5
1062200,33,19,1980,3,male,170,80,76,369,99,369,70,0,29
2126912,23,12,1990,2,female,358,80,18,370,33,0,11,370,22
2015971,63,29,1950,4,male,851,81,24,371,259,21,124,350,135
2048809,63,10,1950,1,female,786,80,37,385,352,211,134,174,218
2007008,40,22,1973,3,female,243,80,54,381,144,381,106,0,38
1020988,62,2,1951,2,male,80,79,66,376,79,376,70,0,9
1016364,49,12,1964,10,female,1368,79,43,413,373,170,269,243,104
1977254,34,11,1979,4,female,509,80,24,396,216,383,109,13,107
1013652,35,20,1978,4,female,93,79,71,399,157,363,132,36,25
2138690,51,12,1962,2,female,525,81,38,415,320,391,196,24,124
1163716,48,2,1965,2,male,124,79,57,397,13,397,11,0,2
1954836,60,24,1953,9,female,763,80,22,404,55,404,34,0,21
1765304,53,20,1960,9,female,468,81,67,420,100,420,60,0,40
1356239,32,9,1981,1,male,67,80,51,420,278,420,245,0,33
2155255,16,4,1997,3,male,219,80,48,445,168,295,75,150,93
1877459,26,15,1987,8,female,283,79,63,444,135,275,37,169,98
1808186,22,1,1991,1,male,169,81,47,437,47,431,19,6,28
1818319,14,30,1999,6,female,185,79,54,429,59,429,49,0,10
2145127,21,12,1992,5,female,255,79,53,430,42,430,42,0,0
1146414,23,25,1990,4,female,284,80,32,425,121,425,120,0,1
1693469,27,1,1986,5,female,392,81,46,448,78,448,57,0,21
1045091,38,24,1975,10,female,413,79,25,431,247,431,200,0,47
1663858,52,19,1961,5,male,981,81,18,424,145,424,113,0,32
1508063,63,15,1950,5,female,664,81,49,454,73,0,31,454,42
1410975,65,1,1948,3,female,1230,81,44,481,118,0,48,481,70
1432020,20,12,1993,1,male,245,79,50,477,53534,78,30387,399,23147
1688936,56,26,1957,5,female,332,79,54,489,96,32,43,457,53
1919104,78,30,1935,1,female,1704,80,25,492,166,0,111,492,55
1277025,61,8,1952,5,female,735,79,33,488,156,486,77,2,79
1699044,19,27,1994,12,female,243,81,42,504,309,504,246,0,63
1621567,63,1,1950,9,female,1203,81,50,513,340,513,183,0,157
1374312,63,1,1950,12,female,310,79,31,557,199,0,35,557,164
1145446,71,1,1942,12,female,453,80,57,547,210,0,71,547,139
1974913,61,8,1952,6,female,2288,79,43,533,609,0,446,533,163
1115733,34,11,1979,7,female,283,79,54,530,156,345,51,185,105
1196250,57,22,1956,6,female,1719,81,21,545,176,545,105,0,71
1702527,14,21,1999,6,female,202,81,32,560,427,560,294,0,133
1704996,31,31,1982,8,female,177,79,34,530,618,530,522,0,96
1536282,31,2,1982,9,female,1035,81,47,572,499,532,402,40,97
1669910,49,22,1964,6,female,727,81,30,567,29,567,20,0,9
1354858,38,15,1975,3,female,273,81,74,570,214,570,61,0,153
2148021,50,11,1963,1,male,811,79,33,600,230,600,181,0,49
1927154,55,12,1958,4,female,1211,80,30,570,275,570,122,0,153
1606344,74,27,1939,11,female,706,79,57,568,351,568,237,0,114
2010846,61,28,1952,2,female,630,79,56,632,63,84,40,548,23
1713872,58,27,1955,1,female,1642,79,58,614,131,0,73,614,58
1858440,62,21,1951,4,female,1190,81,28,610,118,144,80,466,38
1560077,25,24,1988,9,female,117,79,51,644,504,596,403,48,101
1383387,67,22,1946,8,female,1224,79,40,709,482,37,251,672,231
1684484,47,11,1966,12,male,97,81,52,704,41,451,26,253,15
1232080,18,28,1995,1,female,202,80,31,704,145,704,111,0,34
1685371,48,24,1965,11,female,351,79,38,696,137,696,72,0,65
1366318,56,1,1957,1,female,207,79,64,719,296,719,226,0,70
2090476,26,28,1987,5,female,291,80,42,693,1021,693,581,0,440
1454961,52,25,1961,12,male,625,81,71,754,17,0,14,754,3
1378370,49,26,1964,7,female,1521,79,67,751,261,0,95,751,166
1154750,53,21,1960,9,female,810,80,47,782,17,426,4,356,13
1269453,58,6,1955,5,female,880,79,59,776,185,745,118,31,67
1337074,31,4,1982,3,female,226,79,75,736,63,736,41,0,22
2148026,13,16,2000,4,female,77,79,65,868,283,868,270,0,13
1657134,47,10,1966,7,female,737,81,57,1105,399,1101,334,4,65
1741648,54,30,1959,11,female,228,79,42,1019,138,1019,99,0,39
1362938,59,1,1954,7,male,1736,81,15,1038,207,1038,125,0,82
1973629,21,4,1992,3,female,303,79,30,1078,1648,1078,907,0,741
1741048,65,18,1948,6,female,1699,81,48,1281,424,8,221,1273,203
1168049,42,8,1971,2,male,603,79,42,1293,154,1293,118,0,36
1252212,37,25,1976,12,male,152,80,21,1481,258,1481,139,0,119
1762011,35,24,1978,7,female,803,80,19,1393,3380,1393,1624,0,1756
1665098,62,20,1951,9,female,1729,79,61,1700,42,1700,22,0,20
1911885,63,10,1950,6,female,556,79,50,1693,163,1693,117,0,46
1368828,20,5,1993,1,male,113,79,45,2351,1501,2311,1157,40,344
1809305,62,13,1951,7,male,828,81,49,2607,387,351,23,2256,364
1221962,14,5,1999,7,female,266,79,35,2452,4251,1589,326,863,3925
1767150,70,4,1943,11,female,1675,80,40,2556,331,2552,120,4,211
1723407,51,16,1962,3,female,521,79,36,3371,1819,3370,929,1,890
1791289,38,30,1975,10,female,319,81,32,3045,754,3045,679,0,75
1603757,57,18,1956,12,male,221,82,40,21,2,4,2,17,0
2091258,28,17,1985,7,male,454,84,62,21,12,2,2,19,10
1220890,19,15,1994,7,male,229,84,48,21,13,11,4,10,9
2140715,94,19,1919,1,female,1613,83,47,21,36,9,22,12,14
1656650,30,13,1983,3,male,829,83,15,21,0,16,0,5,0
1623445,55,21,1958,1,female,1403,82,41,21,8,16,6,5,2
1856938,17,4,1996,7,male,195,84,83,21,0,21,0,0,0
1610268,24,23,1989,7,male,415,82,53,21,4,21,3,0,1
1452090,22,19,1991,10,male,552,83,45,21,41,21,28,0,13
1938073,26,7,1987,10,male,322,83,59,22,25,4,18,18,7
1024022,19,5,1994,12,female,310,82,46,22,57,9,2,13,55
1125595,23,11,1990,4,male,182,83,45,22,13,22,13,0,0
1429764,18,12,1995,12,male,627,82,54,22,26,22,3,0,23
1771889,20,1,1993,4,male,565,84,33,22,21,22,17,0,4
2029327,35,20,1978,8,male,810,84,11,22,18,22,6,0,12
1143495,25,1,1988,6,male,223,84,46,22,64,22,22,0,42
2108055,70,27,1943,10,male,1439,83,36,22,55,22,54,0,1
1037736,65,26,1948,6,female,1028,82,27,23,0,0,0,23,0
1590696,53,6,1960,1,female,398,83,30,23,10,1,9,22,1
1767598,53,20,1960,5,female,768,84,53,23,11,11,1,12,10
1720818,36,16,1977,6,female,271,83,44,23,118,16,86,7,32
1046472,26,22,1987,1,male,355,84,58,23,2,23,2,0,0
1043130,21,25,1992,12,male,193,82,77,23,7,23,4,0,3
1173556,35,3,1978,2,female,500,83,62,23,12,23,6,0,6
2135846,20,25,1993,10,female,18,84,11,23,89,23,41,0,48
1697230,66,6,1947,2,female,1544,83,36,23,80,23,71,0,9
1598628,33,5,1980,7,male,994,82,71,24,22,20,17,4,5
1190440,39,1,1974,1,male,475,82,57,24,8,24,8,0,0
1887595,18,1,1995,1,male,31,83,57,25,2,0,1,25,1
1126982,113,7,1900,6,female,1707,82,47,25,26,0,16,25,10
1073944,35,17,1978,2,male,337,84,27,25,65,25,27,0,38
1013253,56,25,1957,8,female,274,83,50,25,348,25,107,0,241
2033469,107,2,1906,5,female,270,83,72,26,1,2,0,24,1
1167957,17,19,1996,9,female,507,82,22,26,3,10,1,16,2
1923170,26,7,1987,1,female,1002,82,36,26,10,26,10,0,0
1167332,21,16,1992,7,female,209,82,25,26,18,26,18,0,0
1178887,73,6,1940,8,female,1612,83,44,27,16,0,7,27,9
1764546,40,31,1973,10,male,577,82,24,27,5,26,5,1,0
1477490,23,5,1990,4,female,426,84,42,27,46,26,38,1,8
2094111,24,22,1989,3,female,714,84,8,27,0,27,0,0,0
1803092,33,5,1980,6,male,548,82,26,27,79,27,21,0,58
1380012,50,6,1963,5,female,188,82,64,27,43,27,26,0,17
1698681,54,8,1959,2,female,1166,84,51,27,43,27,33,0,10
2093173,56,16,1957,2,female,42,84,72,27,58,27,55,0,3
1890744,57,11,1956,10,male,405,84,69,28,14,0,8,28,6
1788568,18,1,1995,1,male,348,83,48,28,3,25,2,3,1
1848796,28,25,1985,10,male,482,82,60,28,6,26,5,2,1
1517884,15,26,1998,8,male,88,84,69,28,60,25,25,3,35
1056428,78,14,1935,12,female,1560,83,57,29,17,0,4,29,13
1544232,38,13,1975,9,female,499,83,52,29,38,22,29,7,9
2057378,15,18,1998,11,male,57,82,54,29,14,29,7,0,7
1507255,28,20,1985,2,female,306,82,47,29,62,29,38,0,24
1530283,20,2,1993,11,male,816,84,29,30,2,0,0,30,2
1765721,19,20,1994,1,male,469,84,66,30,1,0,1,30,0
1622170,47,1,1966,8,male,331,83,60,30,1,0,1,30,0
1409447,59,24,1954,6,female,2161,84,61,31,26,0,12,31,14
1739166,108,28,1905,2,male,38,83,82,30,20,0,13,30,7
1724022,20,3,1993,11,female,1950,84,22,31,60,3,36,28,24
1405558,23,23,1990,11,female,281,84,34,31,314,0,92,31,222
1392014,38,20,1975,2,female,268,83,62,31,31,27,5,4,26
2144212,47,9,1966,11,female,402,83,48,30,95,27,51,3,44
2068258,40,4,1973,3,female,447,82,52,31,2,31,2,0,0
2115782,15,1,1998,4,male,500,82,71,31,14,31,10,0,4
1711280,15,1,1998,7,male,7,83,80,30,6,30,6,0,0
2110014,21,17,1992,6,male,266,83,50,30,8,30,7,0,1
1176493,29,20,1984,10,male,295,83,67,31,9,31,6,0,3
2046145,20,22,1993,7,female,393,84,39,31,65,31,52,0,13
1627928,57,10,1956,10,female,1083,84,18,31,178,31,41,0,137
1576903,108,28,1905,1,female,1743,83,27,32,18,0,12,32,6
1117660,76,9,1937,12,female,1152,83,35,32,19,32,9,0,10
1303081,108,1,1905,1,male,240,84,58,33,37,24,19,9,18
1095650,55,30,1958,5,female,587,82,69,34,3,28,1,6,2
1174210,18,22,1995,1,male,264,84,71,34,15,34,15,0,0
1217632,28,10,1985,12,female,222,83,38,34,48,34,48,0,0
1249442,26,18,1987,3,male,480,83,77,35,1,0,0,35,1
1694814,77,29,1936,9,female,1854,83,20,35,11,3,10,32,1
2085254,17,16,1996,10,male,280,84,31,35,30,0,29,35,1
1996303,51,7,1962,10,female,202,84,59,36,63,0,23,36,40
1205770,65,28,1948,7,female,36,82,49,35,131,0,94,35,37
1737194,62,15,1951,4,female,848,84,49,35,1,35,1,0,0
1984464,35,12,1978,3,male,356,83,36,36,17,36,0,0,17
1017132,21,28,1992,3,male,146,82,25,35,50,35,31,0,19
1694951,35,25,1978,7,male,457,84,57,36,31,36,29,0,2
1078581,53,26,1960,8,female,1003,82,43,35,38,35,38,0,0
1805570,23,14,1990,5,male,791,84,42,37,2,0,0,37,2
2037951,28,15,1985,10,male,297,82,58,37,40,3,7,34,33
2192752,37,14,1976,2,female,312,84,35,37,38,9,23,28,15
2088469,80,15,1933,1,male,585,84,13,37,39,33,22,4,17
2178680,24,30,1989,12,male,344,83,53,38,27,0,9,38,18
1426506,45,14,1968,7,female,596,83,47,39,60,0,33,39,27
2102824,57,4,1956,3,female,2418,84,26,39,42,30,12,9,30
1269131,23,12,1990,11,female,379,84,69,39,30,39,23,0,7
1421739,48,6,1965,10,male,1494,82,18,38,39,38,34,0,5
1540592,44,24,1969,9,male,350,84,66,40,0,0,0,40,0
1520534,24,5,1989,3,male,126,82,74,40,30,4,16,36,14
1358293,68,16,1945,8,female,1072,82,33,40,37,1,15,39,22
1872693,23,14,1990,8,male,392,83,39,40,12,39,8,1,4
1442611,113,14,1900,1,female,1820,84,40,40,2,40,2,0,0
1297468,59,5,1954,8,female,557,83,66,40,11,40,2,0,9
1195698,55,19,1958,4,female,649,83,25,42,1,5,0,37,1
2065279,57,24,1956,12,female,313,83,41,41,6,0,1,41,5
2172486,52,25,1961,4,male,147,83,57,41,11,2,6,39,5
1896986,61,29,1952,2,female,1736,84,38,41,46,0,8,41,38
2017057,57,22,1956,3,female,964,82,36,42,38,28,36,14,2
1072202,44,21,1969,10,male,93,82,72,42,117,21,82,21,35
1507246,19,24,1994,12,female,427,84,57,41,13,31,4,10,9
1689097,32,15,1981,10,male,229,84,55,42,29,39,16,3,13
1459431,20,7,1993,11,female,252,82,57,42,0,42,0,0,0
1784072,33,7,1980,7,female,434,82,28,41,28,41,19,0,9
2134413,26,1,1987,1,male,636,82,44,44,18,40,8,4,10
1346330,18,2,1995,3,female,405,84,53,44,48,41,27,3,21
2176428,42,15,1971,8,male,873,84,35,43,356,42,294,1,62
1430273,23,1,1990,1,male,531,82,31,45,19,0,6,45,13
1151946,56,13,1957,9,male,456,84,3,45,23,0,2,45,21
1210887,29,21,1984,9,female,554,83,32,45,117,9,58,36,59
1425990,24,27,1989,8,female,332,83,70,45,16,45,13,0,3
2165676,25,2,1988,2,female,382,84,51,45,15,45,10,0,5
1754823,28,7,1985,12,male,107,84,64,46,93,5,71,41,22
1353832,15,1,1998,5,male,176,83,55,46,31,36,24,10,7
1141258,19,16,1994,5,male,686,82,39,46,46,36,37,10,9
1833631,35,27,1978,12,female,166,83,56,46,52,43,39,3,13
1988158,54,1,1959,10,female,398,84,16,47,113,45,105,2,8
1979428,65,25,1948,7,female,1843,82,21,47,24,47,13,0,11
1099486,28,29,1985,9,female,248,84,63,46,42,46,20,0,22
1856816,61,25,1952,10,male,173,84,62,46,102,46,38,0,64
1567534,57,24,1956,5,female,894,83,13,49,5,5,4,44,1
1477183,23,26,1990,8,male,184,84,51,48,44,1,13,47,31
1561904,57,26,1956,5,female,460,82,37,51,61,0,10,51,51
1036436,31,8,1982,10,female,249,84,62,50,67,14,36,36,31
1161553,20,4,1993,1,male,54,84,62,50,12,50,6,0,6
1865225,76,15,1937,12,female,695,82,70,50,28,50,21,0,7
1020698,32,21,1981,5,male,255,82,55,51,72,51,37,0,35
1748320,53,6,1960,4,male,440,82,32,52,51,5,19,47,32
1945632,25,14,1988,8,female,211,83,75,53,5,50,1,3,4
1586049,24,1,1989,11,female,405,83,78,53,12,49,5,4,7
1788777,100,1,1913,1,male,1848,83,32,53,83,46,58,7,25
1854306,48,11,1965,11,male,325,84,57,53,7,53,4,0,3
2151336,103,14,1910,9,female,2141,82,43,53,30,53,20,0,10
1193138,29,22,1984,11,female,374,84,45,52,39,52,34,0,5
1738817,59,8,1954,6,female,383,82,25,54,39,0,2,54,37
1729016,26,8,1987,6,female,504,83,63,55,0,55,0,0,0
1624556,33,12,1980,2,female,602,84,66,55,2,55,1,0,1
1710693,33,23,1980,8,female,59,83,38,54,3,54,1,0,2
1819412,52,18,1961,8,male,272,83,47,54,6,54,0,0,6
1738772,41,24,1972,3,female,166,84,43,54,28,54,10,0,18
1470452,55,9,1958,7,female,271,82,52,55,11,55,10,0,1
1943624,68,17,1945,8,male,751,84,71,54,16,54,16,0,0
1387127,28,22,1985,6,male,298,84,61,54,121,54,106,0,15
2176862,31,15,1982,12,male,474,83,69,57,5,6,1,51,4
1302329,45,14,1968,12,female,272,84,64,56,2,0,2,56,0
2127527,20,26,1993,6,male,213,83,63,56,10,1,9,55,1
1559455,29,20,1984,9,male,254,84,46,56,176,6,117,50,59
1831549,19,23,1994,11,male,301,82,52,56,9,18,8,38,1
2150301,48,13,1965,1,female,370,82,26,57,35,19,22,38,13
1191812,19,23,1994,8,male,32,83,63,58,129,57,61,1,68
1202694,35,29,1978,11,male,179,83,69,57,3,57,0,0,3
1330229,49,16,1964,8,female,754,84,53,58,1,58,1,0,0
1561004,49,10,1964,7,female,416,83,26,58,35,58,20,0,15
2186607,30,18,1983,3,female,227,84,43,57,46,57,23,0,23
1813213,58,14,1955,2,female,598,82,50,58,41,58,29,0,12
1272892,33,17,1980,3,female,73,82,61,57,101,57,65,0,36
1159432,42,24,1971,9,female,424,84,48,58,223,58,198,0,25
1447906,49,16,1964,5,female,1408,83,28,59,138,13,76,46,62
1386847,81,29,1932,2,male,1344,84,40,60,6,53,1,7,5
1460466,66,8,1947,9,female,1710,84,40,59,26,58,16,1,10
2145441,21,5,1992,6,female,253,82,62,61,31,2,10,59,21
1706262,53,14,1960,1,female,555,82,37,62,86,0,55,62,31
1918389,76,19,1937,2,male,313,84,60,61,52,0,17,61,35
1771732,108,1,1905,12,male,80,82,57,61,55,0,37,61,18
1158951,28,7,1985,7,female,576,82,39,62,6,62,3,0,3
1463229,27,1,1986,11,female,479,83,47,62,51,62,35,0,16
1402200,63,15,1950,3,female,1454,83,36,61,64,61,49,0,15
1411112,59,5,1954,10,female,1843,84,36,65,43,62,32,3,11
1880025,34,9,1979,7,male,15,84,34,68,2,2,2,66,0
2157410,88,26,1925,8,female,1429,84,35,66,130,0,45,66,85
1500167,49,10,1964,5,female,393,84,36,67,6,33,3,34,3
1709953,59,24,1954,5,female,831,83,45,68,123,64,55,4,68
1285246,66,7,1947,10,male,1340,84,23,67,40,67,33,0,7
1182678,59,25,1954,9,female,2174,83,51,67,154,67,117,0,37
1480365,53,17,1960,6,female,1306,84,36,71,19,14,13,57,6
1779344,50,22,1963,8,female,2126,83,33,70,37,58,31,12,6
1141657,24,5,1989,6,male,119,82,82,71,7,71,6,0,1
1646280,27,17,1986,12,male,112,83,69,69,6,69,6,0,0
2008680,27,13,1986,10,male,614,84,38,71,18,71,17,0,1
1034972,102,15,1911,8,male,676,84,47,70,35,70,7,0,28
1160047,31,20,1982,11,female,346,82,68,70,70,70,45,0,25
2051658,52,27,1961,3,female,488,82,51,71,103,71,94,0,9
1906762,17,30,1996,10,male,513,83,25,72,21,62,17,10,4
1484024,61,5,1952,5,female,97,82,40,73,114,73,90,0,24
1118256,58,30,1955,9,male,402,84,54,77,11,0,3,77,8
1196687,33,2,1980,4,male,568,83,67,77,27,13,24,64,3
1730674,60,2,1953,2,male,1706,82,25,77,3,77,0,0,3
1523506,23,26,1990,1,male,209,83,32,75,87,75,73,0,14
2127888,57,27,1956,1,male,769,83,58,77,67,77,22,0,45
1301354,19,28,1994,10,male,354,84,30,78,19,0,9,78,10
2136157,51,15,1962,2,female,304,83,60,78,156,9,62,69,94
1380504,74,9,1939,9,female,979,82,71,79,16,33,5,46,11
2125528,63,24,1950,9,male,1550,83,52,80,15,74,6,6,9
1954397,17,26,1996,8,male,351,84,50,80,39,80,34,0,5
1647645,34,3,1979,2,female,235,83,48,80,78,80,45,0,33
1352766,34,11,1979,5,male,300,82,41,83,34,0,21,83,13
1975314,64,7,1949,2,male,1783,83,21,82,62,2,26,80,36
1354773,15,14,1998,3,female,299,83,54,84,31,23,12,61,19
2001966,29,26,1984,2,female,561,83,48,83,17,49,13,34,4
1311946,44,15,1969,7,female,390,84,49,83,52,38,36,45,16
1912854,68,7,1945,7,female,664,82,40,81,315,42,187,39,128
1099655,44,26,1969,9,male,670,84,53,82,47,82,35,0,12
1387461,50,12,1963,1,male,745,83,46,82,25,82,8,0,17
2018776,42,21,1971,3,female,242,82,64,84,53,84,36,0,17
2141460,38,6,1975,9,female,183,82,50,87,78,1,29,86,49
2095427,14,27,1999,12,female,459,82,37,87,18,58,15,29,3
1204995,64,15,1949,10,female,1690,82,33,85,96,39,34,46,62
1684948,26,7,1987,4,male,570,84,31,87,175,46,62,41,113
1624720,33,11,1980,11,female,294,82,76,86,38,86,35,0,3
2094932,17,1,1996,1,female,22,82,46,86,293,86,147,0,146
1841206,73,7,1940,12,female,403,83,65,90,58,1,44,89,14
2117102,56,5,1957,1,male,339,83,62,88,36,40,30,48,6
1510444,38,20,1975,6,female,354,83,52,89,95,43,59,46,36
1667616,46,8,1967,2,female,819,83,47,91,65,62,9,29,56
1481790,22,10,1991,10,female,595,82,42,90,32,90,30,0,2
1343796,50,28,1963,7,female,1280,82,35,90,93,90,46,0,47
1068473,59,26,1954,5,female,247,82,69,92,13,55,3,37,10
1488770,41,23,1972,3,male,527,84,34,92,0,90,0,2,0
1511090,14,12,1999,4,male,134,83,35,93,32,82,26,11,6
1015430,23,25,1990,3,male,139,82,72,95,14,95,14,0,0
2136217,18,5,1995,5,male,44,84,69,94,56,94,45,0,11
1225791,23,5,1990,5,female,273,82,49,94,72,94,52,0,20
1225876,77,23,1936,10,female,883,82,28,95,130,95,84,0,46
1285140,24,10,1989,4,male,633,82,74,96,148,14,23,82,125
2142920,43,28,1970,5,male,295,82,28,97,103,84,52,13,51
1383692,44,4,1969,1,female,872,82,47,99,2,99,2,0,0
2037908,50,8,1963,4,male,462,84,45,104,10,1,2,103,8
1247377,21,19,1992,1,male,431,84,20,101,61,52,36,49,25
1228275,61,26,1952,9,male,1713,84,29,104,26,25,21,79,5
1384229,34,25,1979,11,male,407,83,61,103,9,100,4,3,5
2051712,20,1,1993,1,male,160,83,35,101,133,101,108,0,25
1427928,20,17,1993,6,female,345,83,30,101,144,101,65,0,79
2178856,15,11,1998,5,male,178,82,50,109,24,35,6,74,18
1566027,51,10,1962,5,female,472,83,37,105,15,105,12,0,3
1098334,16,19,1997,9,female,591,82,54,105,21,105,14,0,7
1938470,54,29,1959,3,male,734,83,40,105,36,105,35,0,1
2073438,28,11,1985,5,male,1220,83,17,108,68,108,59,0,9
1865244,65,13,1948,6,female,1365,82,26,111,94,98,41,13,53
1757500,55,20,1958,8,male,414,82,49,113,15,113,9,0,6
1463840,29,31,1984,7,male,482,82,59,110,37,110,36,0,1
2055357,19,16,1994,1,female,239,83,68,117,90,1,41,116,49
1735888,73,12,1940,5,male,478,84,22,115,101,34,81,81,20
1115262,42,4,1971,4,female,325,83,57,117,50,97,34,20,16
1185824,58,26,1955,3,female,1694,82,14,117,24,108,22,9,2
1718610,61,17,1952,4,female,1915,84,44,117,78,94,12,23,66
1460926,40,2,1973,4,male,360,84,77,115,70,115,67,0,3
1408015,38,1,1975,1,female,245,84,48,121,8,0,2,121,6
1025131,31,31,1982,3,female,110,82,65,121,97,26,22,95,75
2097190,46,11,1967,11,female,1027,84,49,122,98,105,53,17,45
1978297,18,5,1995,2,female,77,84,36,123,43,123,33,0,10
1505072,26,18,1987,3,female,589,83,34,124,64,124,47,0,17
1367335,76,11,1937,7,female,1564,82,49,126,14,1,5,125,9
2130340,36,4,1977,10,female,553,82,51,126,101,16,71,110,30
1491361,30,9,1983,1,female,50,84,65,127,345,2,173,125,172
1468782,46,22,1967,7,female,1503,82,44,127,79,88,38,39,41
1028624,26,7,1987,4,female,641,82,3,130,49,130,29,0,20
1025354,58,9,1955,1,female,1110,83,32,126,71,126,33,0,38
1541980,73,15,1940,1,female,1148,84,36,129,75,129,59,0,16
1422901,20,15,1993,1,male,435,84,51,128,156,128,114,0,42
2177288,40,19,1973,1,female,53,84,73,132,169,49,149,83,20
1672859,36,28,1977,12,female,569,83,71,131,7,126,0,5,7
2119799,18,24,1995,3,female,656,83,48,131,68,131,68,0,0
1427336,39,13,1974,11,female,545,84,39,136,65,136,56,0,9
1365127,27,21,1986,11,male,446,83,22,131,101,131,87,0,14
1234730,74,5,1939,7,female,1137,82,46,140,46,0,37,140,9
1596973,58,20,1955,6,female,311,83,46,142,118,0,78,142,40
1118912,41,28,1972,7,female,890,83,41,143,45,125,31,18,14
2150451,33,12,1980,3,female,545,83,51,142,15,142,15,0,0
1266947,29,27,1984,9,male,488,82,58,137,34,137,27,0,7
1762327,63,14,1950,7,female,369,83,70,143,66,143,51,0,15
1078403,46,20,1967,9,female,1394,82,43,148,52,81,31,67,21
1332582,62,6,1951,1,female,1549,84,36,148,71,97,38,51,33
1875485,30,23,1983,5,female,400,83,68,147,162,85,65,62,97
2181712,53,29,1960,2,female,572,83,26,145,297,37,55,108,242
1117556,20,6,1993,5,female,314,84,46,147,86,147,30,0,56
1017426,29,3,1984,2,male,262,84,74,146,32,146,28,0,4
1568056,33,2,1980,8,female,900,84,35,145,28,145,20,0,8
1584461,49,23,1964,2,female,245,84,26,144,26,144,25,0,1
2092090,38,12,1975,12,female,69,83,21,147,114,147,107,0,7
1222866,63,9,1950,11,female,1458,82,52,151,35,12,20,139,15
1311924,24,26,1989,8,female,201,84,72,151,93,143,68,8,25
1690163,24,18,1989,1,male,342,83,27,161,55,159,27,2,28
1955861,34,11,1979,4,female,762,84,45,164,89,164,50,0,39
1382582,37,16,1976,1,female,52,83,51,163,72,163,33,0,39
2051357,35,14,1978,9,male,743,83,31,163,153,163,123,0,30
1526000,51,17,1962,7,female,953,84,48,161,105,161,89,0,16
1221919,59,1,1954,10,female,454,82,51,170,29,0,5,170,24
1793520,66,18,1947,8,female,596,82,59,171,91,0,36,171,55
1387125,56,17,1957,10,male,379,82,70,165,106,5,3,160,103
1460598,70,9,1943,7,male,365,82,65,167,304,0,150,167,154
1858746,47,6,1966,6,male,82,83,81,172,38,172,35,0,3
1238800,51,7,1962,9,female,513,83,57,172,60,172,46,0,14
1742871,34,10,1979,10,female,199,84,47,174,155,13,122,161,33
1840463,43,24,1970,6,female,231,83,45,175,449,45,155,130,294
1462671,16,8,1997,3,male,301,82,45,175,29,175,15,0,14
1954306,29,16,1984,11,female,623,83,26,177,21,177,19,0,2
1560798,55,14,1958,11,male,265,82,72,181,16,181,12,0,4
2023005,29,30,1984,1,male,485,82,66,180,52,180,23,0,29
1564840,64,16,1949,1,female,1473,82,46,175,76,175,76,0,0
1034486,56,11,1957,4,female,140,84,49,186,55,33,12,153,43
2029797,52,27,1961,4,male,267,84,46,190,131,1,24,189,107
1385047,56,6,1957,3,male,1093,84,41,188,109,151,78,37,31
1560121,108,25,1905,11,female,1391,83,12,183,90,183,35,0,55
1835191,47,18,1966,5,female,390,82,72,188,117,188,87,0,30
1355470,51,8,1962,10,female,1714,82,28,193,167,23,48,170,119
1784894,29,11,1984,10,female,228,84,73,192,133,177,85,15,48
1485131,33,18,1980,4,male,619,84,62,197,104,196,43,1,61
2028480,76,5,1937,11,female,1382,83,20,206,34,0,15,206,19
1275743,20,13,1993,9,female,272,83,67,209,90,197,23,12,67
1112202,30,30,1983,4,female,842,82,40,208,29,208,25,0,4
1516969,18,28,1995,6,male,37,83,68,207,53,207,16,0,37
1566903,28,21,1985,5,female,412,82,72,211,127,211,117,0,10
1324024,48,13,1965,6,female,236,83,42,214,56,0,31,214,25
1427065,71,15,1942,7,female,672,83,43,212,63,4,9,208,54
1432480,54,25,1959,2,female,873,82,33,226,29,0,4,226,25
2012105,64,16,1949,4,male,1591,83,39,231,9,0,0,231,9
1862917,50,21,1963,6,female,614,82,54,230,319,0,51,230,268
1903379,60,14,1953,2,NA,1491,84,55,232,21,151,14,81,7
1574797,50,4,1963,7,female,1236,83,33,222,71,218,18,4,53
2023809,24,25,1989,6,female,330,84,66,228,164,175,122,53,42
1205617,60,24,1953,7,female,2066,83,58,229,22,227,18,2,4
1769286,39,26,1974,2,male,252,83,60,228,125,228,117,0,8
2160035,56,9,1957,5,female,541,84,53,239,58,0,21,239,37
1150367,56,20,1957,8,male,593,83,49,240,73,228,41,12,32
1659712,28,4,1985,10,female,408,82,21,240,279,239,162,1,117
2027864,19,4,1994,1,male,328,82,57,237,91,237,58,0,33
2030532,51,9,1962,7,female,211,84,66,246,81,246,68,0,13
1449760,38,5,1975,7,female,252,82,51,237,212,237,181,0,31
1517967,55,27,1958,4,female,1278,84,54,256,7,0,6,256,1
1933991,31,17,1982,8,male,63,84,82,255,74,255,65,0,9
1529418,26,17,1987,11,female,118,82,46,272,54,272,43,0,11
1744875,26,2,1987,3,female,327,83,40,276,160,276,89,0,71
1369100,27,22,1986,4,female,370,82,29,275,60,275,33,0,27
1435624,49,16,1964,6,female,563,83,41,262,140,262,72,0,68
1560635,108,30,1905,7,male,38,82,71,264,278,264,258,0,20
1076015,20,23,1993,2,female,144,84,68,278,168,219,26,59,142
2136959,62,1,1951,11,female,239,84,51,279,63,279,53,0,10
1528526,52,9,1961,11,male,371,84,28,307,196,4,98,303,98
1098160,58,3,1955,9,female,929,83,43,302,31,229,2,73,29
1253566,40,5,1973,9,male,467,82,58,302,90,294,60,8,30
1566108,60,1,1953,3,female,1559,83,42,293,196,267,131,26,65
1771786,34,15,1979,1,female,400,84,29,301,46,301,32,0,14
1915832,58,15,1955,2,female,671,84,34,317,17,0,6,317,11
1390859,19,4,1994,9,female,370,84,42,314,29,207,11,107,18
1612668,63,20,1950,1,female,1810,82,34,311,21,311,11,0,10
1039152,25,8,1988,2,female,138,83,57,326,151,326,125,0,26
1994410,48,16,1965,6,male,719,84,68,312,256,312,189,0,67
1143661,52,10,1961,6,female,149,83,58,314,236,314,196,0,40
2065594,51,5,1962,5,male,909,82,49,346,168,346,79,0,89
1099934,75,9,1938,12,female,1386,82,35,354,139,0,12,354,127
1018897,43,3,1970,8,female,403,82,52,360,176,355,132,5,44
1307549,49,16,1964,7,female,1868,82,44,352,540,347,353,5,187
1077039,18,25,1995,7,male,39,84,82,365,20,365,18,0,2
2128057,23,7,1990,7,female,309,84,62,356,60,356,56,0,4
2004095,23,30,1990,1,female,1517,83,22,378,422,0,182,378,240
1826956,33,11,1980,2,female,402,84,65,389,183,389,169,0,14
1667735,35,4,1978,12,female,149,82,46,414,291,0,93,414,198
1388509,57,3,1956,2,female,1476,82,23,414,237,354,168,60,69
1912911,24,1,1989,12,male,734,84,69,404,66,404,21,0,45
1434244,23,16,1990,5,male,18,84,60,396,123,396,107,0,16
1218630,24,28,1989,3,female,686,83,49,396,67,396,56,0,11
1313149,42,23,1971,5,female,71,82,68,411,437,411,269,0,168
1630487,43,21,1970,1,female,153,82,29,447,93,2,39,445,54
1254586,55,29,1958,9,female,1942,83,49,445,528,237,304,208,224
1604960,55,30,1958,10,male,542,84,44,442,47,429,41,13,6
1088039,48,8,1965,7,male,146,82,73,438,38,438,34,0,4
2168558,27,12,1986,7,female,335,82,38,426,238,426,107,0,131
1121291,49,23,1964,2,female,1468,84,57,463,87,41,22,422,65
1495731,50,3,1963,4,female,733,83,46,464,367,446,283,18,84
2001604,62,14,1951,7,female,1516,83,27,461,54,461,34,0,20
1443213,47,11,1966,7,female,184,82,69,461,139,461,63,0,76
1389160,58,17,1955,2,female,1362,82,45,470,93,470,44,0,49
2191979,61,20,1952,4,female,1538,84,47,464,273,464,54,0,219
1216950,52,29,1961,3,female,380,82,54,469,442,469,233,0,209
1419417,48,24,1965,7,male,345,82,62,469,782,469,524,0,258
1194591,60,5,1953,10,female,450,84,38,522,41,0,2,522,39
1743002,18,6,1995,7,female,771,84,49,541,428,0,160,541,268
1104393,43,27,1970,2,male,139,82,38,548,141,548,86,0,55
2126387,66,24,1947,11,female,1938,84,21,538,169,538,153,0,16
1738481,76,27,1937,10,female,370,83,42,572,29,0,6,572,23
1083224,69,27,1944,2,male,477,83,28,579,285,0,120,579,165
2000322,63,10,1950,12,female,412,84,50,566,16,566,9,0,7
1562100,49,28,1964,7,female,1402,82,62,599,206,599,85,0,121
1634115,50,30,1963,4,female,392,82,58,621,130,0,64,621,66
1404853,46,22,1967,12,male,321,84,37,710,49,0,10,710,39
1288021,91,5,1922,12,female,1637,84,25,708,63,0,1,708,62
2071046,72,25,1941,8,female,1489,82,45,680,180,0,50,680,130
1513752,47,6,1966,4,female,390,82,41,717,558,0,95,717,463
2180702,32,3,1981,6,female,318,84,56,668,85,661,59,7,26
1142339,33,21,1980,11,male,579,84,61,709,664,681,584,28,80
2081945,64,11,1949,6,female,1794,83,55,763,155,102,44,661,111
1956857,22,21,1991,9,female,152,83,63,749,667,0,33,749,634
2132029,27,4,1986,4,male,120,83,47,728,1250,74,596,654,654
2116102,108,11,1905,1,female,723,84,42,753,327,385,131,368,196
1577444,48,11,1965,8,female,839,82,52,771,217,712,153,59,64
1388335,34,10,1979,2,female,59,84,74,854,197,0,48,854,149
1016917,73,11,1940,2,female,625,84,38,807,385,101,149,706,236
1424527,28,3,1985,7,female,298,82,22,835,529,544,141,291,388
1181355,41,9,1972,5,male,539,82,61,853,435,843,233,10,202
1878128,69,28,1944,11,female,460,82,49,877,56,877,19,0,37
1828665,73,3,1940,8,female,555,83,61,829,29,829,20,0,9
1072051,67,29,1946,1,female,321,83,53,930,465,0,87,930,378
1872203,14,10,1999,10,female,157,83,76,935,581,50,52,885,529
1632950,54,5,1959,7,male,479,84,68,938,753,930,314,8,439
1148591,29,19,1984,5,female,245,82,70,919,151,919,65,0,86
1353655,29,23,1984,9,female,447,82,58,928,104,928,54,0,50
1482251,31,30,1982,7,female,494,82,35,947,274,947,217,0,57
1824406,49,20,1964,11,female,528,84,45,1038,569,0,158,1038,411
1100765,67,2,1946,5,female,721,84,35,1115,310,0,13,1115,297
1938255,58,22,1955,12,male,588,83,54,1007,770,0,101,1007,669
1053043,18,6,1995,2,female,207,82,49,1024,458,632,183,392,275
1960661,39,14,1974,12,female,651,84,73,1003,217,327,76,676,141
1701437,31,24,1982,5,female,310,82,45,1047,72,997,55,50,17
1142761,49,14,1964,7,male,305,82,39,1050,89,1050,60,0,29
1306010,60,12,1953,2,female,732,82,41,1041,347,1041,205,0,142
1579204,54,10,1959,4,female,894,82,27,1175,115,0,12,1175,103
1066944,18,24,1995,1,female,236,83,66,1237,375,0,133,1237,242
1471723,19,24,1994,10,female,42,82,59,1230,1044,61,616,1169,428
1964152,20,5,1993,8,female,634,83,34,1353,171,1326,68,27,103
2090094,66,17,1947,8,female,552,83,62,1995,222,1868,113,127,109
2135462,54,26,1959,3,female,317,82,37,2145,617,1565,432,580,185
1649788,26,1,1987,1,male,321,83,56,2265,49,2265,37,0,12
1360106,57,28,1956,12,female,1542,82,17,2341,278,2341,141,0,137
1147708,54,12,1959,12,male,582,82,49,3477,229,0,125,3477,104
1997381,54,4,1959,6,female,501,83,73,2663,127,2662,83,1,44
1843951,47,25,1966,5,female,446,84,35,7292,494,7291,285,1,209
1513004,23,13,1990,1,male,255,87,82,3,8,3,5,0,3
1625723,23,4,1990,1,female,184,87,72,3,35,3,24,0,11
1263928,26,30,1987,3,male,39,85,68,3,68,3,63,0,5
2180963,42,25,1971,12,male,739,87,36,3,8,3,6,0,2
1366937,45,27,1968,9,female,421,85,67,3,17,3,9,0,8
1303272,61,22,1952,3,male,1874,85,43,3,18,3,7,0,11
1838104,68,9,1945,11,female,842,86,28,3,9,3,9,0,0
1845377,113,20,1900,9,female,1270,85,49,3,10,3,4,0,6
1053972,38,30,1975,1,male,262,86,43,4,0,0,0,4,0
1831885,30,14,1983,6,male,446,85,72,4,3,0,1,4,2
1328868,34,20,1979,5,male,599,85,52,4,4,2,3,2,1
1477065,35,29,1978,1,male,572,85,62,4,5,1,2,3,3
2037375,17,7,1996,11,male,33,86,83,4,1,3,1,1,0
2156133,19,10,1994,10,male,474,87,51,4,1,3,1,1,0
1821989,29,23,1984,7,male,508,86,53,4,2,3,1,1,1
1829575,23,7,1990,6,male,281,87,50,4,0,4,0,0,0
1402407,45,5,1968,6,male,967,85,59,4,0,4,0,0,0
1580339,64,25,1949,4,NA,2318,86,18,4,0,4,0,0,0
1242818,17,13,1996,8,male,510,85,63,4,1,4,1,0,0
1903144,25,8,1988,2,male,108,86,48,4,1,4,1,0,0
1238862,25,7,1988,4,male,449,85,36,4,1,4,1,0,0
1547451,30,13,1983,4,male,695,87,57,4,2,4,2,0,0
2029130,41,18,1972,12,female,622,86,67,4,1,4,1,0,0
1084306,25,14,1988,6,male,16,87,81,4,3,4,3,0,0
2122224,15,11,1998,3,male,531,86,49,4,7,4,5,0,2
1716901,22,2,1991,2,male,526,86,59,4,13,4,6,0,7
2136961,33,1,1980,1,male,398,85,57,4,7,4,4,0,3
1510914,54,3,1959,4,male,781,86,56,5,3,0,0,5,3
1416131,23,16,1990,10,male,714,86,49,5,4,0,0,5,4
1725806,64,15,1949,3,male,638,87,26,5,38,0,15,5,23
1462692,19,15,1994,2,female,264,85,72,5,0,5,0,0,0
1866332,21,21,1992,12,male,695,85,50,5,0,5,0,0,0
1381262,17,10,1996,1,female,478,86,45,5,1,5,0,0,1
1112776,42,22,1971,9,male,525,87,40,5,2,5,1,0,1
1500913,66,13,1947,7,female,1125,85,23,5,2,5,0,0,2
1267382,15,21,1998,1,male,269,87,59,5,4,5,1,0,3
1869596,17,15,1996,4,male,234,85,56,5,4,5,3,0,1
1744597,20,10,1993,1,male,570,87,66,5,4,5,4,0,0
2018981,21,22,1992,5,female,269,86,49,5,5,5,2,0,3
1661906,33,7,1980,5,male,385,86,50,5,6,5,6,0,0
1134950,19,17,1994,11,male,120,87,37,5,16,5,8,0,8
1668743,18,6,1995,1,male,95,87,58,5,28,5,25,0,3
2183913,18,24,1995,3,female,557,87,40,5,10,5,6,0,4
2021056,20,4,1993,7,female,67,85,80,5,8,5,8,0,0
1285035,34,9,1979,8,male,663,85,55,5,28,5,15,0,13
1183044,39,8,1974,9,male,715,87,45,5,35,5,11,0,24
1094033,40,17,1973,8,male,297,85,50,5,13,5,7,0,6
1686544,18,4,1995,10,male,503,87,67,6,0,0,0,6,0
1986891,21,18,1992,9,male,528,85,41,6,1,0,1,6,0
1874550,25,30,1988,5,female,643,87,56,6,1,0,1,6,0
2082338,36,19,1977,4,female,362,85,38,6,1,0,0,6,1
2069220,40,16,1973,8,male,541,86,66,6,2,0,0,6,2
1165925,21,27,1992,6,male,464,86,82,6,6,0,3,6,3
1412349,17,18,1996,1,female,280,87,49,6,11,0,0,6,11
1577595,62,26,1951,7,female,1861,87,49,6,32,1,6,5,26
2030755,25,21,1988,8,male,24,85,72,6,47,4,30,2,17
1909676,18,1,1995,9,male,283,86,78,6,0,6,0,0,0
1793542,30,27,1983,6,male,662,86,6,6,0,6,0,0,0
1176231,16,14,1997,5,male,122,85,81,6,2,6,1,0,1
1284583,29,10,1984,7,male,104,85,45,6,1,6,1,0,0
1805020,37,13,1976,1,male,263,87,38,6,5,6,3,0,2
1586050,16,14,1997,3,male,320,87,18,6,9,6,9,0,0
1712667,18,6,1995,11,male,174,86,59,6,33,6,30,0,3
1818397,25,11,1988,6,female,288,87,62,6,37,6,23,0,14
1120365,27,20,1986,7,female,404,87,62,6,31,6,25,0,6
2059573,45,25,1968,4,female,1020,85,35,6,11,6,7,0,4
1019664,14,6,1999,3,female,263,86,75,7,0,0,0,7,0
1221098,31,5,1982,9,male,762,85,57,7,1,0,1,7,0
1561483,30,17,1983,11,male,395,86,76,7,0,3,0,4,0
1876209,63,24,1950,12,NA,2012,87,27,7,4,4,3,3,1
1875608,64,29,1949,5,male,206,86,82,7,2,2,2,5,0
2141117,24,1,1989,4,male,353,86,57,7,1,7,1,0,0
1843722,33,29,1980,8,male,533,85,72,7,1,7,0,0,1
1465073,20,3,1993,11,male,393,86,51,7,3,7,3,0,0
1220509,51,22,1962,6,male,1747,85,38,7,2,7,2,0,0
1373370,23,1,1990,8,male,295,87,52,7,7,7,2,0,5
2122114,25,17,1988,7,female,146,85,57,7,5,7,0,0,5
1402157,24,14,1989,11,male,353,87,83,8,0,0,0,8,0
1844237,30,31,1983,8,female,292,85,72,8,0,0,0,8,0
1367610,67,1,1946,6,male,979,85,41,8,0,0,0,8,0
2018991,23,13,1990,4,female,472,86,40,8,7,0,5,8,2
1476203,58,20,1955,2,male,1618,86,48,8,17,0,4,8,13
1426098,57,31,1956,8,female,432,85,53,8,1,4,1,4,0
1784577,43,2,1970,2,male,506,86,64,8,3,5,3,3,0
2145241,53,14,1960,10,male,1749,87,14,8,2,4,2,4,0
1178129,27,2,1986,4,male,104,86,62,8,10,7,7,1,3
1204299,18,6,1995,5,male,137,85,50,8,1,8,1,0,0
1989579,25,10,1988,9,male,632,87,44,8,1,8,0,0,1
1673589,74,26,1939,7,male,1671,85,26,8,1,8,0,0,1
1769158,26,20,1987,9,female,264,85,45,8,45,8,25,0,20
1568400,16,30,1997,1,male,604,86,62,9,0,0,0,9,0
1795041,28,25,1985,4,male,589,85,53,9,0,0,0,9,0
1057484,56,26,1957,4,female,273,87,18,9,2,0,1,9,1
1328088,31,14,1982,2,female,229,86,12,9,129,0,77,9,52
1288342,49,24,1964,5,male,192,86,43,9,18,0,10,9,8
1896002,21,12,1992,3,male,493,87,60,9,2,4,1,5,1
1223411,27,10,1986,12,male,277,85,55,9,61,3,49,6,12
1409524,24,14,1989,10,female,508,86,38,9,9,8,8,1,1
1955175,26,4,1987,6,male,383,87,77,9,0,9,0,0,0
1928975,33,1,1980,1,male,236,85,80,9,1,9,1,0,0
1740237,48,6,1965,1,male,90,86,71,9,4,9,2,0,2
1482202,29,20,1984,8,male,489,87,52,9,8,9,6,0,2
1022077,32,1,1981,10,female,22,87,27,9,7,9,4,0,3
1706701,48,8,1965,11,male,12,87,55,9,6,9,5,0,1
1917506,16,11,1997,4,female,225,85,55,9,127,9,107,0,20
1526014,20,26,1993,12,female,302,87,60,9,25,9,18,0,7
2133919,50,14,1963,9,female,747,85,40,9,57,9,29,0,28
2165669,66,6,1947,5,male,215,87,74,10,3,0,2,10,1
1502253,62,8,1951,9,female,561,86,59,10,9,1,4,9,5
1407684,28,8,1985,5,male,267,85,19,10,0,5,0,5,0
1236012,31,3,1982,3,male,453,87,46,10,98,2,53,8,45
1365053,27,21,1986,6,female,417,85,64,10,0,9,0,1,0
1753616,21,1,1992,4,male,153,86,30,10,42,9,14,1,28
1366073,35,17,1978,6,female,744,87,43,10,5,10,5,0,0
1327374,41,19,1972,7,male,1322,86,44,10,6,10,4,0,2
1556100,59,15,1954,4,female,1763,87,19,10,4,10,3,0,1
1514775,68,5,1945,6,male,123,86,52,10,4,10,4,0,0
2045500,77,30,1936,6,female,1587,86,48,10,3,10,0,0,3
1056731,18,13,1995,7,male,167,85,71,10,7,10,5,0,2
1870384,50,9,1963,2,male,1401,87,33,11,1,0,1,11,0
1192416,66,27,1947,11,female,1601,86,43,11,71,0,24,11,47
1460894,19,13,1994,3,male,701,86,48,11,0,6,0,5,0
1191566,60,27,1953,4,female,442,85,59,11,16,10,13,1,3
1132366,30,11,1983,10,male,1797,86,46,11,19,9,18,2,1
1682800,35,2,1978,1,male,512,85,37,11,1,11,1,0,0
1750188,17,17,1996,12,male,312,87,60,11,2,11,1,0,1
1931051,46,16,1967,6,female,688,85,36,11,3,11,2,0,1
1418936,70,1,1943,10,female,1518,85,41,11,5,11,5,0,0
2035485,106,7,1907,8,female,286,86,44,11,12,11,5,0,7
1134659,48,28,1965,1,female,1578,87,55,11,61,11,54,0,7
1973531,19,5,1994,11,female,364,86,41,12,0,1,0,11,0
1905690,23,13,1990,12,male,198,85,79,12,17,0,3,12,14
1634025,108,5,1905,11,male,13,86,49,12,4,11,3,1,1
1281620,19,28,1994,7,male,28,85,72,12,14,9,9,3,5
1229907,32,7,1981,3,male,396,86,47,12,44,11,12,1,32
1446843,43,16,1970,3,male,487,86,47,12,50,10,11,2,39
1761898,21,28,1992,12,male,540,86,66,12,0,12,0,0,0
1532182,46,2,1967,9,male,159,86,80,12,0,12,0,0,0
1103314,56,27,1957,8,male,2142,87,25,12,0,12,0,0,0
1951781,32,31,1981,10,male,552,86,56,12,7,12,7,0,0
1627778,16,7,1997,7,male,19,86,86,12,14,12,8,0,6
1684027,22,8,1991,8,female,567,87,36,12,16,12,12,0,4
1826735,25,29,1988,12,female,411,85,57,12,13,12,10,0,3
1078470,67,23,1946,11,female,634,86,39,12,8,12,8,0,0
1858778,57,30,1956,9,male,268,87,57,12,43,12,11,0,32
1803658,52,9,1961,4,female,342,85,77,13,7,2,4,11,3
1797232,61,28,1952,12,male,621,86,64,13,3,0,0,13,3
1668407,20,15,1993,9,male,301,86,60,13,2,13,2,0,0
1987256,34,29,1979,10,male,596,86,38,13,1,13,1,0,0
1069179,28,6,1985,6,male,36,85,82,13,7,13,7,0,0
1655278,33,30,1980,8,male,189,85,72,13,5,13,4,0,1
2117197,21,1,1992,1,male,683,87,43,13,12,13,12,0,0
1957581,16,14,1997,1,male,581,85,57,13,24,13,21,0,3
1846435,38,7,1975,8,male,316,86,77,13,20,13,11,0,9
1794028,42,6,1971,5,male,266,86,59,13,24,13,12,0,12
1615585,31,5,1982,5,male,454,85,58,14,17,7,2,7,15
1121726,52,12,1961,7,male,1726,85,26,14,11,13,9,1,2
1628807,73,25,1940,10,male,773,86,64,14,0,14,0,0,0
1245120,22,17,1991,4,male,557,85,30,14,13,14,4,0,9
1229949,25,12,1988,12,male,206,85,66,14,13,14,13,0,0
1600497,30,2,1983,10,female,539,86,53,14,15,14,10,0,5
1857131,108,1,1905,1,male,1759,86,69,14,10,14,10,0,0
2000539,38,30,1975,5,female,430,87,30,14,63,14,50,0,13
1909436,51,7,1962,5,male,156,86,22,14,38,14,21,0,17
1236194,51,16,1962,10,male,283,85,79,15,6,0,2,15,4
1011296,30,25,1983,7,male,533,87,35,15,42,2,23,13,19
2056841,20,15,1993,7,male,442,86,48,15,5,13,0,2,5
1812607,19,28,1994,8,male,520,87,37,15,17,13,13,2,4
1735494,26,21,1987,7,male,503,86,54,15,0,15,0,0,0
2128859,56,18,1957,3,female,1607,85,22,15,1,15,1,0,0
1059886,33,17,1980,9,female,125,87,49,15,53,15,32,0,21
1202191,38,7,1975,4,male,201,86,65,15,28,15,26,0,2
1595488,41,6,1972,1,male,333,85,58,16,0,3,0,13,0
1090398,15,1,1998,2,female,480,87,53,16,3,0,0,16,3
2153766,21,2,1992,5,male,333,87,70,16,2,12,1,4,1
1613777,20,14,1993,6,male,377,86,50,16,21,16,20,0,1
1454069,28,19,1985,6,female,108,85,47,16,16,16,16,0,0
1190365,23,1,1990,1,male,102,86,58,16,74,16,52,0,22
1008925,76,10,1937,6,female,425,87,62,17,35,0,21,17,14
1105417,54,18,1959,8,female,81,86,81,17,4,6,2,11,2
1355388,66,9,1947,7,male,1154,87,45,17,11,16,4,1,7
1699132,62,16,1951,8,male,255,86,27,17,4,17,2,0,2
1164937,17,17,1996,9,male,151,87,58,17,17,17,8,0,9
1350667,33,5,1980,9,female,289,86,48,17,23,17,14,0,9
1576873,64,6,1949,9,male,831,85,70,18,15,4,5,14,10
1522182,22,14,1991,12,female,111,87,66,18,27,15,14,3,13
2116095,29,10,1984,3,male,385,86,50,18,134,16,83,2,51
1068979,58,23,1955,11,male,1164,86,26,18,32,17,18,1,14
1507897,37,4,1976,6,male,670,86,20,18,1,18,1,0,0
1423291,23,29,1990,4,female,782,87,65,18,3,18,3,0,0
1125775,39,6,1974,11,female,408,86,49,18,9,18,6,0,3
1812271,53,30,1960,4,female,569,85,38,18,7,18,7,0,0
1320938,31,2,1982,5,female,304,87,61,18,21,18,12,0,9
1520075,38,24,1975,4,male,168,85,76,18,11,18,11,0,0
1170698,58,31,1955,7,female,73,86,59,18,13,18,13,0,0
1496887,23,23,1990,3,female,207,85,43,18,46,18,21,0,25
1555569,26,25,1987,3,female,411,85,64,18,34,18,32,0,2
1804084,18,3,1995,2,male,166,85,77,19,2,1,1,18,1
1531474,22,6,1991,7,male,38,85,81,19,0,0,0,19,0
1139237,63,4,1950,3,female,1559,85,36,19,2,0,1,19,1
1195523,50,3,1963,9,male,373,86,49,19,39,0,9,19,30
1406809,25,8,1988,8,male,59,86,80,19,4,6,4,13,0
1368711,23,1,1990,1,male,96,85,69,19,3,19,2,0,1
1112226,37,28,1976,10,male,239,85,77,19,1,19,1,0,0
1710807,49,21,1964,4,female,535,87,57,19,8,19,7,0,1
1254118,64,10,1949,7,female,1293,87,60,19,4,19,4,0,0
1154815,18,1,1995,3,female,185,87,8,19,28,19,5,0,23
2087691,20,5,1993,4,male,38,85,78,19,45,19,8,0,37
1329874,30,29,1983,8,female,272,85,41,19,40,19,30,0,10
1032643,36,10,1977,3,male,270,87,77,19,45,19,36,0,9
1141710,38,15,1975,6,female,433,87,41,19,43,19,37,0,6
1794110,49,22,1964,12,female,581,86,58,20,60,0,32,20,28
1079853,23,23,1990,3,male,227,87,80,20,0,14,0,6,0
1295211,33,25,1980,9,male,323,87,73,20,2,11,1,9,1
1575280,22,8,1991,8,female,490,87,66,20,21,12,1,8,20
1939199,33,27,1980,10,male,604,86,53,20,27,14,13,6,14
1130182,15,8,1998,2,female,602,87,27,20,59,11,23,9,36
1353051,21,21,1992,8,male,1521,85,34,20,2,20,0,0,2
1715292,21,5,1992,5,male,129,86,68,20,8,20,8,0,0
2186706,24,12,1989,1,female,220,87,79,20,4,20,4,0,0
1904241,32,26,1981,9,male,373,85,70,20,4,20,4,0,0
1429237,64,24,1949,11,female,991,86,41,20,9,20,5,0,4
2016261,48,20,1965,8,female,604,85,37,20,13,20,13,0,0
1175385,17,19,1996,5,female,25,87,61,20,58,20,55,0,3
1633190,18,7,1995,1,male,277,87,81,20,114,20,52,0,62
2059636,22,19,1991,10,female,506,86,39,20,44,20,41,0,3
1407109,28,30,1985,12,female,247,87,52,20,136,20,125,0,11
1643832,56,27,1957,3,female,1461,85,58,21,14,13,9,8,5
1530988,27,3,1986,11,female,283,86,62,21,176,21,149,0,27
2053062,31,17,1982,9,female,277,87,60,21,55,21,38,0,17
1097543,65,7,1948,2,male,1006,87,24,22,36,18,21,4,15
2063511,19,24,1994,7,female,138,87,83,22,11,22,5,0,6
1335981,50,4,1963,4,female,634,87,64,22,10,22,5,0,5
1165553,54,25,1959,11,female,172,87,62,22,4,22,4,0,0
1323415,54,10,1959,2,female,139,86,67,22,7,22,6,0,1
1221011,35,20,1978,10,male,348,85,74,23,5,0,0,23,5
1384921,65,22,1948,1,female,626,86,56,23,10,0,1,23,9
1252751,64,12,1949,7,female,1705,85,46,23,14,0,11,23,3
1313029,24,29,1989,12,male,493,85,36,23,2,15,2,8,0
2024855,32,5,1981,12,male,121,87,55,23,2,13,1,10,1
2130063,66,11,1947,3,female,910,85,45,23,9,6,3,17,6
1376772,19,2,1994,3,female,490,86,38,23,4,20,0,3,4
1835339,26,12,1987,2,male,714,86,47,23,12,23,12,0,0
1935631,28,30,1985,9,male,385,85,76,23,12,23,7,0,5
1526095,63,7,1950,5,female,735,86,63,24,6,0,5,24,1
1109684,53,27,1960,2,female,417,86,42,24,5,8,3,16,2
1783158,28,7,1985,6,male,351,86,34,24,4,24,3,0,1
1176583,22,2,1991,6,male,427,87,64,24,16,24,14,0,2
2070830,24,18,1989,4,male,556,85,62,24,17,24,17,0,0
2056631,25,7,1988,5,male,592,86,49,24,23,24,9,0,14
1310478,50,20,1963,12,male,852,85,51,24,27,24,26,0,1
1555085,57,19,1956,12,female,17,87,80,24,26,24,23,0,3
1458153,25,3,1988,7,male,623,86,69,24,53,24,50,0,3
1173060,65,7,1948,1,female,1450,87,10,24,126,24,106,0,20
1235536,38,12,1975,7,male,397,85,65,25,12,0,4,25,8
2109221,56,10,1957,7,female,160,85,60,25,12,0,6,25,6
1523585,57,14,1956,8,female,283,85,71,25,29,0,4,25,25
1051514,62,14,1951,9,male,1756,85,52,25,20,12,13,13,7
1072849,17,3,1996,8,female,524,86,39,25,62,13,24,12,38
1439994,19,7,1994,11,female,312,87,45,25,9,24,9,1,0
1536517,17,15,1996,2,male,248,86,82,25,1,25,0,0,1
1740756,21,3,1992,3,male,529,85,76,25,15,25,11,0,4
1833835,40,29,1973,3,female,547,85,11,25,8,25,8,0,0
1139491,38,14,1975,7,female,142,87,80,25,31,25,30,0,1
1316452,58,12,1955,12,female,600,87,47,26,12,0,4,26,8
1364238,58,4,1955,6,female,600,87,67,26,23,0,1,26,22
1432366,39,3,1974,2,male,417,87,43,26,8,14,6,12,2
1902668,17,8,1996,4,male,165,87,63,26,36,18,17,8,19
1788861,26,11,1987,12,female,891,87,34,26,65,18,22,8,43
1211493,19,28,1994,4,female,282,85,62,26,2,26,1,0,1
1026725,23,1,1990,1,female,184,86,27,26,28,26,27,0,1
1336274,28,1,1985,1,male,234,85,62,26,65,26,35,0,30
2061570,46,28,1967,2,male,395,87,62,27,1,27,1,0,0
1155382,46,8,1967,1,male,1656,86,65,27,33,27,28,0,5
1303423,25,9,1988,8,male,125,87,74,28,154,20,105,8,49
2003350,59,25,1954,5,male,466,87,75,29,4,0,0,29,4
1190116,26,15,1987,10,female,231,86,40,29,56,1,25,28,31
1239643,46,19,1967,8,male,404,87,69,29,2,25,1,4,1
1622041,22,20,1991,6,female,98,87,60,29,12,29,9,0,3
1614677,45,28,1968,10,female,699,86,69,31,19,0,8,31,11
1864813,13,2,2000,1,male,272,85,39,31,168,0,102,31,66
1424787,32,8,1981,3,male,633,87,56,30,161,28,77,2,84
1971329,21,29,1992,9,male,218,86,75,31,0,31,0,0,0
2097008,29,1,1984,1,male,265,86,83,31,1,31,1,0,0
1737557,30,5,1983,2,male,139,86,40,31,15,31,7,0,8
1584370,36,17,1977,3,female,168,87,76,30,18,30,12,0,6
1844369,31,1,1982,1,male,325,86,51,31,39,31,39,0,0
1452398,63,7,1950,4,female,879,85,24,32,4,0,2,32,2
1740342,60,26,1953,7,female,208,86,39,32,41,0,6,32,35
1843227,54,4,1959,10,male,1829,86,58,32,71,31,40,1,31
1849942,27,15,1986,4,male,236,85,24,32,34,32,28,0,6
2049660,24,25,1989,2,male,177,86,67,33,6,32,3,1,3
1635827,17,18,1996,10,female,515,85,33,33,39,32,34,1,5
1868155,37,9,1976,11,female,410,87,40,33,9,33,8,0,1
1115234,50,27,1963,10,male,1566,86,25,33,12,33,5,0,7
1428344,26,27,1987,8,female,412,86,62,33,31,33,26,0,5
1295160,26,25,1987,10,female,16,85,84,33,31,33,23,0,8
1097125,71,23,1942,12,male,1374,86,37,33,44,33,43,0,1
1066910,75,9,1938,7,female,1000,87,62,33,71,33,41,0,30
1778263,31,10,1982,11,male,567,86,25,34,66,25,38,9,28
1320180,22,12,1991,6,male,155,87,11,34,0,34,0,0,0
1688708,55,15,1958,10,male,195,86,35,34,42,34,34,0,8
1076475,56,21,1957,12,female,207,85,61,34,100,34,73,0,27
1972190,21,18,1992,4,female,350,85,28,36,12,25,2,11,10
2035689,99,11,1914,1,NA,1691,86,31,35,165,13,70,22,95
1518514,19,23,1994,4,male,293,85,79,35,0,35,0,0,0
2004892,68,20,1945,1,male,1393,87,36,35,7,35,5,0,2
1021952,31,31,1982,1,male,698,87,23,36,53,36,46,0,7
1436735,69,3,1944,6,male,687,87,35,37,2,0,1,37,1
1461843,23,3,1990,7,female,420,85,66,37,0,20,0,17,0
1528893,63,24,1950,11,female,1786,87,24,37,22,26,14,11,8
1559173,19,9,1994,9,female,616,85,58,37,197,37,135,0,62
2040829,54,8,1959,7,male,385,86,43,38,18,0,6,38,12
1656614,102,24,1911,5,male,760,87,40,39,11,7,6,32,5
1877517,106,24,1907,11,male,1327,87,43,38,13,26,7,12,6
2172840,29,11,1984,1,female,625,86,40,39,1,39,1,0,0
1976748,18,17,1995,7,male,122,86,71,39,13,39,10,0,3
1273370,32,28,1981,4,male,290,87,63,40,79,27,24,13,55
1472233,14,8,1999,2,female,224,86,85,40,33,39,28,1,5
1935502,19,20,1994,2,male,357,87,51,40,31,37,29,3,2
2173398,43,7,1970,8,female,251,87,52,40,23,40,18,0,5
2155698,35,11,1978,2,male,482,85,64,40,31,40,30,0,1
1912994,39,12,1974,9,female,501,86,43,40,61,40,43,0,18
1860833,62,20,1951,12,male,2315,87,21,42,9,0,5,42,4
2135987,34,17,1979,2,female,337,87,44,41,140,5,91,36,49
1896959,60,6,1953,1,male,1328,85,35,41,9,38,7,3,2
1941387,30,20,1983,4,male,417,85,72,42,4,42,2,0,2
1148037,21,16,1992,3,male,553,87,49,42,22,42,3,0,19
1894374,21,25,1992,7,male,724,86,59,42,33,42,30,0,3
1933025,32,27,1981,9,male,528,85,36,41,154,41,137,0,17
1495057,29,3,1984,4,male,649,85,49,43,3,0,1,43,2
1076379,53,25,1960,9,female,286,86,31,43,34,0,12,43,22
2049482,113,18,1900,5,male,1197,86,50,44,66,0,6,44,60
1349803,26,19,1987,7,female,84,85,77,43,17,23,8,20,9
1468885,22,5,1991,4,female,147,87,59,43,31,26,11,17,20
1150133,36,20,1977,12,male,107,85,76,44,43,39,30,5,13
1220331,40,26,1973,6,male,146,87,51,44,2,44,2,0,0
2134488,32,4,1981,4,male,1009,86,37,44,10,44,10,0,0
1805611,23,27,1990,4,female,136,87,48,43,29,43,28,0,1
2124741,31,9,1982,9,female,227,86,39,44,65,44,57,0,8
1084656,35,22,1978,4,female,194,86,78,45,238,1,84,44,154
1697536,26,27,1987,7,male,307,85,48,45,0,45,0,0,0
1694808,15,3,1998,12,male,528,87,32,45,19,45,17,0,2
1420088,26,11,1987,11,male,380,87,67,45,17,45,14,0,3
1440351,18,4,1995,12,male,214,87,54,47,4,2,0,45,4
1085784,52,25,1961,6,male,407,85,45,46,54,8,20,38,34
2036442,71,24,1942,4,female,1564,85,50,47,46,27,27,20,19
1341159,39,21,1974,3,female,1662,86,39,47,72,30,45,17,27
1530852,24,8,1989,2,male,300,85,58,47,28,42,21,5,7
1395804,100,1,1913,10,male,165,86,73,47,27,43,14,4,13
1526192,35,16,1978,8,male,256,85,61,47,23,47,10,0,13
1361803,15,5,1998,3,male,159,87,42,46,30,46,18,0,12
1066241,28,27,1985,7,male,410,87,43,46,29,46,25,0,4
1678024,39,12,1974,2,female,605,87,61,46,40,46,10,0,30
1176497,53,15,1960,12,male,355,86,57,47,50,47,45,0,5
1374290,108,4,1905,1,male,135,85,48,49,44,16,27,33,17
1188537,14,3,1999,8,male,98,85,66,48,32,45,27,3,5
1988954,16,13,1997,10,male,372,85,39,48,3,48,2,0,1
1793446,26,17,1987,9,female,246,85,50,49,57,49,36,0,21
1933408,37,28,1976,1,male,855,87,41,48,45,48,25,0,20
1174987,45,25,1968,12,male,44,85,71,51,29,50,11,1,18
1543272,24,29,1989,1,male,672,86,46,50,15,50,13,0,2
1504934,89,5,1924,8,female,872,86,27,51,62,51,60,0,2
1019906,45,22,1968,12,female,369,86,65,53,19,6,14,47,5
1304814,35,21,1978,12,female,757,85,49,52,1,36,1,16,0
1946934,59,20,1954,2,female,1128,85,54,53,7,32,4,21,3
2048793,20,24,1993,9,female,580,86,65,53,55,43,35,10,20
1927896,53,22,1960,2,male,299,87,74,52,5,52,5,0,0
1725641,59,9,1954,3,female,568,85,22,53,14,53,4,0,10
1554965,27,15,1986,5,male,181,87,35,53,150,53,99,0,51
1778045,35,24,1978,11,female,489,86,44,54,19,2,5,52,14
2100967,52,4,1961,6,female,547,86,67,55,16,19,11,36,5
1580441,43,6,1970,6,male,240,86,68,54,107,27,96,27,11
1499772,20,25,1993,10,male,247,86,49,54,42,42,37,12,5
2077283,18,28,1995,1,male,120,87,50,54,28,54,12,0,16
1656542,21,27,1992,6,male,472,86,42,54,26,54,16,0,10
1751623,32,13,1981,1,female,299,87,64,54,21,54,21,0,0
1675210,35,20,1978,3,male,829,86,41,55,64,55,26,0,38
1566484,17,24,1996,6,female,52,85,36,54,96,54,80,0,16
1968906,20,22,1993,1,male,327,87,65,54,110,54,35,0,75
1444935,26,14,1987,11,male,121,86,53,54,148,54,56,0,92
2034918,45,21,1968,4,female,77,85,33,54,155,54,72,0,83
2071826,76,11,1937,7,female,1355,87,43,57,15,0,7,57,8
1322037,47,24,1966,10,male,855,85,28,56,84,0,9,56,75
1855635,32,22,1981,10,female,548,85,42,58,36,15,18,43,18
1714798,38,24,1975,9,female,396,85,67,56,77,38,32,18,45
1539744,57,6,1956,12,male,1469,85,46,58,33,57,30,1,3
2101589,108,5,1905,11,female,1768,87,67,57,79,44,29,13,50
2050236,19,24,1994,7,male,693,87,49,56,15,56,9,0,6
1584663,27,2,1986,2,male,241,85,58,58,76,58,55,0,21
1018071,65,3,1948,8,female,1128,86,48,58,102,58,39,0,63
1640244,57,19,1956,4,female,1664,86,57,59,19,0,1,59,18
1108492,52,13,1961,2,female,246,87,75,60,86,0,7,60,79
1783113,17,22,1996,9,male,523,86,29,59,31,41,11,18,20
1710044,31,20,1982,4,male,29,85,83,59,9,56,7,3,2
1789842,54,20,1959,11,female,369,86,69,59,55,59,48,0,7
2181959,45,25,1968,12,male,958,87,20,61,4,0,1,61,3
1835287,19,2,1994,4,male,12,85,66,63,155,30,122,33,33
1142724,29,23,1984,1,female,656,85,33,63,51,51,19,12,32
2155217,38,14,1975,5,female,424,87,42,63,100,54,65,9,35
1566131,83,23,1930,2,female,1169,86,58,61,9,61,4,0,5
2007417,55,17,1958,3,female,294,86,63,61,19,61,7,0,12
1428154,23,11,1990,9,female,376,85,31,63,52,63,20,0,32
1235273,29,14,1984,7,male,164,86,60,62,68,62,31,0,37
1877614,59,9,1954,10,female,1497,87,48,61,70,61,57,0,13
1232570,31,18,1982,2,male,196,86,64,65,11,0,7,65,4
2125921,40,11,1973,7,female,289,87,30,65,87,44,49,21,38
2082584,19,2,1994,11,female,583,87,62,64,13,64,7,0,6
1035686,64,11,1949,5,male,1538,85,31,65,33,65,27,0,6
1981378,93,4,1920,10,male,392,87,84,67,7,0,1,67,6
1269185,29,14,1984,4,male,643,86,67,68,164,20,86,48,78
1715014,17,7,1996,2,male,660,87,41,68,5,64,1,4,4
1755448,19,18,1994,6,male,547,87,64,66,63,49,22,17,41
1493384,15,6,1998,12,male,182,85,75,67,5,67,3,0,2
1524515,50,30,1963,3,male,340,87,77,66,3,66,3,0,0
1059672,69,29,1944,1,female,2382,87,17,67,51,67,34,0,17
1149455,63,8,1950,6,male,527,85,49,67,149,67,110,0,39
1284345,35,3,1978,10,female,63,87,82,70,75,2,17,68,58
1640743,86,20,1927,11,female,1503,87,43,70,37,20,18,50,19
1140025,19,10,1994,11,female,244,86,33,70,5,70,5,0,0
1508014,25,13,1988,9,male,100,87,64,69,87,69,50,0,37
1599979,27,20,1986,4,female,962,86,69,74,10,74,5,0,5
1401075,40,28,1973,12,female,390,86,34,73,36,73,21,0,15
1995991,103,8,1910,3,male,438,86,62,72,12,72,9,0,3
1546361,26,1,1987,1,male,347,86,70,74,246,74,210,0,36
1178489,41,4,1972,7,female,438,87,37,77,94,37,62,40,32
1453023,54,20,1959,5,male,541,86,38,77,27,57,5,20,22
1231070,36,17,1977,5,female,263,86,46,75,19,75,7,0,12
2013786,20,3,1993,7,female,427,86,63,75,88,75,32,0,56
1511907,50,14,1963,11,female,271,85,73,79,12,76,7,3,5
1969666,18,9,1995,11,male,149,85,68,79,37,79,22,0,15
1353355,22,7,1991,12,male,225,85,50,78,43,78,34,0,9
2050931,26,5,1987,3,male,453,87,31,79,21,79,18,0,3
1545759,103,30,1910,9,female,1628,87,58,78,24,78,22,0,2
1396693,20,5,1993,12,female,263,86,47,79,56,79,40,0,16
1113966,108,1,1905,1,female,513,86,54,81,162,0,110,81,52
1996166,43,16,1970,9,female,601,86,51,84,21,43,12,41,9
1844765,20,12,1993,9,male,801,86,60,83,3,83,3,0,0
1854712,43,3,1970,7,female,1179,87,18,87,39,0,12,87,27
1319263,31,21,1982,10,female,412,87,52,86,55,24,35,62,20
1573806,14,6,1999,11,male,310,86,42,86,0,83,0,3,0
1734320,29,4,1984,8,female,820,87,13,86,82,84,78,2,4
1939506,25,4,1988,11,male,296,85,25,86,152,84,84,2,68
1702584,17,8,1996,3,female,244,86,30,86,14,86,9,0,5
1062190,26,1,1987,1,male,450,85,75,85,8,85,8,0,0
1691814,22,28,1991,3,female,531,86,40,87,84,87,73,0,11
1564231,20,18,1993,4,female,76,86,79,89,45,0,9,89,36
1657110,29,17,1984,1,female,123,85,63,90,69,85,40,5,29
1585114,36,25,1977,1,female,814,86,39,91,107,66,51,25,56
2118463,64,9,1949,5,female,1337,86,40,88,7,88,1,0,6
1842863,63,15,1950,5,male,449,87,33,90,20,90,15,0,5
1072470,53,16,1960,3,male,475,87,42,88,125,88,78,0,47
1530732,30,20,1983,4,female,290,86,28,88,160,88,58,0,102
2089539,43,30,1970,6,female,157,87,51,93,16,0,5,93,11
1880462,33,16,1980,10,female,2026,85,34,94,117,41,65,53,52
1568839,61,22,1952,11,female,1832,85,41,93,80,39,53,54,27
1871566,27,9,1986,12,male,831,87,25,95,41,95,33,0,8
1763069,25,2,1988,5,male,95,86,65,93,88,93,49,0,39
1445748,38,19,1975,12,female,618,85,62,92,145,92,124,0,21
1119957,44,25,1969,5,female,217,85,67,99,135,11,32,88,103
1944852,66,21,1947,11,male,521,85,24,98,153,0,63,98,90
1090226,41,5,1972,3,male,666,87,63,99,21,43,13,56,8
1866108,39,15,1974,7,male,298,87,72,97,0,97,0,0,0
1094607,25,5,1988,3,male,269,85,63,98,24,98,14,0,10
1581383,25,6,1988,4,female,475,86,38,97,138,97,77,0,61
1485205,55,23,1958,5,female,1134,87,49,96,74,96,49,0,25
1455590,14,31,1999,3,female,580,87,38,108,10,14,3,94,7
1415195,16,31,1997,10,female,407,87,33,105,21,20,6,85,15
1428818,68,4,1945,10,female,776,87,16,108,98,7,28,101,70
2063340,52,29,1961,10,female,188,85,59,105,386,30,109,75,277
1740085,43,25,1970,4,male,461,87,68,107,129,107,97,0,32
1622718,57,26,1956,9,female,608,86,42,110,111,0,45,110,66
2177679,63,31,1950,12,female,1199,85,35,118,22,1,17,117,5
1145866,68,9,1945,2,female,1490,85,45,117,49,14,25,103,24
1250506,47,1,1966,5,female,1673,86,28,118,70,97,58,21,12
1920225,18,2,1995,1,female,341,86,46,115,15,115,12,0,3
2013284,33,25,1980,12,female,479,85,71,119,64,119,61,0,3
1409705,19,13,1994,7,female,308,85,60,115,70,115,18,0,52
1527879,39,23,1974,7,female,641,85,56,117,144,117,43,0,101
1948737,63,19,1950,8,female,595,85,61,116,122,116,61,0,61
1916111,59,19,1954,11,female,994,87,40,123,19,2,6,121,13
2167427,61,25,1952,2,male,697,87,65,122,161,0,69,122,92
1336026,50,29,1963,3,female,1293,86,44,121,24,87,9,34,15
2008339,38,28,1975,7,female,399,85,18,127,14,1,10,126,4
1298027,67,6,1946,4,male,1665,86,35,128,31,2,17,126,14
1402089,100,26,1913,3,male,677,85,24,128,31,79,12,49,19
2046449,20,5,1993,3,female,53,85,77,129,492,127,308,2,184
1507418,78,16,1935,11,female,1652,86,47,128,57,128,27,0,30
1458826,58,29,1955,9,female,717,86,43,125,134,125,93,0,41
1336361,30,26,1983,9,female,728,85,44,133,91,122,41,11,50
1547879,44,18,1969,8,male,442,85,2,134,0,134,0,0,0
1812758,24,2,1989,7,male,478,85,41,135,27,135,21,0,6
2038009,31,13,1982,9,female,144,87,52,134,46,134,40,0,6
1202623,43,23,1970,2,female,148,86,50,138,87,12,9,126,78
1176062,24,31,1989,7,female,668,85,62,137,137,95,58,42,79
1661187,31,9,1982,7,male,75,86,69,140,48,135,36,5,12
1029093,25,29,1988,11,female,569,85,64,137,188,107,101,30,87
1430791,44,15,1969,9,female,104,87,46,138,296,137,165,1,131
1673226,32,30,1981,1,female,978,86,27,142,60,142,41,0,19
1423953,26,2,1987,12,female,548,86,54,143,122,143,36,0,86
1213567,50,22,1963,1,female,144,86,52,140,110,140,82,0,28
1641779,59,25,1954,8,female,1808,86,35,147,59,114,43,33,16
2127762,28,19,1985,8,female,324,86,43,149,112,126,56,23,56
1667732,58,20,1955,5,female,1393,87,53,147,249,123,205,24,44
1724556,18,28,1995,8,male,68,85,74,147,31,147,27,0,4
1845631,28,11,1985,9,female,162,87,52,145,101,145,56,0,45
1332581,66,13,1947,5,female,1270,85,58,156,41,0,6,156,35
2092785,74,11,1939,10,male,1836,87,25,152,46,68,29,84,17
1942484,24,25,1989,4,female,253,86,65,151,83,113,50,38,33
1838128,32,20,1981,9,female,412,85,56,155,198,149,170,6,28
2167476,28,30,1985,11,female,404,86,60,163,95,111,13,52,82
1820157,23,5,1990,7,female,530,86,80,159,282,34,181,125,101
2029542,47,13,1966,12,male,708,85,43,159,451,49,371,110,80
1734093,50,24,1963,2,female,1514,87,22,159,209,141,108,18,101
1024306,54,18,1959,6,female,117,87,71,161,662,149,553,12,109
1483051,43,7,1970,4,female,530,85,27,164,74,164,14,0,60
1112269,25,17,1988,7,female,178,87,69,164,109,164,74,0,35
1145332,14,15,1999,1,male,329,87,73,172,0,0,0,172,0
1836966,108,28,1905,2,male,1046,87,42,171,28,0,6,171,22
1197323,21,2,1992,8,female,460,86,62,170,93,0,33,170,60
1064999,23,4,1990,11,female,342,86,68,165,115,25,21,140,94
1306550,53,5,1960,10,male,348,86,26,171,130,1,31,170,99
2009158,44,8,1969,12,female,374,86,40,170,90,57,55,113,35
1219897,23,1,1990,1,female,96,87,23,167,171,165,32,2,139
1904231,44,25,1969,2,female,835,85,48,172,121,152,90,20,31
2047113,108,30,1905,6,male,1011,85,51,168,219,152,113,16,106
1346710,24,25,1989,3,female,57,86,68,166,267,164,172,2,95
1672462,25,5,1988,1,female,111,86,69,166,33,166,24,0,9
1667286,32,11,1981,5,female,237,85,29,168,54,168,31,0,23
1566273,28,1,1985,2,female,537,85,20,171,171,171,73,0,98
1560968,47,12,1966,9,female,839,86,43,169,131,169,110,0,21
1669485,63,7,1950,8,male,279,87,71,179,21,0,0,179,21
1096408,29,1,1984,10,female,308,86,44,176,117,1,68,175,49
1993485,28,10,1985,10,male,301,86,53,173,79,46,53,127,26
2037504,46,24,1967,9,female,250,87,62,175,155,163,42,12,113
1817590,42,1,1971,1,male,117,85,59,176,217,176,64,0,153
1188241,69,12,1944,3,male,1901,85,29,184,92,0,57,184,35
2137280,52,16,1961,12,female,985,87,47,190,18,90,5,100,13
1852777,28,12,1985,11,male,407,85,62,182,10,176,4,6,6
1612730,25,5,1988,3,male,35,86,75,184,145,175,82,9,63
1837461,15,5,1998,2,female,285,87,50,185,321,140,289,45,32
1159632,54,25,1959,2,male,588,87,60,186,27,186,8,0,19
1894431,27,15,1986,10,female,568,85,57,196,67,171,54,25,13
1455632,42,17,1971,6,female,385,85,63,195,32,195,15,0,17
1719537,74,1,1939,2,female,1590,87,23,191,35,191,20,0,15
1815812,55,6,1958,9,female,2081,85,55,206,79,75,50,131,29
1390083,18,24,1995,2,female,276,85,41,202,169,135,92,67,77
1684746,49,8,1964,6,female,1954,87,60,210,137,102,56,108,81
1454602,25,1,1988,4,female,120,85,72,205,2,205,2,0,0
1689937,35,30,1978,10,female,57,86,69,202,388,202,279,0,109
2182135,42,5,1971,1,male,277,85,64,212,25,11,5,201,20
1056659,62,21,1951,9,male,1146,86,57,220,155,0,48,220,107
2028423,57,1,1956,5,male,254,85,67,219,114,199,78,20,36
1332079,28,23,1985,11,female,256,85,69,217,95,217,67,0,28
2099014,52,1,1961,1,female,353,87,47,218,58,218,13,0,45
2005522,29,10,1984,9,female,34,85,67,220,154,220,127,0,27
1497396,24,5,1989,3,male,661,85,53,227,13,44,3,183,10
1861057,17,13,1996,9,female,368,86,46,224,200,108,63,116,137
1708936,15,18,1998,10,female,396,86,73,227,350,75,157,152,193
1042774,26,11,1987,7,female,245,86,68,223,37,223,24,0,13
2003052,19,17,1994,4,male,366,86,50,228,132,228,61,0,71
1615509,31,23,1982,6,female,225,86,47,232,170,232,149,0,21
1061942,39,30,1974,9,male,550,85,39,232,300,232,267,0,33
1801759,17,21,1996,5,male,335,86,60,235,0,235,0,0,0
1645935,26,16,1987,3,female,411,85,52,239,13,239,10,0,3
2115585,71,16,1942,3,female,785,87,70,244,51,244,19,0,32
1354501,20,22,1993,9,male,376,87,68,257,101,191,50,66,51
1158618,14,19,1999,10,female,271,85,66,251,12,250,11,1,1
1044948,44,6,1969,6,female,369,85,49,254,21,254,19,0,2
1263528,35,26,1978,5,female,257,85,45,257,278,257,196,0,82
1546083,14,3,1999,10,male,141,85,26,266,19,158,7,108,12
1292632,53,28,1960,6,female,733,87,60,266,38,259,8,7,30
1873440,58,19,1955,5,female,1382,86,57,268,7,199,3,69,4
1190548,20,17,1993,1,male,407,86,63,268,467,212,52,56,415
1949292,16,24,1997,9,female,293,86,39,270,39,270,31,0,8
1445053,25,17,1988,3,female,1015,86,43,262,320,262,134,0,186
1439902,86,11,1927,1,female,1435,87,46,264,364,264,208,0,156
1631233,17,17,1996,2,male,252,86,58,275,638,275,490,0,148
1601689,23,31,1990,10,female,162,87,75,284,343,16,50,268,293
2087612,27,10,1986,8,female,174,85,46,278,85,278,57,0,28
1472325,41,16,1972,6,male,266,85,46,305,48,13,21,292,27
1852543,79,15,1934,10,female,1735,85,42,294,153,33,89,261,64
1657184,60,21,1953,5,female,1378,86,45,299,351,1,54,298,297
1349108,17,10,1996,2,male,322,87,67,302,9,244,9,58,0
1311966,65,24,1948,11,female,1562,85,55,302,130,292,27,10,103
2010201,45,27,1968,6,male,771,85,35,294,218,265,79,29,139
1192981,30,23,1983,1,male,214,85,55,303,151,302,71,1,80
1967756,38,21,1975,2,female,578,87,30,298,224,298,207,0,17
1075689,46,14,1967,2,male,572,86,76,309,85,26,5,283,80
1460069,28,3,1985,2,male,330,85,49,325,219,95,50,230,169
1175291,41,15,1972,1,male,483,86,42,319,120,278,60,41,60
1590442,18,30,1995,10,female,121,86,39,309,25,309,22,0,3
1268249,27,10,1986,1,female,591,85,64,327,0,327,0,0,0
1137961,56,12,1957,8,female,199,87,70,319,262,319,244,0,18
1999405,19,21,1994,5,female,402,86,31,329,265,11,91,318,174
2072985,91,21,1922,1,female,444,85,68,332,37,332,30,0,7
1825780,53,24,1960,1,female,328,86,61,329,135,329,40,0,95
1253856,53,19,1960,6,female,71,87,83,333,71,333,53,0,18
1937636,33,30,1980,12,female,423,86,34,341,494,341,474,0,20
1352733,45,25,1968,12,male,417,85,74,360,37,0,6,360,31
1765004,52,22,1961,1,female,436,87,69,353,200,0,32,353,168
1721914,66,14,1947,8,male,1778,86,7,366,86,0,16,366,70
1213564,67,13,1946,10,female,663,87,67,360,267,0,113,360,154
1310809,32,18,1981,10,female,293,86,69,355,73,322,45,33,28
1693285,58,21,1955,10,female,802,86,54,356,381,355,230,1,151
1701905,60,23,1953,7,female,124,86,70,358,47,358,29,0,18
1454669,50,18,1963,8,female,458,86,19,392,149,0,61,392,88
1925508,48,7,1965,5,female,1371,86,38,391,132,200,78,191,54
1853797,18,8,1995,3,female,217,86,37,392,140,385,104,7,36
1987222,38,9,1975,6,female,1157,87,49,371,275,289,179,82,96
1158323,33,20,1980,11,female,813,87,35,379,58,377,26,2,32
1264134,23,4,1990,2,female,281,85,47,376,175,376,168,0,7
2101894,45,2,1968,4,female,276,86,41,413,384,403,249,10,135
1398783,72,8,1941,1,male,1679,85,67,400,250,320,46,80,204
2085766,54,4,1959,2,female,328,86,44,407,4,407,2,0,2
2176922,75,7,1938,5,female,166,86,81,438,12,0,6,438,6
2042673,102,9,1911,1,female,413,86,24,441,397,56,154,385,243
1177708,28,10,1985,6,female,136,86,68,429,167,100,93,329,74
1018143,48,8,1965,11,female,586,87,45,434,289,330,233,104,56
1636882,16,22,1997,3,male,129,86,61,444,45,444,37,0,8
1098567,32,11,1981,5,male,721,87,64,449,17,449,13,0,4
1376014,27,20,1986,6,male,112,85,45,441,168,441,146,0,22
1622621,21,16,1992,6,female,14,85,73,513,182,0,86,513,96
1593635,62,30,1951,11,female,229,85,78,516,217,0,71,516,146
1841729,74,8,1939,11,male,683,87,22,509,810,3,205,506,605
1270918,15,24,1998,4,male,165,85,50,488,225,483,145,5,80
1748993,34,20,1979,4,male,93,87,83,494,67,494,50,0,17
2122893,57,21,1956,12,female,1049,86,52,532,64,532,40,0,24
1367829,63,28,1950,4,female,1297,87,41,574,214,146,75,428,139
2043403,15,7,1998,1,female,103,87,79,566,12,560,11,6,1
1770246,61,28,1952,11,female,1243,86,49,609,149,609,80,0,69
1920611,58,18,1955,2,female,436,87,49,618,203,0,27,618,176
1096023,32,15,1981,9,female,386,87,75,618,1007,462,518,156,489
1329236,47,25,1966,6,female,267,85,72,663,50,663,31,0,19
2161579,65,20,1948,10,female,938,86,54,704,119,0,25,704,94
1640530,58,25,1955,2,female,1387,86,57,720,500,4,13,716,487
1830832,20,15,1993,1,female,213,85,58,664,408,502,176,162,232
1455759,45,26,1968,3,female,595,87,45,691,113,691,106,0,7
1270589,65,23,1948,6,female,885,85,53,777,230,8,68,769,162
1373403,39,9,1974,12,male,49,86,76,742,289,493,133,249,156
2145492,22,14,1991,3,male,191,87,64,774,459,774,418,0,41
2146600,61,11,1952,6,female,27,87,25,748,368,748,150,0,218
1162529,42,26,1971,10,female,254,87,39,806,316,233,78,573,238
2080038,20,17,1993,5,male,290,85,63,834,574,808,415,26,159
2096210,32,27,1981,5,female,227,87,50,838,759,838,677,0,82
1452758,35,12,1978,7,female,410,85,42,1109,183,749,124,360,59
2112472,57,20,1956,3,female,59,85,77,991,48,551,29,440,19
2175959,63,12,1950,10,female,822,85,62,992,27,969,15,23,12
1777781,51,10,1962,6,female,136,87,52,1033,593,756,233,277,360
1786383,50,8,1963,8,male,683,87,50,1050,461,1050,262,0,199
2105307,60,2,1953,12,male,648,85,58,1092,347,1092,180,0,167
1902606,19,15,1994,2,female,106,87,26,1101,714,1101,442,0,272
1749136,40,28,1973,6,female,387,85,32,1208,543,1208,403,0,140
1685522,63,25,1950,6,female,175,85,73,1379,85,1379,65,0,20
1921702,45,4,1968,8,female,216,87,51,1532,164,1532,116,0,48
2045111,100,9,1913,11,female,1445,86,42,1785,193,1785,123,0,70
1041757,68,14,1945,11,female,123,87,17,2000,226,0,97,2000,129
1941578,28,1,1985,6,male,439,87,54,1886,794,1886,476,0,318
1624310,27,5,1986,3,female,96,85,26,2587,1342,2587,1014,0,328
1484563,18,3,1995,9,female,99,87,57,8593,5674,719,1144,7874,4530
1211199,48,13,1965,6,male,106,85,23,5856,1279,5856,825,0,454
1931162,39,25,1974,12,male,196,88,59,3,10,3,9,0,1
1770301,43,4,1970,6,male,245,89,73,3,20,3,19,0,1
1241820,47,3,1966,6,female,103,89,72,3,17,3,12,0,5
1666102,63,2,1950,12,female,2271,89,44,3,12,3,10,0,2
2120654,65,7,1948,3,male,242,90,61,3,23,3,14,0,9
1215579,91,28,1922,8,female,159,90,54,3,9,3,9,0,0
1325815,23,12,1990,12,male,519,88,50,4,3,0,1,4,2
1237317,54,19,1959,2,female,1174,89,44,4,56,0,14,4,42
1440331,55,9,1958,8,female,1003,88,58,4,17,0,8,4,9
1272863,57,10,1956,11,male,524,90,35,4,33,0,9,4,24
1974687,55,9,1958,1,female,699,88,16,4,2,1,1,3,1
2079110,69,19,1944,7,male,1512,90,59,4,7,2,3,2,4
1727138,30,7,1983,9,male,381,89,33,4,0,3,0,1,0
2164128,19,25,1994,8,male,432,89,60,4,2,3,2,1,0
1999047,19,8,1994,7,male,225,88,45,4,7,3,6,1,1
1068013,22,24,1991,6,male,212,89,73,4,0,4,0,0,0
1510608,23,1,1990,1,male,548,88,43,4,0,4,0,0,0
2035265,24,20,1989,4,male,467,90,69,4,0,4,0,0,0
1248177,25,13,1988,3,male,276,90,56,4,0,4,0,0,0
1680918,52,6,1961,8,male,584,88,66,4,0,4,0,0,0
1438038,19,18,1994,6,female,340,89,62,4,2,4,2,0,0
1958068,29,23,1984,7,female,552,89,29,4,1,4,0,0,1
1748768,32,18,1981,8,male,52,89,72,4,1,4,0,0,1
1631023,103,13,1910,8,male,1040,88,55,4,1,4,1,0,0
1539046,14,20,1999,8,female,356,89,83,4,3,4,2,0,1
1631353,16,6,1997,4,male,335,90,46,4,3,4,2,0,1
1478942,23,8,1990,8,male,174,90,65,4,4,4,4,0,0
1953998,26,25,1987,7,male,485,88,46,4,5,4,4,0,1
2031978,48,16,1965,1,female,1456,90,47,4,3,4,3,0,0
1624050,19,15,1994,8,male,189,90,74,4,26,4,25,0,1
1179451,22,29,1991,4,male,137,90,80,4,9,4,7,0,2
1465413,24,4,1989,10,female,416,89,80,4,35,4,29,0,6
1215482,29,15,1984,12,male,256,90,58,4,25,4,20,0,5
1871527,28,24,1985,8,male,187,90,54,4,13,4,10,0,3
1490857,29,4,1984,3,male,173,90,63,4,75,4,29,0,46
1616529,34,18,1979,2,male,342,88,75,4,8,4,3,0,5
1827702,34,3,1979,3,male,473,90,43,4,7,4,6,0,1
1334658,49,21,1964,9,female,206,88,59,4,19,4,16,0,3
2001834,52,7,1961,11,male,1063,88,80,4,8,4,8,0,0
1097338,57,15,1956,7,male,338,88,52,4,8,4,5,0,3
1690484,61,5,1952,5,female,963,88,47,4,46,4,31,0,15
1525283,108,5,1905,9,female,376,90,68,4,6,4,4,0,2
1591356,15,4,1998,10,male,490,90,46,5,3,0,2,5,1
1800887,24,11,1989,10,male,522,88,58,5,1,0,1,5,0
1382492,43,28,1970,8,male,215,88,55,5,3,0,0,5,3
1484547,103,6,1910,11,male,620,88,56,5,0,1,0,4,0
1278288,22,21,1991,9,male,588,90,22,5,2,1,1,4,1
1316323,26,15,1987,6,female,568,88,70,5,19,3,11,2,8
1457633,58,29,1955,7,female,589,90,69,5,6,4,4,1,2
1033966,18,5,1995,4,male,148,88,76,5,0,5,0,0,0
1447897,19,12,1994,3,male,9,88,84,5,0,5,0,0,0
1952928,19,3,1994,8,male,329,89,45,5,0,5,0,0,0
1936122,22,26,1991,9,male,346,88,53,5,0,5,0,0,0
1613288,28,5,1985,7,female,468,90,34,5,0,5,0,0,0
1253634,18,17,1995,2,female,380,90,68,5,3,5,2,0,1
1442528,31,27,1982,12,male,214,88,78,5,1,5,1,0,0
1810625,30,1,1983,1,male,430,90,89,5,1,5,1,0,0
2065326,47,29,1966,6,male,841,89,37,5,1,5,0,0,1
1836163,16,11,1997,9,male,240,90,73,5,4,5,4,0,0
1664550,28,3,1985,11,female,209,90,76,5,5,5,3,0,2
1511333,27,1,1986,2,male,123,89,58,5,4,5,4,0,0
1804193,33,8,1980,7,female,193,89,59,5,6,5,0,0,6
1851227,45,18,1968,2,female,382,89,61,5,4,5,4,0,0
1882214,21,4,1992,5,female,244,90,66,5,8,5,3,0,5
1296655,25,30,1988,9,female,225,89,40,5,12,5,12,0,0
1490763,28,15,1985,10,male,432,88,42,5,8,5,8,0,0
1212240,40,5,1973,7,male,488,90,41,5,19,5,19,0,0
1296189,53,27,1960,9,male,1587,90,33,5,36,5,27,0,9
1595926,56,5,1957,2,male,259,90,47,5,31,5,11,0,20
1770165,67,14,1946,3,female,1190,89,22,5,10,5,6,0,4
1350033,24,2,1989,3,male,631,89,52,6,0,1,0,5,0
1141354,19,20,1994,11,female,274,88,58,6,3,1,3,5,0
1933910,23,28,1990,10,female,650,88,14,6,155,1,129,5,26
1385029,27,18,1986,10,male,443,90,69,6,19,0,4,6,15
1548960,30,17,1983,1,female,678,89,78,6,5,4,1,2,4
2191933,21,30,1992,12,male,259,88,72,6,1,5,1,1,0
1064955,14,15,1999,2,male,296,90,28,6,0,6,0,0,0
1765842,15,1,1998,6,male,296,89,25,6,0,6,0,0,0
1879954,13,1,2000,1,male,69,90,73,6,2,6,2,0,0
1000756,14,4,1999,5,female,390,90,42,6,2,6,2,0,0
1390264,21,1,1992,7,male,108,88,83,6,3,6,1,0,2
1568790,28,11,1985,11,male,392,89,55,6,2,6,2,0,0
1962749,33,5,1980,9,male,17,90,89,6,3,6,3,0,0
2125068,15,1,1998,7,male,187,88,70,6,7,6,7,0,0
1988173,43,1,1970,1,female,411,90,83,6,8,6,8,0,0
1948410,18,17,1995,3,male,382,89,77,6,15,6,13,0,2
1788878,21,6,1992,5,male,197,90,74,6,39,6,34,0,5
1866250,22,19,1991,1,male,166,89,53,6,12,6,9,0,3
1722593,24,4,1989,3,male,751,90,22,6,14,6,14,0,0
2064402,32,19,1981,11,male,251,90,14,6,28,6,20,0,8
1851076,33,9,1980,2,male,409,88,81,6,46,6,29,0,17
1819975,77,30,1936,4,female,1759,88,25,6,43,6,32,0,11
2164629,30,1,1983,10,male,366,90,40,7,0,0,0,7,0
1603831,51,9,1962,8,male,487,88,33,7,1,0,0,7,1
2056543,42,12,1971,1,male,78,90,45,7,2,0,0,7,2
1573547,97,16,1916,1,male,1553,89,62,7,4,0,2,7,2
2163950,52,29,1961,8,male,281,88,59,7,9,0,0,7,9
1034073,28,20,1985,2,male,347,90,64,7,34,0,14,7,20
1844078,32,29,1981,11,male,615,90,80,7,49,0,21,7,28
1923605,56,8,1957,12,female,1930,88,52,7,68,0,19,7,49
1245328,61,6,1952,1,female,1115,90,22,7,35,1,10,6,25
1281977,76,20,1937,8,female,1448,88,43,7,20,0,15,7,5
1975979,16,5,1997,4,female,322,88,55,7,0,7,0,0,0
2075662,21,20,1992,4,male,390,89,9,7,0,7,0,0,0
1829897,24,20,1989,12,male,467,88,80,7,0,7,0,0,0
1773634,27,24,1986,9,male,1057,88,70,7,1,7,1,0,0
1470794,33,11,1980,2,female,560,88,42,7,4,7,2,0,2
1765158,61,28,1952,8,female,1276,90,29,7,3,7,1,0,2
1731180,24,22,1989,1,male,230,89,74,7,7,7,7,0,0
1596221,25,20,1988,3,male,364,90,57,7,17,7,15,0,2
1726625,27,1,1986,11,male,113,90,67,7,319,7,145,0,174
1327412,38,8,1975,12,male,494,89,77,7,12,7,2,0,10
1583435,53,24,1960,7,male,234,90,76,7,22,7,15,0,7
1080651,20,2,1993,2,male,110,90,47,8,2,0,0,8,2
1843928,50,18,1963,5,female,190,88,66,8,9,0,6,8,3
1244996,61,4,1952,8,female,457,89,71,8,5,0,0,8,5
1329349,25,11,1988,12,male,225,90,48,8,17,0,4,8,13
1224436,54,2,1959,3,female,165,89,59,8,17,0,3,8,14
1502681,63,17,1950,10,female,402,89,62,8,24,0,17,8,7
1260994,15,8,1998,1,male,580,88,37,8,40,3,19,5,21
2087992,24,27,1989,4,male,427,90,69,8,5,7,1,1,4
1954534,22,1,1991,10,male,217,89,71,8,0,8,0,0,0
1484328,42,10,1971,1,female,567,88,48,8,1,8,0,0,1
1926020,54,14,1959,7,female,371,88,73,8,0,8,0,0,0
1361027,22,7,1991,11,male,129,90,72,8,5,8,3,0,2
1436744,40,29,1973,9,male,359,90,77,8,11,8,9,0,2
1506230,18,14,1995,1,male,45,90,71,8,22,8,14,0,8
2107948,43,10,1970,2,male,355,88,43,8,27,8,20,0,7
1432478,106,8,1907,3,male,98,90,74,8,26,8,22,0,4
1883358,23,13,1990,3,female,477,90,53,9,1,0,0,9,1
2016422,36,4,1977,8,male,1275,88,62,9,3,0,2,9,1
1482156,23,2,1990,2,male,406,88,74,9,9,0,2,9,7
1519009,52,14,1961,3,male,214,89,48,9,10,0,4,9,6
1397003,14,27,1999,11,male,243,89,16,9,14,1,3,8,11
1206006,28,1,1985,1,male,120,88,46,9,48,1,14,8,34
1961680,36,13,1977,7,female,142,90,51,9,66,0,3,9,63
1911141,32,13,1981,5,male,650,90,33,9,0,2,0,7,0
1937721,16,31,1997,10,male,281,90,29,9,1,9,1,0,0
1633998,19,24,1994,5,male,1252,90,36,9,0,9,0,0,0
1088566,27,13,1986,7,male,683,89,29,9,0,9,0,0,0
1501702,14,2,1999,10,male,106,89,63,9,5,9,5,0,0
2145546,24,1,1989,2,male,106,88,78,9,2,9,1,0,1
1051437,108,5,1905,1,female,692,89,33,9,3,9,3,0,0
2093221,16,27,1997,12,male,144,90,78,9,9,9,7,0,2
1709871,24,1,1989,1,male,990,89,35,9,16,9,13,0,3
1622116,24,5,1989,8,male,222,89,50,9,83,9,42,0,41
1486222,26,11,1987,5,female,288,88,75,9,36,9,20,0,16
1097716,33,12,1980,12,male,1297,89,81,9,35,9,34,0,1
1412801,21,14,1992,6,male,210,89,72,10,3,1,3,9,0
2121410,46,15,1967,10,male,536,88,42,10,19,0,4,10,15
1025347,112,1,1901,1,male,1251,89,68,10,39,7,22,3,17
1686752,40,21,1973,4,female,457,90,60,10,42,9,36,1,6
1521256,37,6,1976,10,female,366,89,69,10,4,10,4,0,0
2167930,48,18,1965,12,male,53,88,51,10,3,10,3,0,0
1318655,43,19,1970,10,male,783,89,35,10,12,10,12,0,0
1158234,55,9,1958,12,male,657,89,78,10,8,10,4,0,4
1496327,108,29,1905,3,male,162,88,79,10,8,10,7,0,1
1288803,20,14,1993,2,male,92,88,51,10,15,10,7,0,8
2081420,21,11,1992,10,male,429,90,24,11,21,0,15,11,6
2192606,38,13,1975,5,male,281,89,44,11,102,0,18,11,84
1854617,30,23,1983,8,male,1947,89,55,11,2,7,0,4,2
1969213,61,22,1952,3,female,1368,89,31,11,50,5,34,6,16
1561018,66,22,1947,7,male,1487,88,42,11,137,7,97,4,40
1010909,15,1,1998,9,female,152,89,51,11,0,11,0,0,0
2105505,20,7,1993,1,male,909,89,56,11,1,11,1,0,0
1321776,19,19,1994,12,male,394,90,56,11,9,11,7,0,2
2042663,40,15,1973,3,female,540,88,60,11,7,11,0,0,7
1597127,37,27,1976,11,female,647,89,62,11,306,11,256,0,50
1822696,38,22,1975,10,female,132,88,72,11,26,11,4,0,22
1976028,26,1,1987,2,male,212,88,83,12,0,0,0,12,0
2045750,32,20,1981,9,male,213,88,53,12,7,5,2,7,5
1951062,17,22,1996,4,female,521,89,38,12,16,9,5,3,11
2069370,25,2,1988,10,female,345,89,72,12,17,9,5,3,12
1111018,29,2,1984,6,male,631,90,44,12,15,11,10,1,5
2138297,16,7,1997,8,male,529,89,60,12,1,12,1,0,0
1569880,43,7,1970,5,male,581,88,43,12,1,12,1,0,0
1433592,34,31,1979,3,male,230,90,49,12,12,12,9,0,3
1670268,18,12,1995,6,male,130,90,48,12,39,12,23,0,16
1301291,26,11,1987,5,female,22,88,85,12,28,12,25,0,3
1500368,27,31,1986,7,female,352,89,60,12,20,12,14,0,6
1105462,30,26,1983,1,male,354,88,46,12,53,12,42,0,11
1820477,53,14,1960,5,male,443,88,27,12,30,12,13,0,17
1370995,21,17,1992,12,male,341,89,59,13,11,0,2,13,9
1949814,18,30,1995,5,female,159,90,51,13,50,7,18,6,32
1007597,76,30,1937,4,male,1514,89,36,13,5,12,4,1,1
2085193,38,28,1975,6,female,419,88,67,13,79,11,22,2,57
2037748,13,14,2000,1,male,299,88,62,13,11,13,8,0,3
1084377,29,5,1984,2,male,292,89,79,13,11,13,11,0,0
1715065,55,24,1958,7,female,25,90,61,13,10,13,7,0,3
1789060,24,18,1989,8,male,321,88,32,13,28,13,16,0,12
1408544,15,19,1998,2,male,424,88,53,14,1,0,0,14,1
1324989,30,29,1983,9,male,1094,90,67,14,0,0,0,14,0
1351406,30,25,1983,4,female,513,88,47,14,20,0,12,14,8
1365262,19,12,1994,12,male,623,89,56,14,7,4,4,10,3
1370341,27,26,1986,12,male,559,89,80,14,9,4,4,10,5
1262196,26,10,1987,12,male,97,90,87,14,2,14,1,0,1
1731460,40,4,1973,3,female,367,88,49,14,0,14,0,0,0
2005387,49,16,1964,5,male,533,88,52,14,0,14,0,0,0
1819386,24,25,1989,1,male,461,89,39,14,20,14,18,0,2
1337599,19,5,1994,3,female,18,90,85,14,34,14,8,0,26
1673870,20,13,1993,1,male,304,89,79,15,3,0,1,15,2
1987557,45,4,1968,5,male,376,89,27,15,3,0,2,15,1
1192725,13,21,2000,1,male,100,89,40,15,1,13,1,2,0
1408548,23,10,1990,1,female,635,88,29,15,16,11,8,4,8
1353926,37,1,1976,7,male,164,88,46,15,26,13,16,2,10
1393929,15,23,1998,4,male,286,88,78,15,0,15,0,0,0
1114427,33,28,1980,3,male,608,89,57,15,0,15,0,0,0
1691206,20,12,1993,11,female,72,90,85,15,19,15,14,0,5
1268329,19,24,1994,12,male,338,90,34,15,35,15,33,0,2
1563762,34,5,1979,12,female,556,89,50,15,26,15,19,0,7
1385895,33,1,1980,1,male,47,88,79,15,62,15,29,0,33
2040086,38,23,1975,4,male,432,89,25,15,88,15,38,0,50
1974329,26,20,1987,12,female,244,90,41,16,46,0,33,16,13
2096976,23,11,1990,6,female,380,88,50,16,4,6,2,10,2
2151720,58,11,1955,7,female,631,89,53,16,59,14,39,2,20
1596515,30,22,1983,6,male,567,89,62,16,6,16,3,0,3
1948038,23,11,1990,3,male,325,90,56,16,15,16,8,0,7
2149594,26,20,1987,2,male,259,89,20,16,13,16,12,0,1
1365449,108,7,1905,5,male,1385,90,49,16,14,16,1,0,13
1984530,47,14,1966,7,female,94,89,56,16,41,16,26,0,15
1460997,108,22,1905,5,female,1324,89,23,16,35,16,19,0,16
1046204,67,17,1946,6,female,443,89,65,17,14,1,10,16,4
1010558,43,24,1970,1,male,31,88,69,17,37,16,4,1,33
1802714,17,26,1996,2,female,391,90,58,17,1,17,1,0,0
1246482,24,25,1989,10,male,558,88,43,17,3,17,0,0,3
1007479,45,24,1968,8,male,779,90,36,17,10,17,8,0,2
1419436,22,21,1991,1,female,542,90,56,17,14,17,13,0,1
1034737,48,26,1965,11,female,203,88,17,17,52,17,25,0,27
1490555,67,4,1946,11,female,817,88,19,17,40,17,19,0,21
2021642,15,4,1998,9,female,296,88,51,18,19,3,5,15,14
1723798,32,30,1981,9,female,273,88,43,18,12,2,8,16,4
2002054,65,2,1948,10,female,1608,89,57,18,15,0,1,18,14
1192310,18,19,1995,12,male,569,88,33,18,11,6,4,12,7
2023171,31,4,1982,4,male,475,88,82,18,22,11,19,7,3
1548223,22,26,1991,8,male,873,88,28,18,5,18,4,0,1
1759372,32,11,1981,11,female,203,88,51,18,10,18,10,0,0
1394482,33,28,1980,2,male,243,89,73,18,3,18,2,0,1
1346878,18,13,1995,12,male,229,88,54,19,2,0,0,19,2
1154687,51,19,1962,1,female,473,89,65,19,0,1,0,18,0
1440980,51,21,1962,4,female,321,88,73,19,55,0,29,19,26
1036439,22,9,1991,9,female,413,88,41,19,0,12,0,7,0
1630603,56,22,1957,10,female,309,90,40,19,147,7,36,12,111
1204537,20,28,1993,2,male,70,90,85,19,3,18,1,1,2
1270186,18,19,1995,2,male,223,89,69,19,6,19,2,0,4
1597112,30,10,1983,2,male,1200,90,46,19,6,19,4,0,2
1299392,22,4,1991,9,male,37,88,64,19,18,19,14,0,4
1825140,64,20,1949,4,female,2163,90,48,20,0,0,0,20,0
1407831,33,10,1980,12,female,370,90,69,20,124,0,41,20,83
1262038,30,26,1983,4,female,274,89,80,20,2,20,2,0,0
2065285,18,27,1995,2,female,56,88,40,20,15,20,7,0,8
1116393,18,14,1995,6,female,603,90,29,20,23,20,19,0,4
1765204,21,3,1992,12,male,225,89,65,20,36,20,30,0,6
1374046,20,28,1993,2,female,63,89,65,20,85,20,72,0,13
1869857,29,23,1984,1,male,526,90,21,20,86,20,76,0,10
1547467,39,12,1974,8,female,430,88,69,21,1,0,0,21,1
1575027,101,1,1912,6,male,1169,89,77,21,1,0,0,21,1
1887376,33,22,1980,12,male,232,90,83,21,0,6,0,15,0
1039248,49,1,1964,12,female,189,88,57,21,88,21,64,0,24
2068837,49,11,1964,4,male,735,88,76,22,16,2,11,20,5
1036120,49,21,1964,5,female,379,90,42,22,5,17,5,5,0
2140742,30,28,1983,11,male,831,89,56,22,1,22,1,0,0
1475002,38,14,1975,3,female,150,90,41,22,3,22,2,0,1
1053688,59,5,1954,2,female,1299,90,48,22,2,22,1,0,1
1464271,23,30,1990,3,male,124,89,55,22,6,22,4,0,2
1761964,33,5,1980,5,male,189,89,70,22,12,22,8,0,4
1348608,53,19,1960,9,female,85,88,82,22,8,22,8,0,0
1595058,53,24,1960,9,male,661,90,48,22,22,22,13,0,9
1455676,59,7,1954,10,male,824,89,54,23,26,0,1,23,25
1534457,23,17,1990,8,male,154,90,67,23,24,21,9,2,15
1673941,20,24,1993,2,male,99,89,72,23,15,23,13,0,2
1458272,39,12,1974,11,male,196,89,76,23,50,23,36,0,14
1397877,61,24,1952,12,female,1349,89,30,24,10,1,1,23,9
1875217,21,30,1992,5,female,317,88,55,24,20,0,4,24,16
1733001,113,12,1900,7,male,1232,90,40,24,85,0,17,24,68
1014816,14,26,1999,8,male,209,89,70,24,1,24,1,0,0
2133238,22,6,1991,1,male,418,88,50,24,0,24,0,0,0
1794783,23,13,1990,11,male,535,90,10,24,34,24,25,0,9
1731380,30,2,1983,2,female,163,88,67,24,28,24,28,0,0
1439643,21,8,1992,4,female,451,88,14,24,36,24,33,0,3
2139745,53,13,1960,5,male,424,89,55,25,13,0,6,25,7
1359800,43,16,1970,9,male,282,88,6,25,69,0,19,25,50
1545445,18,19,1995,4,male,66,89,73,25,5,25,1,0,4
1940240,36,30,1977,5,male,271,88,73,25,7,25,7,0,0
1307344,31,12,1982,10,female,283,88,49,25,16,25,7,0,9
2013528,41,1,1972,8,male,598,90,61,25,49,25,29,0,20
1508438,47,28,1966,7,male,558,88,62,26,4,26,3,0,1
2138847,44,9,1969,7,male,164,89,45,26,193,26,131,0,62
1938724,20,25,1993,10,male,342,89,61,27,7,26,7,1,0
1516152,20,11,1993,8,female,692,89,28,27,18,27,18,0,0
1263219,35,28,1978,3,male,1332,88,68,27,42,27,23,0,19
2153132,21,27,1992,8,male,425,88,17,28,5,17,2,11,3
1120894,48,24,1965,1,male,825,88,44,28,13,11,2,17,11
1376343,17,28,1996,12,male,602,90,68,28,4,28,3,0,1
1399190,35,23,1978,7,female,124,88,62,28,16,28,15,0,1
1170480,37,24,1976,10,male,556,89,52,29,2,0,0,29,2
1409936,31,18,1982,8,female,372,89,65,29,33,0,3,29,30
1197717,21,23,1992,5,female,88,89,25,29,86,11,38,18,48
1525937,33,19,1980,7,female,340,89,28,29,9,29,9,0,0
1945719,54,12,1959,11,female,747,88,48,29,6,29,2,0,4
1085443,24,28,1989,7,female,162,90,61,29,49,29,24,0,25
1089129,28,6,1985,2,male,854,88,57,29,61,29,54,0,7
2099540,16,12,1997,11,male,383,89,47,31,4,3,4,28,0
1118551,108,16,1905,3,male,79,88,73,30,0,0,0,30,0
2011321,78,2,1935,7,male,101,90,56,30,61,1,16,29,45
1046827,70,19,1943,9,female,654,88,54,30,17,18,3,12,14
1169953,62,14,1951,7,male,43,89,79,30,16,28,6,2,10
1057596,19,3,1994,1,female,576,88,57,31,16,31,11,0,5
1522344,33,8,1980,7,male,309,88,57,31,15,31,14,0,1
1909931,43,6,1970,10,male,408,89,56,31,10,31,9,0,1
1810545,100,8,1913,10,male,1591,89,23,30,21,30,16,0,5
1404597,48,25,1965,7,female,984,90,51,31,161,31,103,0,58
1916688,65,24,1948,6,male,1857,89,21,31,57,31,35,0,22
2033920,26,18,1987,8,male,429,90,50,32,53,0,44,32,9
1589961,47,1,1966,11,female,602,90,78,32,50,0,29,32,21
1132062,22,14,1991,8,male,506,89,66,32,1,32,1,0,0
2148975,77,23,1936,1,female,1443,89,40,32,0,32,0,0,0
1221194,53,14,1960,5,male,168,90,56,32,6,32,6,0,0
2073821,46,20,1967,12,female,1300,90,49,32,31,32,31,0,0
1448980,22,16,1991,4,female,464,89,50,33,109,15,51,18,58
1841139,53,1,1960,6,female,1616,88,41,33,98,31,75,2,23
1317400,54,16,1959,6,female,615,88,45,33,0,33,0,0,0
2050703,32,23,1981,12,female,396,89,67,33,28,33,24,0,4
1853057,33,5,1980,5,male,165,88,7,33,42,33,35,0,7
2003822,53,10,1960,12,female,308,89,63,34,16,0,8,34,8
1585228,57,10,1956,7,male,921,89,63,34,74,6,53,28,21
1890383,108,4,1905,4,male,48,88,69,34,6,30,1,4,5
1019799,15,16,1998,8,male,84,89,69,34,3,34,1,0,2
1307252,27,26,1986,5,female,465,89,41,34,9,34,9,0,0
1812604,16,3,1997,2,male,225,89,48,35,0,3,0,32,0
1009215,38,9,1975,10,female,450,88,44,35,7,0,0,35,7
1098799,51,21,1962,3,male,1080,89,38,35,31,6,14,29,17
1911581,38,28,1975,7,male,489,89,46,36,5,14,3,22,2
1574043,108,1,1905,10,male,157,89,62,36,0,9,0,27,0
1811955,24,30,1989,6,female,671,90,20,35,2,35,2,0,0
1648077,33,4,1980,9,male,388,89,80,35,9,35,6,0,3
1302419,39,24,1974,6,male,680,88,72,35,21,35,7,0,14
1546906,21,2,1992,4,male,774,89,32,36,26,36,25,0,1
1392988,61,26,1952,6,female,1697,88,34,35,150,35,121,0,29
1462026,61,24,1952,2,male,661,90,44,37,2,0,0,37,2
1574899,66,8,1947,2,male,832,88,42,37,9,21,6,16,3
2021435,28,15,1985,1,female,367,90,29,37,14,32,7,5,7
2108442,45,28,1968,8,female,515,88,63,37,124,28,93,9,31
1587356,27,12,1986,5,female,412,88,44,37,2,37,0,0,2
1953909,28,10,1985,3,male,576,88,47,37,0,37,0,0,0
1429654,57,8,1956,11,female,339,90,30,38,69,0,16,38,53
1958994,29,22,1984,6,male,604,90,66,38,1,33,1,5,0
1884901,31,29,1982,10,male,728,88,43,39,3,37,1,2,2
1261108,98,6,1915,4,female,264,90,44,38,52,35,6,3,46
1984360,27,12,1986,3,male,200,89,46,39,0,39,0,0,0
1605950,29,27,1984,4,male,384,90,68,39,1,39,1,0,0
1591282,45,10,1968,1,female,194,90,41,38,6,38,3,0,3
1233838,18,25,1995,7,female,79,90,86,38,9,38,9,0,0
2010912,25,23,1988,9,female,166,89,39,38,10,38,9,0,1
1333208,13,15,2000,1,female,123,89,48,40,1,0,0,40,1
1754204,30,23,1983,1,female,438,89,44,40,30,28,14,12,16
1960666,41,10,1972,12,female,629,89,50,40,74,8,28,32,46
1129609,22,5,1991,6,male,107,90,64,42,23,6,17,36,6
1084620,21,15,1992,2,female,285,88,39,42,55,4,14,38,41
1983520,25,13,1988,1,male,129,89,85,41,4,41,4,0,0
1505133,32,3,1981,10,male,368,89,49,41,2,41,1,0,1
1851289,42,8,1971,6,male,413,90,81,41,14,41,13,0,1
1802485,44,29,1969,11,male,550,90,27,42,23,42,20,0,3
1645378,21,21,1992,1,female,413,90,45,41,91,41,67,0,24
1445077,21,8,1992,6,male,388,89,65,43,14,2,11,41,3
1296628,74,22,1939,6,male,1753,89,86,43,64,4,42,39,22
1020890,19,17,1994,7,male,421,90,52,44,52,29,23,15,29
2112049,37,3,1976,2,male,911,88,30,43,1,41,1,2,0
1182914,22,7,1991,1,male,263,90,55,43,6,43,2,0,4
1976917,71,18,1942,12,male,1656,89,60,44,7,44,5,0,2
2000396,21,13,1992,5,male,555,89,61,44,11,44,3,0,8
1952273,49,14,1964,6,male,174,88,64,44,25,44,11,0,14
1645186,53,1,1960,4,female,602,90,17,45,18,0,6,45,12
1117048,16,13,1997,2,male,81,89,66,45,67,45,60,0,7
1602405,22,31,1991,3,female,743,88,42,45,43,45,38,0,5
1024942,18,27,1995,7,male,109,90,33,46,16,4,6,42,10
1306145,51,1,1962,3,female,637,90,56,47,50,0,10,47,40
1309695,20,22,1993,7,male,459,90,34,46,142,0,122,46,20
1883867,51,29,1962,11,female,496,90,67,46,230,0,20,46,210
1122757,68,13,1945,5,female,734,90,36,46,144,9,42,37,102
1989235,19,2,1994,3,male,877,89,31,47,0,47,0,0,0
2084981,42,5,1971,1,female,914,90,62,47,9,47,6,0,3
2057606,42,14,1971,3,male,221,88,31,46,13,46,3,0,10
1365994,24,6,1989,10,female,194,90,73,46,33,46,27,0,6
1047159,27,11,1986,12,male,361,89,47,47,76,47,57,0,19
1580281,32,18,1981,7,female,553,88,57,46,74,46,72,0,2
1958300,108,17,1905,2,male,307,88,44,47,129,47,128,0,1
1020095,58,15,1955,3,male,227,88,66,49,1,0,1,49,0
1997811,15,19,1998,5,female,529,88,53,49,66,0,38,49,28
1674434,23,3,1990,3,male,474,89,51,48,36,47,28,1,8
2121785,32,19,1981,2,male,295,88,49,49,3,49,3,0,0
1263121,22,13,1991,3,male,164,89,76,49,13,49,9,0,4
1282871,56,18,1957,7,male,157,89,73,48,16,48,11,0,5
1943037,27,3,1986,12,male,462,90,39,48,48,48,45,0,3
1144472,43,2,1970,2,female,55,89,84,51,62,15,23,36,39
1544046,50,20,1963,11,male,356,88,54,50,4,49,0,1,4
1673265,31,11,1982,3,male,555,88,67,50,17,42,15,8,2
1068393,30,1,1983,9,female,124,89,55,51,103,51,53,0,50
1783065,35,3,1978,6,female,292,90,44,51,140,51,86,0,54
1461306,36,4,1977,6,male,248,88,79,53,31,51,11,2,20
2007568,25,1,1988,1,male,43,89,81,52,3,52,0,0,3
1197372,25,4,1988,4,male,574,90,35,52,14,52,10,0,4
1511868,28,16,1985,8,male,119,90,86,53,17,53,16,0,1
1011459,25,21,1988,10,female,514,88,49,53,67,53,39,0,28
1379232,26,1,1987,1,male,339,88,77,53,45,53,41,0,4
1217053,49,11,1964,8,male,406,89,45,52,46,52,32,0,14
1988596,14,26,1999,1,male,219,89,80,54,1,1,1,53,0
1022681,46,10,1967,3,female,509,90,9,55,28,2,12,53,16
1600580,35,9,1978,11,male,284,88,62,55,38,0,13,55,25
1217769,49,22,1964,10,female,535,90,53,54,59,0,23,54,36
2145900,113,5,1900,9,male,1204,88,15,55,112,1,53,54,59
2100486,14,22,1999,1,male,286,88,78,54,2,18,1,36,1
1692485,35,18,1978,12,male,614,89,53,55,38,11,36,44,2
1369183,100,14,1913,1,female,1722,88,37,55,52,27,33,28,19
2132726,42,28,1971,5,male,457,90,64,55,31,50,18,5,13
1891921,23,26,1990,9,male,175,89,23,54,68,53,7,1,61
1131756,60,1,1953,6,female,710,88,55,58,3,0,0,58,3
1090114,56,30,1957,10,female,270,90,75,58,22,6,17,52,5
1457517,36,3,1977,12,male,235,89,69,57,3,25,0,32,3
2032708,18,4,1995,2,female,281,88,59,57,16,12,10,45,6
1597309,57,2,1956,1,male,44,89,30,58,134,35,85,23,49
1865971,19,1,1994,1,male,196,90,68,58,179,55,108,3,71
1655221,26,10,1987,11,female,33,90,79,58,120,58,86,0,34
1641979,55,21,1958,11,female,425,89,66,60,102,22,21,38,81
1353558,31,20,1982,3,female,818,90,44,59,47,57,26,2,21
1360903,61,2,1952,3,male,615,89,63,60,58,52,8,8,50
1720030,19,3,1994,8,male,634,89,45,60,5,60,4,0,1
1984245,55,23,1958,12,male,485,90,38,61,40,0,20,61,20
1778738,21,17,1992,4,female,252,88,48,63,18,48,10,15,8
1577408,26,7,1987,9,male,316,88,57,62,57,59,6,3,51
1790112,23,31,1990,5,female,283,90,38,61,6,61,3,0,3
1278756,19,23,1994,5,male,232,89,65,65,14,59,7,6,7
1188305,25,14,1988,9,female,632,90,63,65,2,65,2,0,0
1882519,60,16,1953,2,female,1475,88,33,68,33,0,16,68,17
2108421,97,1,1916,3,male,685,89,51,67,588,1,66,66,522
1569830,18,1,1995,2,female,414,88,43,68,259,29,117,39,142
1488661,31,9,1982,12,female,447,90,62,66,68,48,37,18,31
1099552,22,1,1991,1,male,655,88,78,66,26,66,25,0,1
2149769,26,12,1987,12,male,295,89,84,68,15,68,10,0,5
2063870,68,2,1945,10,male,2090,88,51,66,104,66,59,0,45
1528849,25,29,1988,7,female,234,88,64,70,21,68,16,2,5
1175388,34,24,1979,4,male,363,90,72,70,11,70,10,0,1
2077959,18,20,1995,12,female,152,88,53,70,12,70,6,0,6
1578825,25,31,1988,12,female,535,89,50,72,34,50,29,22,5
1794043,58,23,1955,8,female,342,88,43,72,19,36,13,36,6
1255372,20,17,1993,10,male,74,88,45,72,22,72,20,0,2
1358653,35,27,1978,9,female,47,89,35,74,62,74,53,0,9
1530052,83,8,1930,1,male,613,90,37,75,34,0,12,75,22
1157188,61,19,1952,5,female,1425,88,43,78,31,73,18,5,13
1786402,50,14,1963,6,male,912,88,40,80,35,80,29,0,6
2074209,26,22,1987,1,male,355,90,56,78,61,78,50,0,11
1986862,33,1,1980,11,male,481,88,70,80,52,80,44,0,8
1179702,56,19,1957,6,female,604,90,37,79,84,79,54,0,30
1409015,28,2,1985,9,female,338,90,49,81,167,8,129,73,38
1025535,52,12,1961,3,male,584,90,39,84,157,0,39,84,118
1873128,43,15,1970,1,female,681,89,20,83,111,40,35,43,76
1844365,81,2,1932,11,female,580,89,84,82,12,82,8,0,4
1103133,32,25,1981,6,female,135,88,49,84,50,84,36,0,14
1131177,18,29,1995,8,male,185,90,66,81,76,81,66,0,10
1838321,34,17,1979,4,female,37,88,82,84,56,84,48,0,8
1899230,58,1,1955,12,male,478,88,30,87,39,0,12,87,27
1306209,65,17,1948,2,female,943,90,45,86,34,0,17,86,17
1302149,55,4,1958,7,female,412,89,63,87,53,1,37,86,16
1654501,29,3,1984,10,female,784,89,46,87,91,81,45,6,46
1028730,33,13,1980,2,female,553,89,36,87,18,87,17,0,1
1408219,18,2,1995,5,female,27,88,13,87,61,87,43,0,18
1349754,25,29,1988,6,male,82,88,67,86,66,86,33,0,33
2023127,28,8,1985,4,male,648,88,58,86,95,86,53,0,42
2015368,55,8,1958,1,female,601,89,42,87,73,87,48,0,25
1830112,60,28,1953,10,female,414,88,53,88,15,0,2,88,13
1685765,58,7,1955,11,female,403,88,65,90,65,0,22,90,43
1177332,71,11,1942,7,female,1909,88,19,90,63,1,35,89,28
1107079,49,9,1964,10,female,573,90,46,91,201,0,97,91,104
1436592,52,27,1961,9,female,804,89,60,88,69,77,35,11,34
1650927,59,5,1954,9,male,1439,90,20,89,77,88,15,1,62
1747205,32,17,1981,6,female,1326,89,52,90,46,90,23,0,23
1183646,36,10,1977,3,female,297,90,26,89,63,89,32,0,31
1233953,37,29,1976,10,female,352,90,38,94,47,0,2,94,45
1463453,69,22,1944,7,male,370,88,27,95,157,53,78,42,79
1142029,53,22,1960,8,female,314,90,36,94,74,86,38,8,36
2051990,52,11,1961,10,female,262,90,62,96,30,35,21,61,9
1399121,73,8,1940,4,male,1593,89,46,96,9,82,8,14,1
1988546,29,6,1984,4,female,538,89,48,97,56,94,55,3,1
1560929,72,16,1941,4,female,1422,90,32,97,71,88,48,9,23
1945574,60,13,1953,3,female,1570,90,25,98,196,80,90,18,106
1467717,58,15,1955,9,female,299,89,69,104,161,0,6,104,155
1528529,61,11,1952,11,female,654,90,47,100,270,0,13,100,257
1990820,41,24,1972,12,male,379,89,81,104,3,70,2,34,1
1434091,14,27,1999,12,male,50,90,88,104,4,104,4,0,0
1201023,33,24,1980,5,female,629,88,49,100,26,100,24,0,2
1863221,26,2,1987,1,female,277,90,28,100,85,100,79,0,6
1405802,42,23,1971,9,female,551,88,26,102,134,102,51,0,83
1734333,98,18,1915,3,female,836,90,39,107,59,0,20,107,39
1395839,106,20,1907,4,male,25,88,86,109,4,109,2,0,2
1902898,108,15,1905,2,male,763,88,66,109,9,109,7,0,2
1161368,100,23,1913,4,male,638,90,88,105,41,105,41,0,0
2017873,50,22,1963,1,female,999,90,22,106,117,106,83,0,34
1636481,18,15,1995,7,male,114,88,78,111,12,111,9,0,3
1668250,63,29,1950,1,male,878,89,24,115,23,0,18,115,5
1598693,22,18,1991,10,female,424,90,51,115,84,114,52,1,32
2026177,65,14,1948,5,female,1856,88,25,114,66,114,50,0,16
1349590,29,22,1984,2,female,327,89,40,119,257,119,236,0,21
1418211,18,7,1995,7,male,180,89,75,122,50,122,48,0,2
1562244,57,26,1956,4,male,677,89,44,120,115,120,68,0,47
1906150,32,28,1981,8,female,475,88,49,124,377,124,194,0,183
1552013,46,9,1967,4,female,563,89,51,126,12,6,4,120,8
1917126,60,8,1953,1,female,463,89,53,129,41,0,3,129,38
1986711,37,28,1976,4,female,339,90,54,128,427,30,58,98,369
1062121,41,9,1972,10,male,421,88,53,128,157,124,85,4,72
2176132,42,27,1971,10,female,424,89,68,130,92,128,58,2,34
1252608,43,12,1970,12,male,321,88,40,130,9,130,8,0,1
1363081,42,15,1971,3,female,283,89,56,126,10,126,4,0,6
1443204,24,26,1989,4,male,428,88,50,125,117,125,66,0,51
1626342,59,8,1954,6,female,244,88,64,134,42,0,11,134,31
2189282,108,20,1905,12,female,348,89,52,133,149,6,51,127,98
1451377,108,19,1905,1,male,1519,88,56,132,226,16,101,116,125
1228110,18,20,1995,3,female,406,88,32,136,6,136,6,0,0
1403769,18,14,1995,5,male,38,88,76,136,25,136,25,0,0
2180803,22,13,1991,8,female,121,90,51,134,105,134,41,0,64
2063076,40,6,1973,8,female,465,90,18,133,115,133,61,0,54
1229054,76,21,1937,3,female,58,90,81,142,46,0,6,142,40
1918446,26,5,1987,3,male,286,88,50,137,147,133,121,4,26
1180230,14,6,1999,4,male,116,88,24,143,96,142,34,1,62
1575157,52,10,1961,2,male,555,89,79,137,21,137,14,0,7
2027818,26,1,1987,11,female,348,89,62,142,26,142,20,0,6
1487229,25,2,1988,4,female,385,90,49,144,106,1,21,143,85
1034272,53,23,1960,8,female,11,89,87,145,100,0,42,145,58
1741480,27,4,1986,1,female,713,90,48,144,188,35,79,109,109
1327581,108,11,1905,7,male,1170,89,51,145,362,73,227,72,135
1402236,60,20,1953,2,female,1875,89,54,150,146,142,51,8,95
2093773,42,24,1971,11,male,746,88,49,150,148,150,113,0,35
1988106,20,22,1993,4,male,504,90,44,155,82,85,51,70,31
1259692,23,25,1990,11,female,212,90,77,155,67,147,29,8,38
1385398,53,12,1960,7,female,1816,89,45,151,53,149,23,2,30
1627182,36,12,1977,9,male,505,88,55,156,105,151,69,5,36
1556922,65,1,1948,5,female,2165,89,58,153,271,153,181,0,90
1945633,27,22,1986,7,male,1765,89,58,163,129,89,97,74,32
1310260,66,15,1947,10,female,1292,90,38,163,55,128,33,35,22
1771499,68,1,1945,2,male,642,89,73,160,22,160,14,0,8
1058093,20,24,1993,1,male,248,88,50,158,55,158,22,0,33
1991385,22,20,1991,1,female,550,89,47,161,46,161,44,0,2
1559865,24,26,1989,10,female,334,89,52,159,126,159,104,0,22
1863711,16,24,1997,3,male,184,90,72,167,3,0,0,167,3
1155608,35,23,1978,5,female,464,89,54,171,9,130,3,41,6
1910702,23,20,1990,10,female,404,88,70,171,243,149,197,22,46
2098908,69,19,1944,3,female,323,88,29,172,22,172,16,0,6
1495411,23,1,1990,6,female,40,89,47,171,94,171,88,0,6
2170887,44,18,1969,9,male,533,90,52,172,77,172,62,0,15
1469541,62,20,1951,6,male,629,90,47,179,86,0,29,179,57
1763229,56,11,1957,10,female,750,88,59,177,200,0,77,177,123
1913279,21,29,1992,8,female,19,90,66,181,243,75,136,106,107
1063657,22,6,1991,7,male,70,89,63,180,15,178,15,2,0
1771406,18,4,1995,7,male,140,88,77,173,43,163,28,10,15
1294018,57,30,1956,3,female,1349,90,38,179,212,174,55,5,157
1558181,17,16,1996,8,female,317,89,37,180,7,180,6,0,1
1443082,61,3,1952,3,male,464,90,87,178,25,178,22,0,3
2154177,34,3,1979,4,female,372,90,56,178,32,178,31,0,1
1069714,60,19,1953,11,male,1605,88,25,173,112,173,59,0,53
1229579,58,17,1955,6,male,386,88,74,184,75,0,20,184,55
1745066,30,27,1983,9,female,500,88,65,189,55,115,48,74,7
1278501,46,17,1967,2,female,566,88,12,185,150,110,92,75,58
1649901,19,14,1994,10,female,314,88,62,189,297,105,53,84,244
2031265,27,21,1986,4,male,793,90,55,182,72,182,65,0,7
1685336,60,13,1953,7,male,1282,88,60,197,31,13,14,184,17
1063836,61,26,1952,11,female,1761,89,37,195,6,168,2,27,4
1156993,28,23,1985,5,male,446,88,73,200,232,181,154,19,78
1078419,42,7,1971,8,male,50,90,66,197,175,197,53,0,122
2066613,14,11,1999,12,male,249,90,40,211,31,0,0,211,31
2099161,73,28,1940,5,female,1506,90,64,207,69,0,13,207,56
1809024,52,12,1961,3,male,62,88,86,209,144,152,82,57,62
1982061,59,9,1954,7,male,1941,88,12,211,137,207,73,4,64
1389424,58,1,1955,2,female,932,90,31,207,15,207,7,0,8
1327937,31,6,1982,6,female,442,89,39,209,46,209,32,0,14
1654154,57,28,1956,8,female,130,90,47,208,66,208,52,0,14
2070629,49,27,1964,6,female,94,88,54,212,90,4,36,208,54
1357415,58,9,1955,12,female,127,89,22,217,151,0,23,217,128
1150881,29,15,1984,2,female,544,88,45,217,119,104,55,113,64
2071810,61,1,1952,8,female,1271,90,33,217,75,147,68,70,7
1876255,23,25,1990,10,male,726,88,63,217,5,209,4,8,1
1381037,18,12,1995,12,male,239,88,39,216,92,208,47,8,45
1085642,19,27,1994,5,female,192,90,57,212,103,169,36,43,67
1214126,42,17,1971,7,female,421,88,61,219,79,208,36,11,43
1016845,56,3,1957,3,male,989,89,21,216,819,166,489,50,330
1565261,33,10,1980,10,female,464,89,45,214,409,214,395,0,14
1931654,108,18,1905,12,male,2,89,79,231,47,0,3,231,44
1348095,73,29,1940,4,female,297,90,65,232,209,0,11,232,198
1724365,23,31,1990,12,female,304,90,51,226,264,132,119,94,145
1813067,49,28,1964,1,male,483,90,33,232,12,232,8,0,4
1187458,21,20,1992,8,female,372,88,68,233,111,233,70,0,41
1054831,52,8,1961,10,female,285,89,72,231,133,231,124,0,9
2123278,57,16,1956,7,female,679,88,40,228,46,228,33,0,13
1566268,39,13,1974,9,female,511,90,67,235,48,5,23,230,25
1969957,40,6,1973,6,female,1492,88,27,244,202,235,151,9,51
1232006,26,22,1987,6,male,457,90,68,244,104,244,72,0,32
1081299,64,28,1949,12,female,981,90,43,237,181,237,115,0,66
1051124,108,10,1905,10,male,964,88,40,243,152,243,102,0,50
1455446,48,21,1965,3,female,435,88,41,250,274,103,116,147,158
2147060,16,17,1997,4,male,6,90,69,258,49,242,44,16,5
1841108,18,10,1995,11,female,13,88,77,248,583,187,299,61,284
1849180,61,28,1952,10,female,769,89,46,273,248,0,63,273,185
1069889,53,3,1960,1,female,734,88,14,263,167,199,118,64,49
2021570,24,10,1989,12,female,136,90,9,273,30,273,30,0,0
1573819,23,1,1990,1,male,67,90,71,261,105,261,100,0,5
1797067,49,13,1964,4,male,517,90,76,289,174,18,92,271,82
2027719,47,10,1966,5,female,766,89,40,283,2,279,1,4,1
1611819,16,27,1997,8,male,322,90,75,284,174,281,56,3,118
1034391,22,19,1991,8,male,492,90,69,298,88,264,62,34,26
1312968,18,26,1995,2,male,270,88,60,300,13,300,12,0,1
1181980,22,10,1991,5,male,81,89,55,302,0,302,0,0,0
1889584,22,1,1991,8,female,527,90,53,296,81,296,80,0,1
1885550,29,31,1984,12,male,150,88,73,322,21,0,11,322,10
1922033,53,12,1960,1,female,638,88,23,321,19,14,11,307,8
1433611,19,30,1994,10,female,624,88,70,324,216,176,59,148,157
1025277,15,20,1998,5,male,42,89,67,310,116,274,76,36,40
1779276,100,28,1913,8,female,962,89,68,325,235,321,168,4,67
1610348,91,21,1922,3,female,1745,88,50,316,187,316,113,0,74
1430431,29,27,1984,1,male,404,90,57,322,199,322,145,0,54
1320793,48,21,1965,4,female,242,90,83,317,276,317,137,0,139
1688764,52,23,1961,4,male,931,89,50,335,41,0,13,335,28
1564243,54,7,1959,6,female,1779,88,37,344,374,223,223,121,151
1944435,36,1,1977,6,female,136,89,68,332,205,292,134,40,71
1951129,17,31,1996,1,female,134,90,41,331,258,329,157,2,101
2139954,46,23,1967,5,female,168,90,67,331,92,331,79,0,13
1233052,58,26,1955,10,female,166,88,65,347,142,0,19,347,123
1017922,54,1,1959,3,male,1657,88,39,347,213,21,77,326,136
1304480,54,30,1959,1,female,309,88,30,357,119,192,24,165,95
1327032,24,6,1989,10,female,587,88,54,357,472,92,241,265,231
1350716,20,13,1993,9,male,303,88,51,349,16,303,7,46,9
1596094,15,10,1998,1,female,217,90,22,363,18,363,18,0,0
1000510,59,9,1954,3,male,765,90,65,360,321,360,149,0,172
1730779,67,24,1946,11,female,1887,89,44,384,263,288,168,96,95
1649425,16,12,1997,10,male,559,89,39,384,34,384,23,0,11
1585138,55,4,1958,3,male,544,90,35,390,40,390,23,0,17
1385244,17,1,1996,1,male,359,90,58,389,132,389,122,0,10
1617369,29,28,1984,9,female,350,89,69,403,164,28,57,375,107
1237862,43,23,1970,2,female,301,89,65,417,344,80,208,337,136
1316583,60,14,1953,2,male,799,90,66,413,11,219,5,194,6
1437732,63,27,1950,1,female,1085,90,45,404,142,316,74,88,68
1073664,57,23,1956,11,female,34,90,69,411,60,410,39,1,21
2061219,108,26,1905,1,male,96,88,61,396,225,396,180,0,45
1587737,30,10,1983,2,female,91,88,34,406,618,406,452,0,166
1055469,30,24,1983,12,male,183,90,49,429,57,416,23,13,34
1094684,69,25,1944,1,female,1515,90,21,460,104,200,56,260,48
1669679,34,17,1979,7,male,23,90,89,465,53,465,48,0,5
1996640,31,11,1982,2,female,166,89,71,480,147,480,141,0,6
2141177,96,10,1917,3,female,150,88,76,516,24,0,10,516,14
2010052,104,16,1909,1,male,1004,90,39,488,222,481,159,7,63
1482907,50,16,1963,6,male,121,90,82,508,3,508,2,0,1
2182959,17,8,1996,1,female,137,89,67,529,230,516,141,13,89
1045799,54,14,1959,10,female,282,88,41,541,313,541,170,0,143
1644793,28,4,1985,11,female,188,89,50,557,498,557,405,0,93
1737372,93,24,1920,4,female,1551,88,61,576,86,0,8,576,78
2133394,56,1,1957,12,female,732,89,27,582,163,0,59,582,104
2004355,53,26,1960,2,female,1592,90,60,574,317,225,207,349,110
2183423,27,27,1986,10,female,1363,89,54,595,603,205,406,390,197
1511818,45,10,1968,1,female,1212,88,43,577,116,577,48,0,68
2052461,63,16,1950,12,male,320,90,69,642,300,0,17,642,283
1443771,18,20,1995,2,female,216,90,34,626,37,626,37,0,0
1400536,70,18,1943,7,female,1455,89,47,648,277,648,131,0,146
2112920,47,24,1966,3,male,582,88,10,700,212,17,200,683,12
1602564,105,22,1908,4,female,233,89,67,699,315,1,50,698,265
2059353,45,14,1968,9,female,1105,89,77,711,734,24,312,687,422
1651304,57,22,1956,6,male,223,90,46,685,1875,685,1122,0,753
1962269,51,22,1962,9,female,286,89,21,745,451,0,283,745,168
1641018,65,23,1948,2,female,947,90,25,784,491,784,323,0,168
1004919,22,10,1991,11,male,195,88,56,818,969,54,459,764,510
1959964,44,5,1969,4,female,670,90,59,948,132,948,95,0,37
1026271,55,18,1958,11,female,421,88,29,936,250,936,161,0,89
1516929,24,7,1989,3,female,334,90,60,1071,745,1068,505,3,240
1429515,65,29,1948,1,female,314,88,81,1230,304,0,217,1230,87
1234389,21,29,1992,4,female,63,90,53,1145,211,1145,139,0,72
1722310,58,21,1955,1,female,668,89,59,1497,1928,39,178,1458,1750
1878652,44,17,1969,7,female,345,90,46,1479,633,937,249,542,384
1855430,33,7,1980,9,female,1923,88,46,1470,1909,643,699,827,1210
1671165,49,31,1964,7,female,410,90,44,1504,231,1495,80,9,151
1042036,17,9,1996,2,female,263,88,55,1608,48,708,14,900,34
1780643,44,28,1969,6,female,276,90,75,1713,1085,1713,721,0,364
1355995,20,19,1993,3,male,580,88,63,2356,289,0,22,2356,267
2187941,23,14,1990,2,male,26,89,64,2434,415,2434,243,0,172
1647232,47,16,1966,3,female,187,90,47,2691,1557,2691,1013,0,544
1112697,19,4,1994,1,male,347,90,33,2695,2422,2695,1949,0,473
1530771,33,10,1980,2,female,31,89,83,2409,1549,2409,784,0,765
1611863,13,11,2000,5,male,129,91,85,2,0,0,0,2,0
1013623,23,23,1990,10,male,122,92,88,2,0,0,0,2,0
1732295,81,29,1932,12,male,1347,92,55,2,0,0,0,2,0
1046288,16,5,1997,8,female,525,91,64,2,2,0,2,2,0
2136930,23,1,1990,12,male,184,92,71,2,2,0,0,2,2
2191828,14,25,1999,5,female,515,91,64,2,6,0,3,2,3
1213908,17,18,1996,8,male,272,92,45,2,26,0,11,2,15
2050696,28,13,1985,2,female,152,92,61,2,4,0,1,2,3
1681372,44,1,1969,6,male,507,92,48,2,4,0,4,2,0
2185395,49,4,1964,9,female,373,93,55,2,4,0,0,2,4
1818501,61,1,1952,2,male,291,93,66,2,7,0,7,2,0
1526965,61,11,1952,10,male,428,93,53,2,3,0,1,2,2
1781167,22,1,1991,3,male,387,92,63,2,1,1,1,1,0
1561263,17,18,1996,3,male,273,91,78,2,4,1,2,1,2
2147239,23,28,1990,6,male,240,92,90,2,6,1,2,1,4
1906695,29,4,1984,4,male,511,91,49,2,12,1,0,1,12
1116534,18,19,1995,11,female,397,92,55,2,0,2,0,0,0
1395242,21,8,1992,2,male,219,93,75,2,0,2,0,0,0
1740123,22,1,1991,1,male,669,93,73,2,0,2,0,0,0
1773688,23,20,1990,3,male,530,93,41,2,0,2,0,0,0
1835834,24,26,1989,2,female,690,91,57,2,0,2,0,0,0
1456553,26,1,1987,1,male,411,92,47,2,0,2,0,0,0
1949969,38,7,1975,11,male,127,93,90,2,0,2,0,0,0
2181396,22,25,1991,7,male,458,91,62,2,1,2,1,0,0
1191148,25,29,1988,6,male,251,91,61,2,1,2,0,0,1
1049232,56,28,1957,1,male,722,91,63,2,1,2,1,0,0
1356580,30,10,1983,10,male,252,92,91,2,2,2,1,0,1
1119695,54,30,1959,8,male,1847,91,37,2,2,2,2,0,0
2028847,16,12,1997,1,female,193,92,55,2,34,2,21,0,13
1261798,17,14,1996,4,male,179,93,70,2,3,2,3,0,0
1693028,19,3,1994,8,male,28,91,82,2,22,2,20,0,2
1684384,19,24,1994,10,female,594,92,35,2,8,2,3,0,5
1026750,20,31,1993,7,male,623,91,29,2,3,2,1,0,2
1932872,21,25,1992,5,male,294,92,58,2,6,2,5,0,1
1619617,21,3,1992,9,female,101,93,65,2,35,2,34,0,1
1573810,22,4,1991,9,male,282,91,53,2,45,2,24,0,21
1546999,22,4,1991,10,female,420,91,46,2,3,2,3,0,0
2032779,24,17,1989,8,male,274,91,74,2,18,2,16,0,2
1160950,30,7,1983,7,male,443,91,43,2,14,2,4,0,10
1979121,31,6,1982,8,male,394,93,77,2,7,2,4,0,3
1635633,33,21,1980,4,female,130,93,87,2,11,2,5,0,6
1745579,35,1,1978,1,male,315,92,59,2,9,2,9,0,0
1042192,46,10,1967,1,female,367,91,76,2,78,2,12,0,66
1593157,66,12,1947,6,male,354,92,62,2,17,2,17,0,0
1411296,33,31,1980,8,male,336,91,85,3,0,0,0,3,0
1359764,41,10,1972,6,male,531,93,43,3,0,0,0,3,0
1936637,68,31,1945,8,male,1693,92,25,3,0,0,0,3,0
1651486,70,15,1943,2,female,325,91,55,3,3,0,2,3,1
1695183,62,16,1951,8,male,698,92,67,3,13,0,1,3,12
2022427,73,12,1940,10,female,1779,93,32,3,45,0,8,3,37
2180262,13,4,2000,1,male,254,92,75,3,3,2,2,1,1
1983062,37,2,1976,2,male,456,92,54,3,8,1,2,2,6
1615116,16,20,1997,8,female,109,93,12,3,0,3,0,0,0
1938759,29,4,1984,10,male,1043,91,55,3,0,3,0,0,0
1310867,35,30,1978,12,male,440,92,75,3,0,3,0,0,0
1953249,35,25,1978,9,male,577,91,66,3,0,3,0,0,0
1379732,52,23,1961,6,female,504,92,71,3,0,3,0,0,0
2020532,57,28,1956,4,female,1620,91,52,3,0,3,0,0,0
1145126,20,7,1993,10,male,165,93,68,3,1,3,0,0,1
1431006,29,16,1984,11,male,1445,93,56,3,1,3,1,0,0
1302539,33,20,1980,3,female,190,93,80,3,1,3,0,0,1
2095312,33,13,1980,10,male,495,91,83,3,1,3,1,0,0
1912554,15,23,1998,8,male,124,93,60,3,3,3,3,0,0
1110836,16,24,1997,5,male,313,93,71,3,2,3,2,0,0
1144314,18,25,1995,9,female,91,91,41,3,3,3,3,0,0
1406433,19,9,1994,3,male,228,91,39,3,4,3,4,0,0
2149676,31,5,1982,6,female,337,91,73,3,2,3,0,0,2
1624883,68,20,1945,11,male,287,93,24,3,3,3,0,0,3
1658698,18,21,1995,4,male,457,91,25,3,5,3,1,0,4
1351433,18,9,1995,9,male,157,91,82,3,20,3,18,0,2
1125749,20,6,1993,4,male,557,93,52,3,75,3,24,0,51
1580687,22,1,1991,3,male,67,92,91,3,5,3,4,0,1
2021266,23,1,1990,1,male,111,93,83,3,5,3,5,0,0
1448064,23,2,1990,3,male,140,91,58,3,13,3,2,0,11
1953851,26,6,1987,11,male,1269,92,42,3,5,3,1,0,4
1526559,28,14,1985,2,male,185,92,78,3,7,3,2,0,5
1428264,37,8,1976,10,male,574,93,57,3,95,3,88,0,7
2043228,15,12,1998,12,male,683,93,72,4,0,0,0,4,0
2060594,30,29,1983,6,female,632,93,93,4,5,0,2,4,3
1956268,26,5,1987,9,male,575,93,50,4,16,0,9,4,7
1663146,58,29,1955,5,male,628,93,51,4,31,0,8,4,23
1943571,19,20,1994,6,male,591,91,68,4,2,2,1,2,1
1263784,23,19,1990,1,female,547,93,40,4,14,1,7,3,7
2093343,26,8,1987,2,female,114,92,88,4,14,2,13,2,1
1534736,34,12,1979,11,female,712,93,55,4,6,1,2,3,4
1313368,58,19,1955,12,male,1125,91,45,4,9,1,8,3,1
1627352,103,1,1910,12,male,1235,92,72,4,0,4,0,0,0
2018799,103,7,1910,5,male,497,93,79,4,0,4,0,0,0
1425130,18,11,1995,1,male,191,93,84,4,2,4,2,0,0
1756068,22,29,1991,7,male,640,91,65,4,2,4,2,0,0
1044227,24,25,1989,9,male,567,93,57,4,2,4,2,0,0
2029819,26,22,1987,2,male,138,91,72,4,1,4,1,0,0
2085640,34,27,1979,8,male,415,92,77,4,2,4,1,0,1
1360121,19,4,1994,2,male,386,93,28,4,3,4,3,0,0
1434329,27,26,1986,9,male,752,91,38,4,3,4,2,0,1
2184360,20,8,1993,8,female,173,93,56,4,50,4,41,0,9
1411220,29,8,1984,4,male,429,93,63,4,7,4,5,0,2
1263977,33,20,1980,1,male,726,91,62,4,7,4,6,0,1
1218382,52,13,1961,6,female,1579,93,35,4,23,4,11,0,12
1611304,54,1,1959,4,male,845,93,17,4,31,4,30,0,1
1649541,23,20,1990,8,male,241,93,76,5,3,0,3,5,0
1812787,24,21,1989,8,male,417,91,51,5,1,0,0,5,1
1944796,28,25,1985,1,male,783,93,27,5,4,0,4,5,0
1695197,61,18,1952,12,female,1668,92,26,5,9,0,0,5,9
1991199,61,8,1952,9,female,37,92,13,5,18,0,10,5,8
1487078,76,2,1937,1,male,1362,92,48,5,32,0,19,5,13
1362725,18,27,1995,5,male,472,93,63,5,3,1,0,4,3
1765418,16,24,1997,2,male,481,91,36,5,0,4,0,1,0
1119837,22,4,1991,4,male,605,93,14,5,0,5,0,0,0
2004059,25,27,1988,11,male,948,91,79,5,0,5,0,0,0
1041555,64,24,1949,2,female,283,92,51,5,0,5,0,0,0
1765647,20,4,1993,6,male,533,92,47,5,2,5,1,0,1
1434689,32,29,1981,3,male,807,93,32,5,3,5,3,0,0
1724277,15,10,1998,7,male,403,91,62,5,6,5,5,0,1
1854894,15,1,1998,11,male,195,91,74,5,4,5,3,0,1
1064576,69,19,1944,8,female,749,92,66,5,6,5,6,0,0
2125017,18,18,1995,3,female,157,92,39,5,33,5,13,0,20
2193027,20,20,1993,10,female,296,93,69,5,9,5,8,0,1
2179423,27,16,1986,3,male,299,91,17,5,10,5,5,0,5
1290417,28,13,1985,5,female,429,92,48,5,32,5,32,0,0
1754594,33,29,1980,9,female,197,92,45,5,76,5,50,0,26
1706398,46,9,1967,12,male,712,92,49,5,11,5,8,0,3
1917294,51,22,1962,7,female,2096,92,23,5,28,5,23,0,5
1539762,52,8,1961,4,male,664,93,66,5,37,5,21,0,16
1069048,52,9,1961,10,male,818,91,42,5,52,5,23,0,29
1555391,55,13,1958,11,female,2300,93,56,5,30,5,1,0,29
1650860,27,1,1986,1,male,324,91,60,6,0,0,0,6,0
1855084,25,5,1988,8,male,43,93,71,6,1,0,1,6,0
1418194,26,11,1987,2,male,311,93,53,6,7,0,2,6,5
1167146,20,15,1993,10,male,679,92,84,6,12,0,0,6,12
1881426,26,15,1987,1,male,1164,92,12,6,14,0,5,6,9
1099602,29,3,1984,7,male,774,91,56,6,47,0,32,6,15
1541519,69,24,1944,12,male,2285,91,21,6,28,0,5,6,23
1194863,14,31,1999,1,male,530,93,64,6,25,4,2,2,23
2090585,33,10,1980,1,male,177,93,41,6,13,4,12,2,1
1302790,67,16,1946,10,male,990,92,50,6,9,5,3,1,6
1569818,20,29,1993,12,male,594,92,20,6,2,6,0,0,2
2096727,25,9,1988,12,male,274,91,69,6,1,6,1,0,0
1390090,28,1,1985,1,male,504,91,73,6,3,6,0,0,3
1264355,39,10,1974,6,male,244,91,74,6,2,6,2,0,0
1965127,18,26,1995,9,male,233,92,38,6,6,6,2,0,4
1474256,28,9,1985,6,male,212,92,67,6,6,6,3,0,3
1477250,29,8,1984,8,male,97,91,86,6,8,6,6,0,2
1549835,38,13,1975,2,male,467,92,70,6,5,6,5,0,0
1816213,19,20,1994,1,female,426,91,54,6,16,6,16,0,0
1688703,25,15,1988,2,male,14,92,82,6,129,6,119,0,10
1518614,28,22,1985,10,female,494,91,27,6,321,6,131,0,190
1476770,21,8,1992,8,female,363,91,75,7,0,0,0,7,0
2022371,45,9,1968,7,female,367,91,75,7,0,0,0,7,0
1660450,17,9,1996,10,male,329,93,52,7,4,1,3,6,1
1497376,57,24,1956,6,female,248,91,36,7,14,0,2,7,12
1352245,20,14,1993,10,male,205,92,56,7,1,3,1,4,0
1316845,49,2,1964,2,female,1300,91,60,7,3,5,0,2,3
2007431,108,11,1905,1,male,1305,91,55,7,2,5,1,2,1
1885383,30,13,1983,4,male,351,93,49,7,15,3,8,4,7
1285962,41,4,1972,6,male,1244,91,17,7,22,2,12,5,10
1433029,17,22,1996,7,male,638,91,64,7,0,6,0,1,0
1261695,24,17,1989,7,male,594,93,52,7,1,7,1,0,0
1397087,28,24,1985,3,male,836,92,50,7,0,7,0,0,0
2122355,23,16,1990,8,male,247,92,80,7,4,7,3,0,1
1949783,20,26,1993,1,male,230,92,56,7,10,7,8,0,2
1811390,25,8,1988,5,female,208,93,39,7,6,7,3,0,3
1258449,19,27,1994,11,female,574,93,58,7,17,7,15,0,2
1378998,18,23,1995,6,male,128,92,68,7,16,7,11,0,5
1825810,20,1,1993,7,male,51,93,58,7,15,7,12,0,3
1513547,39,10,1974,3,male,1517,91,46,7,33,7,25,0,8
1850324,51,27,1962,8,female,1778,92,52,7,24,7,11,0,13
2014433,17,4,1996,2,female,551,92,57,8,2,1,1,7,1
1847582,21,22,1992,12,male,532,91,78,8,3,0,0,8,3
1594928,16,12,1997,3,female,544,92,60,8,11,0,5,8,6
2127217,26,15,1987,8,male,412,93,38,8,41,0,27,8,14
2040720,44,16,1969,4,female,547,91,57,8,31,0,12,8,19
1928559,90,19,1923,6,female,602,93,82,8,3,2,1,6,2
1420642,23,16,1990,8,male,463,92,62,8,3,7,2,1,1
1435951,20,14,1993,2,male,18,91,87,8,22,6,20,2,2
2137625,72,29,1941,3,female,1387,91,53,8,96,7,63,1,33
2172790,25,4,1988,12,female,292,91,73,8,1,8,1,0,0
1826529,27,28,1986,11,male,397,92,61,8,3,8,1,0,2
1039440,47,20,1966,1,female,390,91,55,8,3,8,0,0,3
1067892,13,8,2000,5,male,103,91,11,8,114,8,71,0,43
1309589,27,24,1986,3,male,385,92,78,8,32,8,26,0,6
1687685,57,23,1956,5,male,59,93,81,8,21,8,14,0,7
1375958,57,16,1956,6,male,732,93,71,8,27,8,12,0,15
1300652,58,20,1955,11,male,459,92,71,9,21,0,4,9,17
1188185,66,30,1947,8,female,627,93,55,9,39,0,28,9,11
1523026,22,14,1991,3,male,307,92,61,9,14,3,12,6,2
1296954,24,29,1989,7,male,289,91,65,9,23,3,10,6,13
1020258,48,3,1965,2,male,762,91,36,9,26,6,16,3,10
1296211,26,3,1987,12,male,445,92,61,9,0,9,0,0,0
1451975,21,27,1992,4,female,481,93,60,9,2,9,1,0,1
2098409,46,11,1967,6,male,227,91,34,9,3,9,1,0,2
2006823,50,2,1963,10,male,1380,93,47,9,4,9,4,0,0
2070976,22,25,1991,9,male,306,92,61,9,12,9,7,0,5
1230771,26,2,1987,6,male,462,93,68,9,45,9,27,0,18
1850173,30,24,1983,5,female,377,93,37,9,20,9,13,0,7
1487320,54,12,1959,5,female,535,93,62,9,17,9,17,0,0
1218616,13,6,2000,1,male,125,91,53,10,2,0,1,10,1
1946653,68,27,1945,1,male,387,92,64,10,6,0,0,10,6
2040297,25,2,1988,1,male,198,92,80,10,7,0,5,10,2
2017762,53,27,1960,5,female,955,92,30,10,38,0,8,10,30
2072984,20,12,1993,11,female,409,92,81,10,16,2,9,8,7
1686308,42,25,1971,2,male,1112,93,57,10,70,6,46,4,24
1016774,20,16,1993,5,male,579,92,65,10,0,9,0,1,0
1754000,98,1,1915,1,male,168,92,92,10,1,10,0,0,1
1449670,16,19,1997,5,male,390,91,70,10,5,10,3,0,2
1920360,23,17,1990,4,male,810,91,40,10,4,10,4,0,0
2113117,30,11,1983,7,female,421,93,55,10,3,10,3,0,0
2057646,22,3,1991,3,male,297,93,77,10,11,10,10,0,1
2039060,24,11,1989,5,female,417,91,19,10,12,10,8,0,4
1278869,43,18,1970,11,male,281,91,46,10,9,10,4,0,5
1935924,22,6,1991,4,male,639,93,42,10,42,10,38,0,4
1664186,28,28,1985,4,female,634,92,32,10,50,10,24,0,26
2180701,28,16,1985,4,male,310,91,82,11,5,1,0,10,5
2025985,51,7,1962,10,male,198,92,59,11,8,0,1,11,7
2095150,25,1,1988,1,male,115,93,68,11,0,7,0,4,0
1346568,26,23,1987,10,male,580,93,37,11,2,5,1,6,1
1571512,26,1,1987,1,male,49,92,82,11,44,10,24,1,20
1358889,17,13,1996,6,male,420,92,80,11,1,11,1,0,0
1500300,23,13,1990,7,male,798,92,13,11,0,11,0,0,0
1320044,96,25,1917,2,male,381,93,13,11,3,11,2,0,1
1631009,23,6,1990,5,male,44,91,78,11,10,11,9,0,1
1665687,29,20,1984,5,female,574,91,84,11,8,11,8,0,0
1668055,45,5,1968,6,female,95,92,4,11,188,11,126,0,62
1093337,18,24,1995,2,male,626,92,64,12,1,0,0,12,1
1535672,51,9,1962,9,female,550,93,56,12,3,0,0,12,3
1725639,51,19,1962,4,female,1289,93,62,12,26,9,13,3,13
1835382,16,9,1997,12,male,100,91,73,12,3,12,2,0,1
1779884,25,10,1988,5,male,140,92,37,12,2,12,2,0,0
1247147,108,13,1905,9,female,683,92,39,12,6,12,6,0,0
1984698,20,10,1993,12,male,643,92,52,12,12,12,10,0,2
1906070,15,31,1998,5,male,101,91,61,12,29,12,18,0,11
1753914,21,3,1992,10,male,587,93,65,12,27,12,27,0,0
1081353,37,14,1976,3,male,201,92,57,12,61,12,54,0,7
2166423,49,12,1964,1,female,569,93,33,13,20,0,13,13,7
1943377,22,15,1991,9,male,204,93,87,13,3,11,2,2,1
1592167,45,4,1968,10,male,1867,92,28,13,37,13,29,0,8
1451657,24,8,1989,4,male,528,91,60,14,63,0,35,14,28
2152372,73,28,1940,10,female,1440,93,33,14,60,0,48,14,12
2148117,62,5,1951,6,female,1422,91,33,14,70,10,48,4,22
1526980,26,1,1987,7,male,323,93,43,14,0,14,0,0,0
1526475,35,20,1978,12,male,653,93,43,14,8,14,4,0,4
1276043,45,8,1968,5,male,465,91,76,14,3,14,3,0,0
1973885,20,8,1993,1,female,151,93,55,14,12,14,11,0,1
1408018,38,2,1975,2,male,519,92,72,14,25,14,8,0,17
1301075,72,3,1941,8,female,1803,92,56,14,38,14,29,0,9
1249750,18,18,1995,1,female,401,91,28,15,3,0,0,15,3
1232087,53,8,1960,1,male,1355,92,44,15,20,0,2,15,18
1396239,40,22,1973,1,male,557,92,34,15,5,15,5,0,0
1456285,103,13,1910,8,male,802,91,28,15,11,15,9,0,2
1568954,35,1,1978,10,female,437,92,55,16,5,0,0,16,5
1685860,52,29,1961,8,male,402,91,12,16,3,1,1,15,2
1771979,62,26,1951,11,male,706,93,75,16,23,0,17,16,6
1254935,24,24,1989,2,male,2227,92,25,16,1,16,1,0,0
2100453,17,3,1996,2,male,98,91,76,16,12,16,10,0,2
1054760,55,16,1958,9,NA,2028,92,24,16,34,16,19,0,15
1228167,57,1,1956,8,female,943,91,32,17,4,0,2,17,2
2120835,65,24,1948,10,male,268,93,49,17,18,0,6,17,12
2104821,34,27,1979,9,male,1074,93,34,17,20,15,11,2,9
1548971,31,25,1982,12,male,545,93,42,17,2,17,2,0,0
1743440,63,27,1950,9,female,385,91,46,17,4,17,2,0,2
1824177,31,21,1982,11,male,624,93,39,17,14,17,5,0,9
2047929,28,3,1985,9,male,569,92,39,18,23,0,8,18,15
1866158,56,29,1957,4,female,477,92,34,18,6,13,5,5,1
1478731,17,6,1996,8,male,693,91,57,18,1,18,1,0,0
1367621,19,4,1994,9,female,664,92,71,18,46,18,24,0,22
2108746,52,11,1961,5,male,613,91,51,19,0,19,0,0,0
1853073,28,31,1985,10,male,425,93,50,19,45,19,45,0,0
1566708,27,2,1986,2,male,164,93,76,20,34,0,30,20,4
1032046,46,22,1967,1,male,1127,92,51,20,8,7,5,13,3
1651879,28,9,1985,3,male,816,93,57,20,9,19,7,1,2
1950918,16,21,1997,3,male,406,91,62,20,0,20,0,0,0
1489478,30,3,1983,1,female,918,91,30,20,1,20,1,0,0
1483542,17,29,1996,12,female,178,93,86,20,4,20,0,0,4
1763944,44,23,1969,9,male,292,92,59,20,28,20,3,0,25
1561436,42,20,1971,11,male,654,92,36,20,43,20,38,0,5
2101687,19,3,1994,3,male,450,93,49,21,0,0,0,21,0
1490384,58,11,1955,2,male,632,91,25,21,1,2,0,19,1
2163910,41,19,1972,5,female,572,91,63,21,1,8,1,13,0
1398461,31,28,1982,12,female,578,93,55,21,98,18,88,3,10
1016047,16,2,1997,2,male,52,91,80,21,0,21,0,0,0
2114164,17,2,1996,10,male,236,91,47,21,14,21,8,0,6
1515693,83,8,1930,5,male,412,92,79,21,24,21,14,0,10
1712171,18,19,1995,2,female,29,92,90,21,37,21,26,0,11
1317345,45,1,1968,1,male,283,93,76,22,3,0,2,22,1
1300829,25,26,1988,6,female,488,92,35,22,2,22,2,0,0
1120509,27,16,1986,6,male,732,92,81,22,3,22,3,0,0
1111762,29,30,1984,9,male,922,93,71,22,1,22,1,0,0
2037800,37,15,1976,8,male,494,91,86,22,2,22,0,0,2
1628907,32,11,1981,9,male,703,93,51,22,11,22,9,0,2
1831925,28,18,1985,9,male,295,91,36,22,17,22,13,0,4
1889806,100,22,1913,7,male,280,91,83,22,58,22,56,0,2
2108291,71,24,1942,7,female,553,92,43,23,9,0,2,23,7
1498279,59,19,1954,1,male,1113,91,37,23,14,0,3,23,11
1189086,23,26,1990,7,male,536,91,49,23,17,23,11,0,6
1892921,36,21,1977,6,male,398,93,93,23,46,23,33,0,13
1339607,48,14,1965,8,female,1307,93,20,23,76,23,69,0,7
1036199,18,28,1995,6,male,130,93,85,24,1,0,0,24,1
1574803,88,3,1925,3,male,46,93,80,24,0,0,0,24,0
1356952,42,8,1971,10,male,490,93,58,24,24,22,21,2,3
1735556,19,10,1994,2,female,689,93,64,24,2,24,2,0,0
1807090,25,2,1988,8,male,453,93,74,24,2,24,2,0,0
1035024,17,11,1996,12,female,289,92,64,24,27,24,10,0,17
1143874,25,28,1988,7,male,359,92,60,24,87,24,36,0,51
1693360,54,10,1959,11,female,635,93,42,24,43,24,39,0,4
1866364,15,2,1998,2,male,131,93,71,25,14,0,1,25,13
1291561,31,25,1982,8,male,133,92,89,25,14,2,6,23,8
1233925,21,7,1992,11,male,394,93,56,25,2,25,2,0,0
2028450,21,7,1992,7,female,81,92,66,25,7,25,7,0,0
2028340,55,12,1958,3,female,332,93,41,25,11,25,10,0,1
1266273,99,7,1914,12,male,744,91,59,26,25,9,13,17,12
2046471,59,25,1954,9,male,46,91,67,26,0,26,0,0,0
1334697,21,16,1992,6,male,443,93,52,27,3,0,1,27,2
1670106,19,2,1994,2,male,262,93,32,27,25,4,8,23,17
1910182,28,30,1985,12,male,410,91,57,27,69,12,36,15,33
1746970,23,13,1990,2,male,1163,92,41,27,10,20,1,7,9
2100885,33,3,1980,11,female,378,93,54,28,78,20,29,8,49
1860664,22,13,1991,3,male,557,92,43,28,23,27,12,1,11
1330688,18,21,1995,7,male,595,93,77,28,14,28,13,0,1
1273784,47,16,1966,4,male,837,91,21,28,25,28,24,0,1
1220302,108,5,1905,10,male,2309,91,62,28,38,28,20,0,18
1463237,22,7,1991,11,female,884,91,49,29,22,1,4,28,18
2128311,60,25,1953,4,male,1213,91,52,29,137,0,68,29,69
1139757,21,20,1992,1,male,322,93,54,29,15,27,5,2,10
1260768,15,10,1998,8,female,211,91,33,29,0,29,0,0,0
1813499,36,15,1977,12,male,494,92,56,29,10,29,9,0,1
1734706,51,13,1962,3,female,179,92,76,29,236,29,196,0,40
2035318,16,18,1997,3,male,55,93,49,31,35,3,17,28,18
1214955,14,5,1999,9,male,331,93,55,31,5,16,2,15,3
1950244,107,1,1906,1,male,2310,93,46,30,37,12,12,18,25
1710749,38,5,1975,6,male,1139,92,45,31,7,30,6,1,1
1594934,25,7,1988,2,male,430,93,62,31,20,30,16,1,4
1919640,60,7,1953,12,male,592,93,69,30,0,30,0,0,0
1839971,32,1,1981,2,female,396,93,34,32,17,0,0,32,17
1857861,59,28,1954,11,female,945,92,32,32,11,0,2,32,9
1224960,53,20,1960,9,female,2133,93,35,32,12,7,6,25,6
1281828,16,30,1997,5,male,506,93,61,32,5,32,0,0,5
1853489,56,9,1957,11,female,1117,92,15,32,8,32,8,0,0
1824929,54,23,1959,10,female,258,91,58,32,34,32,16,0,18
1364076,19,20,1994,11,female,230,92,33,32,91,32,21,0,70
1103608,44,30,1969,10,male,139,92,71,33,22,0,9,33,13
1974709,32,8,1981,11,female,59,92,82,33,13,22,6,11,7
1287111,14,5,1999,10,male,280,92,76,33,10,25,3,8,7
2192106,53,4,1960,3,male,1093,91,38,33,263,32,125,1,138
1978085,18,4,1995,12,male,213,91,75,33,2,33,2,0,0
1487353,20,10,1993,5,male,211,91,71,33,20,33,17,0,3
2080618,24,1,1989,1,male,43,91,88,33,7,33,6,0,1
2022802,23,30,1990,6,male,135,91,50,33,69,33,57,0,12
1557290,36,23,1977,8,male,273,93,52,34,76,33,41,1,35
1427181,54,19,1959,10,female,1198,91,48,34,172,25,84,9,88
1514055,16,29,1997,8,male,306,92,79,34,4,34,3,0,1
1653598,74,20,1939,8,male,1640,92,65,34,12,34,10,0,2
1273289,26,1,1987,1,male,669,93,58,34,22,34,20,0,2
1707757,42,20,1971,10,male,718,93,45,34,34,34,30,0,4
1125473,113,25,1900,2,male,1324,93,39,36,19,0,11,36,8
2009084,15,5,1998,7,male,430,91,67,35,26,33,16,2,10
1911756,26,27,1987,6,male,386,92,64,35,4,35,4,0,0
1599429,15,13,1998,5,male,124,91,60,37,44,8,10,29,34
1196506,68,8,1945,8,male,229,91,84,37,3,37,2,0,1
2107532,25,20,1988,12,male,219,91,42,37,24,37,24,0,0
1443466,26,18,1987,4,male,248,92,68,37,34,37,23,0,11
1530365,64,22,1949,6,female,1661,92,41,38,2,0,0,38,2
1601535,53,15,1960,7,female,175,93,82,39,35,0,19,39,16
1332300,53,12,1960,5,female,212,92,61,38,104,2,60,36,44
1154287,51,24,1962,2,male,507,92,71,38,31,27,10,11,21
1177140,64,30,1949,7,female,1443,92,30,38,27,22,20,16,7
1049736,51,30,1962,7,female,337,92,69,39,53,37,29,2,24
1204388,18,31,1995,5,male,138,92,79,39,6,39,5,0,1
2043995,37,11,1976,5,female,367,91,50,39,57,39,20,0,37
2079632,19,12,1994,5,male,267,91,25,39,710,39,338,0,372
1292034,18,6,1995,8,male,412,93,44,40,1,1,0,39,1
1100499,78,30,1935,7,female,1691,91,48,40,19,0,14,40,5
1951487,19,4,1994,7,female,503,93,60,40,37,2,18,38,19
1457717,43,4,1970,7,male,677,93,46,40,240,18,52,22,188
1239941,20,18,1993,2,male,175,93,66,40,14,40,13,0,1
1079056,25,29,1988,3,female,199,91,83,40,18,40,18,0,0
1029439,42,25,1971,9,male,263,91,61,40,64,40,53,0,11
2089904,48,22,1965,9,male,379,93,73,42,23,1,10,41,13
2135146,63,21,1950,10,female,1714,93,45,41,93,17,46,24,47
1390307,26,4,1987,11,female,2168,92,30,42,97,38,54,4,43
1289724,25,22,1988,1,male,284,91,82,42,13,42,9,0,4
1052029,19,30,1994,8,male,336,92,60,42,65,42,62,0,3
1489329,14,14,1999,9,male,139,91,82,43,0,2,0,41,0
1771937,67,28,1946,5,female,572,92,33,44,35,7,21,37,14
1107956,67,11,1946,10,female,1440,92,56,44,5,24,5,20,0
1900510,25,3,1988,6,male,217,92,71,44,40,30,23,14,17
1701931,68,7,1945,8,female,1842,93,35,43,57,38,44,5,13
1586534,27,25,1986,10,male,297,92,74,44,11,44,11,0,0
1594049,32,26,1981,8,male,531,93,63,43,42,43,41,0,1
1607316,46,9,1967,9,male,53,93,55,43,47,43,41,0,6
1534886,59,28,1954,4,male,187,91,47,45,27,0,12,45,15
1965472,35,8,1978,11,male,511,92,65,45,3,45,0,0,3
1037601,36,2,1977,12,male,601,93,52,45,59,45,51,0,8
1827754,25,25,1988,12,male,532,91,52,45,81,45,72,0,9
1936513,32,18,1981,5,female,246,92,41,47,51,33,21,14,30
1885405,34,27,1979,4,female,172,91,62,47,30,45,28,2,2
1488011,35,30,1978,5,female,204,93,32,46,198,45,150,1,48
1014886,62,1,1951,1,male,16,91,67,46,8,46,7,0,1
1195355,14,22,1999,2,female,762,93,51,49,43,7,22,42,21
1844061,62,28,1951,6,female,1530,91,30,49,28,45,17,4,11
2139162,30,31,1983,12,male,394,93,59,49,102,49,86,0,16
1516931,55,4,1958,4,male,346,91,72,48,75,48,37,0,38
1256584,15,3,1998,4,female,656,93,71,50,13,30,6,20,7
1391817,52,27,1961,4,female,669,91,43,50,17,36,10,14,7
1511174,25,13,1988,9,male,292,93,67,53,28,43,24,10,4
2115136,35,6,1978,2,female,256,92,62,53,58,53,53,0,5
1748144,54,17,1959,5,female,167,93,49,55,7,0,1,55,6
1961285,100,6,1913,9,male,1478,91,19,54,18,48,11,6,7
1541254,32,15,1981,6,male,269,92,29,54,55,54,22,0,33
1914790,23,8,1990,10,male,586,91,70,55,93,55,33,0,60
1561223,28,10,1985,2,male,682,93,48,57,43,28,17,29,26
1586227,56,19,1957,1,male,85,93,77,57,103,30,79,27,24
1115376,56,5,1957,10,female,230,92,60,56,11,53,1,3,10
1508618,64,2,1949,10,male,270,91,39,56,1,56,1,0,0
1890708,93,20,1920,12,male,1172,91,68,57,15,57,14,0,1
1208933,42,26,1971,10,female,444,92,65,56,52,56,49,0,3
1178339,34,5,1979,6,female,194,91,66,56,94,56,82,0,12
2025591,45,31,1968,5,female,1833,91,56,59,73,5,65,54,8
1392100,21,30,1992,1,female,500,93,34,59,116,35,87,24,29
1505780,15,22,1998,5,female,169,91,71,59,20,47,11,12,9
1111782,26,29,1987,12,male,489,91,29,60,72,59,68,1,4
2145522,55,2,1958,9,male,729,93,24,59,18,59,7,0,11
1505956,93,6,1920,6,female,1132,92,65,59,12,59,7,0,5
2032942,55,20,1958,2,male,477,92,79,60,67,60,31,0,36
1809222,48,20,1965,1,female,433,91,42,59,314,59,285,0,29
1246705,73,21,1940,9,female,1229,91,17,62,4,25,3,37,1
1297552,51,12,1962,3,male,599,92,79,61,17,57,8,4,9
1305088,23,6,1990,11,male,297,93,53,61,68,61,40,0,28
1582938,57,12,1956,10,male,166,93,76,65,6,65,4,0,2
1008071,16,1,1997,10,female,114,93,63,64,15,64,15,0,0
1672957,18,28,1995,12,male,193,92,75,64,68,64,49,0,19
1270573,17,13,1996,1,male,248,92,24,65,100,65,53,0,47
1517883,36,2,1977,2,female,285,92,49,68,92,0,7,68,85
1764097,57,15,1956,7,female,729,91,69,68,43,0,19,68,24
1232880,113,31,1900,12,male,1263,91,73,67,95,0,40,67,55
1621412,17,3,1996,4,female,308,92,80,67,10,44,3,23,7
1694158,79,3,1934,4,female,62,91,39,67,55,32,45,35,10
1751033,56,27,1957,11,female,1756,92,45,67,107,42,57,25,50
1906264,66,4,1947,9,female,121,92,42,68,16,50,10,18,6
1395014,42,12,1971,10,female,510,91,37,67,98,66,54,1,44
1735572,13,28,2000,6,female,738,93,78,68,2,68,1,0,1
1318554,18,11,1995,3,male,301,91,35,66,11,66,5,0,6
1373486,31,4,1982,12,male,425,93,56,66,12,66,7,0,5
2051238,26,13,1987,10,female,120,91,29,66,114,66,56,0,58
1566926,45,27,1968,10,female,340,91,56,67,101,67,62,0,39
1202656,51,12,1962,7,male,387,91,77,70,332,6,8,64,324
1240017,56,16,1957,1,male,1608,91,47,69,3,31,1,38,2
1357507,59,6,1954,1,female,1188,93,67,71,69,70,36,1,33
1384228,80,3,1933,2,female,1838,92,76,69,17,69,15,0,2
1867227,108,24,1905,12,female,299,91,76,69,53,69,33,0,20
2001224,28,7,1985,10,male,489,91,77,72,123,13,88,59,35
1968125,63,30,1950,5,male,1189,91,30,74,33,62,17,12,16
2093863,31,22,1982,11,female,895,93,63,74,16,74,11,0,5
1360497,33,15,1980,11,male,519,91,49,72,25,72,22,0,3
1323255,30,24,1983,6,male,459,93,82,74,200,74,169,0,31
1511993,75,4,1938,11,female,1758,91,64,77,34,0,11,77,23
2130574,23,3,1990,9,male,1090,93,64,75,3,70,3,5,0
1029023,22,4,1991,3,male,27,93,89,76,73,61,66,15,7
2191583,23,3,1990,7,male,262,93,50,75,5,75,4,0,1
1546671,23,12,1990,12,male,76,93,80,76,52,76,34,0,18
1224386,25,20,1988,12,female,419,93,19,75,57,75,47,0,10
1546961,29,16,1984,12,male,295,91,78,75,74,75,64,0,10
1643616,54,5,1959,6,male,430,91,39,80,52,0,13,80,39
1917383,56,14,1957,3,female,267,92,47,80,382,69,126,11,256
1946831,38,2,1975,4,female,332,91,69,80,75,80,23,0,52
2172850,75,18,1938,3,female,1579,92,58,81,13,0,7,81,6
1103677,41,18,1972,11,female,316,92,66,83,47,77,44,6,3
1417539,80,26,1933,2,female,1651,91,54,83,34,80,20,3,14
1938108,56,5,1957,1,male,1458,93,32,81,81,81,12,0,69
1073114,108,18,1905,12,male,224,92,44,86,82,0,27,86,55
1770030,23,14,1990,1,male,271,92,83,87,38,33,13,54,25
2098869,27,7,1986,12,male,168,91,84,87,73,87,72,0,1
1333899,30,3,1983,1,female,605,91,40,89,0,8,0,81,0
1725121,17,16,1996,9,male,473,91,54,91,72,3,48,88,24
1444352,107,22,1906,4,male,1065,91,49,89,247,36,157,53,90
1906535,28,2,1985,7,male,278,91,76,90,28,89,14,1,14
1442921,73,11,1940,6,male,1365,91,26,89,5,89,2,0,3
1131777,32,2,1981,7,male,210,93,61,91,55,91,34,0,21
2175618,50,11,1963,3,female,222,92,35,88,23,88,23,0,0
1243388,33,14,1980,6,male,231,92,57,88,60,88,44,0,16
1798283,19,17,1994,8,male,193,92,39,90,159,90,57,0,102
1616697,94,28,1919,11,female,98,92,32,92,7,0,1,92,6
1860786,53,15,1960,5,male,176,92,79,94,18,15,13,79,5
1860500,59,29,1954,7,female,1588,91,53,94,56,0,4,94,52
1073987,21,3,1992,1,female,158,91,53,95,84,83,65,12,19
1655304,27,16,1986,10,female,660,91,50,95,91,80,49,15,42
1022372,52,8,1961,3,female,533,91,58,92,87,77,47,15,40
2000789,51,17,1962,1,female,787,93,55,94,27,94,14,0,13
1023194,24,18,1989,5,female,600,92,45,94,107,94,87,0,20
1967413,30,5,1983,6,male,1104,93,44,98,41,10,34,88,7
1201321,15,15,1998,6,female,180,93,71,97,142,16,44,81,98
1219695,52,6,1961,10,male,489,92,7,99,40,93,22,6,18
1643994,24,7,1989,12,male,447,93,56,96,34,96,11,0,23
1419897,44,1,1969,1,female,37,92,62,96,26,96,24,0,2
1417859,62,11,1951,5,female,981,91,69,101,1,3,1,98,0
2093948,75,4,1938,10,female,1555,91,29,103,16,0,10,103,6
1092277,49,21,1964,2,female,428,93,79,100,47,62,45,38,2
1078973,43,8,1970,5,female,454,93,50,103,36,96,22,7,14
2178037,24,23,1989,8,female,674,91,48,100,0,100,0,0,0
1605841,62,9,1951,5,male,639,92,69,104,21,104,15,0,6
1962271,50,16,1963,9,female,346,91,54,104,90,104,60,0,30
1292928,32,18,1981,10,female,153,92,62,102,159,102,114,0,45
1138311,46,25,1967,11,female,795,92,42,109,40,96,31,13,9
1475470,17,28,1996,5,male,146,93,85,109,0,109,0,0,0
2156382,52,29,1961,12,female,185,93,57,108,78,108,41,0,37
1321558,55,30,1958,8,female,1539,92,31,113,26,0,6,113,20
1505450,43,16,1970,12,female,1828,93,58,112,155,80,116,32,39
1679731,22,25,1991,3,female,279,93,43,111,10,111,7,0,3
2166931,33,23,1980,12,male,270,92,38,112,6,112,5,0,1
1206727,49,3,1964,10,male,509,93,90,112,15,112,8,0,7
1127641,14,20,1999,7,male,262,93,60,110,35,110,34,0,1
2187930,62,10,1951,7,female,159,91,28,111,56,111,23,0,33
1996358,47,24,1966,5,female,1221,93,56,114,22,60,4,54,18
1591870,63,6,1950,8,male,1648,93,43,117,38,98,25,19,13
1346273,24,28,1989,9,male,434,93,60,116,51,116,45,0,6
1789625,63,27,1950,10,female,1473,92,20,114,51,114,47,0,4
1715603,66,30,1947,9,female,419,91,72,119,158,119,57,0,101
1436537,25,21,1988,11,female,384,92,53,120,6,34,4,86,2
1676963,108,29,1905,3,female,112,93,84,122,66,87,23,35,43
1217222,57,9,1956,8,female,1424,92,38,120,120,50,34,70,86
1182906,19,18,1994,4,male,269,92,47,124,2,124,2,0,0
2111499,34,10,1979,2,female,1916,93,33,123,58,123,40,0,18
1993720,40,22,1973,5,female,861,92,44,120,204,120,122,0,82
1836767,55,5,1958,9,male,1470,91,58,128,22,120,11,8,11
1273012,50,4,1963,1,male,1489,92,48,125,100,124,22,1,78
1190959,24,26,1989,7,female,1031,91,62,131,139,21,32,110,107
1612245,29,8,1984,4,female,311,93,49,133,225,26,51,107,174
1041458,33,15,1980,4,male,260,93,84,134,132,134,128,0,4
1214156,59,19,1954,8,male,1785,92,45,140,7,3,2,137,5
1005179,23,10,1990,10,male,143,93,74,139,40,130,36,9,4
1458866,38,25,1975,12,male,442,92,49,141,99,139,47,2,52
1355011,61,15,1952,9,female,247,91,78,137,10,137,5,0,5
1202346,61,25,1952,3,female,742,91,53,138,83,138,33,0,50
1257588,35,25,1978,9,female,412,93,50,141,142,141,87,0,55
1105307,48,28,1965,10,female,619,92,69,147,55,0,10,147,45
2133527,59,11,1954,11,female,850,91,68,144,64,0,22,144,42
2159981,63,31,1950,12,female,898,91,54,146,32,26,21,120,11
1723157,42,3,1971,3,female,551,91,50,149,109,149,20,0,89
1888318,57,10,1956,11,female,660,93,59,152,35,74,27,78,8
1214493,23,25,1990,1,female,351,93,55,155,610,68,187,87,423
1024875,43,13,1970,1,male,261,93,65,153,75,152,57,1,18
1973693,61,15,1952,10,female,300,93,82,151,84,150,42,1,42
1390379,16,24,1997,4,male,451,91,87,151,24,151,14,0,10
1632680,44,2,1969,3,male,509,93,75,153,7,153,7,0,0
1327830,53,25,1960,8,female,1378,93,53,151,11,151,8,0,3
1790736,46,12,1967,1,female,75,93,69,155,232,155,38,0,194
1789859,48,11,1965,10,male,252,92,57,163,73,0,17,163,56
1436810,100,13,1913,1,male,1529,93,43,159,116,0,27,159,89
1473471,108,4,1905,10,female,1478,93,70,160,132,0,17,160,115
2044605,27,15,1986,6,male,65,92,80,162,11,135,0,27,11
2132639,16,3,1997,10,male,199,91,37,164,113,124,89,40,24
2101204,26,21,1987,7,female,778,92,28,162,140,123,89,39,51
2033628,24,12,1989,12,female,346,91,49,168,227,7,36,161,191
1746082,28,14,1985,9,male,76,92,80,168,308,164,219,4,89
1684144,36,10,1977,9,female,164,91,72,171,20,171,7,0,13
1683843,41,25,1972,1,female,398,92,86,170,124,170,115,0,9
1000475,64,23,1949,7,female,1773,93,44,176,99,26,38,150,61
1452498,51,4,1962,9,female,317,91,66,180,133,0,60,180,73
1136265,27,25,1986,12,male,581,91,55,181,56,99,35,82,21
1480350,13,14,2000,7,female,629,92,53,173,248,87,112,86,136
1522490,63,22,1950,7,female,783,92,24,180,21,155,9,25,12
1174815,35,6,1978,5,female,102,91,67,176,135,170,30,6,105
1668400,54,16,1959,8,female,803,93,46,177,303,165,164,12,139
1115510,78,13,1935,11,male,124,93,67,175,42,175,40,0,2
1488935,74,7,1939,6,male,747,92,36,183,63,0,14,183,49
1810240,33,12,1980,2,female,469,93,41,188,57,117,34,71,23
1938860,32,23,1981,1,female,282,93,70,183,139,173,96,10,43
1544926,65,27,1948,4,male,593,92,72,186,180,137,79,49,101
1806232,38,25,1975,2,female,227,93,62,188,223,188,212,0,11
1618387,48,16,1965,5,female,91,91,67,187,182,187,109,0,73
1246331,17,10,1996,10,female,426,91,53,195,121,21,35,174,86
1385357,36,10,1977,4,female,250,91,47,200,159,2,63,198,96
1363769,55,24,1958,4,female,458,92,61,196,140,0,24,196,116
1116278,27,2,1986,9,female,176,92,63,193,50,55,24,138,26
2166930,35,7,1978,7,female,461,92,79,196,37,196,34,0,3
2064432,41,21,1972,8,female,1879,91,31,205,402,27,166,178,236
1277957,57,5,1956,11,female,1836,93,13,211,39,134,27,77,12
1156564,48,15,1965,7,male,530,93,83,203,61,148,13,55,48
1347422,18,1,1995,8,male,74,91,71,207,285,207,236,0,49
1032329,55,4,1958,10,male,1000,93,63,216,131,212,95,4,36
1880556,26,1,1987,1,male,274,93,50,221,12,221,10,0,2
1870996,32,18,1981,3,female,650,93,61,219,63,219,37,0,26
1144997,78,13,1935,5,male,734,93,61,215,56,215,52,0,4
1247224,29,1,1984,1,male,99,91,49,214,151,214,67,0,84
1818587,43,14,1970,1,female,371,93,42,233,118,0,71,233,47
1919763,24,18,1989,7,male,29,93,90,232,43,145,36,87,7
1745465,60,13,1953,10,female,1566,91,37,230,152,146,70,84,82
2176954,17,5,1996,1,male,261,91,27,233,103,232,58,1,45
1140058,68,29,1945,12,female,733,91,61,224,62,224,39,0,23
1555546,45,6,1968,8,female,249,93,51,232,302,232,199,0,103
1039539,48,10,1965,3,female,1752,92,23,233,297,233,221,0,76
1096993,44,1,1969,5,male,497,92,25,236,26,236,22,0,4
1493264,22,19,1991,4,female,122,91,79,235,87,235,61,0,26
1261819,19,6,1994,11,male,595,91,83,251,6,1,3,250,3
1101905,65,21,1948,5,female,434,93,56,253,8,0,0,253,8
1759566,63,3,1950,12,female,215,92,37,248,71,10,9,238,62
1503426,29,8,1984,3,male,307,93,46,252,156,228,27,24,129
1303887,20,20,1993,12,male,345,92,80,248,120,248,117,0,3
1784241,25,21,1988,2,female,445,92,30,257,71,257,19,0,52
1632229,32,10,1981,4,male,1989,93,27,274,151,156,75,118,76
2086132,55,7,1958,7,female,1841,93,27,273,95,126,56,147,39
2144420,49,8,1964,4,female,821,91,54,261,192,133,62,128,130
2063186,39,5,1974,7,female,466,92,49,274,360,215,347,59,13
1583621,49,2,1964,10,male,296,92,35,275,2,275,1,0,1
1803351,33,22,1980,9,female,99,93,42,271,290,271,204,0,86
1190008,19,24,1994,6,female,188,91,41,285,47,265,20,20,27
2125204,54,14,1959,6,male,925,91,57,286,125,264,57,22,68
1530728,33,10,1980,11,female,334,92,60,301,32,301,22,0,10
1129761,50,31,1963,3,male,30,91,73,307,497,307,312,0,185
2172691,51,29,1962,4,female,1167,91,40,315,339,18,175,297,164
1111138,24,17,1989,8,female,737,91,67,314,83,121,42,193,41
1005877,53,7,1960,3,male,682,93,60,312,65,282,37,30,28
1718408,53,26,1960,6,female,1203,91,20,317,11,317,6,0,5
1340152,18,26,1995,1,female,985,93,56,342,302,142,93,200,209
1317228,27,26,1986,2,male,176,92,78,330,261,144,167,186,94
1569052,62,13,1951,3,female,1729,92,38,338,550,221,233,117,317
1761681,18,11,1995,1,male,212,92,61,342,130,330,96,12,34
1284247,62,13,1951,10,female,929,91,71,341,74,341,42,0,32
1504579,28,31,1985,1,female,232,93,57,359,78,146,49,213,29
1403021,52,30,1961,12,female,1568,91,40,358,157,326,111,32,46
1826196,24,3,1989,6,male,232,92,47,361,81,361,42,0,39
1923683,32,20,1981,6,female,287,93,68,354,226,354,180,0,46
1117991,56,18,1957,10,male,329,92,53,367,466,367,406,0,60
1998888,28,10,1985,10,male,458,93,67,376,136,245,39,131,97
1939792,48,25,1965,1,female,576,91,56,379,66,138,39,241,27
1691730,18,19,1995,2,male,45,93,51,370,23,370,18,0,5
1681621,18,20,1995,7,male,149,93,78,386,33,386,26,0,7
1635960,25,21,1988,3,female,289,93,63,374,100,374,54,0,46
1691203,57,4,1956,4,female,264,93,76,404,93,246,76,158,17
1767992,22,17,1991,1,male,225,91,58,407,29,407,23,0,6
1844364,24,3,1989,10,female,44,91,51,423,100,423,83,0,17
1202792,62,30,1951,1,male,893,91,57,442,204,442,117,0,87
1568576,63,23,1950,6,female,1420,93,50,422,97,422,47,0,50
2153399,65,11,1948,1,female,751,92,81,459,172,0,109,459,63
1210006,108,10,1905,2,female,1010,92,40,465,865,465,742,0,123
1146843,48,23,1965,3,female,756,92,75,519,292,494,168,25,124
1760320,57,22,1956,10,female,2360,92,60,498,100,431,74,67,26
1160505,22,26,1991,10,female,475,92,54,515,362,482,189,33,173
1690055,59,25,1954,9,female,370,92,72,560,395,0,77,560,318
1017547,21,14,1992,4,male,460,92,85,529,36,401,30,128,6
1357095,63,5,1950,6,female,1843,92,34,523,92,388,57,135,35
1281713,18,31,1995,10,female,134,92,43,549,218,549,83,0,135
1307129,54,25,1959,6,female,1408,93,60,577,65,539,41,38,24
1096458,20,14,1993,11,female,320,93,71,573,296,570,102,3,194
1649723,19,23,1994,8,female,506,91,62,655,57,453,48,202,9
1442476,17,10,1996,2,female,147,93,80,626,210,586,136,40,74
1306942,52,7,1961,10,female,341,93,47,648,302,648,169,0,133
1129135,42,15,1971,3,male,416,93,47,693,87,630,32,63,55
1203900,64,21,1949,2,female,1212,92,58,689,108,656,50,33,58
1821455,75,11,1938,7,female,1110,92,43,737,116,61,84,676,32
1632232,14,1,1999,11,male,96,93,70,757,41,430,30,327,11
1850059,65,16,1948,1,female,645,91,63,740,176,281,129,459,47
2140037,68,12,1945,8,female,541,92,38,743,291,271,86,472,205
1069352,35,31,1978,12,male,280,92,42,811,113,45,45,766,68
1799021,19,15,1994,1,female,474,92,33,829,545,12,134,817,411
1363523,62,14,1951,6,female,795,91,65,903,332,24,277,879,55
1527796,51,2,1962,1,female,222,92,58,891,675,43,94,848,581
1866919,23,25,1990,7,female,205,91,60,931,278,673,58,258,220
1428110,33,6,1980,11,female,275,91,72,985,81,985,69,0,12
1635212,55,22,1958,12,female,1468,92,48,973,282,973,219,0,63
1278460,58,29,1955,9,female,1245,93,48,941,383,941,207,0,176
1585544,38,11,1975,3,female,389,91,57,1053,89,1048,37,5,52
1788679,57,11,1956,9,male,171,91,67,1160,679,505,293,655,386
1432163,21,13,1992,10,female,414,92,55,1282,1013,713,585,569,428
1609226,34,1,1979,2,female,471,92,40,1250,179,1250,114,0,65
2164847,44,16,1969,10,female,225,93,80,1281,541,1281,439,0,102
1792115,26,1,1987,1,male,350,91,53,1520,178,1520,115,0,63
2116622,52,24,1961,6,female,173,91,43,1499,506,1499,380,0,126
1556379,21,10,1992,11,male,420,92,55,1648,622,1511,382,137,240
1400025,25,22,1988,6,female,913,92,49,1807,81,1807,15,0,66
1179423,47,4,1966,10,female,865,91,50,2270,340,417,211,1853,129
2131241,74,14,1939,7,female,1724,92,34,2680,109,178,62,2502,47
1262458,91,30,1922,9,male,566,91,9,11122,2025,10937,1872,185,153
1185459,24,22,1989,11,female,706,91,64,3800,6219,2877,4283,923,1936
1018970,64,26,1949,12,female,285,92,70,8888,445,8888,292,0,153
1270004,108,7,1905,7,male,175,94,82,3,0,3,0,0,0
1448979,19,29,1994,11,male,250,97,66,3,1,3,1,0,0
1586491,19,11,1994,1,female,334,95,28,3,1,3,1,0,0
1041308,63,1,1950,1,male,914,95,62,3,1,3,0,0,1
1457777,19,30,1994,8,male,339,97,27,3,2,3,1,0,1
1082686,20,13,1993,1,female,718,97,71,3,2,3,1,0,1
1775251,28,12,1985,4,male,1468,95,32,3,4,3,4,0,0
1202563,28,21,1985,7,male,685,97,39,3,2,3,0,0,2
1310537,32,13,1981,7,female,187,95,54,3,2,3,2,0,0
1738812,53,12,1960,7,male,794,95,44,3,4,3,3,0,1
1503631,17,21,1996,3,male,33,96,83,3,43,3,39,0,4
1608882,24,5,1989,3,male,259,97,73,3,13,3,11,0,2
2008449,25,24,1988,6,female,672,97,25,3,11,3,9,0,2
1508420,26,10,1987,8,male,146,97,33,3,10,3,7,0,3
1025487,29,6,1984,4,male,1886,97,21,3,12,3,8,0,4
1609576,34,23,1979,12,male,1233,96,20,3,51,3,31,0,20
1879255,43,12,1970,12,male,461,96,65,3,9,3,7,0,2
1248408,65,13,1948,4,female,172,96,80,3,96,3,73,0,23
1039342,83,12,1930,6,male,82,95,58,3,6,3,6,0,0
2086659,32,20,1981,2,male,236,94,45,4,0,0,0,4,0
2010484,20,16,1993,12,male,451,95,71,4,2,0,2,4,0
1301788,33,7,1980,11,male,1063,94,40,4,2,0,0,4,2
2158316,19,28,1994,4,female,316,97,49,4,17,0,7,4,10
1912539,44,6,1969,6,female,284,97,52,4,67,0,29,4,38
1582000,18,13,1995,4,male,306,94,73,4,1,1,0,3,1
1849226,66,2,1947,9,male,483,95,78,4,6,1,4,3,2
1370070,103,29,1910,6,NA,1554,95,38,4,11,1,6,3,5
1909407,52,22,1961,10,male,820,96,28,4,12,3,11,1,1
1943070,16,2,1997,3,male,281,97,91,4,0,4,0,0,0
1486641,19,22,1994,12,female,137,95,85,4,0,4,0,0,0
1290581,19,1,1994,1,female,337,96,59,4,0,4,0,0,0
1135361,21,11,1992,11,male,444,95,15,4,0,4,0,0,0
1739439,22,11,1991,7,male,283,95,86,4,0,4,0,0,0
1413012,25,30,1988,11,male,582,94,41,4,0,4,0,0,0
2183114,31,22,1982,8,male,347,95,76,4,0,4,0,0,0
1458581,33,7,1980,3,male,360,96,82,4,0,4,0,0,0
1953950,33,16,1980,8,male,608,94,36,4,0,4,0,0,0
1755307,22,29,1991,4,male,563,94,39,4,1,4,0,0,1
2023137,52,17,1961,4,male,529,97,55,4,1,4,1,0,0
1235698,107,11,1906,1,male,1488,95,35,4,1,4,1,0,0
1484538,17,1,1996,7,male,351,97,85,4,5,4,4,0,1
1279485,18,24,1995,8,male,523,94,37,4,4,4,4,0,0
2084059,19,18,1994,10,female,938,94,54,4,4,4,4,0,0
2191888,22,27,1991,12,male,1347,94,61,4,5,4,5,0,0
1499321,21,4,1992,3,male,247,95,80,4,5,4,3,0,2
1785073,15,15,1998,9,male,621,96,62,4,9,4,5,0,4
1444970,20,17,1993,2,female,184,94,60,4,12,4,6,0,6
1571213,23,5,1990,3,male,463,96,77,4,12,4,2,0,10
1399437,26,6,1987,11,male,626,97,71,4,9,4,4,0,5
1871430,25,30,1988,8,male,547,94,72,4,9,4,1,0,8
1641876,28,5,1985,7,male,1016,95,70,4,41,4,7,0,34
1595152,51,5,1962,9,female,174,95,66,4,108,4,44,0,64
1133757,56,28,1957,9,female,1291,94,53,4,8,4,5,0,3
1254096,93,24,1920,1,female,1090,95,68,4,16,4,4,0,12
1601203,20,3,1993,3,male,400,94,64,5,4,0,0,5,4
1753473,69,19,1944,1,female,701,97,70,5,5,0,1,5,4
1627607,108,1,1905,1,male,1109,95,36,5,6,0,0,5,6
1823403,19,5,1994,8,male,869,94,54,5,67,0,11,5,56
1897414,55,22,1958,10,male,902,94,68,5,51,0,36,5,15
1074062,60,23,1953,8,male,329,96,58,5,41,0,20,5,21
2008762,21,30,1992,5,male,1079,95,24,5,11,1,2,4,9
1341137,55,3,1958,2,male,84,95,14,5,14,3,10,2,4
1060272,40,5,1973,5,female,560,94,8,5,4,4,2,1,2
1348156,14,25,1999,7,male,61,97,92,5,0,5,0,0,0
1443401,18,6,1995,10,male,593,97,56,5,0,5,0,0,0
1558173,19,18,1994,9,female,241,96,82,5,0,5,0,0,0
1115980,25,27,1988,1,male,290,95,79,5,0,5,0,0,0
1003554,29,24,1984,4,female,317,94,81,5,0,5,0,0,0
1519192,18,2,1995,1,male,377,95,77,5,1,5,1,0,0
1796435,31,9,1982,1,male,1502,97,42,5,2,5,2,0,0
1059306,21,12,1992,12,male,260,96,65,5,7,5,7,0,0
1003597,21,2,1992,6,male,469,97,75,5,14,5,8,0,6
1414475,28,28,1985,9,male,303,96,42,5,29,5,19,0,10
2008570,33,4,1980,9,female,299,94,40,5,33,5,10,0,23
2118890,37,2,1976,8,male,137,96,45,5,13,5,12,0,1
1412240,53,30,1960,3,male,385,96,55,5,25,5,9,0,16
1480594,58,15,1955,1,female,940,94,48,5,32,5,27,0,5
1879597,60,13,1953,7,male,304,95,73,5,37,5,4,0,33
1228862,61,10,1952,8,female,229,95,66,5,26,5,18,0,8
1682875,23,5,1990,11,male,383,94,76,6,0,0,0,6,0
2024090,23,15,1990,12,male,275,96,69,6,0,0,0,6,0
1065449,62,5,1951,1,female,646,96,59,6,0,0,0,6,0
1469005,19,30,1994,6,male,247,95,77,6,12,0,7,6,5
1380560,25,18,1988,5,male,142,96,88,6,67,0,15,6,52
1998235,36,12,1977,8,male,595,97,38,6,75,1,30,5,45
2032618,94,9,1919,7,female,487,94,80,6,14,0,5,6,9
2059982,55,29,1958,9,female,306,95,63,6,87,4,17,2,70
1725154,20,1,1993,2,male,345,96,47,6,7,5,4,1,3
1057626,17,16,1996,1,male,18,96,91,6,23,5,12,1,11
1580508,27,20,1986,5,male,523,97,81,6,14,5,14,1,0
1205087,14,22,1999,9,male,393,97,21,6,0,6,0,0,0
1734435,18,7,1995,7,male,320,95,24,6,1,6,1,0,0
1823954,49,9,1964,12,female,738,94,75,6,2,6,1,0,1
1329964,22,3,1991,11,male,332,96,56,6,4,6,3,0,1
2057456,26,5,1987,7,male,94,94,80,6,8,6,6,0,2
1435242,14,7,1999,8,male,143,97,80,6,11,6,10,0,1
1433443,18,17,1995,10,male,248,94,50,6,11,6,9,0,2
1621680,19,26,1994,8,male,251,95,69,6,35,6,34,0,1
1627372,20,12,1993,2,male,144,96,87,6,62,6,56,0,6
1783376,29,19,1984,10,female,441,96,56,6,15,6,9,0,6
1485317,54,16,1959,1,male,918,97,58,6,48,6,13,0,35
1017887,20,25,1993,1,male,592,94,38,7,8,0,5,7,3
1211924,80,5,1933,3,female,1607,96,49,7,6,0,2,7,4
2000444,54,12,1959,8,female,703,96,52,7,93,0,53,7,40
1024264,108,17,1905,3,female,1043,94,28,7,19,0,13,7,6
2129976,19,1,1994,11,male,749,94,80,7,0,4,0,3,0
1678031,23,22,1990,6,male,535,95,51,7,4,5,3,2,1
1562276,16,30,1997,7,male,147,94,77,7,42,4,13,3,29
1715832,19,9,1994,6,male,526,94,75,7,13,3,4,4,9
1694407,23,12,1990,5,male,265,94,70,7,1,6,0,1,1
2070490,26,22,1987,10,male,852,95,58,7,19,6,13,1,6
1694696,26,27,1987,2,male,452,95,11,7,3,7,2,0,1
1261827,26,8,1987,8,male,85,94,89,7,3,7,2,0,1
1325400,31,25,1982,10,male,769,94,63,7,3,7,0,0,3
1029698,46,7,1967,4,male,412,95,72,7,2,7,2,0,0
1089889,53,16,1960,6,female,685,96,41,7,3,7,2,0,1
1303193,18,26,1995,1,male,338,95,68,7,7,7,7,0,0
1382337,19,1,1994,1,male,29,96,76,7,8,7,8,0,0
1372433,25,23,1988,8,male,636,96,72,7,9,7,7,0,2
2070311,17,6,1996,3,female,70,96,73,7,18,7,9,0,9
2002700,20,24,1993,1,male,335,94,54,7,13,7,3,0,10
1005192,23,1,1990,8,female,225,95,61,7,12,7,10,0,2
2127318,24,30,1989,5,female,269,96,80,7,19,7,11,0,8
1934856,31,29,1982,7,female,59,96,36,7,13,7,13,0,0
2085256,34,29,1979,1,female,315,95,19,7,260,7,91,0,169
1967750,53,10,1960,11,male,290,95,79,7,20,7,6,0,14
1887266,57,18,1956,4,male,1050,97,68,7,11,7,11,0,0
1794496,66,19,1947,7,male,1174,95,35,7,52,7,3,0,49
1103895,38,24,1975,9,female,988,95,16,8,1,0,0,8,1
1223179,31,16,1982,11,male,275,95,65,8,5,1,5,7,0
1176389,42,28,1971,1,male,533,94,56,8,8,0,3,8,5
1837841,51,23,1962,3,female,508,94,51,8,5,0,0,8,5
1447590,70,1,1943,1,male,1027,96,73,8,8,0,4,8,4
1466736,23,3,1990,3,female,649,95,44,8,12,0,5,8,7
1267791,65,10,1948,3,male,983,96,49,8,83,0,16,8,67
1187072,33,3,1980,4,male,1215,96,19,8,1,2,1,6,0
1010615,26,4,1987,7,male,487,96,21,8,10,4,5,4,5
1023085,20,11,1993,11,female,499,94,32,8,18,5,17,3,1
1039060,46,23,1967,8,male,644,94,87,8,5,7,4,1,1
1785652,53,17,1960,11,female,1208,94,40,8,43,6,28,2,15
1220180,23,19,1990,9,female,447,97,8,8,0,8,0,0,0
1775719,25,24,1988,8,male,999,95,68,8,9,8,4,0,5
1755705,38,5,1975,10,male,756,94,69,8,10,8,8,0,2
1182030,19,24,1994,2,female,106,95,63,8,20,8,20,0,0
1865804,19,4,1994,5,male,967,94,61,8,18,8,17,0,1
2116665,22,20,1991,4,female,688,97,53,8,61,8,56,0,5
1936529,26,6,1987,2,male,80,96,48,8,15,8,9,0,6
2156854,49,11,1964,9,male,1489,95,44,8,26,8,19,0,7
1024733,73,17,1940,9,female,301,94,50,9,7,0,1,9,6
1868253,18,16,1995,9,male,91,97,57,9,1,6,1,3,0
1834926,17,30,1996,10,NA,230,96,43,9,6,3,1,6,5
1509101,34,16,1979,9,female,124,95,75,9,98,6,28,3,70
2050240,27,17,1986,1,male,670,96,86,9,4,8,2,1,2
1489033,26,30,1987,1,female,466,97,43,9,40,8,12,1,28
1184354,23,28,1990,6,male,349,95,64,9,0,9,0,0,0
1134949,17,2,1996,12,male,218,97,81,9,3,9,3,0,0
1942563,18,2,1995,6,male,273,94,47,9,3,9,3,0,0
1340611,19,18,1994,10,male,295,97,82,9,2,9,1,0,1
1900061,20,17,1993,9,male,602,95,66,9,5,9,5,0,0
1346073,23,23,1990,11,male,1086,95,48,9,5,9,4,0,1
1997723,33,6,1980,3,male,483,97,70,9,2,9,2,0,0
1583297,19,4,1994,11,female,307,94,83,9,7,9,4,0,3
1764450,20,1,1993,3,male,291,95,68,9,7,9,5,0,2
1806759,53,13,1960,1,male,598,94,65,9,8,9,0,0,8
1140675,25,8,1988,11,female,462,95,72,9,14,9,12,0,2
1588130,25,19,1988,8,male,297,97,31,10,1,0,0,10,1
1643993,18,13,1995,10,female,277,96,35,10,6,0,2,10,4
1347161,21,14,1992,1,female,882,95,63,10,4,1,1,9,3
1619656,50,15,1963,10,male,646,97,61,10,27,0,11,10,16
1606861,66,5,1947,4,male,1602,96,30,10,1,2,0,8,1
1548097,38,7,1975,12,female,328,97,68,10,58,7,5,3,53
1749791,18,23,1995,2,male,250,94,77,10,4,8,3,2,1
1664942,18,23,1995,2,male,263,96,63,10,1,10,1,0,0
2055784,19,12,1994,8,male,353,95,88,10,6,10,3,0,3
2011032,20,25,1993,2,male,222,94,49,10,3,10,2,0,1
1481877,25,1,1988,1,male,90,97,77,10,2,10,1,0,1
1375195,27,15,1986,2,male,525,95,46,10,14,10,3,0,11
1414110,19,19,1994,12,female,346,96,65,10,17,10,13,0,4
2025950,23,2,1990,9,male,221,96,64,10,53,10,42,0,11
2054954,51,23,1962,12,female,223,94,79,10,31,10,27,0,4
1476470,61,7,1952,3,male,398,96,77,10,45,10,37,0,8
1969868,68,14,1945,8,female,829,94,54,10,40,10,23,0,17
2030578,78,16,1935,3,female,1538,95,52,10,44,10,30,0,14
1944490,94,16,1919,6,female,85,95,7,10,45,10,40,0,5
2122824,14,2,1999,4,male,283,94,12,11,1,8,0,3,1
1972647,31,17,1982,4,male,776,94,64,11,1,9,1,2,0
1122793,27,20,1986,4,male,677,94,40,11,0,11,0,0,0
1570114,27,1,1986,7,male,287,97,65,11,1,11,1,0,0
1293866,31,23,1982,8,male,543,96,18,11,0,11,0,0,0
1117231,46,14,1967,3,male,2396,97,43,11,5,11,3,0,2
1599306,57,10,1956,6,male,144,95,73,11,2,11,0,0,2
1704709,34,16,1979,1,male,340,95,6,11,9,11,8,0,1
2132040,19,20,1994,1,male,188,94,44,11,35,11,17,0,18
1721859,24,12,1989,12,female,163,97,53,11,35,11,27,0,8
1307835,23,3,1990,4,male,100,95,78,11,28,11,25,0,3
1379160,28,10,1985,9,male,472,95,31,11,17,11,14,0,3
1357843,35,30,1978,7,male,843,96,69,11,25,11,25,0,0
1523467,16,5,1997,6,male,221,96,86,12,0,0,0,12,0
1179819,55,13,1958,10,male,366,96,61,12,5,0,1,12,4
1590564,66,23,1947,3,male,1320,97,13,12,17,0,9,12,8
1489560,55,8,1958,9,female,791,96,64,12,38,5,12,7,26
1632895,44,1,1969,11,male,419,96,65,12,2,11,2,1,0
2119270,18,10,1995,4,female,327,94,32,12,80,11,38,1,42
1177916,27,30,1986,7,female,89,95,37,12,1,12,1,0,0
1204823,20,8,1993,4,female,432,97,77,12,3,12,3,0,0
2058106,21,25,1992,6,male,37,96,93,12,4,12,4,0,0
1394462,31,7,1982,7,male,432,96,57,12,3,12,2,0,1
1214920,25,18,1988,8,male,89,96,73,12,14,12,13,0,1
1078738,32,27,1981,4,male,572,97,34,12,10,12,2,0,8
1193133,55,31,1958,8,male,1334,95,61,12,12,12,7,0,5
1139206,106,18,1907,12,female,1065,95,60,12,12,12,10,0,2
1357805,17,4,1996,7,male,177,96,62,12,27,12,22,0,5
1560118,50,9,1963,8,female,1550,94,40,12,163,12,108,0,55
1211654,44,18,1969,6,male,519,96,56,13,1,0,1,13,0
1327726,76,18,1937,2,male,292,94,27,13,0,0,0,13,0
2138355,51,9,1962,4,male,714,97,57,13,6,0,1,13,5
1605032,23,13,1990,8,male,368,95,77,13,3,9,1,4,2
1939822,26,8,1987,2,male,492,97,54,13,11,3,5,10,6
2189883,17,27,1996,7,male,316,96,45,13,1,13,1,0,0
1398211,26,1,1987,2,male,587,94,76,13,0,13,0,0,0
1539331,15,26,1998,10,female,391,94,27,13,5,13,4,0,1
1464673,25,24,1988,11,male,358,96,52,13,17,13,10,0,7
2040678,33,13,1980,8,male,673,96,51,13,9,13,9,0,0
2168849,63,1,1950,2,female,451,94,56,13,10,13,7,0,3
2050801,17,26,1996,10,male,158,96,67,13,39,13,13,0,26
1456043,31,30,1982,3,female,366,96,37,13,50,13,34,0,16
1733659,47,28,1966,4,female,326,96,32,13,35,13,31,0,4
1504837,60,10,1953,8,male,1669,97,33,13,55,13,39,0,16
2032903,26,14,1987,4,male,364,97,62,14,1,0,0,14,1
1863901,53,21,1960,11,male,284,96,80,14,8,0,5,14,3
1395395,47,5,1966,11,male,316,94,53,14,16,1,6,13,10
2191449,19,1,1994,1,female,111,95,34,14,72,3,55,11,17
1620921,16,5,1997,1,female,541,94,48,14,1,14,1,0,0
1434760,54,15,1959,8,male,1528,94,43,14,0,14,0,0,0
1844417,17,18,1996,12,female,435,95,73,14,7,14,7,0,0
1952076,17,23,1996,12,female,196,94,61,14,5,14,5,0,0
2039935,16,5,1997,12,female,258,95,33,14,19,14,11,0,8
1455325,22,20,1991,12,male,359,97,58,14,12,14,6,0,6
1990865,24,17,1989,7,male,327,95,56,14,10,14,8,0,2
1799577,26,1,1987,1,male,419,97,37,14,14,14,14,0,0
1190603,97,4,1916,2,female,949,95,14,14,9,14,9,0,0
1748112,65,20,1948,6,female,1215,96,21,14,52,14,42,0,10
1446846,79,7,1934,5,male,927,94,31,15,4,0,2,15,2
1794622,16,11,1997,8,female,445,96,56,15,12,1,2,14,10
1735858,19,9,1994,3,male,85,97,38,15,6,7,4,8,2
1386308,26,17,1987,11,female,442,95,66,15,7,4,3,11,4
1911630,55,2,1958,5,female,1789,96,38,15,39,13,30,2,9
1837259,27,25,1986,1,male,340,97,65,15,2,15,2,0,0
1725964,19,17,1994,8,male,517,94,69,15,3,15,2,0,1
1221275,16,17,1997,8,male,654,96,37,15,20,15,13,0,7
2064273,17,24,1996,8,female,400,95,32,15,12,15,3,0,9
1230418,21,31,1992,8,male,130,95,63,15,15,15,15,0,0
1619901,25,13,1988,3,female,407,94,76,15,24,15,23,0,1
2177252,29,3,1984,10,male,211,95,52,15,60,15,44,0,16
1980238,44,16,1969,1,male,1176,96,36,15,235,15,206,0,29
2141089,24,8,1989,7,female,292,96,33,16,0,0,0,16,0
1031196,59,11,1954,4,female,1603,95,72,16,63,2,17,14,46
1705418,42,14,1971,4,female,170,95,79,16,9,5,7,11,2
1903415,50,28,1963,12,female,1265,96,66,16,59,6,12,10,47
1669708,103,4,1910,7,male,1719,95,36,16,18,13,9,3,9
2150887,16,22,1997,11,male,370,97,55,16,0,16,0,0,0
1393640,23,8,1990,2,male,703,97,48,16,7,16,0,0,7
1891309,22,31,1991,5,male,556,95,46,16,34,16,27,0,7
1678612,25,3,1988,2,male,439,97,57,16,201,16,153,0,48
1279058,36,8,1977,11,male,655,96,75,16,51,16,44,0,7
1679309,42,2,1971,3,female,1046,96,45,16,43,16,5,0,38
1030509,71,12,1942,10,male,350,97,84,17,3,0,1,17,2
1240271,103,25,1910,5,female,1568,96,44,17,105,0,34,17,71
2192658,24,22,1989,9,female,450,97,63,17,5,7,3,10,2
1777797,22,16,1991,5,male,592,96,82,17,0,17,0,0,0
1651669,29,22,1984,6,male,395,96,82,17,2,17,1,0,1
2014859,43,15,1970,5,female,346,96,76,17,0,17,0,0,0
1345007,100,7,1913,6,female,465,96,49,17,9,17,9,0,0
1520443,100,23,1913,8,female,1139,94,46,17,9,17,8,0,1
1455063,17,31,1996,1,male,75,95,82,17,24,17,24,0,0
2111165,29,4,1984,8,female,382,96,35,17,12,17,7,0,5
1997167,47,23,1966,1,female,545,94,39,18,1,0,1,18,0
2019264,76,5,1937,3,female,1072,96,49,18,4,0,3,18,1
1397053,43,29,1970,11,female,303,96,51,18,49,0,17,18,32
1892720,60,20,1953,2,female,172,95,60,18,62,0,13,18,49
1043578,17,1,1996,10,female,579,94,51,18,15,10,7,8,8
1570792,35,11,1978,5,female,1460,95,34,18,32,5,23,13,9
2173926,30,11,1983,11,male,687,95,17,18,55,15,22,3,33
1567292,19,16,1994,3,female,537,94,48,18,2,18,1,0,1
2100808,34,8,1979,7,female,295,94,19,18,1,18,1,0,0
1482542,17,4,1996,5,male,300,96,49,18,10,18,9,0,1
1621493,22,31,1991,10,female,170,96,38,18,13,18,6,0,7
2021975,31,27,1982,5,female,195,96,52,18,335,18,211,0,124
2100447,17,13,1996,1,male,64,96,85,19,10,0,1,19,9
1422948,20,22,1993,2,male,424,97,52,19,10,16,7,3,3
1774015,13,8,2000,4,female,272,97,73,19,6,19,4,0,2
1010277,23,5,1990,9,male,344,96,86,19,9,19,2,0,7
1171834,16,9,1997,3,female,566,97,51,19,18,19,15,0,3
1282866,22,22,1991,1,female,131,96,39,19,21,19,16,0,5
2005236,34,20,1979,12,male,211,97,68,19,84,19,62,0,22
1302211,90,8,1923,4,male,1458,94,28,19,38,19,33,0,5
1761372,23,9,1990,7,female,74,96,68,20,3,1,0,19,3
1053808,64,22,1949,1,female,31,94,79,20,19,0,10,20,9
1803072,68,1,1945,1,male,59,97,88,20,21,0,14,20,7
1423340,61,8,1952,5,female,1064,95,69,20,16,19,7,1,9
1280721,40,23,1973,4,female,376,95,39,20,212,19,52,1,160
2139909,21,2,1992,2,female,235,94,20,20,6,20,0,0,6
1518762,25,4,1988,11,female,483,95,35,20,17,20,14,0,3
1288922,51,5,1962,7,male,117,96,62,20,25,20,15,0,10
1492318,22,1,1991,1,male,539,97,69,20,74,20,51,0,23
1957928,30,15,1983,2,male,132,94,50,20,59,20,42,0,17
1234873,65,15,1948,11,female,2020,95,33,21,17,1,12,20,5
1025123,28,1,1985,1,male,775,96,23,21,2,14,0,7,2
1415686,28,16,1985,2,male,582,96,46,21,12,13,8,8,4
1155449,66,4,1947,8,female,1742,97,41,21,13,15,7,6,6
1010665,64,7,1949,1,male,1316,97,76,21,4,20,2,1,2
1530310,24,20,1989,10,male,550,96,56,21,69,20,10,1,59
2167085,30,13,1983,3,female,323,97,64,21,11,21,10,0,1
1512324,23,9,1990,10,male,323,97,46,21,123,21,30,0,93
1622497,38,7,1975,8,female,276,97,65,21,64,21,49,0,15
1191306,27,16,1986,8,female,324,95,68,22,12,0,6,22,6
2112201,36,8,1977,6,female,463,96,51,22,15,0,4,22,11
1470696,57,30,1956,11,female,525,94,58,22,24,0,13,22,11
1753834,78,1,1935,6,male,931,95,59,22,14,0,5,22,9
1329467,19,6,1994,11,male,147,97,72,22,12,15,9,7,3
1086847,20,19,1993,1,female,329,97,64,22,19,8,15,14,4
1958071,31,14,1982,4,male,187,96,68,22,36,14,23,8,13
2169033,21,7,1992,9,male,542,94,67,22,13,16,6,6,7
1448110,62,3,1951,5,male,1648,94,40,22,14,21,6,1,8
2099322,23,1,1990,7,male,370,96,55,22,1,22,1,0,0
2079216,23,1,1990,9,male,92,97,95,22,3,22,1,0,2
1082205,18,31,1995,7,male,150,95,76,22,11,22,8,0,3
1034534,18,21,1995,10,male,164,97,69,22,5,22,3,0,2
1490675,30,22,1983,4,male,440,94,35,22,7,22,6,0,1
2054383,34,15,1979,8,male,524,94,72,22,4,22,4,0,0
1913879,108,11,1905,3,male,1541,96,37,22,7,22,7,0,0
2054665,47,13,1966,8,female,1438,94,55,22,16,22,14,0,2
1712337,58,3,1955,10,male,205,95,39,23,22,0,8,23,14
2101958,38,3,1975,10,female,758,95,35,23,100,21,60,2,40
1893815,53,18,1960,10,female,1113,95,64,23,1,23,1,0,0
1697646,29,10,1984,11,male,445,97,51,23,8,23,4,0,4
1761820,59,26,1954,7,male,327,96,54,23,7,23,6,0,1
1456698,64,14,1949,3,male,1002,95,36,23,7,23,7,0,0
1350623,24,2,1989,8,male,433,94,28,23,21,23,17,0,4
2102182,67,27,1946,6,female,1479,97,51,23,37,23,17,0,20
2143694,61,7,1952,5,female,999,95,72,24,22,0,12,24,10
2022145,84,13,1929,10,female,2315,94,64,24,57,1,18,23,39
1455443,20,10,1993,5,male,221,96,40,24,13,15,3,9,10
1590533,44,17,1969,3,female,282,95,72,24,253,11,201,13,52
2085463,46,3,1967,2,female,285,96,55,24,22,21,13,3,9
1839416,15,10,1998,1,male,458,96,93,24,0,24,0,0,0
1227576,32,17,1981,4,male,735,95,37,24,0,24,0,0,0
1914494,23,14,1990,11,female,587,96,41,24,10,24,3,0,7
2142485,68,3,1945,1,male,1124,94,37,24,7,24,7,0,0
1055531,15,11,1998,4,female,51,95,15,24,20,24,17,0,3
1547578,18,6,1995,12,female,117,97,42,24,51,24,26,0,25
1892502,23,3,1990,12,female,210,95,67,24,50,24,10,0,40
2164204,24,13,1989,7,male,565,96,68,24,43,24,31,0,12
1202967,30,3,1983,4,male,901,95,59,25,3,24,3,1,0
1483084,17,28,1996,12,male,444,96,56,25,28,21,7,4,21
1678669,18,18,1995,3,male,297,97,72,25,23,21,13,4,10
2092548,34,23,1979,1,female,498,95,55,25,1,25,0,0,1
1600957,17,18,1996,3,female,312,94,65,25,17,25,15,0,2
1409563,16,27,1997,2,female,47,94,83,25,41,25,18,0,23
1007115,14,7,1999,6,male,246,94,49,26,8,0,6,26,2
1746708,20,27,1993,11,male,398,94,32,26,32,23,6,3,26
1279346,26,9,1987,4,male,201,97,55,26,19,22,16,4,3
1451593,20,7,1993,1,male,487,97,47,26,9,26,7,0,2
1400214,41,31,1972,3,male,519,94,61,26,11,26,5,0,6
2140652,20,20,1993,5,male,796,97,42,27,2,0,1,27,1
1260084,19,21,1994,10,male,501,96,71,27,15,0,6,27,9
1200463,38,5,1975,6,male,974,96,52,27,34,7,18,20,16
1675862,57,10,1956,11,female,1446,96,44,27,21,6,4,21,17
1163688,34,24,1979,10,male,696,96,76,27,53,21,25,6,28
1300361,23,4,1990,12,male,246,97,37,27,24,27,18,0,6
1986669,27,4,1986,8,male,190,96,73,27,46,27,46,0,0
1382572,65,17,1948,10,female,324,94,51,27,55,27,54,0,1
1646665,15,12,1998,8,female,370,96,25,28,0,1,0,27,0
2038092,57,8,1956,8,male,295,95,47,28,13,0,11,28,2
1345313,54,29,1959,6,male,551,95,41,28,55,0,13,28,42
1079203,25,29,1988,3,male,699,97,42,28,28,7,14,21,14
1620629,23,30,1990,8,female,639,96,38,28,101,23,69,5,32
1864686,21,27,1992,12,male,584,95,63,28,0,28,0,0,0
1196307,29,17,1984,11,male,1054,94,37,28,5,28,5,0,0
1753773,58,23,1955,11,female,1898,94,34,28,8,28,4,0,4
1886928,34,15,1979,6,male,284,97,65,28,49,28,49,0,0
1881993,61,1,1952,1,male,604,94,54,28,72,28,52,0,20
1339681,33,2,1980,11,male,228,96,85,29,7,5,6,24,1
1651748,108,6,1905,10,male,184,95,76,29,38,26,31,3,7
1170424,21,21,1992,3,male,26,96,85,29,11,29,7,0,4
1163723,31,20,1982,7,male,497,96,26,29,37,29,20,0,17
1134111,50,16,1963,10,male,1696,94,65,31,8,0,2,31,6
1108280,27,21,1986,5,female,773,94,67,30,1,29,1,1,0
1703466,45,17,1968,3,female,557,97,29,31,1,29,1,2,0
1649285,41,26,1972,3,female,553,97,55,31,56,28,25,3,31
1516364,19,28,1994,6,male,384,94,65,31,2,31,2,0,0
2154958,35,30,1978,8,female,214,96,81,31,10,31,4,0,6
1326535,21,2,1992,6,male,94,96,82,31,61,31,38,0,23
1767838,26,1,1987,5,male,252,97,78,31,71,31,55,0,16
1922776,108,7,1905,12,male,1224,95,9,32,5,4,2,28,3
1085715,21,4,1992,6,male,453,97,64,32,13,6,4,26,9
1805495,46,17,1967,3,male,385,95,53,32,13,0,4,32,9
1024353,35,10,1978,11,male,449,97,69,32,12,18,10,14,2
1673672,89,1,1924,4,male,2219,96,33,32,66,15,29,17,37
1037925,48,27,1965,1,female,1227,96,59,32,111,26,81,6,30
1622349,26,3,1987,9,female,614,97,33,32,0,32,0,0,0
1494485,33,23,1980,4,male,225,94,52,32,1,32,1,0,0
1501131,50,4,1963,1,male,1191,96,37,32,0,32,0,0,0
1074356,22,21,1991,8,male,188,94,54,33,35,2,9,31,26
1911965,65,30,1948,12,male,993,97,49,33,38,2,7,31,31
1421207,18,27,1995,10,male,266,97,94,33,7,29,5,4,2
1037139,44,18,1969,1,male,61,94,31,33,133,24,35,9,98
1015387,16,15,1997,4,male,817,95,39,33,0,33,0,0,0
1324350,36,9,1977,9,male,543,97,83,33,30,33,22,0,8
1445336,46,15,1967,2,male,1094,96,9,33,22,33,10,0,12
2135764,66,2,1947,9,male,121,94,0,33,49,33,49,0,0
1884435,32,7,1981,11,female,136,94,18,33,100,33,89,0,11
1529366,61,6,1952,2,female,937,96,17,34,11,2,0,32,11
2033245,20,3,1993,4,male,361,95,33,34,73,12,69,22,4
1570970,39,27,1974,3,male,633,96,81,34,29,28,17,6,12
1359182,21,3,1992,7,male,202,97,64,34,98,34,75,0,23
1482477,34,12,1979,12,male,136,95,80,34,83,34,73,0,10
1888959,52,30,1961,3,female,1611,97,42,34,106,34,80,0,26
1181862,44,18,1969,7,female,314,94,61,36,7,3,4,33,3
2084626,63,16,1950,1,male,794,94,74,36,10,0,3,36,7
2012646,53,9,1960,5,male,524,94,53,35,43,0,7,35,36
1507674,55,10,1958,3,female,620,94,66,36,56,1,43,35,13
1706048,30,3,1983,9,female,326,95,64,35,25,13,9,22,16
1130822,13,23,2000,3,male,203,97,27,36,4,36,1,0,3
1974753,18,28,1995,8,female,277,96,77,36,18,36,17,0,1
2140971,31,12,1982,5,male,604,97,58,36,6,36,6,0,0
1243314,33,27,1980,4,male,548,96,88,35,14,35,10,0,4
2074015,15,3,1998,8,female,295,96,22,36,23,36,23,0,0
2157596,26,2,1987,2,female,347,96,13,35,92,35,87,0,5
1657520,52,27,1961,2,female,1033,94,35,37,33,0,11,37,22
1065255,63,17,1950,6,female,222,96,80,37,39,0,11,37,28
1426203,63,13,1950,10,female,465,94,48,37,46,0,11,37,35
2135833,34,10,1979,8,male,1103,94,46,37,87,28,59,9,28
1928110,43,20,1970,8,female,701,94,43,37,85,29,9,8,76
1403939,19,22,1994,1,female,196,97,78,37,34,37,34,0,0
2020194,85,13,1928,5,male,1293,97,63,39,9,0,7,39,2
1924120,73,1,1940,1,male,1848,94,25,38,24,0,6,38,18
1793666,46,15,1967,7,female,572,95,37,38,6,28,3,10,3
1936656,15,11,1998,11,female,142,97,88,38,156,37,127,1,29
1893596,41,25,1972,10,female,760,94,55,39,70,38,20,1,50
1506690,51,13,1962,5,female,1566,94,41,39,92,36,40,3,52
1985042,28,2,1985,12,male,470,95,67,38,18,38,17,0,1
2003547,33,4,1980,11,female,454,94,67,39,16,39,11,0,5
1054075,38,15,1975,2,male,235,94,20,38,23,38,17,0,6
1385485,100,22,1913,2,male,332,96,59,39,11,39,8,0,3
1872315,59,30,1954,3,male,149,97,68,38,74,38,51,0,23
1644202,17,28,1996,8,female,290,96,66,40,34,13,14,27,20
1917001,71,22,1942,8,male,1725,97,46,40,50,23,9,17,41
2186370,108,14,1905,5,female,281,94,60,40,132,40,98,0,34
1268323,103,12,1910,3,male,508,97,79,41,20,4,9,37,11
1485630,36,29,1977,6,female,696,97,45,41,24,29,3,12,21
1873899,22,14,1991,9,male,529,96,42,41,2,33,1,8,1
1673250,53,15,1960,5,male,689,94,31,42,16,34,9,8,7
1866513,23,14,1990,4,male,708,96,57,42,2,42,0,0,2
2086759,27,2,1986,11,male,426,97,78,42,4,42,4,0,0
1022431,36,15,1977,9,female,529,94,41,41,5,41,3,0,2
1941217,23,17,1990,2,male,528,94,26,43,1,0,0,43,1
2085891,14,27,1999,9,female,102,94,83,44,22,8,16,36,6
1093132,23,26,1990,12,female,371,96,80,43,27,20,10,23,17
1564189,19,11,1994,12,female,668,95,29,43,3,43,3,0,0
2068127,21,15,1992,11,male,380,97,55,44,9,44,5,0,4
1258343,56,21,1957,8,female,346,94,87,43,8,43,6,0,2
2116823,34,21,1979,5,male,1300,97,34,43,102,43,72,0,30
2045102,36,23,1977,2,male,630,96,55,45,3,0,1,45,2
1921076,19,26,1994,12,female,308,97,63,45,6,29,4,16,2
2015384,103,26,1910,6,female,2006,97,54,45,15,44,12,1,3
1678393,23,4,1990,9,male,440,97,72,45,55,35,25,10,30
1995992,54,5,1959,3,female,677,97,49,45,59,39,49,6,10
1350795,30,9,1983,12,male,1103,94,45,45,3,45,3,0,0
1778837,66,25,1947,8,male,798,94,67,45,1,45,1,0,0
1491960,22,15,1991,5,male,285,97,64,45,23,45,23,0,0
2189968,32,3,1981,5,female,255,94,66,47,7,0,2,47,5
1190905,28,1,1985,1,male,468,94,72,46,3,46,3,0,0
1931069,67,11,1946,8,male,138,97,47,46,17,46,6,0,11
1659446,30,12,1983,2,female,259,94,77,47,112,47,94,0,18
1161963,30,19,1983,4,female,618,94,52,47,97,47,74,0,23
1524218,57,27,1956,7,female,1488,97,68,46,110,46,86,0,24
2180974,17,2,1996,2,female,399,95,76,48,50,15,24,33,26
2179781,61,30,1952,9,female,941,96,45,48,111,11,60,37,51
1170766,62,5,1951,5,female,1363,97,39,49,23,41,14,8,9
1614041,15,30,1998,5,female,154,95,79,48,50,46,43,2,7
2098744,19,23,1994,10,male,85,96,44,48,109,43,63,5,46
1900928,33,22,1980,9,female,213,95,82,48,89,47,57,1,32
1360823,53,25,1960,3,female,1141,97,29,48,149,47,71,1,78
1697948,18,31,1995,5,male,276,97,63,49,16,49,14,0,2
1890373,58,25,1955,9,female,1147,96,52,48,63,48,48,0,15
1459719,58,12,1955,9,male,879,96,61,51,1,2,1,49,0
2024660,32,6,1981,5,female,380,96,45,51,12,0,4,51,8
1159626,108,27,1905,7,female,21,97,85,50,31,0,4,50,27
2126734,61,4,1952,3,female,1261,94,54,51,17,27,9,24,8
1471029,34,3,1979,9,female,161,96,56,51,124,50,51,1,73
1687158,49,20,1964,3,female,538,94,71,51,4,51,2,0,2
1165877,18,12,1995,12,male,406,95,80,50,104,50,29,0,75
1833227,32,21,1981,5,female,338,96,40,50,238,50,84,0,154
2107019,62,17,1951,9,female,1404,94,44,52,13,16,9,36,4
2117134,21,10,1992,12,male,434,95,66,52,83,27,42,25,41
2176704,48,23,1965,1,male,327,94,84,53,29,53,22,0,7
1603615,35,18,1978,2,male,1913,94,42,53,33,53,28,0,5
1863995,51,17,1962,11,male,528,94,62,55,3,0,0,55,3
2148449,23,20,1990,12,female,387,96,60,55,15,13,8,42,7
1898676,63,5,1950,12,female,1666,96,57,54,26,21,6,33,20
1527060,64,14,1949,5,female,1537,96,68,55,87,49,62,6,25
1072097,28,10,1985,11,female,295,94,68,55,11,55,7,0,4
1970527,35,1,1978,3,male,162,97,29,54,18,54,17,0,1
1234152,41,6,1972,9,male,152,96,64,55,14,55,2,0,12
2008876,21,10,1992,11,female,200,96,46,58,59,22,16,36,43
1701908,76,12,1937,7,female,1537,96,38,57,36,27,15,30,21
1904817,32,9,1981,9,female,740,97,48,56,113,24,30,32,83
2120739,41,8,1972,7,female,485,95,36,56,156,52,50,4,106
2017326,23,1,1990,5,female,517,95,71,57,63,57,47,0,16
1289384,25,4,1988,1,female,45,94,75,58,105,58,100,0,5
1935776,26,13,1987,12,male,420,96,73,59,45,0,8,59,37
2025034,59,15,1954,6,female,1125,95,68,60,40,0,11,60,29
1743143,34,10,1979,2,female,195,97,85,59,189,59,160,0,29
1755528,37,26,1976,1,male,90,94,59,60,108,60,75,0,33
1900026,32,4,1981,8,male,442,97,49,61,55,0,2,61,53
1427071,52,6,1961,1,male,1834,96,39,63,37,36,12,27,25
1384325,19,12,1994,8,male,813,95,83,63,4,56,1,7,3
1182207,24,18,1989,5,male,39,94,21,61,15,56,8,5,7
1330131,36,17,1977,8,male,37,96,83,63,46,53,28,10,18
2137126,30,30,1983,7,male,168,97,91,63,15,63,15,0,0
1172308,47,27,1966,2,male,293,94,86,61,12,61,12,0,0
1606684,26,22,1987,6,male,647,96,25,63,49,63,33,0,16
2167695,25,23,1988,2,female,88,95,81,63,233,63,147,0,86
2145504,30,10,1983,9,male,301,96,88,65,8,0,2,65,6
1500432,21,26,1992,6,female,253,95,78,65,14,0,2,65,12
2093873,16,1,1997,2,female,94,95,57,65,16,65,11,0,5
2061397,23,1,1990,1,male,370,94,61,65,29,65,25,0,4
1661206,25,1,1988,1,female,274,94,39,64,28,64,25,0,3
1154823,30,24,1983,10,male,300,94,68,65,43,65,43,0,0
1054724,100,6,1913,6,male,531,94,83,65,60,65,35,0,25
1865060,80,6,1933,9,male,1189,95,79,68,39,0,15,68,24
1117279,22,18,1991,8,male,164,94,70,68,61,14,24,54,37
1961440,48,24,1965,10,female,830,96,52,67,95,65,39,2,56
1414361,17,30,1996,1,male,366,97,84,67,7,67,4,0,3
1828632,25,18,1988,1,male,430,97,90,68,28,68,18,0,10
1486476,33,1,1980,1,female,259,96,72,67,22,67,20,0,2
1609207,42,13,1971,3,male,2184,94,63,68,53,68,41,0,12
1945660,39,6,1974,6,female,1990,96,39,67,101,67,69,0,32
1971930,53,23,1960,7,male,937,94,64,67,151,67,132,0,19
1667044,17,15,1996,9,male,145,95,83,71,27,10,22,61,5
2055276,51,3,1962,4,male,628,97,71,70,46,0,12,70,34
1812257,20,17,1993,1,male,15,94,59,70,38,35,8,35,30
1822110,21,1,1992,1,female,699,94,50,71,40,49,16,22,24
1929357,30,22,1983,8,female,257,97,55,70,41,48,26,22,15
1482522,50,3,1963,2,male,1755,94,31,69,143,63,77,6,66
2107330,23,17,1990,11,male,577,96,49,70,76,70,26,0,50
1860631,18,21,1995,8,male,102,95,57,69,116,69,11,0,105
1682886,26,1,1987,1,male,79,94,76,74,41,5,26,69,15
1242957,60,4,1953,11,male,2051,97,20,72,162,1,76,71,86
1121691,22,21,1991,4,female,300,95,44,72,0,68,0,4,0
1444578,15,1,1998,1,male,294,97,72,74,23,56,21,18,2
1000172,27,15,1986,8,male,112,96,76,72,254,70,146,2,108
1206109,47,1,1966,1,female,1045,94,27,73,159,72,48,1,111
1516475,14,29,1999,7,female,77,95,37,72,5,72,5,0,0
1060306,46,8,1967,11,male,806,95,63,75,47,45,6,30,41
1127266,108,28,1905,9,male,1579,96,48,75,64,74,44,1,20
2158204,28,11,1985,5,male,135,94,76,76,2,76,2,0,0
1613374,54,9,1959,3,male,1167,97,45,77,116,77,92,0,24
1269565,17,13,1996,9,female,141,95,81,79,39,4,19,75,20
1261676,21,20,1992,11,female,199,95,29,78,164,50,36,28,128
1720443,39,28,1974,2,female,303,97,78,80,50,70,34,10,16
1012134,18,27,1995,1,male,171,96,37,79,77,79,59,0,18
1225564,31,22,1982,7,female,446,94,49,80,113,80,67,0,46
2035423,23,3,1990,3,male,169,94,32,84,159,44,69,40,90
1553103,18,7,1995,7,female,195,94,38,81,32,81,29,0,3
1730227,18,10,1995,8,male,289,95,45,83,33,83,22,0,11
1511216,25,1,1988,1,female,17,95,38,83,66,83,57,0,9
1657689,59,6,1954,9,female,1307,94,75,84,93,84,68,0,25
1767221,63,6,1950,8,female,2339,95,34,84,79,84,63,0,16
1296321,108,21,1905,2,male,1046,95,62,84,122,84,65,0,57
1301097,35,7,1978,8,female,1002,96,63,86,102,76,57,10,45
1860820,36,7,1977,10,female,539,97,37,85,66,84,26,1,40
2176379,46,9,1967,9,male,185,95,60,87,30,87,18,0,12
2159000,21,9,1992,10,female,515,96,82,87,63,87,52,0,11
1856968,58,29,1955,7,female,1750,97,35,91,33,0,17,91,16
1846067,29,16,1984,5,male,278,95,27,91,71,60,40,31,31
1976753,20,14,1993,2,male,434,96,26,88,83,87,63,1,20
1017841,17,2,1996,4,female,279,94,75,89,11,89,11,0,0
1877102,39,15,1974,6,male,732,95,67,90,0,90,0,0,0
1731504,65,22,1948,12,female,747,94,52,90,11,90,6,0,5
1969678,34,12,1979,5,male,482,96,80,91,21,91,19,0,2
1683511,35,23,1978,3,male,456,97,62,88,27,88,6,0,21
1229045,59,23,1954,2,female,127,96,82,88,22,88,14,0,8
2038488,29,26,1984,3,female,337,97,44,88,70,88,62,0,8
1116252,28,14,1985,8,female,525,95,64,89,164,89,125,0,39
2138912,18,10,1995,9,male,11,95,75,93,184,12,101,81,83
1614710,41,17,1972,6,male,1337,96,32,93,112,64,22,29,90
1940269,64,9,1949,5,female,1533,94,48,92,527,21,332,71,195
1915593,104,8,1909,12,female,1354,94,37,93,57,90,37,3,20
1716592,17,27,1996,6,female,100,94,69,93,0,93,0,0,0
1280534,31,23,1982,8,male,651,97,70,94,80,94,57,0,23
1899177,25,12,1988,4,male,460,96,76,96,45,69,33,27,12
1155059,51,4,1962,7,male,777,94,39,97,53,28,39,69,14
1824759,43,26,1970,5,female,220,96,71,99,112,95,69,4,43
1857450,26,3,1987,7,male,49,95,92,99,0,99,0,0,0
1784117,29,28,1984,2,male,579,97,60,97,0,97,0,0,0
2005348,63,22,1950,4,female,420,97,72,97,25,97,9,0,16
1519868,61,21,1952,12,male,732,97,60,97,61,97,19,0,42
1758284,72,31,1941,1,female,915,95,28,96,59,96,50,0,9
1509374,56,16,1957,10,female,411,96,68,102,42,7,23,95,19
1349321,66,9,1947,3,female,601,95,46,100,25,0,18,100,7
1494779,46,17,1967,7,female,346,94,63,100,69,20,25,80,44
1922610,62,11,1951,12,male,559,97,32,103,139,63,94,40,45
2137774,35,26,1978,7,female,547,97,61,102,161,22,78,80,83
1320567,44,1,1969,1,male,963,95,32,102,97,86,32,16,65
1320891,18,6,1995,4,female,423,94,49,104,43,104,41,0,2
1568121,21,10,1992,10,female,357,94,43,100,47,100,36,0,11
1540640,33,31,1980,10,male,357,96,40,100,19,100,19,0,0
1633394,26,6,1987,4,male,202,96,89,104,107,104,103,0,4
1648246,26,27,1987,10,female,299,94,69,102,152,102,79,0,73
1450452,27,21,1986,3,male,252,97,54,106,4,4,3,102,1
1184775,58,16,1955,12,female,937,95,47,109,22,8,12,101,10
1818246,68,11,1945,3,female,1495,94,62,108,80,0,27,108,53
2156352,25,3,1988,3,female,385,94,51,109,64,31,25,78,39
1000620,56,2,1957,5,female,1352,97,60,108,261,65,197,43,64
2175714,38,16,1975,6,male,298,95,19,105,0,102,0,3,0
1218038,30,20,1983,12,male,597,96,82,105,46,90,36,15,10
1761582,68,25,1945,8,female,1617,95,36,106,93,92,36,14,57
1089457,29,7,1984,3,male,601,96,50,109,33,109,32,0,1
2010390,50,25,1963,5,female,1713,94,23,107,53,107,45,0,8
1737970,56,1,1957,5,male,135,95,85,110,27,0,1,110,26
1626913,68,10,1945,6,male,503,97,50,112,32,0,10,112,22
1532631,66,4,1947,7,female,1834,94,39,112,74,0,60,112,14
1011133,20,17,1993,12,male,194,97,62,111,52,77,25,34,27
1258526,31,13,1982,5,female,440,97,77,112,20,103,16,9,4
1148966,16,22,1997,1,female,202,97,69,113,8,112,8,1,0
1959850,20,14,1993,12,female,659,96,45,112,86,112,83,0,3
1904726,62,12,1951,7,female,450,94,35,110,269,110,72,0,197
1602595,21,6,1992,11,female,227,97,89,119,6,10,0,109,6
1521499,32,30,1981,10,female,104,97,91,118,96,4,58,114,38
1645713,42,28,1971,7,female,174,96,44,116,135,65,76,51,59
1445481,46,4,1967,10,female,910,97,49,116,119,79,95,37,24
1175462,18,3,1995,1,male,243,97,65,119,77,110,35,9,42
1070829,26,28,1987,4,male,178,94,66,114,14,114,3,0,11
2086621,26,15,1987,8,female,300,97,33,116,2,116,2,0,0
2144104,33,2,1980,7,female,737,96,21,115,7,115,6,0,1
1623875,42,8,1971,4,male,383,95,38,117,3,117,3,0,0
1255902,43,10,1970,11,female,766,95,49,114,101,114,58,0,43
1619408,61,14,1952,4,female,714,96,53,121,52,0,24,121,28
1049254,66,5,1947,5,female,1112,97,55,124,27,9,5,115,22
1096313,62,7,1951,5,female,1749,95,48,122,129,0,67,122,62
1511033,59,16,1954,4,female,1870,96,27,121,56,104,35,17,21
2083493,35,5,1978,12,male,371,94,89,124,6,124,4,0,2
1677011,50,3,1963,12,male,631,94,36,129,74,0,2,129,72
1115464,63,28,1950,12,female,384,97,40,125,39,0,11,125,28
1964958,40,16,1973,12,female,732,95,33,129,483,97,268,32,215
1322251,24,6,1989,2,female,960,96,70,130,17,130,9,0,8
1471256,23,20,1990,3,male,589,96,29,127,27,127,20,0,7
1653901,54,18,1959,1,male,548,95,47,127,64,127,42,0,22
1672751,58,21,1955,12,female,2007,96,39,127,44,127,30,0,14
1856588,20,1,1993,1,male,286,94,59,127,101,127,53,0,48
1800459,36,26,1977,12,male,371,96,68,135,56,79,36,56,20
1173114,49,9,1964,7,female,781,95,53,131,120,113,100,18,20
1961902,26,26,1987,11,male,306,94,76,132,158,131,133,1,25
1533693,26,18,1987,12,male,527,94,83,134,13,134,11,0,2
1438795,41,21,1972,2,female,775,95,66,131,18,131,8,0,10
1019135,26,13,1987,6,male,87,97,80,134,34,134,16,0,18
1376213,71,31,1942,7,male,71,95,37,137,24,1,10,136,14
1147238,42,28,1971,1,female,443,97,21,137,17,102,9,35,8
1052318,63,18,1950,6,female,529,97,72,141,43,140,20,1,23
1601284,27,15,1986,5,female,297,96,50,140,145,140,41,0,104
2002813,67,3,1946,10,female,860,94,53,150,6,0,1,150,5
1434411,32,17,1981,2,female,574,97,33,144,51,140,34,4,17
1909581,53,29,1960,11,female,1403,95,59,144,59,141,42,3,17
1662984,34,25,1979,3,male,181,94,63,148,94,130,64,18,30
1124387,23,7,1990,8,female,173,94,91,149,47,148,40,1,7
2101726,28,28,1985,12,female,87,94,28,145,188,145,168,0,20
2176662,48,30,1965,4,male,724,94,42,156,67,156,37,0,30
1220083,25,7,1988,6,female,181,95,72,156,161,156,157,0,4
1478517,42,15,1971,8,male,205,94,51,154,208,154,137,0,71
1719852,49,18,1964,8,female,2207,95,47,155,185,155,119,0,66
1407444,18,10,1995,8,male,180,95,23,159,22,0,0,159,22
1041963,26,9,1987,9,male,265,95,70,163,51,18,28,145,23
1036658,59,11,1954,6,female,1326,95,48,164,63,11,38,153,25
1468833,71,10,1942,5,male,714,94,48,160,118,0,24,160,94
1772800,26,23,1987,3,male,364,94,41,162,326,4,17,158,309
1308474,23,16,1990,9,female,320,97,23,159,67,70,43,89,24
1299455,24,8,1989,9,male,332,96,80,162,46,116,8,46,38
1720207,14,19,1999,5,female,613,95,57,159,74,151,52,8,22
1583710,53,4,1960,2,female,1639,97,69,161,30,157,23,4,7
1704826,30,30,1983,5,female,131,96,63,160,264,160,178,0,86
2096203,22,1,1991,10,female,218,95,75,167,25,167,18,0,7
2163114,14,21,1999,9,male,58,94,75,168,80,168,61,0,19
1771716,40,13,1973,3,male,580,94,37,166,50,166,32,0,18
2147468,52,18,1961,10,female,29,96,74,167,49,167,27,0,22
1963439,54,16,1959,9,female,386,97,41,171,102,171,67,0,35
1316368,22,22,1991,9,female,43,94,87,173,74,127,39,46,35
1787207,25,5,1988,2,female,726,94,54,180,90,175,73,5,17
1405006,33,9,1980,3,female,284,96,28,176,156,153,50,23,106
1408464,21,4,1992,2,female,14,95,37,181,36,181,28,0,8
2166513,52,18,1961,10,female,354,94,63,182,182,0,26,182,156
1838338,83,12,1930,4,male,1094,95,61,183,151,0,43,183,108
1668998,49,27,1964,11,female,1523,97,61,182,174,110,133,72,41
1627827,56,26,1957,7,male,487,94,81,186,32,177,22,9,10
1323520,25,1,1988,2,male,347,97,52,183,233,182,182,1,51
2188251,37,22,1976,11,male,300,96,78,190,12,190,11,0,1
1481995,32,26,1981,8,male,573,96,72,187,68,187,49,0,19
1627367,52,4,1961,9,male,316,95,92,188,94,188,82,0,12
2142364,57,16,1956,6,female,593,94,61,190,54,190,47,0,7
1744654,51,28,1962,4,female,451,97,82,186,150,186,99,0,51
1084070,62,24,1951,10,male,179,97,71,200,8,0,3,200,5
1197545,55,24,1958,6,female,446,94,63,195,40,0,29,195,11
2171941,101,21,1912,12,male,1669,97,63,195,123,80,63,115,60
1957410,51,6,1962,3,female,555,94,26,194,53,184,16,10,37
1838171,58,16,1955,3,female,90,95,88,196,113,195,76,1,37
2136808,52,1,1961,2,female,503,97,66,196,34,196,30,0,4
1985263,77,4,1936,4,female,584,95,54,211,29,0,9,211,20
1616453,33,20,1980,4,female,193,95,50,202,52,30,23,172,29
1235508,54,13,1959,5,female,1260,96,32,210,90,26,48,184,42
1820430,15,9,1998,4,female,972,95,59,209,2,63,2,146,0
1116886,20,25,1993,6,male,498,96,38,205,69,114,38,91,31
1469182,58,11,1955,8,female,2438,95,36,205,154,119,108,86,46
1866936,32,22,1981,6,female,96,96,66,207,395,77,270,130,125
1491964,25,21,1988,2,female,328,97,82,207,220,199,169,8,51
2051152,15,5,1998,8,female,440,96,21,210,10,210,7,0,3
2144760,68,31,1945,12,female,1911,96,26,205,3,205,3,0,0
1685889,51,9,1962,6,male,500,94,81,210,121,210,78,0,43
1748433,32,1,1981,4,female,47,94,58,211,133,211,70,0,63
2064606,49,14,1964,1,female,781,96,29,216,159,3,40,213,119
1854215,21,19,1992,8,female,1093,95,56,219,55,125,22,94,33
1335490,18,12,1995,8,male,94,94,43,215,6,159,2,56,4
1703984,22,16,1991,12,male,37,94,77,219,267,214,77,5,190
2041246,21,19,1992,3,female,636,97,66,219,410,214,278,5,132
1032435,24,12,1989,11,female,292,94,50,214,593,178,312,36,281
2089912,26,11,1987,5,female,327,95,54,216,133,216,127,0,6
1765632,26,18,1987,8,male,333,97,86,216,271,216,248,0,23
2126356,43,6,1970,6,male,616,94,79,229,15,0,11,229,4
1993943,63,15,1950,2,female,578,96,45,227,2,34,2,193,0
1510577,65,10,1948,4,female,1559,96,35,224,120,7,79,217,41
1985915,62,21,1951,10,female,1696,97,33,225,114,93,68,132,46
1948002,108,1,1905,1,female,2297,96,46,225,67,213,40,12,27
1654321,59,19,1954,10,female,424,95,63,227,300,225,151,2,149
1766408,33,19,1980,6,male,971,97,48,230,75,230,72,0,3
1390231,20,22,1993,6,male,344,95,74,243,78,0,5,243,73
1205091,39,19,1974,11,female,780,94,53,243,58,13,33,230,25
1743288,28,30,1985,11,female,403,94,78,240,244,41,115,199,129
1909431,66,2,1947,2,female,733,96,48,241,274,0,37,241,237
1239957,44,9,1969,4,female,337,96,68,237,93,136,45,101,48
2022670,71,14,1942,5,female,1957,94,50,237,92,84,59,153,33
2099003,39,1,1974,9,male,418,96,69,242,1,242,0,0,1
1930741,51,22,1962,10,male,1073,94,30,235,105,235,56,0,49
1512203,45,20,1968,3,male,397,96,69,252,15,19,2,233,13
1316214,26,14,1987,2,male,455,97,44,254,92,0,35,254,57
2103805,55,12,1958,9,female,1600,96,25,258,75,130,22,128,53
1583776,23,15,1990,7,male,725,96,62,250,17,239,5,11,12
1198308,49,24,1964,1,female,2063,95,66,250,0,231,0,19,0
1164102,52,16,1961,9,female,1386,94,48,250,227,243,171,7,56
1297384,24,26,1989,2,female,153,95,59,252,151,252,114,0,37
1615884,70,24,1943,8,male,758,97,58,258,281,258,142,0,139
1591797,63,11,1950,6,female,1675,96,72,271,45,0,16,271,29
1418477,56,14,1957,8,female,205,94,69,261,58,1,13,260,45
1561584,44,8,1969,5,female,1707,96,30,269,115,181,52,88,63
2188115,24,10,1989,1,female,392,94,45,266,369,114,161,152,208
1458262,51,3,1962,12,male,585,95,56,275,233,78,148,197,85
1125184,67,18,1946,4,female,1772,97,36,268,71,268,48,0,23
1855771,26,26,1987,1,male,349,94,43,262,272,262,171,0,101
1664332,50,8,1963,12,female,105,94,37,267,264,267,237,0,27
1532454,21,20,1992,8,female,374,95,64,279,52,47,12,232,40
2003281,21,5,1992,2,female,410,94,63,279,90,91,32,188,58
2001188,44,17,1969,3,female,1688,96,53,284,217,205,151,79,66
1927222,50,24,1963,9,female,625,97,51,290,61,259,44,31,17
1969581,23,11,1990,2,male,347,97,90,280,25,280,24,0,1
1679552,55,21,1958,5,female,820,97,7,280,98,280,63,0,35
1968152,36,17,1977,2,male,76,95,73,287,460,287,422,0,38
1219858,56,1,1957,8,female,795,94,50,295,76,0,21,295,55
1400295,29,14,1984,9,female,443,97,60,307,135,307,109,0,26
1503202,35,16,1978,2,female,652,97,65,299,202,299,189,0,13
1645630,52,1,1961,5,male,209,94,78,297,244,297,208,0,36
1869784,46,5,1967,10,male,491,95,55,325,108,0,51,325,57
1549498,59,20,1954,7,female,823,95,59,322,29,265,22,57,7
2084572,26,13,1987,12,female,832,95,34,315,344,246,200,69,144
2129999,28,13,1985,4,female,366,95,68,322,359,315,296,7,63
2074621,39,10,1974,1,male,11,96,88,311,217,257,130,54,87
2015745,19,18,1994,9,male,641,96,58,316,188,316,178,0,10
1630816,35,26,1978,8,male,530,97,34,326,127,326,86,0,41
1680642,41,10,1972,1,male,434,97,67,327,165,327,117,0,48
1573018,37,4,1976,2,female,471,94,57,325,858,325,778,0,80
1856874,49,3,1964,3,male,249,96,50,346,386,17,255,329,131
1484308,16,21,1997,9,female,508,95,54,345,202,221,62,124,140
1262684,15,31,1998,3,male,240,95,28,328,10,311,8,17,2
1009039,63,1,1950,6,male,1236,95,60,330,109,276,81,54,28
1390607,57,3,1956,1,male,297,97,57,368,9,0,3,368,6
1516132,54,22,1959,1,female,363,94,90,350,280,0,31,350,249
1791038,59,22,1954,3,female,129,96,64,350,480,0,72,350,408
2142660,21,9,1992,9,male,799,97,56,368,419,212,343,156,76
2039058,15,22,1998,9,female,270,97,50,381,9,2,5,379,4
1135355,41,28,1972,10,female,508,95,56,379,382,365,302,14,80
2085327,23,17,1990,7,female,641,97,64,382,727,365,363,17,364
1056511,25,8,1988,8,female,251,94,36,371,58,370,44,1,14
1491954,39,20,1974,6,male,380,94,69,390,257,388,172,2,85
1416493,17,18,1996,7,female,111,96,67,393,11,393,10,0,1
1271618,37,22,1976,4,male,117,96,82,380,1,380,1,0,0
1308762,21,18,1992,11,male,53,94,84,385,98,385,71,0,27
1942016,44,11,1969,3,male,192,96,81,377,91,377,76,0,15
1417270,21,19,1992,4,male,94,94,75,372,313,372,244,0,69
2144565,67,22,1946,3,male,692,95,49,407,17,0,13,407,4
1978444,23,5,1990,4,female,123,96,72,416,456,156,142,260,314
1962196,21,28,1992,4,female,146,94,71,414,27,405,23,9,4
1978450,24,23,1989,12,male,205,95,72,401,1,395,1,6,0
1488419,20,13,1993,2,male,97,97,73,416,81,413,49,3,32
1594399,45,25,1968,9,female,1698,95,39,411,213,408,83,3,130
1169044,47,26,1966,12,female,369,95,58,420,344,420,92,0,252
1024578,56,10,1957,9,female,373,97,71,427,62,0,20,427,42
1401336,46,9,1967,9,female,1113,95,57,441,337,41,165,400,172
2067113,108,19,1905,5,female,192,94,69,432,134,254,66,178,68
1226394,47,12,1966,5,female,1186,96,25,432,324,388,158,44,166
1254643,55,26,1958,5,female,430,97,77,422,368,311,234,111,134
1682908,67,7,1946,4,female,863,97,36,433,103,430,51,3,52
1340057,47,5,1966,3,female,210,95,49,427,427,427,391,0,36
1845749,48,26,1965,6,female,219,97,82,472,22,0,12,472,10
1931739,20,27,1993,6,female,576,95,66,456,486,9,267,447,219
2044228,23,17,1990,3,female,420,94,28,477,471,90,226,387,245
1976884,37,14,1976,1,female,433,96,33,479,336,137,97,342,239
2124267,67,18,1946,4,female,1332,97,30,494,741,1,191,493,550
2156625,35,4,1978,11,female,498,95,60,490,92,167,57,323,35
2175428,21,13,1992,12,female,379,96,47,514,656,247,152,267,504
1672803,19,28,1994,10,male,429,96,72,490,198,440,184,50,14
1379277,34,20,1979,11,male,79,97,70,509,135,415,107,94,28
1124401,51,21,1962,10,female,577,95,9,516,292,431,229,85,63
2068896,65,27,1948,10,female,344,94,80,506,15,506,11,0,4
1571106,25,27,1988,8,female,295,95,35,494,190,494,154,0,36
1838120,69,2,1944,9,female,1453,94,54,541,215,0,98,541,117
1774973,67,28,1946,4,female,397,95,72,521,114,269,46,252,68
1920684,26,11,1987,3,female,224,94,29,552,147,545,90,7,57
2045732,29,15,1984,10,female,547,96,87,524,165,524,152,0,13
1689109,53,13,1960,5,female,265,94,68,574,334,0,21,574,313
1669792,19,29,1994,3,female,228,94,48,602,38,602,29,0,9
1998787,30,21,1983,3,male,409,97,65,562,362,562,333,0,29
1584330,39,15,1974,8,female,185,94,78,647,369,556,300,91,69
1363585,52,2,1961,5,female,276,97,58,639,239,639,172,0,67
1231743,70,8,1943,4,male,692,94,78,679,23,0,14,679,9
1401073,35,14,1978,5,female,99,96,62,685,411,149,159,536,252
1425656,49,13,1964,5,female,382,94,62,688,237,388,92,300,145
1684665,28,16,1985,5,male,787,96,57,690,65,690,35,0,30
1535001,25,1,1988,2,female,455,97,69,671,210,671,174,0,36
1925558,49,23,1964,2,female,613,95,57,749,911,7,171,742,740
1996170,108,13,1905,3,female,1262,96,39,744,576,27,202,717,374
2181750,47,9,1966,2,male,483,95,31,753,183,211,144,542,39
1315185,65,1,1948,8,female,1341,97,39,767,242,767,127,0,115
2173684,42,29,1971,9,male,422,97,70,731,681,731,472,0,209
2026843,49,31,1964,10,male,544,94,41,842,478,0,9,842,469
1120772,53,4,1960,5,female,1198,95,48,835,233,12,155,823,78
1261536,84,19,1929,8,female,1339,97,64,802,274,59,213,743,61
1757054,60,23,1953,7,female,1394,96,38,816,353,790,182,26,171
1120637,66,23,1947,12,female,2127,95,60,874,186,874,41,0,145
1088936,23,14,1990,6,female,144,94,45,888,288,74,158,814,130
1205781,47,4,1966,4,female,699,96,82,886,395,21,175,865,220
1275598,50,5,1963,12,female,1468,95,53,885,269,724,211,161,58
1193113,28,15,1985,8,female,474,94,55,964,347,961,204,3,143
1558781,24,11,1989,1,male,81,97,82,985,460,985,389,0,71
1553507,63,8,1950,3,female,993,97,50,995,506,4,70,991,436
1393434,23,6,1990,9,female,1210,97,24,1115,2343,427,657,688,1686
1962327,59,2,1954,11,male,1003,97,52,1014,136,1000,85,14,51
1637338,47,25,1966,10,female,488,95,55,1225,169,17,109,1208,60
1980245,54,2,1959,1,female,627,94,63,1158,392,0,75,1158,317
1278174,36,11,1977,3,female,460,96,49,1168,195,1168,174,0,21
1539051,20,26,1993,12,male,326,95,76,1447,237,93,82,1354,155
1961248,43,3,1970,8,female,111,96,63,1516,347,64,106,1452,241
2126785,40,17,1973,6,male,372,97,45,1434,417,1337,223,97,194
1798092,22,25,1991,2,male,446,97,78,1827,162,0,31,1827,131
1022110,52,25,1961,4,female,1373,97,47,1669,257,230,139,1439,118
1401034,47,10,1966,10,female,530,94,35,1604,2583,306,1917,1298,666
1668381,18,1,1995,1,male,182,94,33,1822,468,749,114,1073,354
1757620,16,4,1997,12,male,345,94,56,1710,68,1696,54,14,14
1567375,18,1,1995,3,male,168,96,79,1725,1222,1725,1153,0,69
1717021,28,9,1985,1,female,565,95,65,2137,271,2111,126,26,145
1906113,43,21,1970,7,female,469,97,53,1987,2000,1987,1425,0,575
1997188,48,21,1965,12,male,548,95,73,2395,109,197,50,2198,59
1051982,17,1,1996,10,female,193,94,70,2919,1671,521,202,2398,1469
1998353,58,26,1955,4,male,1656,94,33,3062,200,3057,58,5,142
1374729,22,11,1991,10,male,389,97,65,3037,20,3037,8,0,12
2161050,58,4,1955,10,female,1815,94,50,3842,780,618,263,3224,517
1639116,25,22,1988,9,male,449,98,84,4,0,0,0,4,0
2110492,33,14,1980,4,male,528,100,22,4,0,0,0,4,0
2158971,30,23,1983,10,female,705,99,84,4,1,0,1,4,0
2038478,34,25,1979,6,male,524,98,37,4,2,0,0,4,2
1604725,74,7,1939,6,male,1388,99,23,4,1,0,1,4,0
1116821,23,10,1990,6,male,608,100,59,4,3,0,0,4,3
2138094,23,27,1990,5,male,297,99,96,4,11,0,5,4,6
1593824,37,13,1976,4,male,332,100,46,4,61,0,2,4,59
1805334,78,3,1935,10,female,1150,98,41,4,10,0,2,4,8
1989717,20,18,1993,10,female,304,98,65,4,2,1,1,3,1
1492587,73,4,1940,1,male,1633,100,36,4,2,2,2,2,0
1888596,18,6,1995,4,male,295,100,23,4,0,4,0,0,0
2167479,25,3,1988,3,female,396,100,89,4,0,4,0,0,0
1587741,34,15,1979,4,male,565,98,82,4,0,4,0,0,0
1231179,15,26,1998,2,male,192,98,69,4,2,4,2,0,0
1748676,15,2,1998,3,male,332,98,62,4,2,4,1,0,1
1608498,15,17,1998,10,male,248,98,74,4,2,4,2,0,0
1583197,20,27,1993,9,female,462,100,39,4,1,4,0,0,1
1883021,22,26,1991,2,male,1234,99,71,4,1,4,0,0,1
2020785,26,9,1987,9,female,482,99,46,4,1,4,0,0,1
2025825,28,8,1985,3,male,547,99,83,4,2,4,2,0,0
1095247,40,15,1973,1,male,589,99,73,4,1,4,1,0,0
1301567,22,14,1991,11,male,136,99,70,4,4,4,3,0,1
1759157,26,14,1987,7,male,710,99,28,4,4,4,4,0,0
1151813,16,23,1997,9,female,402,99,18,4,14,4,9,0,5
1484402,18,6,1995,8,female,199,99,80,4,33,4,27,0,6
1549665,23,23,1990,3,male,276,98,72,4,13,4,3,0,10
1674813,28,27,1985,5,female,391,100,49,4,16,4,15,0,1
1898397,29,31,1984,1,female,219,98,41,4,22,4,9,0,13
1537282,34,15,1979,10,female,177,98,45,4,21,4,21,0,0
1639326,38,7,1975,12,male,265,100,75,4,22,4,20,0,2
1545648,42,23,1971,4,male,397,99,54,4,63,4,42,0,21
1704214,74,22,1939,10,female,358,100,60,5,0,0,0,5,0
1978934,36,4,1977,4,male,341,99,59,5,1,0,1,5,0
1582515,52,28,1961,10,male,271,98,92,5,41,0,26,5,15
1261545,18,17,1995,3,female,153,99,87,5,49,2,4,3,45
1623081,29,11,1984,8,male,1563,98,43,5,22,3,9,2,13
2112739,64,23,1949,3,male,240,98,59,5,2,4,2,1,0
1558697,23,15,1990,3,male,629,100,81,5,0,5,0,0,0
1712507,29,6,1984,5,male,734,99,42,5,0,5,0,0,0
1458753,13,2,2000,2,male,63,98,67,5,1,5,1,0,0
1158109,18,12,1995,12,male,58,98,52,5,2,5,2,0,0
1954905,27,21,1986,4,male,351,100,71,5,1,5,1,0,0
2036806,23,1,1990,5,male,391,98,63,5,4,5,4,0,0
1621372,33,23,1980,5,male,223,100,88,5,7,5,6,0,1
1579956,36,3,1977,7,female,446,100,44,5,7,5,2,0,5
1610452,20,3,1993,12,male,259,99,58,5,35,5,29,0,6
1913720,24,27,1989,6,female,388,99,73,5,26,5,16,0,10
1415275,26,11,1987,2,male,356,100,87,5,23,5,23,0,0
1999264,30,28,1983,1,male,490,99,28,5,8,5,8,0,0
1362477,52,9,1961,8,female,1717,100,61,5,28,5,15,0,13
1802159,20,22,1993,1,male,296,99,87,6,0,0,0,6,0
1535609,37,10,1976,6,male,1134,99,43,6,7,0,4,6,3
1369477,15,10,1998,1,male,97,99,57,6,1,3,0,3,1
1871228,23,20,1990,9,male,335,98,79,6,5,3,1,3,4
1403202,26,14,1987,6,male,227,98,51,6,8,3,8,3,0
1190837,34,3,1979,3,female,624,98,55,6,8,4,4,2,4
1596368,31,4,1982,6,female,567,100,29,6,7,5,4,1,3
1093047,29,14,1984,1,female,505,98,36,6,46,5,33,1,13
1450482,22,2,1991,11,male,431,99,61,6,0,6,0,0,0
1820033,33,14,1980,8,male,366,100,23,6,0,6,0,0,0
1970337,34,20,1979,4,male,1419,98,37,6,0,6,0,0,0
1786422,70,8,1943,4,female,1440,100,27,6,0,6,0,0,0
1548954,26,1,1987,1,male,330,98,67,6,3,6,2,0,1
2053971,13,30,2000,8,female,58,100,87,6,4,6,2,0,2
1336258,15,22,1998,7,male,468,99,78,6,4,6,2,0,2
1808344,18,27,1995,8,male,214,100,89,6,4,6,4,0,0
1999021,23,25,1990,11,male,417,100,75,6,7,6,6,0,1
1812288,31,14,1982,7,male,715,99,18,6,5,6,5,0,0
1114671,45,1,1968,6,male,594,99,83,6,4,6,3,0,1
1141543,33,30,1980,1,male,1360,99,46,6,131,6,105,0,26
1730851,55,27,1958,6,female,113,98,81,6,50,6,37,0,13
1250717,32,20,1981,1,male,89,100,84,7,2,0,2,7,0
1973334,21,10,1992,10,male,427,100,71,7,0,2,0,5,0
1561633,20,22,1993,2,male,561,98,82,7,5,4,1,3,4
1813941,50,18,1963,8,female,1013,100,60,7,16,5,13,2,3
2082048,19,9,1994,8,male,397,98,54,7,13,6,7,1,6
1466902,16,14,1997,6,male,393,99,60,7,0,7,0,0,0
1655805,18,13,1995,9,male,117,100,77,7,1,7,1,0,0
2148965,22,2,1991,5,female,465,100,78,7,1,7,0,0,1
1079968,28,25,1985,5,female,1437,98,30,7,1,7,1,0,0
1124351,26,1,1987,1,male,583,98,75,7,4,7,4,0,0
1978021,78,19,1935,11,male,509,99,43,7,3,7,3,0,0
1436638,23,14,1990,11,male,568,99,49,7,10,7,10,0,0
1421360,37,8,1976,1,male,506,100,80,7,5,7,5,0,0
2028968,17,4,1996,4,male,221,99,52,7,83,7,59,0,24
1649754,21,5,1992,11,female,11,99,96,7,16,7,13,0,3
1251789,20,5,1993,1,female,465,100,52,7,14,7,6,0,8
1000824,21,8,1992,6,male,425,99,51,7,28,7,27,0,1
2138843,62,6,1951,6,male,672,99,41,7,33,7,23,0,10
1681606,47,1,1966,5,male,1749,99,60,8,0,0,0,8,0
2093729,15,3,1998,10,female,356,99,92,8,4,0,1,8,3
1684670,53,22,1960,2,female,336,99,76,8,24,1,13,7,11
1821948,58,28,1955,7,male,1462,100,70,8,30,0,1,8,29
1949966,26,9,1987,7,male,639,99,78,8,0,8,0,0,0
1014348,103,22,1910,8,male,1005,98,36,8,0,8,0,0,0
1191518,21,12,1992,6,male,531,100,86,8,4,8,4,0,0
1224903,23,14,1990,12,female,209,100,37,8,4,8,3,0,1
1434423,49,2,1964,9,male,704,99,57,8,3,8,3,0,0
1509916,73,8,1940,8,male,1193,98,43,8,5,8,5,0,0
1891232,21,20,1992,11,female,271,98,57,8,51,8,3,0,48
1362800,21,2,1992,2,male,207,99,55,8,12,8,12,0,0
2131675,16,21,1997,9,female,271,100,81,9,0,0,0,9,0
1498859,50,12,1963,2,male,1113,98,75,9,2,0,0,9,2
1268975,60,16,1953,8,male,534,100,87,9,14,0,8,9,6
1170955,22,9,1991,1,male,186,98,82,9,1,6,0,3,1
2184314,63,25,1950,2,female,2103,100,36,9,65,6,24,3,41
1323947,16,17,1997,3,female,90,99,85,9,89,7,41,2,48
1052390,37,2,1976,12,female,400,100,43,9,66,8,29,1,37
2147962,59,5,1954,12,male,287,99,84,9,0,9,0,0,0
1850179,20,2,1993,4,male,62,99,44,9,2,9,1,0,1
1902651,24,5,1989,10,female,266,100,67,9,3,9,3,0,0
1189679,55,5,1958,9,female,387,99,57,9,2,9,2,0,0
1780494,29,1,1984,8,male,104,98,93,9,7,9,7,0,0
1139771,17,3,1996,2,male,307,99,59,10,1,0,1,10,0
1493150,27,6,1986,6,male,430,100,93,10,0,0,0,10,0
2124707,57,8,1956,1,male,352,100,81,10,5,0,3,10,2
1503272,13,5,2000,2,male,265,100,47,10,16,0,3,10,13
1822647,33,30,1980,3,female,564,100,48,10,21,0,1,10,20
1060746,53,24,1960,2,female,638,99,48,10,24,3,7,7,17
1461565,65,10,1948,11,male,727,99,61,10,5,9,2,1,3
2055711,17,12,1996,4,male,314,99,47,10,0,10,0,0,0
1008072,24,25,1989,6,male,580,100,25,10,0,10,0,0,0
1267811,53,30,1960,5,male,596,98,38,10,1,10,1,0,0
1571050,18,10,1995,11,male,875,98,52,10,2,10,2,0,0
1468479,23,4,1990,11,female,335,98,32,10,40,10,35,0,5
1889515,31,6,1982,6,female,82,99,77,10,43,10,29,0,14
1943633,83,7,1930,12,male,441,98,72,11,2,0,1,11,1
1513399,26,26,1987,3,female,415,100,67,11,109,0,15,11,94
1810758,34,29,1979,3,male,339,100,57,11,155,10,98,1,57
1809261,15,26,1998,6,male,144,99,64,11,1,11,1,0,0
1904660,17,2,1996,8,female,309,98,39,11,9,11,9,0,0
1319436,23,31,1990,5,male,439,100,86,11,36,11,16,0,20
1405469,26,6,1987,11,female,216,99,67,11,39,11,39,0,0
2043216,35,21,1978,4,male,453,100,41,11,51,11,24,0,27
1732648,20,5,1993,9,female,255,98,85,12,0,0,0,12,0
1960614,18,24,1995,1,female,362,100,59,12,5,10,5,2,0
1222894,64,29,1949,6,female,738,99,86,12,1,12,1,0,0
1284601,17,24,1996,11,male,448,98,51,12,3,12,2,0,1
1181561,22,3,1991,1,male,367,98,79,12,6,12,0,0,6
1753099,108,16,1905,7,female,256,100,68,12,2,12,1,0,1
1453216,19,9,1994,7,male,261,100,50,12,14,12,12,0,2
1267147,33,26,1980,6,male,466,99,56,12,64,12,25,0,39
2172756,82,10,1931,6,female,380,99,68,12,70,12,55,0,15
1246539,103,11,1910,9,female,374,100,45,12,53,12,50,0,3
1488812,27,28,1986,4,male,474,100,78,13,5,1,5,12,0
2162621,28,15,1985,3,male,338,98,69,13,37,0,19,13,18
1796223,67,7,1946,11,female,776,98,51,13,145,0,41,13,104
1197668,17,8,1996,7,female,120,100,94,13,17,8,1,5,16
1465564,23,1,1990,1,male,232,100,76,13,1,13,1,0,0
1692130,54,5,1959,8,male,600,98,59,13,12,13,5,0,7
2034053,18,24,1995,3,female,249,98,95,13,55,13,32,0,23
1219802,56,25,1957,7,male,307,100,62,13,29,13,15,0,14
1911072,25,21,1988,9,male,470,98,72,14,1,0,0,14,1
1985045,26,16,1987,1,female,869,100,81,14,18,0,7,14,11
2163198,54,17,1959,8,female,26,98,75,14,34,0,10,14,24
1054107,20,17,1993,12,male,310,100,50,14,2,10,2,4,0
1098812,37,15,1976,4,male,1174,98,41,14,2,14,2,0,0
2066956,40,3,1973,11,female,860,100,59,14,0,14,0,0,0
1621200,19,17,1994,3,male,337,100,87,14,5,14,5,0,0
1321964,16,15,1997,12,female,239,99,67,14,11,14,10,0,1
1830627,69,11,1944,12,male,1184,100,34,15,9,0,0,15,9
2031246,33,29,1980,6,male,394,100,61,15,12,0,6,15,6
1548364,65,15,1948,5,male,479,100,75,15,12,0,6,15,6
2127841,50,23,1963,9,male,699,99,39,15,1,7,1,8,0
1550170,27,10,1986,2,male,688,100,66,15,8,3,5,12,3
1078119,69,19,1944,1,male,1353,98,36,15,28,9,12,6,16
1977124,22,12,1991,11,male,294,98,94,15,1,15,1,0,0
1215854,26,2,1987,1,male,503,98,65,15,0,15,0,0,0
2093018,28,1,1985,7,male,723,99,59,15,8,15,8,0,0
1262334,22,21,1991,5,male,318,100,41,15,98,15,72,0,26
1164490,44,12,1969,12,female,391,98,93,16,0,0,0,16,0
1918438,45,1,1968,7,female,254,99,69,16,8,0,0,16,8
1516540,28,1,1985,9,male,221,99,82,16,10,0,1,16,9
1514346,35,1,1978,3,male,422,100,62,16,11,3,4,13,7
1843829,16,28,1997,4,male,96,98,72,16,2,16,2,0,0
1377554,35,9,1978,1,male,80,99,91,16,7,16,7,0,0
1864978,25,5,1988,3,female,413,98,66,16,19,16,19,0,0
2137382,36,11,1977,2,male,615,98,71,16,17,16,4,0,13
1066514,50,25,1963,4,female,2200,100,29,16,35,16,26,0,9
1833455,54,3,1959,7,male,2012,99,9,16,57,16,46,0,11
1586887,15,21,1998,5,female,261,100,65,17,5,2,4,15,1
1719763,25,10,1988,7,female,429,99,67,17,23,0,5,17,18
1498752,41,4,1972,12,female,364,99,73,17,13,0,3,17,10
2082947,19,4,1994,9,male,569,100,68,17,0,8,0,9,0
1446631,27,15,1986,4,male,673,98,57,17,2,9,2,8,0
1265272,56,24,1957,7,male,739,99,44,17,0,10,0,7,0
1988161,54,12,1959,9,male,1130,98,73,17,16,15,10,2,6
1509725,21,21,1992,5,male,446,99,23,17,1,17,1,0,0
2186917,30,2,1983,10,female,509,100,10,17,0,17,0,0,0
1138366,18,6,1995,1,female,274,99,55,17,9,17,6,0,3
1785411,32,12,1981,11,female,348,100,69,17,22,17,5,0,17
1186322,24,22,1989,5,female,693,99,42,17,34,17,34,0,0
2044654,36,25,1977,5,male,480,99,57,18,4,0,1,18,3
2116636,69,7,1944,1,female,656,100,36,18,6,0,4,18,2
1311383,15,10,1998,9,male,82,98,80,18,2,10,1,8,1
1876494,21,22,1992,11,male,126,98,75,18,64,14,31,4,33
2112926,21,16,1992,8,female,240,100,33,18,10,18,9,0,1
1818583,27,20,1986,8,female,426,99,78,18,8,18,7,0,1
1958263,38,25,1975,1,male,494,99,70,18,8,18,8,0,0
1057696,20,18,1993,8,male,344,99,83,18,17,18,13,0,4
2155697,75,11,1938,10,male,1390,99,42,19,56,0,1,19,55
2119076,23,15,1990,3,male,449,98,94,19,7,6,4,13,3
1514968,21,10,1992,4,male,90,98,85,19,19,13,12,6,7
1878533,44,27,1969,5,female,1288,99,62,19,94,6,38,13,56
1799257,68,25,1945,11,male,2366,100,50,19,36,14,21,5,15
2048883,15,17,1998,7,female,603,98,45,19,0,19,0,0,0
2062569,17,16,1996,5,female,188,100,58,19,0,19,0,0,0
1239829,25,1,1988,1,male,171,98,96,19,0,19,0,0,0
1521610,21,28,1992,3,female,427,100,16,20,0,0,0,20,0
1325087,48,15,1965,8,male,1414,100,48,20,16,0,4,20,12
1567429,49,23,1964,7,male,484,100,70,20,18,2,5,18,13
2025679,78,15,1935,7,male,1393,98,61,20,16,18,13,2,3
1099505,23,28,1990,2,male,195,100,60,20,9,20,8,0,1
1149193,23,20,1990,10,male,513,100,76,20,5,20,3,0,2
1658819,32,15,1981,11,female,1217,100,48,20,42,20,28,0,14
1950040,57,17,1956,9,female,2114,100,59,21,170,4,135,17,35
2148196,34,13,1979,11,male,544,98,73,21,1,21,0,0,1
1490171,67,12,1946,9,male,62,99,14,21,2,21,1,0,1
1218878,19,24,1994,2,female,407,98,60,22,21,0,16,22,5
2086872,71,20,1942,7,male,191,98,62,22,66,0,35,22,31
1727898,34,2,1979,2,male,254,100,36,22,4,17,1,5,3
1689232,19,1,1994,4,male,97,98,89,22,0,22,0,0,0
2040783,25,10,1988,8,male,482,98,33,22,0,22,0,0,0
1553935,33,5,1980,9,female,227,98,59,22,2,22,1,0,1
1009062,103,14,1910,2,female,519,99,43,22,11,22,11,0,0
1303666,27,20,1986,8,male,112,100,38,22,24,22,14,0,10
1318369,63,1,1950,1,female,1039,98,29,22,27,22,20,0,7
1200634,22,14,1991,2,female,58,99,82,22,195,22,183,0,12
1127828,64,3,1949,7,male,519,99,77,23,5,0,1,23,4
1420585,36,15,1977,9,female,474,99,21,23,40,17,8,6,32
1399475,18,23,1995,5,male,217,98,63,23,30,23,23,0,7
1434846,42,1,1971,12,male,643,100,58,23,26,23,20,0,6
1451908,19,1,1994,5,male,432,100,77,24,20,0,5,24,15
1431892,23,25,1990,7,female,296,98,76,24,2,14,1,10,1
1563892,17,9,1996,5,male,262,98,76,24,26,23,21,1,5
1527403,23,2,1990,7,male,256,100,46,24,2,24,2,0,0
1777013,17,2,1996,6,male,327,100,88,24,34,24,21,0,13
1933838,18,5,1995,5,female,280,100,58,24,27,24,13,0,14
1587755,100,30,1913,3,female,775,98,44,24,28,24,27,0,1
1848039,21,4,1992,5,male,402,100,45,25,5,14,3,11,2
1599695,111,1,1902,1,male,2353,99,34,25,11,22,11,3,0
1508425,26,19,1987,3,female,428,99,80,25,35,23,28,2,7
2078575,46,7,1967,8,female,1286,98,4,25,22,25,17,0,5
2028009,16,22,1997,7,female,172,99,59,26,1,0,0,26,1
1720182,54,2,1959,6,male,1532,99,72,26,13,0,5,26,8
1717434,16,1,1997,9,male,303,99,75,26,33,9,4,17,29
2051666,26,3,1987,12,female,469,100,35,26,48,14,30,12,18
1001355,14,29,1999,10,female,317,100,56,26,0,25,0,1,0
1357674,19,4,1994,8,male,742,99,58,26,4,23,4,3,0
2135829,18,8,1995,4,male,270,100,96,27,1,0,0,27,1
1202497,40,12,1973,3,male,240,100,43,27,22,0,10,27,12
1167613,24,14,1989,10,male,256,100,88,27,11,18,4,9,7
1888837,26,2,1987,11,female,666,100,27,27,12,20,7,7,5
1409622,15,8,1998,9,male,359,98,34,27,4,27,2,0,2
1284852,49,1,1964,3,female,317,99,47,27,1,27,1,0,0
1339284,19,21,1994,12,male,360,99,59,28,37,0,16,28,21
1835219,56,6,1957,7,male,248,100,88,28,21,0,5,28,16
2041856,19,21,1994,2,male,619,100,56,28,23,20,7,8,16
1193683,40,28,1973,8,female,390,99,57,28,36,9,18,19,18
1759786,37,19,1976,8,female,776,98,80,28,2,22,0,6,2
1573713,21,5,1992,2,male,700,99,82,28,1,28,1,0,0
1535625,27,6,1986,2,male,157,99,93,28,0,28,0,0,0
2122202,41,23,1972,1,male,140,98,78,28,6,28,4,0,2
1568250,26,6,1987,9,male,276,100,67,28,102,28,97,0,5
1192154,27,5,1986,10,female,703,100,62,28,45,28,32,0,13
1742677,23,24,1990,1,male,166,99,82,29,26,0,9,29,17
2157369,108,27,1905,2,female,2112,98,54,29,28,1,17,28,11
1758608,17,2,1996,6,female,629,99,53,29,115,29,41,0,74
2151091,74,7,1939,3,female,1895,98,28,30,3,2,2,28,1
1682256,58,11,1955,10,male,1665,98,47,31,4,17,4,14,0
2084664,63,12,1950,11,male,422,99,78,31,64,21,42,10,22
2122153,25,8,1988,8,female,573,98,66,31,22,24,12,7,10
1632040,25,17,1988,9,female,443,100,52,31,46,25,42,6,4
1427171,16,12,1997,2,male,260,100,54,30,4,30,4,0,0
1623696,18,24,1995,1,male,260,99,75,30,0,30,0,0,0
1166078,19,23,1994,7,male,421,98,61,31,1,31,1,0,0
1397606,20,4,1993,7,female,203,99,44,31,5,31,4,0,1
1631161,17,29,1996,7,male,395,100,82,31,12,31,9,0,3
1923241,21,3,1992,7,male,452,99,52,31,16,31,16,0,0
1817660,18,25,1995,6,male,215,100,69,30,45,30,40,0,5
1995295,53,16,1960,10,male,525,99,71,32,1,0,1,32,0
1492400,30,3,1983,2,male,373,100,87,32,34,30,28,2,6
1328708,19,1,1994,1,male,278,98,63,32,14,32,11,0,3
1459761,35,6,1978,5,male,63,98,65,32,72,32,24,0,48
1678745,70,15,1943,3,male,1536,98,36,32,206,32,129,0,77
1545632,24,2,1989,1,male,469,98,56,33,20,0,1,33,19
1335285,46,3,1967,4,female,781,99,58,33,53,0,33,33,20
1207496,15,2,1998,4,male,622,100,66,33,13,20,9,13,4
1533157,17,9,1996,10,male,545,100,4,33,5,33,5,0,0
1850361,20,24,1993,9,male,182,98,47,33,1,33,1,0,0
1328049,15,1,1998,1,male,164,100,89,34,2,0,0,34,2
1921378,29,28,1984,4,female,447,98,73,34,17,34,11,0,6
1365576,33,20,1980,11,male,1218,99,28,34,24,34,9,0,15
1089460,56,2,1957,7,female,421,99,94,35,2,0,0,35,2
1804576,18,18,1995,12,female,104,100,66,36,24,32,12,4,12
1836668,48,21,1965,2,female,184,98,60,36,66,35,42,1,24
1820858,56,22,1957,11,male,1203,99,45,36,70,35,23,1,47
1804323,24,10,1989,12,male,367,100,87,35,6,35,3,0,3
1241310,30,18,1983,4,male,659,98,56,35,20,35,17,0,3
1069935,13,12,2000,1,male,11,99,61,37,110,10,28,27,82
2009077,23,23,1990,5,male,33,99,82,37,76,31,60,6,16
1815489,38,2,1975,11,male,953,100,42,37,13,37,11,0,2
2071901,57,6,1956,1,male,384,98,70,37,27,37,11,0,16
1352823,45,22,1968,12,male,469,100,69,39,14,0,14,39,0
1337975,59,20,1954,11,male,691,99,44,38,15,0,9,38,6
1638235,31,8,1982,12,male,1237,99,56,39,11,16,7,23,4
1016346,27,8,1986,10,male,139,99,74,39,2,33,1,6,1
2149968,38,22,1975,9,female,421,98,91,39,31,35,13,4,18
1842846,27,21,1986,9,male,738,99,68,39,19,39,9,0,10
1927501,46,20,1967,10,male,172,100,58,38,24,38,22,0,2
1357372,33,4,1980,5,female,572,100,74,38,79,38,62,0,17
1250834,55,2,1958,8,female,897,99,84,40,90,37,67,3,23
1762192,73,25,1940,1,male,1167,100,32,42,4,11,4,31,0
1379093,42,27,1971,3,female,586,99,55,42,13,11,1,31,12
2089153,71,27,1942,3,female,1778,100,77,42,1,41,1,1,0
1411869,33,7,1980,9,male,707,98,60,42,62,36,36,6,26
1041553,19,19,1994,5,male,379,99,56,42,16,42,16,0,0
1064642,24,12,1989,5,female,692,98,40,41,13,41,11,0,2
1367147,15,25,1998,2,male,58,100,90,41,43,41,32,0,11
1963867,42,10,1971,12,male,587,98,58,42,28,42,25,0,3
1719750,50,14,1963,8,male,1557,99,41,42,61,42,47,0,14
2186396,103,22,1910,5,male,840,98,73,42,52,42,29,0,23
1167601,50,4,1963,8,female,1263,98,66,43,25,13,11,30,14
1141185,72,18,1941,8,female,1406,99,60,43,11,28,9,15,2
1078808,52,8,1961,5,female,19,98,95,44,88,24,51,20,37
1687642,44,9,1969,10,female,274,99,92,43,124,41,74,2,50
1010467,15,17,1998,1,male,291,100,76,44,7,44,5,0,2
1691761,46,2,1967,11,female,189,99,50,44,46,44,40,0,6
1281897,31,15,1982,4,female,350,99,39,43,129,43,62,0,67
1205988,30,29,1983,10,female,302,100,21,45,131,35,67,10,64
2077609,18,13,1995,7,male,428,98,74,46,0,0,0,46,0
1451888,96,17,1917,6,male,1100,99,46,46,16,0,9,46,7
2008131,26,18,1987,2,male,330,99,63,47,0,47,0,0,0
1329555,29,6,1984,1,male,174,100,43,47,7,47,7,0,0
1358128,32,5,1981,3,male,546,98,46,46,7,46,7,0,0
1812206,24,6,1989,5,male,320,100,67,47,73,47,47,0,26
1640128,52,28,1961,8,female,473,98,69,48,92,0,63,48,29
2013797,20,6,1993,6,male,421,100,81,49,6,49,6,0,0
1699280,33,26,1980,11,male,506,99,76,48,82,48,80,0,2
2008673,58,30,1955,6,female,1366,100,33,50,132,0,78,50,54
1753149,21,28,1992,12,female,1018,98,77,51,98,23,77,28,21
1933292,20,1,1993,12,male,489,99,56,51,0,51,0,0,0
1044844,33,5,1980,1,male,735,99,20,51,110,51,84,0,26
1130141,22,29,1991,10,male,265,99,76,52,5,0,0,52,5
1846472,54,16,1959,9,male,781,99,26,53,154,52,100,1,54
1493893,30,22,1983,11,male,506,98,68,52,27,52,22,0,5
1758025,67,8,1946,1,male,1326,100,14,54,4,0,2,54,2
1893206,74,29,1939,4,female,1785,100,57,54,11,32,9,22,2
1727036,26,15,1987,2,male,363,100,93,55,0,55,0,0,0
1305596,27,3,1986,7,male,226,99,55,55,26,55,13,0,13
1570702,27,21,1986,11,female,384,98,63,55,54,55,39,0,15
1125883,51,30,1962,10,female,558,98,33,55,78,55,40,0,38
1753484,65,7,1948,9,male,1073,99,53,54,60,54,40,0,20
2136944,17,28,1996,8,male,192,98,68,58,5,58,5,0,0
2001024,19,16,1994,1,male,127,99,73,57,16,57,13,0,3
1030385,26,4,1987,4,male,314,99,63,58,24,58,21,0,3
1713100,41,24,1972,7,female,1225,98,38,58,138,58,114,0,24
1494188,71,17,1942,2,female,1736,99,30,60,35,60,14,0,21
1724109,20,1,1993,6,female,329,99,49,59,47,59,37,0,10
1063366,48,29,1965,5,male,480,100,34,63,37,0,19,63,18
1859863,48,23,1965,7,male,420,100,89,61,54,0,15,61,39
1854984,22,24,1991,10,female,58,100,67,61,93,42,30,19,63
2052783,49,21,1964,7,male,843,100,69,62,4,61,2,1,2
2188521,24,8,1989,1,female,315,98,69,61,29,61,22,0,7
1701208,39,14,1974,2,female,378,99,52,61,16,61,15,0,1
2100823,46,20,1967,2,female,533,98,83,61,30,61,19,0,11
1142026,18,22,1995,1,male,444,100,60,61,123,61,115,0,8
1998229,21,9,1992,9,female,1500,98,28,61,193,61,180,0,13
1121256,49,12,1964,2,female,269,100,83,65,35,3,21,62,14
1701725,36,7,1977,11,male,278,100,78,65,39,65,34,0,5
1931980,21,30,1992,4,female,430,100,70,64,42,64,27,0,15
1741324,31,17,1982,10,male,671,100,73,64,93,64,93,0,0
1887614,51,17,1962,6,male,2216,100,71,64,160,64,125,0,35
2142201,25,9,1988,2,male,370,98,58,68,3,28,3,40,0
1888841,36,31,1977,3,female,263,99,59,66,156,24,38,42,118
1546079,44,5,1969,7,female,229,99,88,68,112,19,52,49,60
1100028,16,15,1997,6,female,14,99,54,67,80,62,80,5,0
1147753,37,25,1976,4,female,625,99,64,67,263,66,206,1,57
1222437,37,22,1976,2,male,1285,99,19,66,3,66,2,0,1
1074351,59,30,1954,11,male,1082,100,70,70,4,0,1,70,3
1439011,17,19,1996,3,male,270,99,36,69,44,63,23,6,21
1109704,66,9,1947,4,female,573,98,48,69,4,69,2,0,2
1564172,60,1,1953,10,female,771,99,46,69,58,69,33,0,25
1731742,103,15,1910,8,male,767,100,43,73,3,47,2,26,1
1125204,48,25,1965,1,female,1176,99,54,74,50,74,25,0,25
1693005,20,25,1993,12,male,43,98,71,72,154,72,128,0,26
1937585,31,29,1982,11,female,162,99,59,75,60,23,44,52,16
2090947,27,27,1986,2,female,629,100,60,77,37,67,17,10,20
1446921,65,12,1948,2,female,1653,98,70,76,27,75,22,1,5
2052229,45,27,1968,9,male,73,100,43,76,65,76,23,0,42
1295101,44,20,1969,9,male,915,98,48,78,0,11,0,67,0
1134902,59,14,1954,3,male,1608,100,40,78,8,0,2,78,6
1526277,22,5,1991,4,male,382,98,57,78,5,39,3,39,2
1498144,58,6,1955,9,female,2306,98,56,80,65,26,44,54,21
2177887,16,6,1997,12,female,114,99,72,79,131,77,82,2,49
2158762,24,7,1989,11,female,246,98,70,78,34,78,34,0,0
2169077,50,16,1963,1,female,604,99,56,79,94,79,55,0,39
1544826,101,10,1912,12,male,1085,98,29,82,42,2,22,80,20
1209430,59,23,1954,10,female,1010,98,72,84,27,53,8,31,19
1924652,38,22,1975,1,female,222,98,56,81,90,80,36,1,54
1256549,25,24,1988,10,female,408,99,43,81,180,81,130,0,50
1449030,77,12,1936,3,female,848,100,64,86,76,14,11,72,65
1875015,17,1,1996,1,female,173,98,76,86,90,83,19,3,71
1314615,26,17,1987,6,female,450,98,60,86,4,86,4,0,0
1741783,27,14,1986,9,female,221,100,54,85,21,85,10,0,11
1497894,28,6,1985,6,female,296,98,94,86,53,86,32,0,21
1570999,74,31,1939,8,female,1709,99,36,89,42,0,16,89,26
1601313,29,19,1984,9,female,146,98,84,88,106,84,63,4,43
1764224,25,20,1988,10,female,438,100,97,89,70,89,52,0,18
2026066,38,16,1975,5,female,641,100,58,91,84,91,83,0,1
1935463,23,11,1990,10,female,377,99,41,90,160,90,124,0,36
1992767,53,10,1960,9,female,234,99,67,92,30,17,12,75,18
1702321,57,6,1956,8,male,591,100,84,93,131,0,61,93,70
1691906,18,12,1995,8,female,153,100,3,92,236,3,62,89,174
1307993,19,17,1994,1,female,406,100,47,94,37,47,29,47,8
2093399,57,31,1956,5,female,37,100,91,93,10,77,6,16,4
1453297,38,14,1975,7,female,408,99,47,93,16,85,9,8,7
1285249,20,19,1993,9,male,455,100,64,94,6,94,6,0,0
1686973,23,25,1990,1,female,567,100,56,94,7,94,7,0,0
1597219,18,9,1995,8,male,110,99,49,95,26,95,12,0,14
1737431,20,3,1993,7,male,509,98,51,94,31,94,26,0,5
1203724,16,1,1997,9,female,824,98,56,96,70,76,40,20,30
1723751,21,21,1992,12,male,137,99,75,99,85,72,68,27,17
1501122,47,5,1966,1,female,656,100,55,98,34,98,18,0,16
2075537,68,18,1945,3,male,1008,100,90,98,33,98,33,0,0
1517385,20,22,1993,7,male,414,99,88,102,14,45,2,57,12
1691055,30,13,1983,1,female,964,98,36,103,100,47,40,56,60
1292078,48,3,1965,3,female,708,99,42,103,193,23,34,80,159
1372658,25,2,1988,4,male,738,100,30,104,77,87,52,17,25
1073490,40,11,1973,10,male,708,100,32,104,94,97,80,7,14
1281699,51,10,1962,12,female,1993,99,40,104,64,82,31,22,33
1751627,33,8,1980,5,female,340,99,72,104,121,103,77,1,44
1906030,73,29,1940,6,female,1526,100,78,104,12,104,11,0,1
1121035,28,26,1985,7,female,475,99,50,104,26,104,18,0,8
1719328,29,28,1984,9,male,411,99,63,105,39,65,29,40,10
1907756,36,7,1977,7,female,170,100,84,107,38,78,32,29,6
1212492,21,1,1992,8,male,101,99,89,107,75,107,65,0,10
1150755,33,3,1980,2,female,445,98,20,107,320,107,256,0,64
1094101,65,1,1948,5,female,444,98,77,110,11,0,2,110,9
2151903,44,22,1969,10,male,362,100,78,111,52,111,14,0,38
2141492,64,6,1949,10,female,579,98,46,119,84,15,44,104,40
1859695,19,14,1994,2,male,59,100,72,114,51,24,39,90,12
1993826,61,22,1952,10,female,1394,100,41,117,96,69,68,48,28
1269960,44,29,1969,5,female,592,100,81,118,202,71,120,47,82
1789951,19,6,1994,1,female,274,98,76,115,12,90,7,25,5
1196063,23,1,1990,7,male,265,100,66,118,10,115,9,3,1
1385626,27,7,1986,4,male,136,99,62,115,32,113,15,2,17
2189666,18,14,1995,11,male,45,98,63,115,22,115,20,0,2
1577110,103,31,1910,12,female,578,98,65,119,23,119,19,0,4
1352778,25,7,1988,2,female,15,100,5,118,127,118,103,0,24
1931981,56,13,1957,9,male,532,100,77,120,3,0,0,120,3
1411058,42,30,1971,8,female,832,98,68,121,64,55,35,66,29
1870532,19,7,1994,12,male,651,99,14,122,54,116,48,6,6
2009960,40,18,1973,5,male,490,98,82,120,37,120,5,0,32
1986954,51,13,1962,11,female,118,99,57,121,68,121,55,0,13
1766366,42,27,1971,2,male,70,98,77,121,75,121,61,0,14
1243263,23,24,1990,5,male,629,99,56,127,229,88,143,39,86
1514684,13,10,2000,2,female,150,100,60,130,68,123,31,7,37
1282787,48,6,1965,4,female,324,100,52,129,16,129,12,0,4
1640144,18,21,1995,11,female,303,100,62,125,35,125,14,0,21
1660728,33,5,1980,7,male,189,99,81,128,38,128,38,0,0
1617421,58,14,1955,6,female,1762,99,55,130,47,130,23,0,24
1279249,76,17,1937,6,female,270,99,76,125,24,125,15,0,9
1779414,42,20,1971,3,female,486,100,67,135,302,115,203,20,99
1351099,24,17,1989,11,female,614,98,72,135,10,135,8,0,2
1031179,33,13,1980,6,male,298,99,60,134,154,134,92,0,62
1407297,55,27,1958,6,female,1215,98,38,132,283,132,233,0,50
1038549,23,13,1990,7,female,147,99,74,138,185,129,76,9,109
1453722,19,1,1994,1,male,249,99,86,137,29,136,23,1,6
1063038,23,14,1990,7,female,35,100,71,137,97,137,80,0,17
1226447,48,10,1965,9,male,602,99,5,149,60,0,28,149,32
1247935,57,29,1956,2,female,319,99,75,148,70,77,35,71,35
2118948,20,8,1993,7,female,787,98,36,148,59,108,20,40,39
1869064,21,8,1992,10,female,39,98,92,146,113,130,36,16,77
1413999,69,25,1944,2,female,207,98,76,144,15,144,12,0,3
1016240,23,28,1990,4,male,273,100,80,146,47,146,20,0,27
1818425,31,16,1982,11,male,339,98,87,150,30,150,7,0,23
2053171,47,5,1966,9,female,444,99,48,145,66,145,50,0,16
1715788,64,13,1949,9,female,357,98,74,150,30,150,30,0,0
1986810,25,26,1988,5,female,1100,98,35,151,34,110,30,41,4
1810224,32,13,1981,12,male,365,98,77,154,37,149,37,5,0
1917952,35,27,1978,5,female,968,98,65,157,124,153,87,4,37
1151365,52,17,1961,3,female,280,99,59,153,93,153,52,0,41
1920481,49,13,1964,1,female,727,98,42,155,143,155,87,0,56
1019136,59,7,1954,1,female,588,99,69,162,60,0,40,162,20
1356710,66,18,1947,12,female,1938,100,60,164,57,6,27,158,30
1988809,108,24,1905,12,female,209,100,79,159,95,0,70,159,25
1813691,30,6,1983,7,male,1156,100,83,159,131,49,90,110,41
1987507,23,12,1990,1,female,288,98,51,166,280,68,70,98,210
1220553,30,11,1983,2,female,609,99,35,172,25,172,10,0,15
1492600,23,20,1990,4,female,266,99,56,165,58,165,50,0,8
1837504,31,16,1982,5,female,774,99,34,167,73,167,60,0,13
1097401,53,10,1960,6,female,1110,100,59,173,53,18,13,155,40
2144381,51,6,1962,6,female,243,100,62,181,215,1,75,180,140
1730167,28,11,1985,7,female,458,98,86,174,74,50,46,124,28
1705914,53,18,1960,5,female,619,100,50,179,22,179,17,0,5
1801002,42,19,1971,9,male,433,98,43,174,54,174,42,0,12
1209320,57,8,1956,8,female,723,98,59,173,32,173,28,0,4
1668642,49,23,1964,6,male,415,99,62,190,29,0,2,190,27
2015537,25,4,1988,1,female,156,98,74,189,233,189,191,0,42
1398565,79,17,1934,12,female,411,98,70,199,110,0,30,199,80
1269396,21,24,1992,3,male,404,99,58,197,129,34,30,163,99
1789193,17,4,1996,5,male,157,99,37,194,23,194,13,0,10
1745185,33,2,1980,2,male,73,98,58,196,95,196,80,0,15
1016849,55,25,1958,8,female,765,99,71,209,64,0,42,209,22
2159610,20,16,1993,9,male,627,98,50,208,84,48,25,160,59
1092819,50,9,1963,5,female,1631,100,51,205,56,46,3,159,53
1791333,21,8,1992,8,female,505,100,71,210,311,187,139,23,172
1331457,55,23,1958,9,female,1011,100,84,202,21,202,12,0,9
1476622,43,5,1970,3,female,217,99,42,208,82,208,46,0,36
1569151,56,13,1957,3,female,832,100,28,220,134,5,36,215,98
1709392,41,6,1972,10,male,266,100,84,220,12,220,10,0,2
2085520,33,15,1980,4,female,234,98,64,218,92,218,72,0,20
1255753,60,9,1953,3,female,1422,99,46,215,102,215,61,0,41
1151808,19,15,1994,2,male,233,99,66,230,66,0,20,230,46
1977633,44,15,1969,7,female,191,98,30,232,68,13,38,219,30
1455683,53,17,1960,5,female,948,99,43,227,44,0,5,227,39
1212714,22,23,1991,7,female,424,99,60,232,28,199,26,33,2
1761096,31,24,1982,9,female,621,98,36,224,320,187,62,37,258
1949346,22,7,1991,4,female,794,98,63,230,86,230,77,0,9
1999637,27,18,1986,2,female,418,98,54,230,110,230,59,0,51
1831148,39,23,1974,7,female,267,98,40,226,43,226,43,0,0
2146357,51,26,1962,2,female,61,99,27,223,68,223,50,0,18
1368981,61,11,1952,3,male,995,100,91,238,16,4,13,234,3
1660952,51,20,1962,6,female,1432,99,37,245,166,90,114,155,52
1789532,52,26,1961,8,female,594,98,37,238,79,234,54,4,25
1938791,31,6,1982,8,female,410,98,63,241,16,241,13,0,3
1282354,68,12,1945,2,female,1559,100,50,246,30,246,11,0,19
1787959,91,31,1922,1,male,693,99,84,242,87,242,80,0,7
1549296,76,19,1937,3,female,251,99,60,243,208,243,158,0,50
1777885,43,28,1970,9,male,947,98,40,254,41,0,9,254,32
1285643,52,2,1961,2,female,1013,98,56,258,43,0,21,258,22
1114593,43,30,1970,3,female,345,99,59,256,302,0,66,256,236
1298807,59,30,1954,1,male,606,100,64,250,532,0,77,250,455
1157250,17,1,1996,1,male,103,98,66,256,142,233,109,23,33
1826625,48,16,1965,5,female,383,98,54,254,121,254,67,0,54
1024655,51,29,1962,5,male,1099,100,72,264,286,13,96,251,190
1732836,30,5,1983,6,male,736,98,84,267,565,211,202,56,363
1033045,32,6,1981,1,male,365,99,48,267,265,267,218,0,47
1858164,36,19,1977,7,female,43,98,76,267,189,267,142,0,47
1739848,67,28,1946,7,female,1379,99,42,292,16,0,10,292,6
2188036,28,14,1985,1,female,39,99,79,290,1,137,1,153,0
1937340,47,8,1966,2,female,708,98,40,289,368,130,191,159,177
2016369,31,3,1982,12,female,675,100,79,278,83,272,82,6,1
1909860,75,8,1938,3,female,1466,98,31,290,57,212,20,78,37
1016076,43,11,1970,9,female,287,100,45,279,6,279,3,0,3
1912553,19,15,1994,10,male,216,99,64,279,72,279,54,0,18
1638073,21,20,1992,3,female,216,98,69,294,334,0,112,294,222
1414624,67,9,1946,7,female,347,100,54,307,24,304,17,3,7
1125849,21,2,1992,2,male,400,98,91,295,4,295,0,0,4
1934422,42,24,1971,12,female,444,99,54,294,30,294,24,0,6
1304256,16,3,1997,5,male,59,100,82,298,89,298,52,0,37
1922438,60,12,1953,6,female,324,98,78,317,316,0,0,317,316
1053704,61,27,1952,9,male,124,98,89,313,0,182,0,131,0
1083182,32,11,1981,11,male,287,100,75,325,40,325,40,0,0
1481488,49,11,1964,4,female,1960,98,56,317,67,317,53,0,14
1686877,49,18,1964,10,male,344,98,74,314,63,314,50,0,13
1766931,52,27,1961,6,female,56,98,71,310,201,310,52,0,149
1045914,60,11,1953,3,female,350,100,82,335,73,0,22,335,51
1886620,49,13,1964,1,female,694,98,67,338,102,165,50,173,52
1397815,25,1,1988,1,female,72,98,84,332,421,328,249,4,172
1483749,38,15,1975,2,female,479,99,68,328,234,309,187,19,47
1897201,27,17,1986,6,male,284,100,56,334,94,334,53,0,41
1757394,59,7,1954,2,female,633,99,47,353,102,1,32,352,70
1224542,21,10,1992,5,female,343,99,57,355,1155,9,474,346,681
1468840,26,1,1987,3,female,131,98,88,347,75,128,36,219,39
2115497,26,3,1987,10,male,1396,98,37,356,40,324,35,32,5
1342922,27,10,1986,10,male,296,98,64,358,179,328,147,30,32
1680263,34,17,1979,7,male,400,98,76,360,98,356,69,4,29
1371826,53,30,1960,7,female,1328,98,44,358,163,269,41,89,122
1623024,77,9,1936,1,female,1477,99,55,360,38,360,27,0,11
1133792,68,16,1945,12,male,972,98,90,367,69,367,61,0,8
1845625,52,27,1961,10,male,1151,98,52,380,58,39,22,341,36
1402930,60,13,1953,3,female,1062,99,37,383,50,380,10,3,40
1927029,54,3,1959,6,female,1039,99,55,392,327,392,269,0,58
1619841,40,18,1973,9,female,365,99,57,418,173,367,99,51,74
1397704,22,14,1991,6,male,440,99,51,416,182,416,178,0,4
1352147,91,1,1922,1,male,14,99,97,414,132,414,26,0,106
2062959,33,24,1980,5,female,194,98,86,441,189,294,95,147,94
1092014,20,22,1993,10,male,521,98,73,432,55,424,39,8,16
1179048,62,18,1951,9,female,870,99,56,453,135,2,39,451,96
2076832,36,10,1977,6,female,390,99,35,454,68,280,41,174,27
1545386,24,29,1989,10,female,334,99,57,474,366,397,140,77,226
1864533,16,25,1997,6,female,221,99,49,481,34,481,32,0,2
2035075,113,23,1900,12,female,1656,100,24,477,117,477,75,0,42
1094369,17,8,1996,7,female,9,98,80,518,78,502,65,16,13
1040711,39,3,1974,9,female,253,99,36,514,193,442,86,72,107
2035347,43,16,1970,11,female,518,99,72,514,129,372,75,142,54
1894989,30,15,1983,4,female,221,100,66,491,567,409,455,82,112
1250921,53,26,1960,6,female,200,98,61,505,74,505,28,0,46
1448538,20,5,1993,10,male,153,100,77,533,707,52,182,481,525
1956349,46,13,1967,6,female,1844,98,45,527,974,176,698,351,276
1851093,16,26,1997,10,female,596,100,48,523,312,467,134,56,178
1766432,20,30,1993,12,female,342,99,45,547,176,529,98,18,78
1614798,64,12,1949,1,female,2252,98,34,552,291,552,222,0,69
1090534,75,5,1938,6,female,1400,99,63,524,345,524,55,0,290
1571667,38,21,1975,2,female,351,100,70,575,927,303,251,272,676
1418146,77,7,1936,12,male,1718,99,30,631,157,0,74,631,83
1061373,26,25,1987,4,female,1672,100,51,614,344,289,208,325,136
1361754,31,3,1982,2,female,211,100,58,633,620,423,102,210,518
2181019,56,3,1957,6,female,1021,100,52,624,268,575,179,49,89
2077335,71,22,1942,11,male,655,98,54,782,292,0,120,782,172
1365286,94,22,1919,9,female,2261,98,29,730,435,18,270,712,165
2088982,68,17,1945,2,female,163,100,35,740,514,0,275,740,239
1096308,20,28,1993,4,female,164,100,89,770,350,723,123,47,227
1410773,56,4,1957,12,male,471,100,34,753,243,647,166,106,77
1165252,33,31,1980,10,male,433,99,26,754,93,754,70,0,23
1915587,42,19,1971,5,male,202,99,58,758,71,758,34,0,37
1580939,21,27,1992,4,male,555,99,48,862,370,551,312,311,58
1223401,16,16,1997,12,female,323,98,56,833,333,833,32,0,301
1556562,44,11,1969,12,female,205,100,48,860,252,860,197,0,55
1557020,39,26,1974,8,female,1099,99,67,821,597,821,478,0,119
2055832,52,23,1961,5,female,174,100,66,926,276,926,85,0,191
1200763,68,17,1945,8,male,150,98,90,958,224,958,215,0,9
2110931,31,6,1982,4,female,108,99,72,941,758,941,631,0,127
1343758,43,29,1970,9,female,899,100,29,1109,477,1031,330,78,147
1298279,52,22,1961,4,female,353,100,85,1097,104,1097,88,0,16
1506476,38,18,1975,3,female,205,98,50,1087,861,1087,729,0,132
2149387,72,11,1941,1,female,139,100,39,1168,41,0,11,1168,30
1451790,23,9,1990,4,male,353,98,71,1154,278,0,46,1154,232
2183339,62,13,1951,10,female,1675,99,59,1254,515,0,68,1254,447
1438065,56,22,1957,8,female,1502,100,63,1206,346,1206,102,0,244
1710508,60,3,1953,6,female,1301,98,49,1228,396,1228,170,0,226
1959896,43,13,1970,10,female,154,98,85,1402,220,1402,108,0,112
1853010,17,10,1996,5,female,673,98,40,1672,1033,9,435,1663,598
1539672,51,28,1962,11,female,478,100,48,1748,2096,137,192,1611,1904
1890541,20,3,1993,7,female,490,99,67,2280,1090,414,440,1866,650
1163228,19,7,1994,12,female,483,98,30,2701,1814,295,174,2406,1640
1641008,25,1,1988,5,male,957,100,40,2400,1443,1364,734,1036,709
1413615,23,1,1990,1,male,415,100,44,4463,20,4334,19,129,1
2028649,18,10,1995,6,male,202,103,63,9,16,9,10,0,6
1923345,19,11,1994,1,female,20,102,50,9,48,9,33,0,15
1970266,46,20,1967,9,male,2202,101,38,9,30,9,30,0,0
1024949,18,15,1995,3,female,139,104,88,10,9,0,2,10,7
1694012,17,16,1996,8,male,769,103,53,10,484,0,25,10,459
1465049,59,3,1954,12,female,155,101,70,10,17,0,10,10,7
1612100,14,4,1999,12,female,230,104,92,10,26,2,14,8,12
1955753,67,23,1946,10,female,2281,101,26,10,21,7,8,3,13
1402778,14,3,1999,7,male,152,101,85,10,0,9,0,1,0
1606532,26,29,1987,8,male,89,101,94,10,1,8,1,2,0
2126077,18,28,1995,5,male,318,104,29,10,0,10,0,0,0
1608435,21,13,1992,1,male,172,102,73,10,6,10,5,0,1
1403664,14,8,1999,8,male,111,101,46,10,15,10,10,0,5
1739602,18,14,1995,11,female,115,102,50,10,28,10,24,0,4
1444730,20,8,1993,10,male,208,104,58,10,64,10,48,0,16
2060637,23,7,1990,11,female,160,101,74,10,64,10,48,0,16
1377229,22,14,1991,10,female,380,101,40,10,30,10,20,0,10
1688466,30,4,1983,1,female,202,102,61,10,85,10,83,0,2
1333682,39,22,1974,4,male,574,103,32,10,32,10,30,0,2
1500165,92,26,1921,5,male,125,102,95,10,32,10,9,0,23
1784611,38,11,1975,10,male,422,103,34,11,0,0,0,11,0
1328637,31,12,1982,5,male,526,102,85,11,8,0,5,11,3
1484837,17,29,1996,7,male,181,101,72,11,0,10,0,1,0
1344416,22,22,1991,10,female,221,102,81,11,17,8,8,3,9
1105138,19,22,1994,3,male,687,104,16,11,0,11,0,0,0
1841353,35,1,1978,1,male,493,103,19,11,1,11,1,0,0
1006811,23,22,1990,4,female,231,104,45,11,12,11,7,0,5
1378291,23,23,1990,8,female,197,104,63,11,7,11,4,0,3
2152474,41,22,1972,12,male,387,102,85,11,15,11,9,0,6
1255446,24,14,1989,9,female,53,104,84,11,84,11,57,0,27
2076235,38,26,1975,11,male,376,101,54,11,17,11,11,0,6
1898921,50,27,1963,4,female,278,102,71,11,150,11,144,0,6
1618056,53,3,1960,11,male,781,104,89,12,0,0,0,12,0
1858723,19,26,1994,6,male,837,101,62,12,37,2,17,10,20
1535472,108,15,1905,10,male,778,103,65,12,19,0,3,12,16
1756175,21,31,1992,8,male,172,103,84,12,5,5,5,7,0
1485589,25,2,1988,2,male,221,103,47,12,0,12,0,0,0
1129341,25,10,1988,9,male,554,101,81,12,4,12,3,0,1
1184690,21,17,1992,3,female,472,104,30,13,10,1,7,12,3
2068782,56,25,1957,12,female,1310,103,11,13,20,0,14,13,6
2072354,19,20,1994,3,male,174,101,87,13,7,8,4,5,3
1514469,15,9,1998,12,female,350,103,68,13,0,11,0,2,0
1703641,19,25,1994,2,male,304,103,82,13,5,13,5,0,0
1599296,27,9,1986,2,male,332,102,76,13,11,13,10,0,1
1746176,27,21,1986,2,male,210,102,94,13,16,13,13,0,3
1217603,45,28,1968,2,female,1709,103,30,13,51,13,36,0,15
2159383,53,10,1960,4,female,249,101,44,13,25,13,19,0,6
1318239,13,1,2000,1,male,243,102,87,14,2,0,2,14,0
1915264,38,15,1975,12,female,332,102,95,14,9,0,0,14,9
1283146,39,17,1974,12,male,456,102,82,14,0,6,0,8,0
1198024,14,2,1999,3,female,180,101,80,14,14,3,8,11,6
1877143,35,10,1978,1,male,420,101,37,14,97,6,56,8,41
1445634,15,1,1998,1,male,537,104,75,14,3,14,3,0,0
1838212,42,17,1971,5,female,369,104,49,14,8,14,7,0,1
1621514,15,10,1998,2,male,247,101,83,14,9,14,9,0,0
1863747,55,30,1958,4,male,619,102,77,14,10,14,8,0,2
1528286,17,26,1996,8,male,541,101,70,14,37,14,33,0,4
1758162,23,23,1990,6,male,665,103,48,14,72,14,59,0,13
1485074,27,21,1986,3,male,450,101,84,14,39,14,18,0,21
2064865,38,11,1975,11,male,541,102,73,14,33,14,30,0,3
1740213,52,18,1961,1,female,88,101,89,15,42,0,9,15,33
2052198,58,3,1955,3,male,292,103,60,15,24,0,8,15,16
1543250,58,22,1955,9,female,378,102,76,15,28,2,3,13,25
1791907,25,19,1988,7,male,338,102,100,15,2,10,1,5,1
1106001,93,30,1920,8,female,1347,102,36,15,5,6,1,9,4
1740457,53,18,1960,2,male,13,102,98,15,12,3,9,12,3
1171353,27,3,1986,3,female,560,103,55,15,55,13,43,2,12
1106470,19,2,1994,12,male,324,103,61,15,16,15,12,0,4
1719687,94,18,1919,4,female,1300,104,43,15,21,15,21,0,0
1547162,16,29,1997,8,female,277,101,51,15,23,15,13,0,10
1787353,44,30,1969,12,male,180,101,91,15,40,15,23,0,17
1791170,54,30,1959,10,male,1843,104,46,15,43,15,31,0,12
1116208,44,8,1969,5,male,165,101,60,16,5,0,1,16,4
1519894,69,17,1944,4,male,391,103,83,16,18,0,12,16,6
2057282,18,18,1995,1,female,186,102,51,16,42,4,9,12,33
2126514,25,14,1988,9,female,195,102,28,16,77,9,68,7,9
1521416,25,10,1988,1,male,377,101,90,16,17,12,15,4,2
1305181,16,31,1997,7,male,305,104,35,16,1,16,1,0,0
1853038,20,5,1993,8,female,880,102,72,16,2,16,2,0,0
2160060,21,1,1992,4,male,234,102,89,16,6,16,6,0,0
1569950,23,16,1990,3,male,485,103,70,16,21,16,14,0,7
2007868,59,26,1954,5,male,251,103,67,16,34,16,27,0,7
1167112,53,30,1960,5,female,85,101,63,17,39,0,8,17,31
1438572,26,26,1987,4,male,367,104,85,17,0,17,0,0,0
1976280,55,24,1958,8,male,2346,101,32,17,2,17,2,0,0
1969396,19,22,1994,11,male,29,103,97,17,7,17,3,0,4
2085200,24,5,1989,11,male,669,101,65,17,9,17,4,0,5
1742122,33,3,1980,4,female,988,103,63,17,4,17,2,0,2
1345675,19,14,1994,8,male,380,102,91,17,37,17,22,0,15
1623589,28,7,1985,12,male,553,104,44,17,178,17,85,0,93
1618440,37,21,1976,5,male,369,102,82,18,3,0,2,18,1
1807923,25,1,1988,2,male,466,102,79,18,4,15,4,3,0
1029091,24,26,1989,7,male,157,104,71,18,3,18,3,0,0
2079034,35,11,1978,4,female,522,101,63,18,14,18,12,0,2
1686487,17,21,1996,12,male,320,101,40,19,9,5,7,14,2
1095950,17,25,1996,9,female,167,101,32,19,14,10,12,9,2
1211455,22,15,1991,5,female,203,101,59,19,14,13,2,6,12
1916033,23,14,1990,9,male,90,102,11,19,22,7,7,12,15
1489312,28,30,1985,12,male,534,104,54,19,1,19,1,0,0
1933695,52,23,1961,3,male,717,102,36,19,13,19,9,0,4
1213183,98,8,1915,4,female,1648,102,68,20,15,0,4,20,11
1263773,23,18,1990,4,male,233,104,49,20,33,1,14,19,19
1626997,17,23,1996,5,female,392,101,13,20,5,15,1,5,4
1377655,14,19,1999,3,female,258,103,62,20,4,20,3,0,1
1513450,19,18,1994,3,male,442,103,69,20,22,20,14,0,8
1718394,28,23,1985,1,male,290,104,69,20,37,20,23,0,14
1703827,67,12,1946,10,female,1077,104,54,20,72,20,68,0,4
1548908,17,30,1996,6,male,249,104,82,21,1,0,0,21,1
1776685,103,1,1910,1,female,814,104,56,21,5,0,0,21,5
1089360,65,8,1948,4,male,17,101,92,21,36,0,31,21,5
1427232,19,4,1994,5,male,625,103,89,21,3,13,1,8,2
1338798,23,10,1990,12,female,464,101,55,21,6,20,6,1,0
1495548,21,4,1992,7,female,232,102,70,21,2,21,1,0,1
1459013,27,9,1986,1,male,455,103,81,21,1,21,1,0,0
1177684,28,30,1985,12,male,97,103,88,21,5,21,3,0,2
1886205,27,9,1986,10,female,409,102,52,21,18,21,10,0,8
1176198,57,6,1956,12,male,645,104,94,22,23,0,1,22,22
1948772,61,31,1952,12,male,222,101,57,22,73,0,32,22,41
1544237,16,2,1997,10,male,66,104,89,22,5,21,5,1,0
1907625,32,7,1981,1,female,565,102,60,22,58,22,17,0,41
1586197,33,26,1980,6,female,540,103,74,22,82,22,39,0,43
1668865,47,29,1966,1,female,674,104,81,23,7,4,4,19,3
2057317,108,8,1905,11,female,1568,104,43,23,9,1,2,22,7
2153096,22,18,1991,12,male,427,103,91,23,30,4,11,19,19
1350359,22,15,1991,5,male,242,103,83,23,14,5,4,18,10
1217470,23,27,1990,6,male,342,104,47,23,1,22,1,1,0
1573315,26,1,1987,1,male,332,104,91,23,18,17,14,6,4
1878817,21,19,1992,2,male,241,104,59,23,44,22,18,1,26
1718901,18,2,1995,2,male,263,104,68,23,2,23,1,0,1
1941515,46,5,1967,6,male,366,101,77,23,12,23,11,0,1
1025301,56,24,1957,7,male,1037,102,29,23,7,23,2,0,5
1650684,25,15,1988,6,male,626,102,76,23,31,23,10,0,21
1149555,51,12,1962,9,female,101,104,70,23,16,23,15,0,1
1889302,76,24,1937,10,male,1522,104,33,23,53,23,23,0,30
2190477,42,10,1971,9,female,476,103,65,24,9,0,3,24,6
1459138,108,9,1905,3,female,1740,102,50,24,139,12,77,12,62
1726478,18,22,1995,6,female,313,101,34,24,5,24,5,0,0
1312004,19,7,1994,9,female,358,103,74,24,5,24,4,0,1
1585109,25,1,1988,1,male,168,103,77,24,7,24,7,0,0
1646985,36,18,1977,9,male,297,104,49,24,8,24,4,0,4
1390239,34,6,1979,12,male,923,103,32,24,28,24,27,0,1
1940435,59,29,1954,7,male,277,101,55,24,31,24,18,0,13
1573635,83,12,1930,7,female,30,103,91,24,28,24,9,0,19
1822166,40,22,1973,10,female,1383,104,56,24,63,24,26,0,37
1947620,23,11,1990,2,male,308,103,33,25,3,24,1,1,2
1687880,14,2,1999,5,female,135,104,54,25,14,24,6,1,8
1662159,58,6,1955,5,male,311,103,70,25,26,21,13,4,13
1816512,32,7,1981,1,male,142,104,88,25,14,25,10,0,4
2144164,27,8,1986,9,female,131,104,80,25,99,25,77,0,22
1224157,48,9,1965,10,male,605,104,52,25,69,25,50,0,19
1701199,33,14,1980,1,female,658,104,67,26,16,1,10,25,6
1586925,100,5,1913,9,female,1632,104,42,26,0,14,0,12,0
1144431,26,28,1987,10,male,464,102,67,26,3,26,0,0,3
1832973,53,20,1960,10,male,424,104,87,26,7,26,7,0,0
1689247,60,11,1953,12,male,390,103,49,26,14,26,14,0,0
1270520,27,24,1986,1,male,340,103,76,26,29,26,15,0,14
1203675,19,9,1994,10,male,172,101,70,26,39,26,36,0,3
1853277,42,8,1971,12,female,989,104,64,26,274,26,190,0,84
1506229,58,23,1955,9,male,701,103,33,27,12,6,0,21,12
1256829,23,23,1990,5,female,207,102,61,27,13,27,11,0,2
1182988,31,4,1982,4,female,488,102,54,27,13,27,10,0,3
1836144,27,27,1986,4,male,524,103,50,27,23,27,17,0,6
1201748,56,1,1957,8,female,1611,103,58,27,28,27,23,0,5
1933120,37,25,1976,3,female,1108,104,43,27,55,27,36,0,19
1452551,38,17,1975,4,male,241,104,53,28,3,20,2,8,1
1326737,20,31,1993,8,male,524,101,65,28,12,26,6,2,6
2109918,21,27,1992,2,male,463,102,59,28,27,26,13,2,14
1975519,32,25,1981,7,male,199,102,83,28,90,27,52,1,38
1147910,28,24,1985,9,male,138,101,78,28,19,28,15,0,4
1025393,30,27,1983,10,male,145,102,87,29,6,29,5,0,1
2075111,32,19,1981,1,female,674,101,80,29,29,29,17,0,12
1257461,40,29,1973,8,female,516,104,56,31,0,0,0,31,0
1129877,23,1,1990,1,male,256,104,76,30,0,30,0,0,0
1206179,18,12,1995,11,male,399,103,50,30,12,30,11,0,1
1240029,22,1,1991,1,female,517,101,52,31,9,31,9,0,0
1807941,26,17,1987,10,male,193,101,84,31,11,31,10,0,1
1912377,18,29,1995,4,male,175,101,56,32,1,0,0,32,1
2079450,52,15,1961,12,female,290,102,86,32,46,1,31,31,15
1195888,60,19,1953,9,NA,2301,103,35,32,27,31,16,1,11
1537213,14,7,1999,3,male,363,103,81,32,3,32,0,0,3
1511325,15,29,1998,6,male,203,104,91,32,1,32,1,0,0
1634953,19,14,1994,12,male,465,104,77,32,8,32,7,0,1
1600036,27,19,1986,1,male,61,101,97,32,15,32,7,0,8
1320729,33,3,1980,8,male,299,104,80,32,14,32,11,0,3
1066576,58,31,1955,12,male,407,103,18,33,38,0,13,33,25
1844245,20,1,1993,6,male,624,103,64,33,4,24,1,9,3
2030023,27,24,1986,3,male,511,103,39,33,45,33,42,0,3
1026768,24,10,1989,5,male,345,102,67,33,230,33,164,0,66
1541773,35,24,1978,3,female,276,102,45,33,57,33,25,0,32
1882653,56,25,1957,12,male,1199,101,29,33,67,33,36,0,31
1226315,14,20,1999,7,male,347,101,77,34,4,0,0,34,4
1744829,23,1,1990,2,male,160,104,74,34,0,1,0,33,0
1622191,33,29,1980,9,male,737,103,24,34,0,0,0,34,0
1711083,16,9,1997,10,female,278,102,56,34,90,8,21,26,69
1681220,28,15,1985,3,female,529,101,40,34,12,34,10,0,2
2050034,29,3,1984,4,male,697,102,12,34,22,34,21,0,1
1443107,48,26,1965,10,female,342,101,44,34,235,34,142,0,93
1484350,38,1,1975,6,male,228,101,79,35,0,4,0,31,0
1090165,48,3,1965,4,female,362,103,93,36,8,0,2,36,6
1070548,34,12,1979,11,female,503,104,39,35,12,14,12,21,0
1072526,16,27,1997,9,female,342,103,74,36,218,22,172,14,46
1886814,28,26,1985,7,male,288,103,78,35,2,32,0,3,2
1644206,53,2,1960,9,male,769,101,92,35,0,33,0,2,0
2059656,34,21,1979,8,female,50,104,100,35,45,31,12,4,33
1989838,28,5,1985,4,female,1156,103,44,35,61,34,35,1,26
1378800,18,18,1995,11,male,320,104,74,35,8,35,4,0,4
1728569,65,21,1948,10,male,1302,104,34,36,10,36,10,0,0
1484497,21,26,1992,1,female,331,103,36,36,31,36,25,0,6
2143898,36,2,1977,6,female,623,104,40,35,27,35,21,0,6
1049628,17,4,1996,1,male,231,102,49,37,19,36,4,1,15
1492488,20,14,1993,8,female,759,102,62,37,7,37,3,0,4
1784964,51,16,1962,4,female,1604,103,31,38,20,0,7,38,13
1148020,19,21,1994,10,female,385,104,59,38,26,0,6,38,20
1537818,54,24,1959,12,male,905,101,52,38,27,0,15,38,12
1727706,38,3,1975,1,male,345,101,71,38,5,26,3,12,2
1224789,66,11,1947,2,female,767,103,87,38,1,9,0,29,1
2056463,55,30,1958,12,male,91,101,96,39,23,9,12,30,11
2068216,33,1,1980,5,female,848,104,45,38,0,37,0,1,0
1772009,42,6,1971,3,female,291,101,64,39,24,29,12,10,12
1600358,20,6,1993,9,male,37,102,102,38,1,38,1,0,0
1189908,22,21,1991,4,female,302,101,62,39,37,39,21,0,16
2039636,22,1,1991,9,female,533,101,68,38,32,38,24,0,8
1469566,54,14,1959,7,male,1281,102,30,38,46,38,16,0,30
1381306,108,29,1905,12,male,248,103,80,40,13,1,8,39,5
1962589,40,2,1973,7,female,278,101,71,40,3,40,2,0,1
2131294,25,1,1988,1,male,260,103,64,40,127,40,30,0,97
1335038,26,20,1987,6,female,202,101,61,40,78,40,70,0,8
1857641,108,27,1905,6,male,1491,103,22,41,48,0,29,41,19
2132749,25,19,1988,2,male,182,103,72,42,8,31,4,11,4
1769839,47,1,1966,1,male,152,103,79,41,52,41,44,0,8
1975958,58,23,1955,9,male,787,101,47,43,59,0,9,43,50
1319493,57,16,1956,8,female,1819,101,30,44,45,43,28,1,17
2153736,32,19,1981,8,male,594,104,87,43,33,43,32,0,1
1989075,40,6,1973,3,male,1378,104,32,43,57,43,43,0,14
1056664,24,15,1989,6,female,306,104,30,43,100,43,62,0,38
1741066,31,22,1982,8,male,980,101,27,45,59,17,32,28,27
1897536,38,28,1975,11,male,537,104,87,46,39,5,2,41,37
2109722,21,13,1992,3,male,340,103,60,46,26,13,11,33,15
1179622,27,6,1986,5,female,190,101,91,46,14,19,6,27,8
1964617,64,4,1949,9,male,892,101,35,47,41,22,27,25,14
2150407,68,21,1945,1,female,1881,102,59,46,22,39,7,7,15
1066364,25,2,1988,7,female,200,104,74,47,0,47,0,0,0
1518590,24,29,1989,9,male,50,102,96,46,100,46,82,0,18
1721052,67,26,1946,7,male,527,101,78,48,35,0,3,48,32
1468732,91,28,1922,6,male,1068,101,42,48,83,14,7,34,76
1333730,21,2,1992,9,male,552,102,60,48,3,48,0,0,3
1098745,18,5,1995,4,male,480,101,40,48,62,48,58,0,4
1486095,33,1,1980,6,male,194,103,65,49,56,49,32,0,24
1322959,69,7,1944,11,female,859,104,26,50,19,6,11,44,8
1909048,14,16,1999,5,male,514,104,60,50,8,32,5,18,3
1179853,18,16,1995,5,male,390,104,64,50,3,50,2,0,1
1389471,21,14,1992,2,female,311,104,65,51,11,51,10,0,1
1260520,43,26,1970,2,female,384,103,44,51,27,51,25,0,2
1655579,57,4,1956,3,male,866,101,69,51,68,51,50,0,18
1481520,55,9,1958,7,female,721,104,53,51,122,51,46,0,76
1484577,89,24,1924,3,NA,1832,103,23,52,0,0,0,52,0
1648572,25,18,1988,11,male,466,101,75,52,10,0,8,52,2
1090566,50,19,1963,8,female,1522,104,52,52,187,10,112,42,75
2178605,36,5,1977,11,male,425,103,4,52,5,44,5,8,0
1913457,108,22,1905,6,male,1989,101,47,53,48,47,24,6,24
1483085,26,9,1987,4,male,207,104,76,53,25,53,21,0,4
1060701,18,26,1995,5,female,505,101,56,52,38,52,33,0,5
1969637,32,24,1981,7,male,38,104,51,53,56,53,47,0,9
1024347,64,12,1949,7,male,1052,101,42,54,62,21,32,33,30
2146908,41,28,1972,7,female,864,104,30,55,76,54,63,1,13
1603092,53,3,1960,12,male,744,102,65,55,0,55,0,0,0
1882594,15,18,1998,6,female,71,101,90,55,29,55,28,0,1
1430801,15,8,1998,8,female,156,104,75,54,31,54,20,0,11
1521425,24,2,1989,12,male,48,101,92,55,41,55,33,0,8
2141452,22,19,1991,9,male,361,103,70,56,29,19,14,37,15
1631424,24,19,1989,11,male,833,104,78,58,33,19,23,39,10
2170745,27,2,1986,2,male,562,101,56,58,31,47,16,11,15
2050766,14,2,1999,7,male,359,104,70,57,9,57,5,0,4
1464654,20,1,1993,1,male,24,103,95,56,2,56,2,0,0
1189115,39,27,1974,2,female,284,102,44,56,19,56,15,0,4
2154057,68,17,1945,8,male,76,103,53,58,52,58,40,0,12
1442465,34,1,1979,4,female,700,103,57,56,110,56,59,0,51
1086929,59,5,1954,1,male,1404,103,66,57,92,57,60,0,32
1237572,17,11,1996,9,male,15,102,81,59,37,57,37,2,0
2087191,29,28,1984,10,female,527,101,86,60,57,57,46,3,11
1474358,48,6,1965,1,male,118,101,74,63,20,0,4,63,16
1027747,71,5,1942,2,female,1005,101,69,63,70,0,44,63,26
1828435,16,3,1997,4,male,15,101,98,61,30,37,4,24,26
2171615,36,3,1977,11,male,261,101,65,61,18,32,15,29,3
1286435,57,15,1956,3,female,1984,101,35,61,96,44,76,17,20
1780719,30,27,1983,11,male,380,102,65,61,27,61,21,0,6
1125409,32,19,1981,10,female,433,101,34,62,54,62,33,0,21
1557011,19,2,1994,11,female,842,102,41,65,32,9,17,56,15
1234131,60,13,1953,1,female,1314,102,40,64,19,17,3,47,16
2165876,79,29,1934,4,male,1019,104,56,64,109,59,89,5,20
1416319,23,23,1990,7,male,372,102,81,64,25,64,12,0,13
1568960,25,25,1988,8,male,204,104,82,64,21,64,10,0,11
1393700,38,2,1975,7,female,1124,101,74,64,20,64,12,0,8
1275502,103,26,1910,7,female,1049,104,63,65,61,65,52,0,9
1351615,48,15,1965,5,female,1524,103,55,67,10,0,1,67,9
1208818,53,22,1960,4,female,535,101,68,67,32,0,2,67,30
1418411,66,14,1947,2,male,436,101,57,66,28,0,7,66,21
1420101,26,13,1987,6,female,147,102,44,67,26,63,24,4,2
1048174,49,6,1964,11,female,434,101,60,66,31,51,18,15,13
1128641,69,26,1944,11,female,1754,101,43,67,40,67,25,0,15
1211338,19,24,1994,8,female,529,103,64,67,51,67,40,0,11
1292280,35,2,1978,8,female,149,104,46,66,99,66,96,0,3
1471981,55,10,1958,4,female,1433,101,63,68,128,68,31,0,97
1803302,20,18,1993,2,female,209,102,41,71,35,58,3,13,32
2062031,21,7,1992,1,female,330,102,70,70,53,69,49,1,4
1302050,30,3,1983,12,male,242,102,45,71,4,71,3,0,1
1864037,31,29,1982,1,female,345,101,59,71,3,71,3,0,0
1545606,42,16,1971,4,male,308,104,98,69,1,69,1,0,0
1774048,23,9,1990,9,female,45,103,67,71,43,71,42,0,1
1768717,30,29,1983,3,male,841,101,33,71,58,71,32,0,26
1613574,28,12,1985,12,male,52,103,54,71,133,71,104,0,29
1537225,69,27,1944,2,male,758,102,67,72,52,0,24,72,28
1423891,31,14,1982,7,male,471,103,80,73,12,20,6,53,6
1570955,83,8,1930,12,female,1721,104,22,73,9,49,3,24,6
1442426,24,22,1989,3,female,362,103,48,72,9,72,8,0,1
1494304,31,22,1982,12,female,281,101,86,73,35,73,25,0,10
1656036,33,5,1980,3,male,423,101,57,73,34,73,20,0,14
2086236,28,6,1985,11,male,291,101,74,76,43,54,25,22,18
1553290,65,8,1948,9,male,1089,104,52,76,79,40,14,36,65
1870490,28,1,1985,6,male,160,103,76,77,70,77,47,0,23
1355547,50,6,1963,7,male,962,101,43,78,98,3,71,75,27
1530557,44,9,1969,10,female,532,101,44,80,98,75,72,5,26
1734751,57,16,1956,7,male,652,101,60,78,11,78,10,0,1
1607740,30,1,1983,1,male,430,104,63,79,41,79,39,0,2
1096896,62,23,1951,9,female,1081,102,37,80,93,80,70,0,23
2025227,18,19,1995,1,male,448,103,67,82,3,8,0,74,3
1244273,23,7,1990,6,female,404,102,44,84,34,11,2,73,32
1188549,17,20,1996,11,female,298,102,50,81,87,0,10,81,77
1557645,29,16,1984,7,male,554,102,60,82,67,6,22,76,45
1926927,94,12,1919,6,male,207,104,70,84,202,0,80,84,122
1943424,17,10,1996,1,female,228,104,85,84,72,77,40,7,32
1281886,67,20,1946,1,female,1038,104,63,87,139,0,60,87,79
1108955,33,1,1980,1,male,424,102,88,86,1,75,1,11,0
1142468,108,5,1905,5,male,212,103,89,87,92,82,10,5,82
1630426,44,10,1969,6,female,415,104,81,86,15,86,12,0,3
2185937,18,24,1995,2,female,733,101,68,87,63,87,48,0,15
1817968,27,1,1986,4,female,418,101,59,86,110,86,105,0,5
1016155,55,29,1958,9,female,545,102,46,90,35,14,25,76,10
2110725,113,2,1900,4,NA,1366,101,66,90,49,0,31,90,18
1148778,18,11,1995,9,female,126,101,49,91,138,14,50,77,88
2090523,23,1,1990,1,male,211,101,39,88,41,61,24,27,17
1814364,22,12,1991,7,female,255,102,51,89,54,88,29,1,25
1028718,18,15,1995,12,male,544,104,79,88,8,88,6,0,2
1048500,27,19,1986,4,female,418,102,68,91,0,91,0,0,0
2174457,29,4,1984,3,female,301,101,36,88,118,88,57,0,61
2172430,54,17,1959,3,male,199,101,62,92,47,58,24,34,23
1680138,13,21,2000,6,male,198,102,79,95,41,95,26,0,15
1814261,19,19,1994,8,male,47,101,96,92,40,92,20,0,20
2183737,24,1,1989,1,male,667,102,88,95,97,95,52,0,45
1669314,25,15,1988,10,male,343,103,26,94,121,94,113,0,8
1925236,15,23,1998,1,female,720,104,43,95,176,95,106,0,70
1557986,18,31,1995,8,male,858,102,56,99,24,2,15,97,9
1095769,34,6,1979,4,male,710,102,74,99,99,75,56,24,43
1080856,49,13,1964,10,female,716,103,61,99,68,93,55,6,13
1880474,20,21,1993,2,female,480,104,67,96,111,96,93,0,18
1981503,53,5,1960,5,male,371,104,50,101,3,0,0,101,3
1657929,26,24,1987,9,female,462,101,45,103,58,103,32,0,26
1365439,40,28,1973,7,male,742,102,70,100,29,100,29,0,0
1446501,18,24,1995,8,female,284,101,81,109,30,33,4,76,26
1279883,50,4,1963,1,male,897,102,58,108,90,51,55,57,35
1410864,108,6,1905,7,female,836,101,65,105,233,21,40,84,193
2047930,62,1,1951,12,female,1883,101,47,108,16,86,16,22,0
2012814,21,5,1992,7,female,434,104,60,107,44,85,15,22,29
1280467,30,30,1983,9,male,513,103,84,105,27,99,20,6,7
1325216,23,30,1990,7,male,202,102,89,105,4,105,2,0,2
1094332,19,19,1994,4,female,533,104,61,106,31,106,31,0,0
1626933,39,12,1974,10,female,621,101,42,106,124,106,109,0,15
1774857,67,28,1946,7,female,743,103,41,111,351,2,145,109,206
1462650,75,15,1938,7,male,2326,101,14,111,5,68,2,43,3
2139987,32,26,1981,4,male,379,101,38,111,52,111,51,0,1
2106742,37,2,1976,10,female,503,104,46,113,37,113,27,0,10
2052941,55,2,1958,1,NA,1977,104,71,113,103,113,74,0,29
1185275,57,27,1956,3,female,593,103,45,111,139,111,91,0,48
2183783,28,29,1985,9,female,73,104,97,110,286,110,274,0,12
2004667,53,2,1960,4,female,780,104,59,116,21,0,6,116,15
1353840,65,22,1948,4,female,1496,104,15,115,39,14,17,101,22
1000323,68,10,1945,3,male,1891,103,45,119,36,8,4,111,32
1668772,20,8,1993,5,female,241,102,52,117,84,83,31,34,53
1185078,84,15,1929,8,female,1583,103,51,115,18,101,9,14,9
1092135,29,25,1984,4,male,396,102,68,117,66,106,54,11,12
1315513,45,3,1968,5,female,376,104,82,117,35,107,24,10,11
1072434,100,15,1913,6,female,1758,101,62,114,64,95,38,19,26
2086742,22,20,1991,12,female,294,104,71,115,139,84,99,31,40
1007289,18,2,1995,2,male,192,101,82,116,21,116,21,0,0
1553164,23,23,1990,1,female,254,104,83,114,185,114,165,0,20
1964543,53,26,1960,12,female,263,104,84,122,15,0,4,122,11
1912857,69,14,1944,10,female,1397,101,59,122,278,4,72,118,206
1576192,45,5,1968,10,female,537,101,72,122,87,114,77,8,10
1792454,16,3,1997,3,female,156,102,93,120,8,120,6,0,2
1676627,28,25,1985,11,male,586,101,62,123,5,123,5,0,0
1176369,35,1,1978,1,male,440,101,51,122,64,122,57,0,7
1462980,16,22,1997,8,male,83,104,88,125,8,0,3,125,5
1740956,108,21,1905,11,female,346,103,65,125,92,68,41,57,51
1014758,23,8,1990,4,female,474,101,27,125,153,122,105,3,48
1040780,38,9,1975,1,male,205,104,29,126,14,126,13,0,1
1959685,39,1,1974,2,female,1012,103,64,127,193,127,154,0,39
2126161,16,22,1997,9,male,298,101,68,135,83,94,38,41,45
2171813,30,17,1983,5,female,496,101,31,135,216,124,138,11,78
2097007,16,19,1997,12,female,265,103,64,132,92,132,77,0,15
1464975,103,20,1910,11,female,1299,102,35,137,44,0,21,137,23
1288782,60,21,1953,8,female,96,103,79,140,132,0,16,140,116
2109323,58,11,1955,10,female,764,103,54,141,84,37,28,104,56
1929695,28,7,1985,12,female,18,102,85,138,120,69,41,69,79
1601250,27,28,1986,5,male,398,103,67,142,145,114,116,28,29
1379131,51,11,1962,8,female,1465,102,24,139,110,131,57,8,53
1478655,63,4,1950,3,female,973,102,67,142,106,109,61,33,45
1747397,23,2,1990,4,male,314,102,76,137,63,137,52,0,11
1416043,46,9,1967,9,male,496,103,71,146,22,7,18,139,4
1846736,26,27,1987,3,female,558,102,47,145,17,68,7,77,10
1219782,35,12,1978,1,male,654,101,25,149,46,118,18,31,28
2004546,26,19,1987,10,female,402,102,67,148,115,113,62,35,53
2147483,16,11,1997,9,male,43,102,82,147,13,146,13,1,0
1259661,16,6,1997,3,male,155,103,31,147,8,147,7,0,1
1480866,36,26,1977,12,male,464,104,61,150,18,150,8,0,10
1275547,105,17,1908,7,female,1492,104,37,149,8,149,6,0,2
1773079,25,1,1988,1,male,232,104,62,148,46,148,32,0,14
2089018,36,21,1977,2,female,494,103,50,157,68,0,0,157,68
2137422,52,25,1961,3,female,861,102,59,153,42,2,3,151,39
1459872,108,31,1905,12,female,932,103,67,154,39,0,8,154,31
2109233,14,7,1999,1,female,303,103,51,153,151,6,112,147,39
1186963,80,20,1933,10,male,1143,101,52,154,352,19,60,135,292
1054309,31,1,1982,6,male,485,103,53,154,55,74,8,80,47
1702711,21,2,1992,5,female,591,104,82,154,303,56,168,98,135
1174028,16,7,1997,1,male,566,103,51,152,22,126,15,26,7
1765804,40,14,1973,8,female,747,101,54,154,25,148,23,6,2
1135583,40,3,1973,3,male,201,103,88,153,120,152,39,1,81
2175983,53,31,1960,12,male,275,104,77,154,41,154,23,0,18
1882642,55,7,1958,7,female,311,102,78,155,47,155,21,0,26
1641605,28,9,1985,3,male,427,104,40,153,97,153,68,0,29
1623767,26,18,1987,11,female,85,102,91,155,287,155,235,0,52
1479996,63,2,1950,10,female,1618,102,26,158,44,0,12,158,32
1986091,17,20,1996,9,female,415,103,63,163,21,142,1,21,20
1402790,21,8,1992,5,male,259,101,49,159,521,155,316,4,205
2053346,39,25,1974,1,male,541,103,24,160,75,160,62,0,13
1422519,26,20,1987,12,female,273,103,17,158,221,158,192,0,29
1130096,57,9,1956,7,female,835,102,56,163,179,163,139,0,40
1812086,53,6,1960,9,female,879,104,56,166,18,0,11,166,7
1188084,17,26,1996,9,male,507,103,77,170,50,25,17,145,33
1670123,61,25,1952,9,female,235,102,51,172,252,0,30,172,222
1920097,64,21,1949,2,female,863,103,48,165,330,0,269,165,61
1436339,25,12,1988,8,female,246,104,92,167,0,160,0,7,0
2126808,25,2,1988,4,female,524,101,56,170,202,167,59,3,143
1809131,60,19,1953,4,female,293,103,78,165,25,165,18,0,7
1642913,47,26,1966,8,male,685,103,32,170,83,170,48,0,35
1200599,52,18,1961,5,male,619,103,91,166,34,166,23,0,11
2087745,63,20,1950,11,male,176,103,54,167,34,167,17,0,17
1956412,21,12,1992,5,female,417,101,30,167,148,167,143,0,5
2155305,108,28,1905,5,female,1802,104,32,178,24,0,10,178,14
1782104,51,3,1962,4,female,890,104,55,174,52,0,42,174,10
1003646,61,29,1952,3,female,413,102,51,178,719,1,91,177,628
1314511,32,15,1981,8,female,249,102,82,177,80,177,42,0,38
1501654,40,10,1973,11,male,305,103,94,176,37,176,29,0,8
1504559,41,5,1972,1,female,372,101,80,179,162,179,117,0,45
1641967,65,2,1948,9,female,369,103,46,190,69,0,31,190,38
1521006,55,3,1958,3,female,343,102,62,185,118,0,35,185,83
2068081,20,6,1993,6,male,224,104,40,184,4,174,3,10,1
1246818,30,16,1983,11,female,447,104,66,184,35,184,31,0,4
2040478,26,21,1987,5,female,400,104,66,188,195,188,142,0,53
1390638,30,27,1983,5,female,656,102,37,185,161,185,142,0,19
2153840,31,5,1982,12,female,399,101,43,193,49,112,27,81,22
1064698,14,22,1999,6,female,466,102,85,198,35,148,28,50,7
2065129,41,22,1972,9,female,538,104,96,191,52,183,21,8,31
1852786,61,8,1952,1,female,1338,101,58,196,159,163,86,33,73
2137679,16,8,1997,1,male,266,103,66,193,36,193,32,0,4
1019455,16,22,1997,6,female,340,103,70,196,103,196,67,0,36
1411648,21,1,1992,5,male,382,102,56,193,49,193,14,0,35
2158262,25,23,1988,9,female,340,101,70,194,258,194,211,0,47
1550878,44,1,1969,6,male,552,102,43,196,131,196,100,0,31
1631230,67,28,1946,8,female,801,101,39,208,28,0,1,208,27
1244736,73,17,1940,10,female,1472,101,46,207,89,1,10,206,79
1381665,66,20,1947,1,female,1084,103,48,204,81,72,31,132,50
1357357,44,24,1969,4,female,1299,101,46,204,28,204,16,0,12
1866780,59,15,1954,9,female,93,101,58,208,173,208,88,0,85
1288184,51,19,1962,9,female,733,101,62,216,46,50,33,166,13
1930585,16,2,1997,3,male,568,102,43,221,33,211,17,10,16
1039791,44,2,1969,2,female,877,102,49,218,97,212,59,6,38
1619155,51,21,1962,2,female,638,104,72,219,205,202,97,17,108
1515868,59,5,1954,10,female,1746,103,31,221,93,220,59,1,34
1097977,23,31,1990,12,female,244,103,68,217,32,217,23,0,9
1249839,24,1,1989,1,male,420,103,80,219,142,219,139,0,3
1079941,44,20,1969,8,male,79,104,101,217,148,217,28,0,120
1329415,68,10,1945,5,female,130,102,87,220,238,220,229,0,9
1780490,24,7,1989,12,male,386,103,63,230,53,151,38,79,15
1198240,56,29,1957,9,female,363,103,79,225,117,225,57,0,60
1622252,64,22,1949,1,female,829,102,57,238,132,93,80,145,52
1683181,41,22,1972,12,female,940,103,64,242,415,230,295,12,120
2120047,60,10,1953,6,female,608,102,70,236,438,235,265,1,173
1244067,27,6,1986,9,female,457,102,71,238,116,238,54,0,62
1325870,48,28,1965,3,male,262,102,79,245,113,245,91,0,22
1944339,32,8,1981,3,female,108,103,87,240,351,240,136,0,215
1256618,56,25,1957,12,female,345,103,77,252,105,0,27,252,78
1599381,47,1,1966,4,female,1359,101,61,257,97,171,44,86,53
2151424,30,22,1983,12,female,45,101,94,259,164,60,91,199,73
1689668,19,24,1994,3,female,545,101,43,249,142,243,91,6,51
1990521,44,8,1969,2,female,710,104,77,252,216,185,72,67,144
1606790,58,21,1955,8,female,307,104,58,254,461,254,307,0,154
1905132,50,5,1963,6,male,1703,104,77,262,30,242,27,20,3
1496603,63,3,1950,2,male,83,102,68,268,0,268,0,0,0
1777799,24,4,1989,1,female,131,103,81,267,55,267,52,0,3
1191879,25,1,1988,1,male,197,101,83,262,147,262,48,0,99
2065359,17,19,1996,12,male,329,104,48,281,0,19,0,262,0
1507290,23,17,1990,11,female,117,102,66,283,155,91,68,192,87
1191988,48,28,1965,6,female,1258,104,53,286,991,136,795,150,196
1941498,43,27,1970,11,female,682,102,64,283,190,267,105,16,85
2154741,34,18,1979,11,male,559,104,46,281,54,281,48,0,6
1256409,54,17,1959,2,female,510,101,52,290,66,290,51,0,15
1101061,71,24,1942,5,female,1863,101,40,288,62,288,51,0,11
1551508,62,27,1951,1,male,733,104,16,308,111,2,51,306,60
1289679,108,24,1905,2,female,2251,102,75,299,214,35,127,264,87
1709603,44,8,1969,8,male,462,102,39,304,146,260,66,44,80
1824916,30,15,1983,6,female,422,104,82,299,232,285,168,14,64
1084128,47,28,1966,11,female,247,104,56,295,5,295,4,0,1
1228477,22,26,1991,11,female,102,103,63,293,57,293,39,0,18
1490340,24,14,1989,1,female,453,102,43,293,50,293,41,0,9
1474339,43,29,1970,12,female,169,104,67,307,85,307,51,0,34
1984696,42,28,1971,3,male,373,101,55,306,114,306,28,0,86
1797378,45,12,1968,3,male,567,103,32,297,137,297,96,0,41
1599810,47,21,1966,1,male,1082,103,15,304,110,304,103,0,7
2053228,17,17,1996,2,male,433,102,99,322,4,14,3,308,1
1365154,45,23,1968,5,female,1784,102,44,310,176,211,111,99,65
1627379,33,27,1980,8,female,788,104,70,324,1179,226,970,98,209
2058637,35,10,1978,4,female,480,101,63,320,221,304,191,16,30
1914157,66,13,1947,5,female,253,102,59,342,577,0,301,342,276
1523198,14,21,1999,11,female,161,102,55,344,126,221,79,123,47
1067584,21,9,1992,8,male,391,103,95,346,41,299,5,47,36
2188161,17,10,1996,5,male,467,104,92,339,104,281,88,58,16
1428449,43,19,1970,3,male,317,101,34,332,118,306,54,26,64
1577771,25,20,1988,12,male,370,101,94,332,212,309,86,23,126
1529985,44,5,1969,4,male,646,102,78,345,334,276,289,69,45
1978012,52,7,1961,7,female,449,103,69,334,221,284,145,50,76
2050142,15,29,1998,9,female,138,104,51,333,148,333,132,0,16
1087498,41,20,1972,2,male,1702,101,44,332,541,332,113,0,428
1035898,35,15,1978,11,female,173,103,55,352,67,0,7,352,60
1496013,52,9,1961,5,female,575,101,47,351,126,0,55,351,71
1082875,28,16,1985,2,female,435,102,70,357,253,115,129,242,124
1971312,49,21,1964,9,female,549,101,48,363,290,193,171,170,119
1438844,17,4,1996,1,male,480,101,57,353,5,274,2,79,3
1932495,23,17,1990,10,male,469,104,40,360,429,320,287,40,142
1807079,35,13,1978,2,female,288,101,87,360,136,360,91,0,45
1175678,66,9,1947,11,female,1938,103,50,376,411,0,46,376,365
1958770,39,26,1974,3,female,685,104,75,394,165,188,102,206,63
2120766,15,25,1998,1,female,145,103,54,371,401,371,302,0,99
2087277,21,30,1992,10,female,583,102,49,385,250,385,132,0,118
2117217,31,1,1982,9,female,168,101,22,387,691,387,582,0,109
2071993,23,16,1990,6,female,742,102,46,410,160,0,56,410,104
1587416,54,19,1959,7,male,1187,101,52,410,505,0,81,410,424
2073274,39,27,1974,4,male,648,104,70,398,542,190,388,208,154
2037471,24,24,1989,1,female,191,103,78,418,688,418,549,0,139
1166124,29,4,1984,7,female,169,101,74,443,4038,443,1451,0,2587
1936143,38,18,1975,1,male,650,101,62,481,857,329,705,152,152
1633609,26,8,1987,1,male,356,101,82,480,28,480,11,0,17
1522914,45,18,1968,9,male,531,101,48,464,281,464,203,0,78
1459828,62,2,1951,1,male,605,101,81,474,528,474,456,0,72
1259883,21,5,1992,1,male,311,104,62,493,319,114,123,379,196
2013849,19,28,1994,1,female,44,104,94,488,219,431,115,57,104
1077875,61,4,1952,12,female,1689,101,61,510,393,496,241,14,152
2031567,35,17,1978,3,female,378,103,75,489,60,489,11,0,49
1807036,39,9,1974,8,female,1566,104,68,494,150,494,125,0,25
1221878,55,14,1958,8,female,242,104,79,493,266,493,195,0,71
2067735,22,10,1991,4,male,67,103,82,496,306,496,144,0,162
1455000,28,25,1985,4,female,411,102,62,543,124,0,84,543,40
1825342,65,11,1948,1,female,764,101,56,543,114,17,30,526,84
1604758,33,1,1980,3,female,198,101,75,556,60,129,23,427,37
2009966,16,21,1997,8,female,233,102,63,536,301,180,157,356,144
1401229,19,12,1994,12,female,245,101,78,532,579,486,393,46,186
1776812,16,2,1997,12,male,313,102,49,558,22,558,17,0,5
2110405,19,28,1994,1,female,123,103,78,545,351,545,329,0,22
1742179,24,16,1989,6,female,366,102,73,529,479,529,447,0,32
1446663,24,1,1989,4,female,314,102,90,605,482,514,262,91,220
1217644,57,10,1956,12,female,650,103,51,597,127,597,102,0,25
2099920,68,14,1945,10,female,1230,101,50,618,563,0,43,618,520
1074074,18,15,1995,11,female,428,103,37,656,222,581,141,75,81
2184398,18,5,1995,9,female,469,104,52,616,224,484,97,132,127
1001346,37,4,1976,5,female,1038,102,48,634,183,634,148,0,35
2183584,19,30,1994,4,male,310,101,75,722,85,722,75,0,10
1689199,53,14,1960,2,female,333,101,63,702,312,702,262,0,50
1887098,38,17,1975,6,female,444,103,70,763,443,4,93,759,350
2080877,57,10,1956,3,female,743,102,46,761,193,0,59,761,134
1444260,100,4,1913,9,female,1018,102,32,745,42,744,16,1,26
1301330,19,23,1994,6,male,547,101,49,865,3,103,0,762,3
2108756,15,2,1998,11,female,176,104,65,822,266,819,81,3,185
1713583,75,15,1938,4,female,2322,102,45,835,201,834,143,1,58
1564897,33,6,1980,9,female,352,101,82,823,674,822,625,1,49
2101473,28,19,1985,6,male,573,103,55,829,47,829,31,0,16
1862793,26,18,1987,5,female,493,103,58,981,30,226,21,755,9
1933791,39,20,1974,9,female,78,104,82,946,355,448,148,498,207
1248500,35,16,1978,6,female,294,101,68,959,881,283,558,676,323
2103062,50,4,1963,6,male,414,102,66,955,1126,486,791,469,335
1404326,38,18,1975,12,female,239,102,86,980,249,972,140,8,109
1127544,66,10,1947,4,female,398,103,62,886,71,886,45,0,26
1385881,50,15,1963,9,female,1136,101,50,978,264,978,210,0,54
1132776,57,16,1956,9,female,1476,102,65,996,471,11,260,985,211
1321167,30,25,1983,11,male,1579,102,31,1115,258,451,150,664,108
2150986,27,30,1986,8,male,77,101,92,1063,1002,464,446,599,556
1171000,67,5,1946,11,female,1864,104,68,1031,170,1021,91,10,79
1422169,53,10,1960,11,male,69,104,82,1058,155,1058,103,0,52
1103111,61,6,1952,7,female,234,103,74,1242,284,0,129,1242,155
1305027,18,21,1995,1,female,374,101,59,1208,310,824,203,384,107
1991878,17,1,1996,1,male,93,102,86,1234,116,1074,60,160,56
1271723,56,26,1957,1,female,120,101,11,1481,145,25,48,1456,97
2010352,60,12,1953,12,female,425,103,65,1357,775,16,335,1341,440
1799744,64,8,1949,6,male,1127,104,72,1325,263,333,105,992,158
1933129,18,18,1995,4,female,70,102,84,1366,1541,314,316,1052,1225
1273088,104,10,1909,12,female,1794,103,14,1631,422,198,96,1433,326
1212061,43,13,1970,7,female,324,102,68,1759,283,1373,211,386,72
1191335,17,27,1996,1,female,148,102,49,1579,350,1579,73,0,277
1185462,53,23,1960,3,female,154,104,53,1704,880,1704,765,0,115
1944338,27,8,1986,8,female,41,103,93,2273,849,849,386,1424,463
1227977,24,20,1989,1,male,360,103,31,2082,124,1910,79,172,45
1538469,70,7,1943,3,female,533,104,93,2214,433,2174,265,40,168
1978406,36,4,1977,8,female,518,104,51,2057,510,2057,225,0,285
1724408,46,20,1967,2,female,61,104,86,2650,493,0,44,2650,449
1145181,55,1,1958,11,male,659,104,33,2684,1229,2,7,2682,1222
2137728,46,22,1967,5,male,549,104,83,2879,214,2784,120,95,94
2114660,16,18,1997,11,female,358,101,42,11140,3075,10909,1682,231,1393
1329474,14,6,1999,7,female,605,107,51,13,4,13,1,0,3
1773175,17,6,1996,3,male,119,106,93,13,6,13,4,0,2
1418848,20,1,1993,7,male,504,105,44,13,5,13,4,0,1
1729566,27,21,1986,3,male,303,106,59,13,10,13,8,0,2
1420528,57,16,1956,2,male,183,106,81,13,23,13,19,0,4
1860488,16,5,1997,8,male,187,107,50,14,1,0,1,14,0
1638412,47,4,1966,11,male,676,105,69,14,0,0,0,14,0
1798425,64,10,1949,10,female,1077,106,56,14,89,0,24,14,65
1175739,69,15,1944,3,female,1456,106,24,14,26,0,12,14,14
1513395,23,11,1990,4,female,447,106,72,14,1,8,0,6,1
1749958,64,1,1949,4,NA,2237,107,31,14,62,3,39,11,23
1729807,66,24,1947,2,male,1604,106,57,14,27,13,25,1,2
1594321,18,11,1995,4,male,299,105,34,14,2,14,1,0,1
1826530,26,20,1987,10,male,781,107,96,14,6,14,6,0,0
1007627,29,15,1984,10,male,687,105,76,14,22,14,10,0,12
1889673,66,12,1947,10,male,378,106,78,14,54,14,7,0,47
1596319,21,16,1992,8,male,527,107,67,15,0,15,0,0,0
1616350,22,25,1991,3,male,362,107,75,15,1,15,1,0,0
1713633,26,1,1987,1,female,358,105,61,15,2,15,1,0,1
1878560,16,27,1997,8,male,89,105,78,15,29,15,15,0,14
1524221,41,30,1972,9,female,163,107,93,15,40,15,35,0,5
1542350,44,31,1969,5,female,992,106,63,15,82,15,53,0,29
1463174,26,10,1987,11,male,475,105,84,16,21,0,9,16,12
1142672,63,10,1950,9,female,1098,106,61,16,20,0,20,16,0
2124890,21,7,1992,12,female,471,106,83,16,0,16,0,0,0
1333474,15,20,1998,1,male,313,106,64,16,17,16,14,0,3
1264877,16,2,1997,11,male,519,107,61,17,3,0,1,17,2
1653497,20,14,1993,2,female,210,106,53,17,32,0,17,17,15
1107246,50,1,1963,12,female,752,105,44,17,52,1,19,16,33
1015200,48,31,1965,7,male,1333,106,39,17,47,11,40,6,7
2097104,23,15,1990,8,female,622,105,34,17,0,17,0,0,0
1929201,20,12,1993,8,male,227,107,96,17,11,17,10,0,1
1573405,27,1,1986,1,male,672,107,81,17,17,17,7,0,10
2143865,45,9,1968,2,male,1022,105,28,17,20,17,10,0,10
1191029,108,19,1905,5,female,241,107,59,17,51,17,29,0,22
1099827,61,20,1952,1,male,632,106,46,18,6,1,0,17,6
1583419,59,27,1954,8,female,871,107,40,18,130,0,28,18,102
1240985,77,1,1936,1,male,1019,107,52,18,39,0,23,18,16
1830479,26,1,1987,1,male,260,107,82,18,9,17,5,1,4
2157375,27,23,1986,3,male,493,107,75,18,0,18,0,0,0
1137488,31,16,1982,1,male,452,105,94,18,6,18,3,0,3
1946680,18,4,1995,5,female,30,107,44,18,61,18,45,0,16
1373813,52,25,1961,6,male,336,105,92,19,22,0,20,19,2
2133268,78,24,1935,11,female,1596,106,43,19,130,0,111,19,19
1949608,22,26,1991,1,male,297,105,44,19,9,12,9,7,0
1846489,60,14,1953,2,male,41,107,82,19,34,17,20,2,14
1006377,53,17,1960,2,male,146,107,73,19,129,19,69,0,60
1368740,58,9,1955,3,male,691,107,56,20,0,0,0,20,0
1787774,54,16,1959,3,female,1488,107,20,20,78,0,12,20,66
1963878,59,16,1954,1,female,1016,106,52,20,59,16,48,4,11
1559892,29,10,1984,10,male,618,105,85,20,0,20,0,0,0
1876876,22,11,1991,10,male,117,107,106,20,11,20,2,0,9
1926302,15,2,1998,12,male,440,106,101,21,0,0,0,21,0
1016223,14,3,1999,1,female,284,105,85,21,0,0,0,21,0
1967090,22,27,1991,12,male,1023,105,72,21,0,0,0,21,0
2036047,15,22,1998,9,male,554,105,47,21,2,20,1,1,1
1984969,27,29,1986,7,female,308,105,55,21,53,16,28,5,25
1400334,18,7,1995,1,male,311,107,94,21,1,21,1,0,0
1898956,22,22,1991,2,male,598,107,61,21,0,21,0,0,0
2010345,35,3,1978,10,female,384,105,97,21,99,21,99,0,0
1817883,42,29,1971,8,female,357,105,67,21,63,21,31,0,32
1923115,61,2,1952,1,male,761,105,45,22,2,0,0,22,2
2175872,113,18,1900,7,female,1549,106,67,22,26,0,9,22,17
1225759,26,3,1987,9,male,305,106,68,22,23,18,11,4,12
1219618,19,19,1994,11,male,156,105,68,22,0,22,0,0,0
1835799,26,11,1987,3,male,260,107,66,22,0,22,0,0,0
1731617,17,13,1996,11,male,433,105,70,22,9,22,3,0,6
2082658,52,1,1961,2,male,997,105,28,22,57,22,30,0,27
1343716,60,6,1953,5,male,483,107,82,23,4,0,2,23,2
1235409,24,17,1989,6,male,663,106,95,23,5,12,2,11,3
1478623,40,26,1973,9,male,754,105,68,23,3,17,1,6,2
1992828,59,15,1954,5,male,1497,106,37,23,24,22,15,1,9
1563743,26,1,1987,1,male,345,107,36,23,0,23,0,0,0
1868108,32,7,1981,4,male,311,107,103,23,0,23,0,0,0
1781494,21,28,1992,2,female,253,105,58,23,21,23,18,0,3
1694867,40,25,1973,4,female,1300,107,47,23,70,23,47,0,23
1012998,60,16,1953,8,male,626,106,55,24,5,0,2,24,3
1042512,101,4,1912,5,male,1138,106,79,24,11,0,9,24,2
2168040,44,14,1969,10,male,1805,105,41,24,2,13,1,11,1
1182899,71,31,1942,8,female,955,105,57,24,3,10,2,14,1
2127445,67,12,1946,1,female,260,107,69,24,31,17,21,7,10
1672109,23,5,1990,12,male,373,105,39,24,1,24,0,0,1
1073005,32,6,1981,2,female,516,106,53,24,86,24,80,0,6
1602928,45,18,1968,10,female,427,107,67,25,34,0,1,25,33
1168837,55,5,1958,11,female,1455,107,58,25,44,0,30,25,14
2024432,38,8,1975,8,male,672,106,34,25,7,16,6,9,1
1686018,21,11,1992,1,male,53,107,90,25,30,24,7,1,23
1888820,21,24,1992,4,female,429,105,56,25,25,20,10,5,15
1624980,21,23,1992,12,female,385,105,23,25,1,25,1,0,0
1896698,24,12,1989,8,male,300,107,89,25,1,25,1,0,0
1123337,75,9,1938,10,female,808,106,76,25,7,25,5,0,2
2027740,68,5,1945,6,female,224,105,51,25,51,25,26,0,25
1763065,89,18,1924,10,male,1240,107,41,26,26,6,17,20,9
1431070,108,5,1905,11,male,1261,105,36,26,10,25,10,1,0
1696140,16,25,1997,3,female,41,105,50,26,17,25,9,1,8
1211585,25,1,1988,1,male,177,105,80,26,11,26,11,0,0
1834612,65,3,1948,8,male,389,107,71,27,210,0,38,27,172
2159632,51,24,1962,12,female,603,105,42,27,12,19,10,8,2
1085962,60,22,1953,9,male,1235,106,49,27,16,24,11,3,5
1763843,24,9,1989,8,male,155,106,57,27,7,27,3,0,4
1872685,51,1,1962,1,female,1468,107,29,27,11,27,7,0,4
1307510,22,6,1991,8,male,418,107,65,27,39,27,13,0,26
1713451,22,16,1991,6,male,661,107,40,28,16,1,6,27,10
1816877,63,24,1950,12,male,1250,105,48,28,12,15,9,13,3
1390024,25,9,1988,9,male,421,106,62,28,9,28,7,0,2
1391479,31,27,1982,7,male,223,105,64,29,16,0,9,29,7
1844026,17,17,1996,9,female,162,107,94,29,4,25,2,4,2
1829983,25,14,1988,1,male,655,107,49,29,0,29,0,0,0
1039115,26,28,1987,8,male,161,106,93,29,3,29,3,0,0
2118091,29,2,1984,3,male,610,105,50,29,20,29,19,0,1
2005503,30,24,1983,6,male,765,105,29,29,31,29,24,0,7
1546190,106,3,1907,8,male,1566,107,49,31,4,0,0,31,4
1683152,103,24,1910,6,female,1314,105,45,31,49,0,20,31,29
2083280,23,30,1990,7,female,285,105,71,31,65,26,54,5,11
2152286,61,30,1952,4,female,413,107,66,30,0,30,0,0,0
1708055,96,17,1917,6,male,936,105,23,32,50,1,34,31,16
1227285,47,3,1966,10,male,1583,105,57,32,33,31,24,1,9
1121180,14,17,1999,5,male,346,106,34,32,4,32,2,0,2
1684938,38,12,1975,3,female,408,105,64,32,25,32,21,0,4
1111933,42,7,1971,5,female,1160,106,32,32,142,32,124,0,18
1574718,22,28,1991,3,female,1100,107,54,33,50,0,5,33,45
1444567,59,15,1954,10,female,767,107,64,33,1072,0,585,33,487
1293764,18,1,1995,1,male,287,106,65,33,3,10,1,23,2
1181516,70,12,1943,11,male,1558,107,70,33,19,15,8,18,11
1463136,27,4,1986,10,male,602,107,90,33,39,33,36,0,3
1710689,34,29,1979,9,male,312,106,76,34,0,0,0,34,0
1694143,31,9,1982,8,male,202,107,52,35,6,0,2,35,4
2163010,91,21,1922,1,female,328,105,59,36,30,3,7,33,23
1435254,18,11,1995,1,male,204,105,47,36,10,36,10,0,0
2022048,46,28,1967,8,female,671,105,24,36,60,36,48,0,12
1259381,53,28,1960,5,female,817,106,29,37,28,20,11,17,17
2052335,24,22,1989,8,female,1085,107,101,37,0,37,0,0,0
2139780,32,16,1981,9,female,326,105,92,37,11,37,4,0,7
1685711,23,9,1990,9,female,65,105,86,37,32,37,3,0,29
2085409,23,5,1990,6,male,184,106,52,37,64,37,61,0,3
1720464,53,7,1960,12,female,697,106,93,37,75,37,59,0,16
1025237,16,28,1997,11,female,542,106,57,38,27,32,9,6,18
1199250,21,18,1992,1,male,342,106,47,39,33,38,24,1,9
1619186,22,23,1991,5,male,461,107,74,39,17,39,12,0,5
1375457,28,29,1985,8,female,429,107,59,38,19,38,14,0,5
1161353,67,3,1946,10,female,1031,106,73,40,2,40,2,0,0
1037962,52,1,1961,1,male,209,105,71,40,58,40,33,0,25
1630593,53,14,1960,11,male,677,107,77,40,146,40,134,0,12
1895165,89,25,1924,1,female,1042,105,54,42,10,4,0,38,10
2177165,17,19,1996,1,female,361,107,44,41,49,1,24,40,25
1297511,21,12,1992,5,male,368,107,78,41,13,17,5,24,8
1032529,28,15,1985,10,male,1171,107,69,41,182,22,125,19,57
1618222,14,15,1999,8,male,17,106,89,42,18,41,16,1,2
1661689,23,10,1990,10,female,206,105,58,42,31,36,17,6,14
1048815,18,24,1995,8,male,151,106,84,42,7,42,5,0,2
1559713,27,2,1986,7,male,74,107,27,41,36,41,20,0,16
1383924,31,1,1982,11,female,153,106,101,41,72,41,60,0,12
1961132,34,6,1979,3,female,331,105,82,42,70,42,63,0,7
2127974,21,6,1992,6,male,330,106,75,44,11,44,10,0,1
1014546,52,5,1961,7,male,1549,107,28,44,21,44,18,0,3
1822213,18,18,1995,8,male,539,105,54,45,29,0,29,45,0
1350267,19,11,1994,3,male,171,107,88,47,3,0,0,47,3
1356648,22,12,1991,11,female,566,105,24,46,5,0,3,46,2
1457818,55,10,1958,9,female,491,105,78,46,0,0,0,46,0
1736728,83,4,1930,3,female,10,105,95,46,63,5,29,41,34
1757581,72,20,1941,1,male,432,106,69,46,88,31,37,15,51
1859237,16,1,1997,10,female,70,105,57,46,1,46,1,0,0
1314981,17,4,1996,11,female,408,105,76,47,15,47,15,0,0
1965760,44,11,1969,3,male,619,105,81,47,8,47,3,0,5
1792329,20,1,1993,6,male,128,106,98,47,34,47,28,0,6
1537937,60,20,1953,1,male,1625,106,34,48,6,0,1,48,5
1656685,24,21,1989,12,male,284,107,76,49,87,31,36,18,51
1693432,19,24,1994,7,female,136,107,86,49,9,47,8,2,1
2179872,27,27,1986,4,female,124,105,43,49,309,45,153,4,156
1192666,20,22,1993,2,male,405,105,80,48,27,48,21,0,6
1045426,40,25,1973,9,female,356,107,71,49,9,49,8,0,1
1452410,25,10,1988,2,female,533,107,67,50,48,0,4,50,44
1804007,70,29,1943,7,male,375,107,72,51,33,0,5,51,28
1744630,32,2,1981,9,male,604,105,60,51,15,28,4,23,11
1422449,28,4,1985,3,male,852,107,73,51,48,41,17,10,31
2166959,32,10,1981,5,female,501,105,63,50,126,48,81,2,45
1255327,22,21,1991,8,female,475,105,49,51,56,51,33,0,23
2080648,37,22,1976,5,female,240,107,68,50,66,50,66,0,0
2147513,48,13,1965,8,female,404,105,27,50,44,50,19,0,25
1554746,52,19,1961,12,male,272,105,64,50,62,50,45,0,17
1792688,17,9,1996,1,male,257,106,75,53,23,0,9,53,14
1519180,34,21,1979,8,female,667,106,63,53,37,45,14,8,23
2118200,24,14,1989,12,male,243,107,59,53,0,53,0,0,0
1761334,31,1,1982,7,male,473,106,35,53,2,53,2,0,0
1091435,50,20,1963,7,male,287,106,70,53,1,53,1,0,0
1632987,18,20,1995,2,male,66,105,90,54,16,54,14,0,2
1154729,25,10,1988,10,male,93,107,90,54,18,54,13,0,5
1342686,33,30,1980,8,female,572,107,69,55,25,55,21,0,4
1762518,30,28,1983,4,female,480,105,72,55,45,55,33,0,12
1756340,38,25,1975,3,female,868,105,49,54,115,54,101,0,14
1340245,20,9,1993,5,male,292,105,61,58,73,0,8,58,65
1930830,22,23,1991,3,male,237,106,70,57,2,45,1,12,1
1451029,20,29,1993,1,male,416,105,83,60,1,5,1,55,0
1448415,26,6,1987,4,male,373,106,91,59,51,59,49,0,2
2113869,18,29,1995,10,male,355,106,61,61,16,0,3,61,13
1674620,49,30,1964,8,male,990,106,14,63,19,0,5,63,14
1604970,66,17,1947,11,male,184,107,73,61,209,0,146,61,63
1205559,22,31,1991,7,female,469,105,56,63,66,59,26,4,40
1398937,20,23,1993,7,female,130,106,63,63,22,63,22,0,0
1537832,23,19,1990,1,female,178,105,100,63,27,63,21,0,6
2037362,24,10,1989,10,female,285,106,55,63,72,63,24,0,48
1111435,63,13,1950,10,female,322,106,76,64,22,0,7,64,15
1468082,59,25,1954,6,male,2198,105,49,65,40,61,21,4,19
1225971,23,2,1990,12,male,244,106,77,64,21,64,20,0,1
2119431,30,2,1983,12,male,324,106,85,64,18,64,18,0,0
2123944,20,5,1993,12,female,304,105,61,64,84,64,47,0,37
2065441,55,2,1958,5,female,363,106,71,68,108,0,54,68,54
1789620,100,14,1913,8,female,2068,106,36,67,3,67,3,0,0
1302463,50,10,1963,9,female,1317,105,69,66,83,66,66,0,17
1746553,27,28,1986,2,female,244,107,86,71,35,5,32,66,3
1011901,46,18,1967,8,male,312,106,75,69,55,0,36,69,19
2189569,57,5,1956,5,female,777,107,75,69,68,66,59,3,9
1720429,18,5,1995,5,female,353,106,30,69,36,69,36,0,0
1066565,25,26,1988,6,male,267,106,87,69,44,69,40,0,4
1173427,17,13,1996,7,female,500,107,19,74,26,2,2,72,24
1127173,32,30,1981,3,female,409,107,21,72,104,0,61,72,43
2162376,56,7,1957,11,female,93,106,45,74,47,0,22,74,25
1836121,63,30,1950,8,female,859,106,74,73,70,5,38,68,32
1251578,54,9,1959,11,female,801,107,66,72,110,1,63,71,47
1634924,35,23,1978,11,female,282,106,63,74,37,31,33,43,4
1259392,93,27,1920,9,male,1534,105,64,72,21,15,11,57,10
1228447,45,17,1968,12,male,719,107,53,72,62,48,50,24,12
1968964,71,4,1942,2,male,1514,107,46,74,5,73,3,1,2
1229249,25,16,1988,1,male,286,106,56,76,16,75,14,1,2
1988246,18,14,1995,2,female,373,106,73,77,69,77,43,0,26
1408553,32,20,1981,1,male,585,105,48,77,112,77,53,0,59
1895264,29,5,1984,7,female,530,105,67,78,48,71,24,7,24
2101476,38,6,1975,6,female,98,106,78,78,18,78,16,0,2
2109757,52,28,1961,6,female,1613,107,69,81,199,29,159,52,40
1184514,52,4,1961,2,male,205,106,48,81,78,62,27,19,51
1802996,72,31,1941,1,female,2064,105,45,81,87,80,77,1,10
1821311,73,27,1940,8,male,1733,106,41,83,74,79,34,4,40
1239986,103,9,1910,11,female,729,105,18,82,2,82,2,0,0
1932364,43,24,1970,5,female,833,105,56,81,30,81,20,0,10
1662387,65,4,1948,10,female,1790,106,33,82,32,82,22,0,10
1192757,23,4,1990,5,female,129,106,44,83,76,83,39,0,37
1601621,57,22,1956,5,female,60,106,71,81,128,81,46,0,82
1459788,70,14,1943,10,male,1646,105,68,87,169,42,57,45,112
2127147,34,22,1979,11,male,324,106,65,87,93,69,29,18,64
1130880,15,2,1998,10,male,308,105,62,88,22,82,17,6,5
2016605,34,20,1979,5,male,758,107,68,91,68,67,39,24,29
1806426,108,20,1905,5,male,110,105,92,89,1,89,1,0,0
2010349,26,7,1987,8,female,260,107,48,90,26,90,20,0,6
1852820,35,5,1978,9,female,271,107,69,92,8,0,4,92,4
1896976,18,4,1995,4,male,83,106,98,98,7,0,0,98,7
1110766,75,6,1938,3,female,1552,106,44,98,8,0,4,98,4
1451600,20,6,1993,3,male,441,105,75,98,68,3,30,95,38
1126312,19,11,1994,7,female,190,107,75,96,88,68,67,28,21
1246730,26,12,1987,11,female,471,105,54,97,17,97,17,0,0
1660764,48,20,1965,6,female,646,106,37,96,124,96,77,0,47
1880226,112,30,1901,4,female,1477,105,55,100,114,0,58,100,56
1672483,63,31,1950,12,male,810,107,19,100,59,38,33,62,26
1645728,36,30,1977,5,female,142,106,24,100,51,100,32,0,19
1823500,30,6,1983,4,female,1414,107,48,100,129,100,108,0,21
1011982,30,3,1983,10,male,141,107,94,101,62,101,44,0,18
1125501,37,25,1976,7,female,989,106,45,104,74,104,40,0,34
1428382,37,5,1976,2,female,422,105,46,105,26,0,15,105,11
1528341,39,29,1974,6,female,787,106,63,105,291,105,251,0,40
1022755,58,5,1955,11,female,1798,106,63,110,48,0,8,110,40
1907105,34,5,1979,2,male,283,107,27,110,13,78,3,32,10
1052953,20,16,1993,7,female,502,106,60,110,32,64,9,46,23
1545409,24,6,1989,6,female,389,105,44,111,80,30,41,81,39
2045729,42,2,1971,6,male,731,106,69,113,129,110,105,3,24
1759495,28,7,1985,9,female,485,105,81,112,199,112,192,0,7
1423836,47,23,1966,9,female,770,106,59,117,72,0,22,117,50
1835534,80,4,1933,9,female,1723,106,18,118,78,0,53,118,25
1808791,25,16,1988,1,male,171,107,91,119,21,37,15,82,6
1552453,31,2,1982,12,male,246,107,66,118,43,118,28,0,15
1656488,76,23,1937,12,male,1566,106,45,117,45,117,12,0,33
1215762,22,21,1991,11,female,381,106,46,118,127,118,106,0,21
1713752,102,31,1911,1,female,950,105,88,124,2,0,0,124,2
1079097,60,24,1953,12,female,1910,105,73,121,92,119,67,2,25
1890133,41,23,1972,10,female,515,106,60,122,324,93,179,29,145
1906414,31,20,1982,7,female,358,107,41,121,13,121,11,0,2
1515647,44,14,1969,5,female,577,107,61,121,70,121,13,0,57
2075955,63,3,1950,1,male,498,105,72,121,103,121,37,0,66
1625313,35,24,1978,11,female,1144,107,46,121,325,121,169,0,156
1988208,15,22,1998,4,female,641,106,46,128,190,86,52,42,138
1642023,52,2,1961,1,female,878,107,74,131,121,0,37,131,84
2060110,37,26,1976,8,female,443,105,49,132,13,30,3,102,10
1544308,49,11,1964,1,female,1911,106,38,131,220,118,171,13,49
1715479,17,3,1996,5,female,50,107,93,133,0,133,0,0,0
1264972,21,8,1992,11,female,476,105,42,135,19,135,18,0,1
1201706,24,25,1989,10,male,1324,105,25,131,40,131,20,0,20
1660743,69,10,1944,9,female,1697,106,37,136,47,136,41,0,6
1324853,59,11,1954,11,female,256,105,82,142,14,0,8,142,6
1188212,58,21,1955,9,female,628,106,43,139,16,0,4,139,12
2124209,52,6,1961,1,female,398,105,35,139,96,0,4,139,92
1390035,40,14,1973,9,male,233,106,66,139,29,121,16,18,13
1399647,40,18,1973,2,male,313,106,79,142,13,142,8,0,5
1942077,65,22,1948,4,female,401,105,80,150,70,1,51,149,19
1307156,63,27,1950,5,female,1471,105,75,147,162,0,62,147,100
1251134,23,10,1990,1,male,98,107,81,144,12,54,10,90,2
1518937,16,11,1997,4,male,571,105,55,145,5,145,4,0,1
1508058,19,18,1994,6,male,634,107,69,144,106,144,70,0,36
1999399,32,18,1981,11,female,698,105,42,149,327,149,297,0,30
1981614,67,8,1946,9,female,907,107,80,157,15,0,4,157,11
1642782,60,15,1953,1,female,1526,105,48,156,127,21,65,135,62
1033852,29,21,1984,12,female,1419,105,58,164,159,46,107,118,52
1087323,65,16,1948,11,female,1068,106,48,160,842,99,548,61,294
1458888,18,10,1995,7,female,538,106,55,159,102,157,66,2,36
1203288,51,16,1962,4,female,1838,105,56,163,158,161,109,2,49
2029178,17,10,1996,9,female,135,105,56,160,410,150,88,10,322
1970343,23,19,1990,7,male,298,107,49,159,281,120,177,39,104
1770911,29,21,1984,9,male,1052,106,66,163,6,163,6,0,0
1863027,107,26,1906,2,female,1406,105,49,158,56,158,41,0,15
1760734,28,31,1985,12,male,230,107,74,160,189,160,181,0,8
1551771,28,1,1985,2,female,674,106,79,161,135,161,97,0,38
1338416,56,6,1957,10,male,804,106,50,164,123,164,67,0,56
1110779,53,1,1960,1,female,268,106,65,171,284,88,137,83,147
1601526,35,24,1978,11,male,508,107,29,170,171,159,39,11,132
1845011,19,6,1994,12,male,276,107,49,172,91,172,75,0,16
1603566,14,6,1999,1,male,382,107,66,181,253,43,89,138,164
1384950,15,17,1998,6,male,87,105,79,181,150,85,39,96,111
1722274,16,26,1997,3,male,337,106,66,175,138,98,66,77,72
1183475,32,10,1981,1,female,359,107,63,176,120,110,104,66,16
1488266,106,2,1907,10,female,1308,107,35,176,93,169,68,7,25
1987993,21,21,1992,6,male,329,107,93,175,126,175,75,0,51
1043652,28,14,1985,2,female,70,106,57,178,319,178,276,0,43
1576288,55,28,1958,2,female,944,107,39,183,49,183,45,0,4
2180415,25,3,1988,4,female,126,107,104,183,130,183,128,0,2
1484099,51,3,1962,4,male,574,105,62,198,128,20,98,178,30
1009992,54,10,1959,3,female,107,107,72,192,64,192,22,0,42
2012656,36,28,1977,9,female,817,106,39,196,201,196,115,0,86
1270399,61,16,1952,6,female,772,107,76,211,511,0,25,211,486
1114137,108,10,1905,10,female,2337,105,54,210,257,210,168,0,89
1270036,13,11,2000,6,male,115,107,77,214,99,173,47,41,52
1850440,24,18,1989,5,male,1009,106,53,220,514,196,314,24,200
1252729,31,21,1982,9,female,230,107,77,213,102,213,98,0,4
1442766,31,22,1982,9,female,1496,107,59,212,438,212,183,0,255
1672163,19,21,1994,1,male,50,105,75,230,205,81,123,149,82
1280016,36,11,1977,7,female,473,105,79,230,466,156,217,74,249
1511762,46,18,1967,8,female,523,107,56,222,341,136,266,86,75
1974089,25,25,1988,2,female,371,105,79,224,51,224,51,0,0
1291078,108,10,1905,10,male,0,106,102,234,58,0,5,234,53
1800930,15,15,1998,11,female,455,107,75,236,233,6,134,230,99
2021717,21,22,1992,9,female,233,107,63,245,124,96,45,149,79
1750758,43,4,1970,7,female,525,107,61,234,252,107,129,127,123
2137454,23,26,1990,8,female,124,107,86,239,210,226,53,13,157
2065807,61,10,1952,8,female,1351,106,47,235,36,235,24,0,12
1172476,39,22,1974,3,female,1041,107,49,244,296,244,249,0,47
1346889,55,20,1958,12,male,1567,106,48,259,117,173,79,86,38
1971423,49,21,1964,4,female,366,107,71,252,105,232,87,20,18
1171659,20,24,1993,7,female,390,107,58,250,87,250,66,0,21
1274959,23,1,1990,1,female,456,106,23,253,90,253,42,0,48
1980662,90,11,1923,1,male,726,106,85,256,155,256,147,0,8
1121640,65,23,1948,7,female,1392,106,47,265,109,0,31,265,78
1329974,15,12,1998,9,female,561,105,41,263,93,248,48,15,45
1531164,70,16,1943,9,female,138,105,30,262,11,261,6,1,5
1963939,17,6,1996,5,female,96,105,65,274,400,274,327,0,73
1542624,28,8,1985,10,female,212,105,72,268,201,268,158,0,43
2171572,65,31,1948,12,female,998,105,51,269,768,269,572,0,196
2174404,33,2,1980,5,female,455,105,76,278,7,10,1,268,6
1163767,67,26,1946,10,female,46,105,83,278,254,0,93,278,161
1566811,46,7,1967,4,female,652,106,59,280,135,258,104,22,31
1411634,23,28,1990,11,female,747,106,60,277,195,256,109,21,86
1478889,31,14,1982,5,female,705,106,92,289,136,289,135,0,1
1690179,38,15,1975,8,female,736,106,56,286,77,286,71,0,6
1058493,24,1,1989,1,female,539,105,77,297,317,297,169,0,148
1134449,58,24,1955,1,male,445,107,38,293,351,293,148,0,203
1724891,56,10,1957,4,female,1985,107,71,318,40,3,27,315,13
1960959,27,14,1986,1,female,271,106,54,316,111,316,73,0,38
1244433,33,10,1980,11,male,396,105,78,311,142,311,119,0,23
1079270,46,24,1967,2,female,459,107,17,312,128,312,78,0,50
1495888,32,9,1981,12,female,205,105,75,323,251,323,110,0,141
1379472,34,18,1979,7,female,297,107,55,317,211,317,116,0,95
1507570,35,8,1978,8,female,371,105,35,317,416,317,192,0,224
1220318,58,19,1955,5,male,439,105,33,327,371,327,247,0,124
2160827,20,15,1993,4,female,188,106,46,338,130,302,69,36,61
1781562,58,26,1955,9,male,1376,105,65,341,174,341,98,0,76
1390571,15,18,1998,3,male,432,106,59,364,15,349,9,15,6
1900265,31,22,1982,1,female,668,106,76,354,245,308,161,46,84
1282333,38,29,1975,4,male,135,106,77,351,53,351,29,0,24
1970552,103,17,1910,3,female,1438,107,65,351,145,351,115,0,30
1088668,108,7,1905,2,male,1403,107,40,348,96,348,77,0,19
1778925,108,4,1905,4,male,340,107,35,377,15,29,5,348,10
2007610,52,10,1961,12,female,1114,107,36,371,107,0,34,371,73
1926628,16,20,1997,1,male,287,106,51,371,12,142,3,229,9
1286394,34,6,1979,6,female,622,107,60,383,307,174,109,209,198
1224917,53,15,1960,9,female,428,105,56,373,395,252,329,121,66
2109264,35,2,1978,6,female,224,106,58,379,182,379,174,0,8
1737107,52,2,1961,2,female,688,107,94,385,117,385,103,0,14
1218677,23,19,1990,10,female,512,107,62,375,322,375,287,0,35
1220276,103,8,1910,4,female,1630,106,45,401,166,31,39,370,127
1040186,26,5,1987,8,male,1226,105,34,416,63,252,7,164,56
1269623,24,15,1989,12,female,888,107,82,397,229,196,127,201,102
1869864,46,1,1967,1,female,1699,107,32,420,203,416,113,4,90
1543383,17,20,1996,4,male,496,107,79,403,11,403,6,0,5
1634299,58,19,1955,5,female,1528,105,47,438,185,426,59,12,126
1832978,15,6,1998,1,male,506,105,77,443,18,443,17,0,1
1972743,24,14,1989,7,male,530,105,78,426,20,426,17,0,3
1648049,67,24,1946,10,female,1617,105,49,457,537,58,207,399,330
1146412,21,2,1992,8,male,402,105,29,456,96,439,71,17,25
2119829,28,16,1985,5,female,531,106,66,460,445,412,306,48,139
1399333,29,24,1984,1,male,163,105,68,494,212,494,192,0,20
2172466,49,22,1964,7,female,1545,106,41,487,281,487,169,0,112
1690673,58,25,1955,12,male,6,105,90,486,161,486,160,0,1
1437422,53,1,1960,1,female,309,107,78,532,330,0,182,532,148
2061065,15,27,1998,10,female,340,106,66,520,183,444,95,76,88
1903957,18,17,1995,8,female,189,107,68,537,444,506,246,31,198
1457789,47,3,1966,3,female,224,106,27,536,77,536,54,0,23
1349237,17,8,1996,3,male,737,107,69,536,154,536,109,0,45
2110166,22,4,1991,9,male,230,106,85,551,337,551,297,0,40
1672361,108,15,1905,5,male,721,107,79,587,25,586,21,1,4
2114791,17,26,1996,3,female,168,105,86,587,19,587,17,0,2
1187926,18,6,1995,4,male,256,107,70,579,61,579,21,0,40
1671947,32,22,1981,3,female,1149,105,43,562,282,562,195,0,87
1593308,40,1,1973,1,male,283,106,57,650,290,37,74,613,216
1219000,56,25,1957,5,female,1588,107,60,612,267,202,127,410,140
1803271,30,7,1983,3,male,279,105,75,622,902,135,251,487,651
1385378,45,19,1968,9,male,876,106,82,640,9,640,7,0,2
1189687,30,9,1983,1,female,273,105,34,618,272,618,264,0,8
1794218,15,7,1998,4,male,35,107,74,677,89,643,52,34,37
1587108,56,12,1957,8,female,594,106,69,706,280,565,259,141,21
1691294,18,21,1995,3,male,336,106,60,683,781,647,341,36,440
1248135,49,12,1964,6,female,437,106,62,793,235,784,103,9,132
1218754,45,26,1968,11,male,610,107,84,743,2,743,0,0,2
2115871,45,27,1968,5,male,217,107,75,739,280,739,223,0,57
1418119,62,27,1951,7,female,481,106,65,845,548,0,91,845,457
1149684,43,13,1970,10,female,1446,107,61,889,958,606,186,283,772
1126046,35,2,1978,6,male,288,107,93,956,158,729,3,227,155
1924697,56,21,1957,12,female,1495,105,60,1026,344,1013,184,13,160
1445666,62,9,1951,7,female,358,105,74,1221,821,0,180,1221,641
1385717,29,24,1984,8,female,328,107,77,1178,527,935,171,243,356
2005831,56,6,1957,5,female,970,107,75,1238,102,1238,69,0,33
1997063,56,23,1957,2,female,213,106,82,1348,982,0,245,1348,737
1181847,16,7,1997,10,female,411,105,87,1464,714,1134,378,330,336
1488623,56,5,1957,11,female,1364,105,59,1301,431,1301,368,0,63
1870741,55,7,1958,9,female,363,107,67,1412,283,1412,159,0,124
2018516,60,24,1953,4,male,600,107,84,1568,62,0,4,1568,58
1524027,55,1,1958,9,female,1290,106,65,1734,594,99,196,1635,398
1346808,37,6,1976,7,female,524,107,52,1568,867,1479,560,89,307
1041425,67,5,1946,3,female,36,105,79,2353,801,0,181,2353,620
1657857,46,30,1967,11,female,947,107,28,2087,1058,1988,777,99,281
1476590,43,15,1970,9,male,311,107,77,1964,2192,1963,1803,1,389
2126197,20,13,1993,6,male,208,106,56,3831,869,2947,425,884,444
1693371,56,25,1957,8,female,60,105,98,3680,334,3668,210,12,124
2183818,81,16,1932,11,female,600,108,56,10,131,1,28,9,103
1966524,108,1,1905,1,male,1412,108,41,10,63,0,23,10,40
1197704,21,10,1992,8,male,856,110,42,10,45,5,4,5,41
1367478,44,8,1969,1,male,579,111,33,10,34,3,27,7,7
1538769,108,30,1905,11,male,217,111,81,10,18,3,8,7,10
1233559,22,1,1991,3,male,337,110,52,10,28,8,7,2,21
1682496,22,4,1991,1,male,508,110,75,10,4,10,4,0,0
1844433,34,21,1979,1,male,1112,110,56,10,5,10,4,0,1
2081378,38,4,1975,9,male,420,109,89,10,6,10,6,0,0
1749829,20,24,1993,11,male,519,109,72,10,14,10,14,0,0
1834799,26,23,1987,10,male,489,108,84,10,39,10,26,0,13
1437033,28,6,1985,1,male,220,110,51,10,34,10,24,0,10
1562188,30,14,1983,12,male,222,110,58,10,17,10,14,0,3
1473720,41,16,1972,6,male,394,109,46,10,65,10,25,0,40
1841296,47,1,1966,1,male,475,110,74,10,42,10,34,0,8
1364949,64,26,1949,10,male,1128,111,55,10,20,10,18,0,2
2049991,21,23,1992,11,male,1177,110,82,11,0,0,0,11,0
1607250,50,26,1963,12,male,599,109,40,11,1,0,0,11,1
1634861,58,14,1955,8,female,738,111,22,11,3,0,2,11,1
1137389,63,12,1950,7,male,1873,109,25,11,11,0,6,11,5
1730483,15,6,1998,1,male,938,109,55,11,18,1,1,10,17
1353930,30,21,1983,3,male,1234,110,53,11,1,7,0,4,1
2128570,68,17,1945,8,female,687,111,79,11,3,11,0,0,3
2011686,22,26,1991,11,male,540,108,86,11,8,11,6,0,2
1051119,32,31,1981,5,female,286,109,85,11,7,11,7,0,0
2184400,22,26,1991,6,male,479,109,82,11,89,11,17,0,72
1196681,46,26,1967,10,female,2283,108,44,11,57,11,55,0,2
1640927,28,1,1985,1,male,504,111,90,12,4,0,1,12,3
1131240,29,13,1984,4,male,648,109,44,12,30,9,27,3,3
2002651,21,30,1992,4,male,236,109,17,12,5,12,2,0,3
1412520,22,18,1991,11,male,207,108,93,12,39,12,26,0,13
1444854,17,19,1996,5,male,376,109,97,13,0,1,0,12,0
2014646,14,16,1999,8,male,152,108,106,13,0,7,0,6,0
1887827,29,9,1984,4,male,490,108,49,13,18,8,10,5,8
1180746,16,22,1997,6,male,857,110,92,13,27,12,18,1,9
1103789,36,7,1977,7,male,164,110,81,13,1,13,1,0,0
2072364,43,28,1970,12,male,267,111,99,13,3,13,3,0,0
1976086,65,14,1948,2,male,782,110,67,13,8,13,6,0,2
1495748,20,17,1993,12,female,355,111,54,13,36,13,27,0,9
1566454,23,28,1990,8,male,327,110,82,13,31,13,27,0,4
1104241,24,29,1989,7,female,242,109,51,13,92,13,73,0,19
1282851,26,1,1987,1,female,358,111,48,13,62,13,28,0,34
1267880,27,29,1986,5,male,496,110,89,14,3,0,0,14,3
1263615,66,28,1947,12,male,1082,109,33,14,47,0,11,14,36
1198869,58,13,1955,4,female,1949,109,35,14,56,4,34,10,22
2124427,103,19,1910,10,female,1292,110,94,14,10,13,10,1,0
1167316,29,16,1984,11,male,323,108,97,14,31,13,15,1,16
1742836,21,15,1992,9,male,308,108,84,14,0,14,0,0,0
1252210,29,11,1984,6,male,327,110,59,14,2,14,2,0,0
1005097,72,20,1941,8,male,443,111,100,14,0,14,0,0,0
1824606,26,11,1987,12,male,222,110,94,14,4,14,3,0,1
1099765,36,4,1977,4,male,277,110,96,14,11,14,9,0,2
1308235,26,4,1987,6,male,606,108,76,14,32,14,32,0,0
1932477,50,1,1963,11,male,331,109,80,15,21,0,4,15,17
1322919,22,1,1991,3,female,201,108,61,15,36,0,20,15,16
1756793,19,2,1994,4,male,232,110,92,15,6,10,4,5,2
1898295,49,9,1964,11,female,1488,109,80,15,63,8,31,7,32
1713209,99,1,1914,7,male,1179,108,26,15,26,14,11,1,15
1465304,17,5,1996,12,male,405,111,63,15,0,15,0,0,0
1411031,27,26,1986,11,male,928,108,76,15,18,15,15,0,3
2138592,19,22,1994,11,female,511,110,71,16,1,3,0,13,1
1295320,16,21,1997,1,male,263,108,78,16,6,0,5,16,1
1583189,33,12,1980,2,male,354,110,107,16,8,0,1,16,7
1354073,14,16,1999,12,female,203,108,64,16,9,4,0,12,9
1947268,16,24,1997,3,female,298,111,61,16,10,8,5,8,5
2076825,19,1,1994,1,male,647,110,54,16,0,16,0,0,0
1509393,44,30,1969,11,male,426,108,46,16,1,16,1,0,0
2149985,28,16,1985,3,female,122,108,83,16,9,16,7,0,2
1907091,31,1,1982,1,male,253,110,69,16,7,16,3,0,4
2148685,16,5,1997,7,male,135,110,93,16,19,16,16,0,3
1854248,100,17,1913,9,male,96,109,105,16,12,16,8,0,4
2133461,17,16,1996,5,male,373,111,108,16,34,16,29,0,5
1086946,37,3,1976,1,male,1736,111,52,16,24,16,23,0,1
1383469,103,25,1910,5,male,916,111,42,17,10,0,2,17,8
1648204,21,14,1992,1,female,561,108,25,17,15,9,13,8,2
1363591,52,5,1961,4,male,1706,109,82,17,17,14,4,3,13
2164814,100,15,1913,2,male,1377,109,12,17,58,16,19,1,39
2126405,47,8,1966,4,female,541,111,72,17,2,17,2,0,0
2183867,20,9,1993,6,male,662,111,31,17,14,17,14,0,0
2141017,20,27,1993,2,female,564,111,51,17,30,17,29,0,1
2120893,21,4,1992,2,male,1206,108,71,18,2,3,1,15,1
1965256,17,16,1996,12,male,645,108,71,18,12,0,1,18,11
1469530,31,2,1982,11,male,566,110,87,18,6,18,6,0,0
2112491,33,1,1980,1,male,305,109,58,18,4,18,2,0,2
1693627,63,20,1950,6,male,436,109,38,18,6,18,6,0,0
1708630,17,30,1996,4,female,245,109,35,18,24,18,18,0,6
1835688,27,27,1986,7,male,225,108,72,18,26,18,24,0,2
1554861,50,19,1963,2,female,237,109,72,18,18,18,16,0,2
2035803,62,8,1951,5,female,1757,111,55,18,20,18,16,0,4
2107843,69,2,1944,5,male,1467,108,54,18,71,18,57,0,14
2102097,24,4,1989,9,male,791,108,44,19,0,19,0,0,0
2103937,32,21,1981,8,male,503,109,51,19,15,19,4,0,11
1284615,52,9,1961,1,female,1649,109,51,19,12,19,9,0,3
1793010,52,27,1961,1,female,580,110,56,19,14,19,13,0,1
1138547,35,18,1978,12,female,537,108,79,19,70,19,48,0,22
2112900,55,20,1958,4,female,1937,111,42,19,35,19,34,0,1
2032419,13,1,2000,8,male,68,108,96,20,7,0,2,20,5
1423153,21,1,1992,9,male,893,108,64,20,3,8,1,12,2
1456557,16,13,1997,3,female,91,109,90,20,60,10,38,10,22
1334541,14,1,1999,1,male,44,110,98,20,10,20,7,0,3
1810864,18,14,1995,6,male,208,110,38,20,9,20,9,0,0
1448341,22,18,1991,5,male,449,111,44,20,18,20,11,0,7
1358947,25,10,1988,6,female,290,111,50,21,87,0,5,21,82
1869716,108,18,1905,9,male,1304,111,58,21,19,6,16,15,3
1193380,19,28,1994,7,male,380,108,54,21,1,17,1,4,0
2123646,63,14,1950,3,male,1757,109,45,21,0,19,0,2,0
2024456,14,26,1999,3,male,49,108,90,21,5,19,4,2,1
1826719,23,17,1990,6,male,506,109,59,21,399,21,394,0,5
2088462,92,17,1921,6,male,1607,110,39,21,59,21,27,0,32
1532346,38,3,1975,4,female,450,111,83,22,123,4,64,18,59
1298147,44,6,1969,7,male,1051,110,41,22,61,0,12,22,49
1562077,30,9,1983,5,female,249,111,91,22,34,17,17,5,17
2048294,34,16,1979,2,male,386,108,41,22,67,16,50,6,17
1882750,28,26,1985,5,male,520,110,88,22,0,22,0,0,0
1958016,25,1,1988,1,female,120,109,75,22,26,22,23,0,3
1803044,94,8,1919,4,male,308,110,87,22,14,22,10,0,4
1645810,25,1,1988,1,female,212,109,42,23,2,23,2,0,0
1161859,21,21,1992,6,male,446,110,35,23,18,23,13,0,5
1231507,32,23,1981,12,female,999,109,60,23,31,23,24,0,7
1997090,52,28,1961,10,male,201,111,57,23,62,23,53,0,9
1635209,32,26,1981,5,female,289,108,89,24,11,0,3,24,8
1159429,46,19,1967,5,male,345,109,53,24,28,15,25,9,3
1347929,34,10,1979,2,female,1133,108,77,24,13,21,4,3,9
1810507,26,22,1987,8,female,319,109,46,24,10,24,9,0,1
2169886,66,3,1947,9,female,1832,109,30,24,6,24,1,0,5
1521730,18,21,1995,5,female,471,111,61,24,21,24,19,0,2
1505193,33,22,1980,4,female,585,109,63,24,46,24,32,0,14
2145787,102,14,1911,11,female,231,108,33,24,60,24,21,0,39
1010106,27,26,1986,3,male,337,111,17,25,0,25,0,0,0
1938633,31,5,1982,12,male,341,110,81,25,12,25,9,0,3
1151818,33,1,1980,1,male,173,110,64,25,12,25,5,0,7
1533191,53,4,1960,11,male,155,111,77,25,13,25,5,0,8
1939875,25,2,1988,6,male,358,108,82,25,24,25,20,0,4
2121665,53,6,1960,5,female,1169,111,80,25,43,25,14,0,29
1241251,19,23,1994,11,male,445,111,54,26,3,3,2,23,1
1867687,23,26,1990,5,male,464,110,36,26,208,14,148,12,60
1104432,19,8,1994,4,male,46,108,86,26,8,26,0,0,8
2057116,100,29,1913,1,male,257,108,73,26,6,26,6,0,0
1453696,53,30,1960,9,male,301,110,68,26,19,26,10,0,9
1279939,62,15,1951,10,female,113,110,29,27,96,0,41,27,55
1521698,20,16,1993,6,male,604,111,87,27,13,27,8,0,5
1757173,32,8,1981,5,male,437,110,40,27,19,27,19,0,0
2044609,19,31,1994,7,female,505,109,28,27,62,27,55,0,7
1768690,51,15,1962,4,female,453,110,69,28,11,0,7,28,4
1060959,64,6,1949,5,female,1561,111,48,28,58,1,30,27,28
1538920,28,23,1985,12,male,532,109,48,28,7,15,6,13,1
1904469,17,8,1996,2,male,285,109,38,28,11,24,5,4,6
1908187,23,18,1990,3,female,351,111,65,28,33,21,21,7,12
1657144,58,19,1955,5,female,447,109,80,28,102,22,46,6,56
1157425,18,2,1995,12,male,59,111,101,28,24,28,21,0,3
1658253,15,26,1998,5,male,24,111,106,28,59,28,55,0,4
1867347,57,10,1956,4,female,648,109,66,29,12,5,3,24,9
1955574,45,13,1968,11,male,315,108,96,29,5,28,2,1,3
1432271,29,21,1984,4,female,631,108,85,29,24,29,19,0,5
1686949,67,19,1946,9,male,880,108,69,31,1,0,0,31,1
1587080,19,17,1994,1,male,590,110,73,31,20,13,10,18,10
1547109,36,13,1977,11,male,475,108,91,31,5,29,3,2,2
1084793,36,27,1977,7,male,632,108,77,31,43,30,32,1,11
1682057,51,19,1962,5,male,2043,108,31,31,12,31,12,0,0
1141279,57,29,1956,8,female,425,108,52,32,22,0,2,32,20
1031101,18,24,1995,4,male,310,109,68,32,59,4,10,28,49
2014819,55,26,1958,10,female,501,108,89,32,8,24,5,8,3
1417283,23,8,1990,10,male,149,110,78,32,52,32,41,0,11
1177288,37,1,1976,5,female,845,110,55,32,97,32,73,0,24
1226422,20,10,1993,6,male,430,109,78,33,15,32,4,1,11
1208689,24,25,1989,7,male,410,108,67,33,21,33,21,0,0
1545921,58,24,1955,1,female,1629,111,58,34,11,2,6,32,5
1976488,20,7,1993,1,female,295,110,70,34,7,18,0,16,7
1340493,18,8,1995,7,female,774,108,72,34,102,16,29,18,73
1598837,18,29,1995,1,female,436,109,84,34,8,27,4,7,4
1126145,24,4,1989,5,male,590,109,66,34,5,34,5,0,0
1184736,48,10,1965,6,male,488,109,76,34,12,34,4,0,8
2124074,20,22,1993,7,male,135,109,71,34,25,34,23,0,2
1163943,40,13,1973,1,male,455,111,23,34,58,34,36,0,22
1356087,66,8,1947,8,male,927,109,56,34,190,34,86,0,104
1588813,65,24,1948,3,female,1242,111,64,36,35,0,24,36,11
1636987,67,7,1946,8,female,520,108,94,36,26,0,12,36,14
1043699,15,12,1998,8,female,370,110,53,36,6,9,0,27,6
1624454,56,19,1957,3,male,979,110,62,35,101,14,45,21,56
1955125,64,5,1949,6,female,1881,109,50,36,11,33,6,3,5
1972526,19,30,1994,10,female,429,108,65,35,125,33,37,2,88
1471146,33,15,1980,5,male,150,111,74,36,15,36,6,0,9
1975568,23,3,1990,9,female,332,109,52,35,46,35,44,0,2
1149688,16,22,1997,12,female,615,109,56,35,65,35,52,0,13
1458738,31,9,1982,3,male,151,111,74,35,182,35,179,0,3
1878595,33,14,1980,4,female,118,110,71,37,47,0,9,37,38
1541514,24,19,1989,12,male,802,110,55,37,2,37,1,0,1
1242296,19,21,1994,9,male,438,110,55,38,18,1,3,37,15
1606825,46,24,1967,10,female,431,110,51,39,28,0,14,39,14
1156437,65,24,1948,11,female,891,111,68,38,38,5,4,33,34
1525243,47,21,1966,4,female,194,108,57,39,24,17,7,22,17
1428499,38,1,1975,4,female,514,111,66,39,150,32,100,7,50
1642200,24,20,1989,5,female,232,108,85,38,11,38,8,0,3
1350417,29,1,1984,1,male,496,108,86,39,7,39,3,0,4
1676614,61,5,1952,12,female,293,108,63,38,67,38,29,0,38
2130966,51,27,1962,6,male,303,111,80,40,37,0,1,40,36
1031411,60,31,1953,5,male,1636,110,75,40,15,14,9,26,6
1752828,50,16,1963,6,male,2285,110,34,40,66,20,41,20,25
1754450,23,15,1990,9,female,426,108,77,40,20,40,18,0,2
2002153,52,4,1961,3,male,742,111,75,40,137,40,85,0,52
1221161,34,7,1979,1,male,564,110,75,41,0,0,0,41,0
1468097,19,19,1994,2,male,275,108,74,42,64,25,42,17,22
1389542,20,3,1993,7,male,363,110,84,41,107,21,46,20,61
1111516,22,18,1991,11,male,151,110,77,42,25,31,19,11,6
1389261,44,24,1969,1,male,263,110,103,42,0,42,0,0,0
1040718,61,6,1952,6,male,1711,108,46,41,1,41,1,0,0
1586230,59,6,1954,6,male,685,111,88,41,11,41,10,0,1
1084787,108,19,1905,7,male,2067,111,60,42,11,42,10,0,1
1381529,22,4,1991,6,male,58,110,95,41,55,41,48,0,7
1405856,17,12,1996,7,male,481,110,73,43,16,0,3,43,13
1154972,33,3,1980,8,female,289,111,84,44,12,4,3,40,9
1517903,40,2,1973,11,male,210,111,102,44,24,17,9,27,15
1469253,54,11,1959,8,male,2190,110,76,43,118,16,62,27,56
1687530,52,15,1961,2,male,159,108,87,43,125,41,88,2,37
1233739,23,10,1990,10,female,239,109,79,43,39,43,39,0,0
1872765,16,15,1997,2,female,498,108,63,45,7,43,5,2,2
1200112,46,29,1967,6,female,155,108,45,45,40,41,17,4,23
1891664,17,24,1996,5,male,167,108,38,45,19,45,18,0,1
1879392,23,26,1990,11,male,345,111,30,47,45,0,13,47,32
1058428,19,6,1994,10,male,146,108,89,47,158,10,83,37,75
2140894,58,15,1955,8,male,796,111,85,47,55,38,34,9,21
1830110,46,7,1967,8,male,226,108,105,46,6,46,6,0,0
2033999,108,31,1905,5,female,227,110,59,46,4,46,1,0,3
1062149,42,24,1971,12,female,404,108,37,46,21,46,15,0,6
1797435,21,2,1992,11,female,488,109,77,47,33,47,27,0,6
1765082,20,9,1993,4,female,726,109,47,47,42,47,41,0,1
2162741,23,27,1990,3,female,250,109,46,47,43,47,37,0,6
1842999,31,14,1982,2,female,325,108,58,47,64,47,49,0,15
1266734,25,24,1988,7,female,464,109,77,49,52,3,11,46,41
1090615,103,3,1910,3,female,965,111,36,48,334,34,172,14,162
1848814,25,1,1988,1,male,88,110,82,48,38,48,35,0,3
1772493,34,2,1979,11,male,48,108,97,48,98,48,73,0,25
1150010,17,29,1996,6,male,577,110,61,51,4,9,1,42,3
1477753,106,18,1907,11,male,147,109,97,50,0,5,0,45,0
2023844,38,6,1975,6,female,383,111,71,51,123,1,25,50,98
1438910,32,18,1981,6,male,208,109,84,50,49,36,25,14,24
1934745,25,17,1988,4,female,603,111,78,50,5,50,2,0,3
1756478,23,28,1990,11,male,633,111,66,50,23,50,22,0,1
1541766,25,17,1988,12,male,347,110,53,51,30,51,19,0,11
1853586,14,22,1999,1,male,478,109,85,53,21,0,3,53,18
1420937,65,24,1948,1,female,1006,108,57,52,12,6,6,46,6
1297956,28,19,1985,4,male,534,108,76,52,6,32,6,20,0
1566439,16,15,1997,9,male,739,109,66,52,14,35,5,17,9
1232749,70,30,1943,5,male,1421,108,22,53,16,51,8,2,8
1702345,58,10,1955,3,female,185,111,69,52,141,48,81,4,60
1256202,73,5,1940,9,female,1225,111,58,52,226,40,183,12,43
2116745,72,2,1941,11,NA,1978,109,42,53,29,53,22,0,7
1080068,101,9,1912,1,female,84,111,105,54,8,1,1,53,7
1387006,37,6,1976,10,female,289,111,68,55,76,0,19,55,57
1434766,42,15,1971,1,female,1746,108,67,54,12,45,10,9,2
1608856,27,27,1986,3,male,489,108,76,54,0,54,0,0,0
1819543,23,3,1990,1,male,60,108,89,55,21,55,10,0,11
1443124,30,8,1983,8,female,1256,110,51,55,13,55,7,0,6
1055993,26,5,1987,6,female,23,110,81,54,45,54,23,0,22
2190036,37,18,1976,8,female,479,110,45,55,36,55,19,0,17
1903687,78,19,1935,11,male,1638,110,45,58,6,39,4,19,2
1209723,22,4,1991,10,female,285,109,25,57,12,31,10,26,2
1167356,31,5,1982,1,male,250,110,92,56,79,40,47,16,32
1542511,57,27,1956,1,male,1622,109,65,56,83,23,65,33,18
1095403,19,31,1994,8,male,249,111,88,56,35,48,30,8,5
1329611,58,26,1955,8,female,631,108,56,57,83,45,55,12,28
1053941,38,10,1975,1,male,474,109,106,57,1,57,1,0,0
1269927,19,5,1994,7,male,374,109,70,57,77,57,62,0,15
1696788,55,25,1958,8,male,1214,110,65,56,46,56,39,0,7
1198208,96,21,1917,10,female,1787,109,51,58,48,58,26,0,22
1060230,21,9,1992,6,male,110,111,68,56,112,56,107,0,5
2100534,69,2,1944,10,male,1685,110,42,57,349,57,175,0,174
1052479,57,8,1956,8,female,354,108,84,60,3,0,2,60,1
2131085,36,13,1977,5,female,1809,109,67,60,43,60,27,0,16
1304618,21,23,1992,8,male,154,109,80,62,81,0,36,62,45
1985247,54,28,1959,12,female,299,110,77,62,87,1,25,61,62
1076229,48,21,1965,4,female,2131,109,62,61,118,54,110,7,8
1114140,86,29,1927,8,female,2326,108,59,63,99,57,55,6,44
1983146,18,5,1995,3,male,188,111,72,61,8,61,5,0,3
1593956,23,4,1990,1,male,109,111,68,61,39,61,34,0,5
1983207,26,1,1987,1,female,257,111,78,63,61,63,29,0,32
1098616,16,28,1997,8,male,204,108,91,61,154,61,139,0,15
1531608,42,5,1971,3,male,179,110,74,62,445,62,332,0,113
1377085,113,21,1900,5,male,1199,110,82,65,15,0,4,65,11
1292396,49,5,1964,12,male,591,109,99,65,82,0,37,65,45
1238740,53,25,1960,12,female,559,111,66,65,42,26,8,39,34
1334071,57,30,1956,10,female,729,111,74,64,739,16,229,48,510
1950200,50,7,1963,8,male,870,109,25,65,58,65,45,0,13
1934680,55,5,1958,12,male,764,108,28,66,55,25,22,41,33
2054780,20,10,1993,1,female,627,111,59,67,148,42,83,25,65
2013583,27,18,1986,1,male,380,109,33,67,6,54,2,13,4
2024819,54,25,1959,3,female,572,108,18,66,3,48,2,18,1
1074495,18,12,1995,4,male,243,109,77,67,4,67,4,0,0
1812475,33,19,1980,5,female,621,108,66,66,35,66,30,0,5
1792207,61,1,1952,12,female,1518,109,54,68,225,68,132,0,93
1456919,102,8,1911,10,female,1503,110,35,69,37,9,24,60,13
1538581,47,9,1966,8,male,1269,111,36,69,16,25,15,44,1
1619551,32,23,1981,5,male,313,110,91,69,9,65,5,4,4
1913007,73,4,1940,7,female,1907,108,25,71,78,70,57,1,21
1463691,16,21,1997,3,female,374,111,69,71,7,71,5,0,2
1908574,28,14,1985,5,male,1012,109,61,69,37,69,34,0,3
1452103,43,13,1970,3,female,339,110,66,69,29,69,18,0,11
1020323,61,7,1952,12,female,766,108,77,71,43,71,42,0,1
1823509,64,21,1949,5,male,253,110,64,70,21,70,15,0,6
1829300,52,22,1961,4,male,96,111,77,73,76,4,60,69,16
1952225,61,18,1952,3,female,1223,108,41,74,99,5,18,69,81
2107716,18,7,1995,1,female,27,108,83,73,76,39,68,34,8
1963123,15,2,1998,5,male,610,111,58,72,1,69,0,3,1
1130157,24,25,1989,1,female,781,109,53,74,99,57,59,17,40
1717713,33,27,1980,10,female,158,109,66,74,97,73,27,1,70
2178379,50,16,1963,10,female,920,111,60,72,79,71,52,1,27
1702775,25,3,1988,2,female,857,108,93,72,155,59,63,13,92
1590743,23,7,1990,9,female,254,111,68,73,41,73,23,0,18
1869350,31,9,1982,6,female,497,109,66,73,36,73,35,0,1
1394552,23,14,1990,2,female,321,110,29,74,71,74,41,0,30
1400640,46,15,1967,3,female,552,111,88,76,27,0,4,76,23
1071603,49,15,1964,5,female,328,111,90,75,29,0,2,75,27
1230134,26,8,1987,9,male,321,110,70,77,33,77,33,0,0
1141972,72,30,1941,10,female,592,110,55,76,141,76,66,0,75
1690729,23,17,1990,9,male,227,109,90,79,13,79,8,0,5
1472392,39,9,1974,6,male,811,108,77,79,21,79,19,0,2
1907510,36,18,1977,12,female,838,108,47,79,78,79,61,0,17
1597511,44,8,1969,6,female,129,109,99,84,19,0,9,84,10
2097518,55,24,1958,8,female,222,111,93,83,47,0,19,83,28
1244538,65,8,1948,5,male,1718,108,38,82,24,0,17,82,7
1258464,22,22,1991,11,female,316,111,55,84,52,8,18,76,34
1780661,18,18,1995,8,female,85,109,26,84,244,3,152,81,92
1533817,37,31,1976,7,female,424,109,84,83,23,82,9,1,14
1603287,71,31,1942,12,female,1543,109,56,84,42,64,10,20,32
1454906,29,25,1984,2,female,1734,109,29,82,85,64,34,18,51
1175827,29,27,1984,10,male,442,111,57,81,108,73,27,8,81
2006031,21,3,1992,4,female,442,108,52,83,160,63,82,20,78
1269745,23,30,1990,10,male,597,109,78,82,26,82,3,0,23
1804344,61,17,1952,8,female,1054,110,72,83,37,83,22,0,15
2096639,25,3,1988,3,male,351,109,69,84,119,84,101,0,18
1297260,53,4,1960,5,female,1981,108,35,82,55,82,51,0,4
1981600,16,19,1997,9,male,200,110,93,87,7,8,1,79,6
1793248,60,25,1953,7,female,558,108,61,87,71,0,11,87,60
2044844,27,21,1986,4,male,269,108,84,86,27,34,15,52,12
1867541,27,15,1986,2,male,718,110,91,86,69,62,29,24,40
1022990,13,21,2000,2,male,127,110,94,85,3,71,2,14,1
1517556,31,8,1982,4,male,25,109,81,86,96,86,63,0,33
1863415,31,16,1982,3,male,234,108,95,90,57,87,46,3,11
1149522,49,30,1964,6,male,369,108,89,88,7,88,4,0,3
1587425,50,4,1963,8,female,1502,108,15,90,7,90,3,0,4
1882599,34,29,1979,5,female,363,108,76,90,23,90,9,0,14
1094646,25,12,1988,2,female,905,110,52,89,69,89,41,0,28
1903784,25,10,1988,6,female,175,111,71,88,93,88,43,0,50
1170995,18,29,1995,4,male,207,108,85,93,1,0,0,93,1
1434054,14,18,1999,4,male,135,111,43,92,7,92,7,0,0
2111653,40,26,1973,10,male,137,108,94,95,0,95,0,0,0
1888685,56,10,1957,11,female,715,111,67,99,16,0,3,99,13
1315094,58,23,1955,1,female,505,109,85,97,0,0,0,97,0
1017613,27,7,1986,4,female,545,109,42,96,29,51,5,45,24
2090962,54,3,1959,7,male,835,108,44,96,6,73,4,23,2
1642313,61,12,1952,3,female,609,111,31,98,11,98,10,0,1
1052517,75,14,1938,2,female,1117,108,55,99,38,99,26,0,12
1201739,64,8,1949,6,NA,1074,111,53,100,12,0,11,100,1
1956894,20,20,1993,4,male,1377,111,48,104,198,71,29,33,169
1221143,48,20,1965,6,male,1003,109,73,101,37,84,29,17,8
2187428,23,1,1990,1,male,296,109,71,100,5,100,3,0,2
1931017,23,26,1990,11,male,130,108,54,100,35,100,35,0,0
2106763,22,14,1991,2,male,74,108,99,103,62,103,32,0,30
1605613,75,22,1938,4,male,221,111,87,105,12,0,2,105,10
1415788,51,7,1962,9,female,408,109,62,107,158,0,33,107,125
1552810,58,15,1955,11,female,638,108,59,108,72,0,11,108,61
1903006,27,18,1986,3,female,763,108,93,106,37,54,26,52,11
1951692,48,6,1965,9,female,1083,109,73,106,82,54,39,52,43
1751309,42,18,1971,12,female,659,110,59,107,95,80,78,27,17
1131947,30,16,1983,10,male,604,111,64,105,9,105,5,0,4
1233139,103,17,1910,4,male,465,109,74,105,6,105,4,0,2
2174637,40,8,1973,1,male,622,111,28,109,52,109,42,0,10
1408279,28,17,1985,1,female,429,109,38,106,153,106,125,0,28
1066946,83,8,1930,12,female,845,108,71,113,26,0,9,113,17
1882267,66,3,1947,12,female,214,110,46,111,589,0,438,111,151
1949363,47,12,1966,7,female,355,109,78,112,35,85,28,27,7
1938221,31,19,1982,11,male,525,109,43,110,16,110,11,0,5
1839607,51,11,1962,7,female,294,108,61,113,14,113,8,0,6
1994638,29,27,1984,7,female,784,111,59,113,78,113,40,0,38
1145471,65,20,1948,1,female,284,109,85,118,6,0,4,118,2
1011634,22,8,1991,8,male,573,110,72,119,47,15,19,104,28
1556820,52,16,1961,5,female,231,111,68,116,119,1,52,115,67
1934644,45,12,1968,7,male,858,110,58,115,195,17,86,98,109
1724784,49,5,1964,8,female,1547,108,57,117,103,69,63,48,40
1477156,22,25,1991,10,female,286,109,60,118,150,112,24,6,126
1069815,62,15,1951,3,female,1770,111,49,116,212,109,180,7,32
1877787,19,15,1994,6,male,822,109,75,119,26,118,20,1,6
1782576,54,28,1959,12,female,983,110,50,118,80,118,51,0,29
1433648,25,4,1988,11,female,176,109,91,122,81,15,53,107,28
1177818,26,1,1987,1,male,593,109,106,122,3,122,3,0,0
1606002,27,15,1986,4,male,406,111,80,121,34,121,16,0,18
1229717,34,14,1979,7,female,638,109,89,123,40,123,32,0,8
1710598,53,5,1960,5,male,466,109,68,123,21,123,14,0,7
1521063,108,13,1905,9,female,137,109,86,124,35,124,25,0,10
1696068,42,20,1971,1,female,1299,109,44,125,173,3,32,122,141
1659454,17,25,1996,7,male,484,111,77,125,47,44,8,81,39
1838645,33,6,1980,10,male,252,109,62,127,40,54,5,73,35
2004210,31,15,1982,7,female,468,109,83,128,61,128,56,0,5
1610913,60,19,1953,6,female,80,108,88,128,76,128,38,0,38
1224536,35,15,1978,4,female,1010,111,72,128,156,128,120,0,36
1771425,19,17,1994,2,female,42,108,87,128,424,128,230,0,194
1957128,39,22,1974,6,male,1700,110,63,136,157,123,137,13,20
2020066,20,8,1993,8,female,285,108,91,134,764,123,270,11,494
1395642,33,31,1980,5,male,259,110,61,135,15,135,12,0,3
1422082,51,21,1962,11,male,1637,109,66,134,0,134,0,0,0
1350740,17,6,1996,11,male,462,110,68,131,69,131,45,0,24
1356827,42,17,1971,4,female,487,111,84,131,41,131,36,0,5
2065974,28,8,1985,3,female,413,109,56,143,211,0,4,143,207
1473642,106,6,1907,2,male,20,109,100,143,127,27,55,116,72
1374622,29,2,1984,9,female,581,110,67,142,121,139,74,3,47
1903796,66,23,1947,7,female,838,108,53,142,112,113,62,29,50
2024321,20,6,1993,11,female,578,110,38,141,0,141,0,0,0
1363229,17,7,1996,7,male,198,111,74,137,28,137,15,0,13
1084513,103,1,1910,7,male,1083,111,80,147,18,17,1,130,17
1538159,46,7,1967,8,female,613,110,84,145,148,8,32,137,116
1087194,27,1,1986,11,female,454,110,59,145,107,86,38,59,69
2192532,32,1,1981,1,female,612,109,6,144,91,101,49,43,42
1426773,20,5,1993,3,male,223,108,59,149,26,143,25,6,1
1493789,38,25,1975,3,female,281,108,73,144,67,141,37,3,30
1615240,52,18,1961,2,female,1127,108,58,146,243,146,172,0,71
1838011,51,15,1962,3,female,537,109,39,153,171,5,48,148,123
1712125,57,4,1956,8,female,1821,111,52,157,121,1,57,156,64
2173356,108,10,1905,9,male,237,109,90,156,94,156,68,0,26
1501829,29,11,1984,1,female,320,109,91,154,134,154,125,0,9
1470826,65,19,1948,11,female,475,110,88,158,188,0,19,158,169
1334219,30,18,1983,4,female,261,109,33,164,239,147,163,17,76
1014223,36,22,1977,5,female,368,108,73,159,431,159,362,0,69
2037662,20,23,1993,3,female,393,110,82,170,25,118,12,52,13
1193254,58,1,1955,3,male,21,109,107,165,15,33,4,132,11
1072848,20,30,1993,3,female,1884,110,67,166,229,113,92,53,137
1750175,46,1,1967,8,male,636,108,70,172,150,82,93,90,57
1237195,57,9,1956,8,female,72,108,85,166,6,148,3,18,3
1229372,23,14,1990,4,female,87,109,106,172,94,140,69,32,25
1510563,25,8,1988,6,female,223,108,55,169,220,168,199,1,21
2163566,19,28,1994,8,female,268,108,74,166,84,166,75,0,9
1618575,51,25,1962,10,male,446,108,85,169,30,169,22,0,8
1570143,25,18,1988,10,male,473,111,93,174,131,110,81,64,50
1810645,45,31,1968,1,female,1170,110,67,174,197,56,137,118,60
1768364,20,22,1993,7,female,243,111,107,175,47,170,32,5,15
1011856,51,25,1962,8,female,613,110,92,181,153,148,72,33,81
1539951,59,20,1954,5,female,791,109,42,181,58,181,30,0,28
2064391,17,1,1996,2,female,57,111,103,173,167,173,116,0,51
1257499,21,23,1992,1,female,256,108,50,189,7,1,3,188,4
2137938,39,24,1974,9,female,254,110,87,183,50,126,12,57,38
1486716,26,6,1987,5,male,229,110,65,188,139,134,109,54,30
1829013,47,2,1966,4,female,1322,108,59,187,222,89,140,98,82
1947015,24,14,1989,11,male,287,111,66,187,248,187,153,0,95
1120146,108,25,1905,4,male,1639,111,42,198,125,195,84,3,41
1216153,26,27,1987,6,female,793,111,46,203,406,123,304,80,102
1013480,33,16,1980,1,female,392,109,56,203,3,165,3,38,0
2022750,51,25,1962,11,female,53,110,103,203,24,203,23,0,1
1956620,33,6,1980,5,male,587,110,48,207,117,207,88,0,29
1413617,27,5,1986,10,female,283,111,75,217,466,212,198,5,268
2100208,47,1,1966,1,female,571,111,74,212,248,212,87,0,161
1077657,53,28,1960,2,female,567,108,83,230,68,0,13,230,55
1486025,65,28,1948,5,female,1167,111,14,223,56,53,29,170,27
1113881,60,23,1953,10,male,1004,111,62,222,209,125,93,97,116
1984516,35,13,1978,3,female,409,108,19,226,275,222,41,4,234
2108967,50,15,1963,2,male,675,111,89,226,19,225,15,1,4
1875053,45,15,1968,9,male,421,108,60,229,95,228,51,1,44
2094467,43,14,1970,6,female,394,108,68,223,102,223,62,0,40
1390652,62,23,1951,2,female,1930,108,27,244,84,0,37,244,47
2166492,111,2,1902,6,female,1576,109,56,244,459,5,297,239,162
1136608,50,7,1963,10,female,153,110,53,241,267,125,120,116,147
1276265,34,12,1979,8,female,129,109,60,245,73,245,66,0,7
1839936,33,1,1980,4,female,279,108,59,249,63,0,16,249,47
1776180,55,11,1958,10,female,387,108,96,250,128,7,53,243,75
1156045,20,27,1993,9,female,412,108,27,248,171,46,34,202,137
1268695,59,1,1954,12,female,1084,110,46,266,66,0,8,266,58
2130065,19,17,1994,3,male,240,111,84,271,158,176,126,95,32
2153610,34,21,1979,6,female,658,108,65,275,323,255,221,20,102
1981753,43,1,1970,2,female,261,110,22,261,95,261,17,0,78
1469712,56,4,1957,10,female,804,111,86,283,82,0,11,283,71
1569105,34,12,1979,3,female,310,111,68,287,279,282,188,5,91
1026772,25,14,1988,1,female,383,111,33,285,32,285,28,0,4
1081489,24,27,1989,1,male,445,108,73,289,99,289,55,0,44
1990603,39,5,1974,7,female,380,111,63,286,283,286,211,0,72
1656547,46,1,1967,6,female,126,109,94,304,85,0,35,304,50
1578422,57,26,1956,11,female,810,110,78,297,161,1,75,296,86
1309844,89,1,1924,1,male,1240,110,31,295,141,0,57,295,84
1482189,65,19,1948,10,female,1877,108,43,295,346,243,250,52,96
1980001,28,15,1985,1,male,454,111,101,294,7,294,3,0,4
1699907,30,1,1983,6,male,254,111,73,297,23,297,23,0,0
1768135,51,30,1962,12,female,233,109,80,293,166,293,117,0,49
1739714,47,20,1966,6,female,457,110,72,306,335,306,218,0,117
1393169,65,18,1948,3,female,160,110,40,317,100,0,17,317,83
1127366,50,28,1963,1,female,281,111,71,319,237,0,22,319,215
1711314,108,7,1905,9,female,2194,111,34,315,365,40,226,275,139
1438771,24,21,1989,5,female,543,110,79,318,430,107,159,211,271
1619664,30,22,1983,9,female,173,111,70,320,196,229,89,91,107
1797538,68,6,1945,12,female,2248,110,43,320,132,316,103,4,29
1899100,53,4,1960,8,female,1123,108,52,316,10,316,9,0,1
1201658,15,7,1998,8,male,534,110,50,310,66,310,66,0,0
1916080,75,11,1938,7,male,909,110,74,336,66,0,10,336,56
2163905,23,28,1990,3,male,806,108,82,331,79,323,16,8,63
1712036,40,25,1973,2,female,681,110,81,328,683,324,310,4,373
1001898,20,20,1993,1,female,304,108,59,346,22,346,14,0,8
1975151,44,30,1969,5,female,356,109,90,341,54,341,54,0,0
1966698,69,22,1944,8,female,1464,110,39,342,61,342,42,0,19
1618630,39,8,1974,10,male,60,111,97,351,314,14,135,337,179
1718395,23,7,1990,12,female,427,110,73,348,113,327,88,21,25
1079699,30,16,1983,5,male,125,108,89,350,28,350,25,0,3
1004038,60,29,1953,3,female,1568,108,63,367,171,367,137,0,34
2174873,62,22,1951,8,female,1617,110,35,348,63,348,49,0,14
1682943,65,28,1948,1,male,304,111,37,380,845,1,305,379,540
1284595,20,10,1993,1,male,104,108,100,370,1,370,0,0,1
2063658,40,20,1973,12,female,752,108,33,387,103,387,62,0,41
1255564,54,14,1959,6,female,1007,109,41,372,352,372,80,0,272
2067980,63,12,1950,9,female,988,110,51,382,381,382,279,0,102
1799933,24,5,1989,4,female,471,110,56,384,709,384,671,0,38
1870154,79,12,1934,11,female,1230,111,69,406,116,0,13,406,103
1036096,55,6,1958,8,female,1033,109,61,405,222,246,74,159,148
1751892,37,28,1976,4,female,81,110,75,412,100,411,79,1,21
2097859,15,15,1998,1,male,223,111,47,416,9,416,6,0,3
2070893,25,12,1988,3,male,334,111,34,406,37,406,26,0,11
1197779,20,27,1993,2,male,100,109,101,399,79,399,63,0,16
1358720,39,12,1974,2,female,591,108,98,396,112,396,45,0,67
2089176,32,16,1981,7,male,192,108,61,443,35,9,15,434,20
1702951,59,7,1954,10,female,1560,110,21,443,81,67,40,376,41
2014238,24,31,1989,12,male,403,108,64,443,792,442,735,1,57
1823078,66,27,1947,1,male,415,109,48,448,82,448,71,0,11
2103958,48,14,1965,6,female,1731,110,57,464,395,211,231,253,164
1987743,22,11,1991,7,male,284,109,99,474,288,469,203,5,85
1338555,36,13,1977,8,female,542,109,64,480,124,474,57,6,67
1422833,15,2,1998,10,male,25,108,66,495,255,50,120,445,135
1412495,34,19,1979,9,male,455,111,88,515,367,353,115,162,252
1156820,57,1,1956,10,female,512,108,45,493,776,491,286,2,490
1278198,38,8,1975,9,male,270,109,77,507,111,507,91,0,20
1515363,31,1,1982,7,male,326,111,95,522,256,393,141,129,115
1096081,20,25,1993,12,male,34,110,55,538,398,537,332,1,66
2155572,15,11,1998,1,male,407,110,98,528,2,528,1,0,1
1063240,54,12,1959,6,male,49,110,84,522,8,522,6,0,2
1105264,20,19,1993,11,male,43,109,101,550,140,550,59,0,81
1324197,51,20,1962,8,female,402,111,60,528,858,528,651,0,207
1666595,63,30,1950,10,female,1319,109,50,574,299,13,81,561,218
1372581,84,20,1929,7,female,253,109,71,563,240,559,124,4,116
1306339,57,15,1956,6,female,1731,111,66,579,286,579,234,0,52
1449502,23,3,1990,1,female,88,108,39,572,356,572,314,0,42
1829214,63,27,1950,1,female,1707,109,39,651,224,35,66,616,158
2082729,15,9,1998,8,female,93,110,75,618,445,583,299,35,146
1696839,36,10,1977,1,male,164,108,68,644,277,644,236,0,41
1294824,56,21,1957,6,female,564,110,49,700,19,0,7,700,12
1616155,18,13,1995,5,male,329,108,16,688,7,615,5,73,2
1290004,22,1,1991,1,female,30,109,94,668,352,603,168,65,184
2181944,26,2,1987,10,female,692,110,61,681,695,668,641,13,54
1040419,20,27,1993,3,male,482,110,61,671,162,671,105,0,57
1247624,67,15,1946,6,female,128,111,33,791,127,791,65,0,62
1274222,52,20,1961,6,male,374,110,64,758,368,758,59,0,309
2146063,53,7,1960,3,female,259,108,69,782,210,782,189,0,21
1731126,52,8,1961,7,male,462,109,32,800,686,0,249,800,437
1030852,38,2,1975,5,female,81,108,98,836,615,828,433,8,182
1005039,52,6,1961,7,female,1543,111,42,812,669,810,351,2,318
1950702,25,22,1988,1,female,747,109,64,800,212,800,172,0,40
2013159,39,3,1974,10,female,914,110,66,967,1296,55,216,912,1080
1558397,20,15,1993,11,female,545,110,52,969,678,969,664,0,14
1274853,66,3,1947,12,male,721,110,69,1076,78,40,31,1036,47
1114465,55,18,1958,1,female,603,110,86,995,238,0,79,995,159
1609741,59,14,1954,3,female,1428,110,86,1066,274,0,97,1066,177
1571859,39,15,1974,5,female,575,110,73,1083,502,1066,151,17,351
1373740,23,19,1990,5,female,176,109,50,1103,166,1103,81,0,85
1058547,30,20,1983,4,female,362,108,46,1106,339,1106,329,0,10
2113858,43,17,1970,10,male,538,109,74,1004,240,1004,186,0,54
2140319,32,19,1981,9,female,622,108,94,1040,727,1040,646,0,81
1255192,43,30,1970,5,female,157,109,75,1273,89,174,27,1099,62
2056486,21,28,1992,2,female,354,110,55,1218,2429,1204,774,14,1655
1005334,31,7,1982,7,female,193,111,82,1156,509,1156,322,0,187
1372089,39,18,1974,12,male,205,110,82,1131,242,1131,242,0,0
1093956,59,11,1954,5,male,717,111,77,1331,36,0,11,1331,25
1232301,31,15,1982,1,female,1513,111,45,1484,1629,839,1152,645,477
1233054,19,1,1994,3,male,183,111,82,1425,327,1424,226,1,101
1905622,38,23,1975,7,male,389,108,89,1811,1036,797,643,1014,393
1350751,51,17,1962,3,female,1963,111,62,1751,982,1047,715,704,267
1424599,67,20,1946,6,female,1459,111,65,1813,156,1721,100,92,56
1670187,108,21,1905,3,female,1483,109,64,1676,486,1552,377,124,109
1097753,61,19,1952,9,female,825,109,64,1665,105,1665,59,0,46
1089237,37,24,1976,10,female,432,109,59,1816,922,1816,636,0,286
1320542,61,2,1952,11,female,1684,111,58,1878,683,121,156,1757,527
1674775,17,19,1996,9,female,564,111,36,2094,2332,1937,1217,157,1115
1209607,66,28,1947,12,male,779,108,66,2086,1254,2086,861,0,393
1591321,39,2,1974,2,male,315,108,29,2061,2031,2061,1233,0,798
1909302,51,20,1962,1,female,2278,109,34,3253,1527,722,485,2531,1042
1783491,72,29,1941,7,male,173,111,84,2807,814,2807,764,0,50
1756773,59,27,1954,5,female,2004,108,66,4640,312,3057,208,1583,104
2027403,35,20,1978,4,male,523,115,78,5,1,5,0,0,1
2156296,20,18,1993,6,male,25,115,65,5,6,5,5,0,1
1550228,53,25,1960,3,male,1738,113,69,5,5,5,5,0,0
2112661,63,25,1950,8,male,1390,113,55,5,7,5,5,0,2
1123059,20,5,1993,11,female,508,115,13,5,17,5,13,0,4
1213786,25,31,1988,8,female,221,112,101,6,2,0,0,6,2
1915935,38,21,1975,2,male,238,115,70,6,3,0,1,6,2
1687308,15,19,1998,3,male,310,114,76,6,6,0,3,6,3
2025546,20,25,1993,12,male,290,112,50,6,4,0,0,6,4
1038009,19,18,1994,12,male,288,113,89,6,11,0,6,6,5
1651049,73,15,1940,1,male,1086,114,53,6,0,4,0,2,0
1465140,16,18,1997,11,male,384,113,85,6,8,4,0,2,8
1501272,19,17,1994,10,female,122,114,89,6,2,5,1,1,1
1546676,19,29,1994,9,male,589,113,40,6,8,5,4,1,4
1580220,31,13,1982,4,male,305,115,98,6,25,5,12,1,13
1059966,20,30,1993,4,male,246,114,66,6,3,6,3,0,0
1902565,25,1,1988,1,male,197,115,63,6,4,6,2,0,2
1642394,26,1,1987,7,male,354,114,29,6,5,6,5,0,0
1075568,41,21,1972,9,male,949,115,15,6,7,6,7,0,0
1515621,31,15,1982,2,female,358,114,60,6,47,6,44,0,3
2035769,32,1,1981,1,male,161,114,75,6,22,6,4,0,18
1872746,38,27,1975,1,male,462,112,103,6,39,6,23,0,16
1980093,44,10,1969,3,male,1516,114,72,6,10,6,9,0,1
1748928,49,23,1964,1,female,537,113,10,7,0,0,0,7,0
1717207,19,1,1994,1,male,260,112,88,7,5,0,1,7,4
1008388,41,27,1972,2,male,295,113,67,7,9,0,3,7,6
1152226,46,5,1967,5,female,748,115,45,7,28,0,4,7,24
1417232,84,10,1929,4,female,1325,113,76,7,21,0,21,7,0
1004980,66,26,1947,1,NA,2162,113,51,7,8,3,6,4,2
1939423,17,6,1996,4,male,330,115,68,7,1,7,0,0,1
1848600,18,1,1995,1,male,514,114,84,7,1,7,1,0,0
1526593,20,2,1993,7,male,444,113,69,7,0,7,0,0,0
2134186,23,17,1990,2,male,356,114,56,7,0,7,0,0,0
1439461,22,16,1991,9,female,213,112,70,7,4,7,3,0,1
1002754,19,10,1994,7,female,646,114,45,7,10,7,6,0,4
1148136,23,6,1990,4,male,830,113,98,7,10,7,9,0,1
1168103,68,8,1945,8,male,216,112,101,7,9,7,6,0,3
1885315,20,25,1993,4,female,127,114,76,7,63,7,33,0,30
1235339,20,7,1993,9,female,904,115,21,7,18,7,17,0,1
1315339,26,19,1987,11,female,474,112,42,7,78,7,13,0,65
1842308,40,10,1973,10,female,195,113,62,7,150,7,119,0,31
1966159,55,1,1958,6,female,1361,113,51,7,28,7,11,0,17
1171214,18,1,1995,10,male,306,112,40,8,0,0,0,8,0
1274420,56,12,1957,12,male,978,112,65,8,4,2,2,6,2
1557612,23,14,1990,2,male,343,114,41,8,2,6,1,2,1
1634058,69,15,1944,4,male,1375,114,46,8,10,7,4,1,6
1020737,23,10,1990,10,male,474,114,111,8,0,8,0,0,0
2005467,25,18,1988,6,male,178,113,81,8,0,8,0,0,0
1131819,36,6,1977,1,male,428,113,66,8,3,8,2,0,1
1720411,14,12,1999,8,male,297,115,104,8,5,8,3,0,2
1860798,25,14,1988,9,female,278,115,79,8,5,8,4,0,1
1443409,19,28,1994,4,female,47,115,66,8,23,8,21,0,2
1881453,23,23,1990,2,male,307,115,39,8,122,8,110,0,12
1204945,34,2,1979,1,male,775,112,58,8,12,8,8,0,4
2183224,52,14,1961,1,male,84,112,77,8,63,8,34,0,29
1540085,65,19,1948,10,female,1199,112,75,8,13,8,10,0,3
1107003,80,23,1933,10,female,601,114,60,9,1,0,0,9,1
1900023,22,30,1991,1,male,402,112,83,9,28,1,9,8,19
1109323,18,1,1995,1,male,65,115,94,9,35,4,29,5,6
1126730,26,1,1987,7,male,402,112,67,9,1,8,0,1,1
2065211,15,26,1998,2,male,424,114,78,9,16,7,10,2,6
1138379,22,26,1991,4,male,137,115,79,9,16,7,7,2,9
1011606,58,22,1955,6,male,1409,115,42,9,61,8,50,1,11
1460178,15,12,1998,12,female,443,113,30,9,0,9,0,0,0
2037420,18,16,1995,11,male,322,113,83,9,0,9,0,0,0
1381831,27,2,1986,12,female,602,113,32,9,0,9,0,0,0
1159710,56,14,1957,9,male,900,112,63,9,0,9,0,0,0
1727309,20,26,1993,11,female,301,113,110,9,3,9,2,0,1
1136225,24,27,1989,12,female,187,113,95,9,2,9,1,0,1
1232715,75,1,1938,1,male,2428,113,6,9,2,9,2,0,0
1695284,22,1,1991,9,male,108,114,87,9,21,9,10,0,11
1991606,61,21,1952,12,male,410,113,79,9,35,9,30,0,5
1045296,15,3,1998,10,female,519,115,68,10,11,0,2,10,9
1874269,39,14,1974,10,male,278,113,55,10,19,0,5,10,14
1074714,101,1,1912,1,female,1598,115,78,10,43,0,4,10,39
1240616,48,11,1965,2,female,806,114,72,10,5,8,4,2,1
2186368,14,3,1999,8,male,318,114,49,10,5,10,5,0,0
1283504,23,25,1990,11,male,87,113,96,10,7,10,7,0,0
1539546,37,13,1976,3,female,600,114,54,10,8,10,6,0,2
1920934,16,6,1997,8,male,445,114,70,10,15,10,9,0,6
1567594,29,23,1984,4,male,63,113,103,10,27,10,22,0,5
1147325,29,22,1984,8,female,358,112,105,10,154,10,136,0,18
1455407,68,1,1945,7,male,457,113,71,11,13,0,3,11,10
1603938,23,7,1990,10,male,196,114,105,11,18,2,18,9,0
1369683,23,6,1990,12,male,257,114,72,11,2,10,2,1,0
1119588,21,23,1992,12,female,148,115,90,11,0,11,0,0,0
1242377,18,12,1995,8,male,546,113,99,11,16,11,13,0,3
1544961,19,19,1994,7,female,347,113,85,12,40,0,8,12,32
1117363,67,19,1946,1,male,380,114,76,12,36,1,11,11,25
1233194,25,18,1988,5,female,202,113,91,12,3,7,1,5,2
1589658,27,4,1986,2,male,82,112,78,12,27,5,20,7,7
1468957,38,27,1975,12,male,155,114,108,12,129,9,63,3,66
1080457,19,16,1994,6,male,737,113,64,12,1,12,1,0,0
1661034,15,23,1998,4,female,261,112,0,12,5,12,5,0,0
1770773,28,2,1985,11,male,137,113,62,12,8,12,8,0,0
1024861,30,27,1983,8,male,659,113,72,12,8,12,7,0,1
1312561,17,27,1996,7,male,40,115,94,12,45,12,25,0,20
1796425,24,8,1989,6,female,531,113,67,12,156,12,133,0,23
1938206,75,23,1938,7,male,1870,112,86,12,20,12,20,0,0
1936707,32,5,1981,12,male,517,114,75,13,0,0,0,13,0
1082604,67,4,1946,8,male,352,115,88,13,27,0,12,13,15
1670293,19,19,1994,8,male,308,113,99,13,0,3,0,10,0
1949852,27,23,1986,10,male,828,115,75,13,15,9,4,4,11
1300668,32,7,1981,7,male,221,113,59,13,8,9,6,4,2
1862990,53,14,1960,2,male,1243,114,59,13,35,12,20,1,15
1112661,19,10,1994,6,female,345,114,63,13,2,13,2,0,0
1724983,29,31,1984,12,male,752,115,76,13,1,13,1,0,0
2027767,32,13,1981,11,male,629,114,77,13,1,13,1,0,0
1451146,15,12,1998,2,male,257,112,32,13,7,13,7,0,0
1328878,19,25,1994,4,male,574,114,68,13,3,13,3,0,0
1359615,31,9,1982,3,male,798,112,44,13,7,13,6,0,1
1361164,19,9,1994,5,male,662,114,80,13,15,13,13,0,2
1874941,35,13,1978,8,female,944,112,51,13,16,13,16,0,0
1899879,17,3,1996,2,male,426,114,71,13,47,13,33,0,14
2010382,19,9,1994,5,male,138,115,94,13,30,13,26,0,4
2162504,33,13,1980,11,male,524,113,57,13,25,13,24,0,1
2039478,32,6,1981,8,female,382,115,49,14,3,0,0,14,3
1672713,48,8,1965,3,female,566,113,44,14,12,2,3,12,9
1914582,61,22,1952,4,female,1337,112,55,14,9,0,1,14,8
1874492,20,7,1993,7,female,432,113,43,14,20,6,13,8,7
2185659,26,2,1987,8,male,441,113,65,14,21,13,15,1,6
1166932,54,18,1959,4,male,1654,113,63,14,25,11,18,3,7
1867553,50,24,1963,8,male,162,112,107,14,1,14,1,0,0
1293806,15,28,1998,10,female,86,113,103,14,5,14,5,0,0
2151342,29,8,1984,3,male,533,112,85,14,4,14,3,0,1
1314835,24,19,1989,4,female,382,115,63,14,19,14,18,0,1
2118031,21,27,1992,1,male,454,112,56,14,23,14,23,0,0
2162723,23,4,1990,10,female,552,114,77,14,64,14,45,0,19
1618534,80,19,1933,11,female,972,112,59,15,8,0,7,15,1
2117675,74,28,1939,12,male,1024,113,30,15,35,0,18,15,17
1003279,67,31,1946,7,male,1037,114,101,15,3,15,3,0,0
1874840,24,3,1989,1,female,522,115,69,15,19,15,13,0,6
1810023,71,27,1942,7,female,1879,114,39,15,13,15,12,0,1
2059523,18,4,1995,7,female,183,112,75,15,23,15,22,0,1
1485118,22,14,1991,4,female,59,115,54,15,48,15,46,0,2
1927839,27,4,1986,11,female,414,113,66,15,120,15,88,0,32
1147123,71,13,1942,5,female,1828,112,57,16,0,3,0,13,0
1653912,17,5,1996,12,male,1170,112,45,16,4,1,1,15,3
2121427,74,15,1939,11,male,1350,112,45,16,9,0,4,16,5
1677691,62,18,1951,1,female,955,115,67,16,18,0,10,16,8
2178340,52,22,1961,12,female,233,113,65,16,5,7,2,9,3
1520609,16,14,1997,11,female,510,114,72,16,34,9,18,7,16
1148128,18,17,1995,1,male,353,112,73,16,34,14,27,2,7
1094499,27,11,1986,11,male,340,114,77,16,6,16,2,0,4
1768730,52,13,1961,7,male,775,112,40,16,5,16,3,0,2
2091456,25,16,1988,3,male,476,112,85,16,19,16,10,0,9
1749856,37,23,1976,3,female,104,114,64,16,17,16,7,0,10
1499898,48,5,1965,1,male,713,115,92,16,21,16,15,0,6
1957832,21,18,1992,11,male,55,112,102,17,0,0,0,17,0
2074885,17,24,1996,11,male,481,115,72,17,0,17,0,0,0
1924138,52,28,1961,7,female,556,114,86,17,3,17,3,0,0
1339724,27,22,1986,8,female,141,113,6,17,13,17,12,0,1
1875741,19,1,1994,1,male,199,112,81,17,250,17,179,0,71
1655154,21,7,1992,10,male,374,112,48,17,43,17,27,0,16
1203089,28,23,1985,2,male,566,115,91,17,137,17,135,0,2
2002500,18,1,1995,1,male,159,113,108,18,0,0,0,18,0
1838602,18,17,1995,11,female,257,113,65,18,15,8,7,10,8
2009252,19,19,1994,3,female,571,114,47,18,15,13,3,5,12
1489825,16,11,1997,3,female,315,115,56,18,4,18,1,0,3
1562624,22,5,1991,5,male,419,114,84,18,4,18,4,0,0
1371748,59,1,1954,12,female,220,112,95,18,6,18,6,0,0
1770819,26,1,1987,1,male,388,113,61,18,11,18,8,0,3
1644069,30,22,1983,12,male,202,113,79,18,18,18,15,0,3
1711465,29,22,1984,4,female,444,115,49,18,11,18,5,0,6
2146171,24,14,1989,8,male,242,112,46,19,1,6,1,13,0
2171307,24,19,1989,6,female,395,112,78,19,16,7,13,12,3
1202684,17,15,1996,7,male,112,114,103,19,2,19,2,0,0
1399845,23,21,1990,11,male,321,112,80,19,15,19,12,0,3
1010148,23,8,1990,5,male,330,115,89,19,15,19,10,0,5
2056606,23,29,1990,10,male,984,112,39,19,14,19,14,0,0
1323098,93,1,1920,1,female,498,114,80,19,18,19,13,0,5
1064241,24,14,1989,6,female,374,114,52,19,56,19,52,0,4
2148503,38,19,1975,3,male,139,114,85,19,64,19,48,0,16
1992323,20,24,1993,8,male,31,114,105,20,11,20,5,0,6
2110742,23,31,1990,10,male,404,115,112,20,5,20,5,0,0
1027253,25,11,1988,1,male,242,114,64,20,16,20,13,0,3
1891944,27,3,1986,3,male,458,114,61,20,54,20,41,0,13
2100879,15,27,1998,3,male,693,115,70,21,5,0,0,21,5
1773035,17,24,1996,4,male,241,114,61,21,11,2,5,19,6
1514526,14,4,1999,3,male,26,113,77,21,43,1,29,20,14
1896385,18,10,1995,12,male,407,113,64,21,8,15,6,6,2
1415651,92,27,1921,4,male,1618,114,81,21,8,15,7,6,1
1122492,34,26,1979,10,male,145,114,102,21,38,13,34,8,4
1235019,27,11,1986,12,male,466,112,98,21,30,18,26,3,4
1421063,27,11,1986,4,male,250,115,59,21,50,20,13,1,37
1016103,27,9,1986,10,male,178,113,102,21,0,21,0,0,0
1794232,29,8,1984,12,female,583,115,83,21,11,21,9,0,2
1930630,48,1,1965,5,male,468,114,89,21,29,21,8,0,21
1076314,24,15,1989,4,female,300,114,64,21,69,21,54,0,15
1752322,62,4,1951,8,male,242,113,101,22,9,0,3,22,6
1521828,29,10,1984,1,male,446,113,69,22,74,8,36,14,38
1785276,36,19,1977,1,female,509,115,94,22,145,14,56,8,89
2053449,35,26,1978,4,male,431,112,64,22,13,19,9,3,4
1486967,55,28,1958,5,female,1707,113,61,22,1,22,0,0,1
1968999,35,13,1978,9,female,18,113,37,22,12,22,10,0,2
2130202,80,26,1933,5,female,1942,114,17,22,11,22,8,0,3
1780364,47,8,1966,10,male,1313,114,76,22,22,22,14,0,8
1856173,37,7,1976,1,female,589,113,82,22,60,22,43,0,17
1940365,21,1,1992,5,male,779,115,81,23,17,0,6,23,11
1727767,38,13,1975,3,female,460,112,53,23,203,12,122,11,81
1807650,25,19,1988,8,female,380,115,73,23,17,17,8,6,9
2058139,113,1,1900,5,female,1463,115,37,23,3,23,2,0,1
2168845,21,2,1992,8,male,546,113,47,23,13,23,12,0,1
1843210,13,3,2000,2,female,296,112,99,23,18,23,10,0,8
1037046,25,10,1988,7,male,383,114,85,23,30,23,19,0,11
1913288,38,23,1975,4,male,599,114,50,23,15,23,5,0,10
1355786,60,20,1953,6,female,2356,113,18,23,17,23,11,0,6
2052490,29,17,1984,11,female,566,112,41,23,63,23,29,0,34
2176537,65,31,1948,10,female,207,115,62,24,28,0,13,24,15
1189567,34,15,1979,12,male,167,115,88,24,26,9,17,15,9
1266153,32,22,1981,9,male,544,113,75,24,1,24,1,0,0
1636473,16,26,1997,3,male,299,112,96,24,10,24,5,0,5
1290890,23,1,1990,1,female,459,113,94,24,4,24,4,0,0
1996347,24,1,1989,1,male,35,112,99,24,22,24,18,0,4
1517631,29,8,1984,8,female,676,112,36,24,56,24,42,0,14
1121072,37,14,1976,1,female,907,114,57,24,37,24,27,0,10
1570765,72,24,1941,1,female,46,113,45,25,20,4,6,21,14
1651972,24,13,1989,7,male,188,115,114,25,10,16,8,9,2
1906821,53,18,1960,6,male,271,115,93,25,4,24,3,1,1
1689268,28,1,1985,8,male,119,112,94,25,10,24,6,1,4
1479210,49,16,1964,1,female,66,112,71,25,50,23,19,2,31
1114821,21,18,1992,8,female,294,115,67,25,14,25,9,0,5
2080668,102,3,1911,3,male,904,113,70,26,23,0,9,26,14
1190501,24,25,1989,11,female,119,113,40,26,10,26,7,0,3
1053464,23,9,1990,5,female,371,114,48,26,47,26,28,0,19
1087976,21,5,1992,6,female,374,115,94,27,38,2,13,25,25
1399497,16,6,1997,12,male,311,114,63,27,0,27,0,0,0
1679229,17,15,1996,12,male,27,112,105,27,17,27,12,0,5
1606044,20,1,1993,8,male,852,112,92,27,20,27,16,0,4
1591414,62,8,1951,2,female,1213,114,58,27,20,27,9,0,11
1862870,23,10,1990,9,female,405,115,85,27,54,27,37,0,17
1657530,17,22,1996,8,male,230,112,102,28,1,3,1,25,0
1000605,89,4,1924,3,female,684,112,87,28,5,0,0,28,5
1857368,28,2,1985,8,male,695,114,96,28,59,26,27,2,32
1527725,19,20,1994,3,male,509,115,68,28,3,28,3,0,0
2155520,18,10,1995,10,male,60,112,108,28,16,28,16,0,0
1254675,29,29,1984,12,male,548,115,45,28,109,28,77,0,32
1078200,23,12,1990,1,male,607,113,39,29,4,0,1,29,3
2095794,30,5,1983,6,male,520,115,63,29,3,0,2,29,1
1547726,22,29,1991,11,male,665,115,58,29,22,0,5,29,17
1338337,44,1,1969,10,male,1842,115,95,29,47,23,30,6,17
1379302,36,6,1977,11,male,230,115,91,29,4,29,3,0,1
1555343,19,18,1994,10,female,713,114,80,29,26,29,25,0,1
1651494,54,7,1959,3,male,639,112,51,30,23,2,6,28,17
2152429,74,12,1939,2,male,2188,115,31,30,11,6,5,24,6
1658360,16,1,1997,3,female,284,113,27,30,23,9,1,21,22
1592998,21,1,1992,10,male,531,113,57,30,36,21,19,9,17
1235593,61,21,1952,7,female,2368,112,95,30,39,10,35,20,4
1324478,26,4,1987,7,male,570,115,57,31,0,31,0,0,0
1040758,30,17,1983,1,male,406,115,58,30,13,30,6,0,7
1191937,66,2,1947,11,male,275,114,77,30,17,30,14,0,3
1596326,18,27,1995,7,female,149,115,57,31,37,31,26,0,11
1491104,25,10,1988,8,female,280,113,17,30,31,30,15,0,16
2096650,27,24,1986,12,female,245,115,61,31,43,31,40,0,3
1043105,33,10,1980,10,female,247,115,77,31,29,31,26,0,3
2131126,39,27,1974,12,female,232,112,59,31,26,31,7,0,19
1543816,21,29,1992,4,male,480,113,79,32,8,0,7,32,1
1118382,65,22,1948,11,female,1759,114,41,32,12,5,6,27,6
1461514,25,1,1988,1,male,164,113,103,32,9,19,9,13,0
2159080,17,13,1996,11,male,519,115,98,32,0,27,0,5,0
1682786,29,29,1984,1,female,841,115,45,32,4,32,2,0,2
1879219,21,3,1992,6,female,336,115,87,32,25,32,23,0,2
1457462,48,1,1965,11,male,1385,112,59,32,41,32,24,0,17
1068586,24,25,1989,5,female,462,114,90,32,86,32,65,0,21
1063907,18,18,1995,8,female,274,113,84,33,38,31,26,2,12
1060409,23,3,1990,1,male,589,113,69,33,1,33,1,0,0
1265121,36,18,1977,3,female,446,112,45,33,82,33,33,0,49
1394996,93,17,1920,6,female,1683,114,72,34,28,0,14,34,14
1684375,27,15,1986,5,male,662,114,72,34,0,27,0,7,0
1021904,67,1,1946,12,male,1768,112,45,35,147,0,17,35,130
1011169,26,15,1987,2,male,480,115,36,35,70,19,41,16,29
1293337,45,18,1968,3,female,796,115,76,36,33,33,25,3,8
1746313,60,28,1953,9,male,259,113,85,36,59,33,6,3,53
2069566,26,14,1987,6,male,554,112,76,35,0,35,0,0,0
1940498,64,13,1949,9,male,1111,114,63,36,0,36,0,0,0
2181932,21,7,1992,2,male,521,112,70,36,14,36,10,0,4
1208504,33,1,1980,9,male,372,115,58,35,8,35,6,0,2
1993755,33,7,1980,10,female,838,112,20,35,211,35,157,0,54
1606276,62,23,1951,3,female,1370,112,72,37,41,0,9,37,32
2036535,48,15,1965,5,female,829,114,28,37,97,31,73,6,24
1410331,55,24,1958,12,female,785,112,49,37,82,35,49,2,33
1859849,54,5,1959,2,male,673,114,71,37,25,37,1,0,24
1211644,49,10,1964,1,male,497,115,21,38,17,0,2,38,15
1917275,27,15,1986,10,female,1054,113,60,38,61,24,24,14,37
2093957,20,22,1993,7,female,388,112,52,39,43,39,41,0,2
1806010,22,15,1991,10,female,1826,114,55,39,92,39,63,0,29
2043447,25,2,1988,5,male,190,112,33,40,26,0,3,40,23
1720721,14,26,1999,8,male,52,112,100,40,18,40,17,0,1
1589290,33,30,1980,6,male,241,112,76,40,10,40,4,0,6
1031420,18,20,1995,4,male,85,115,13,40,30,40,23,0,7
2078844,49,18,1964,2,female,594,115,88,42,10,0,0,42,10
1819819,93,9,1920,8,female,1726,114,15,42,11,4,6,38,5
1480395,108,30,1905,5,female,89,113,106,42,33,0,16,42,17
1178289,19,4,1994,10,female,221,113,54,41,163,5,97,36,66
2098973,46,10,1967,2,male,56,113,18,41,66,0,8,41,58
1581043,20,14,1993,2,male,766,114,46,41,26,22,11,19,15
1321831,23,17,1990,12,male,19,114,104,41,25,11,8,30,17
1193523,26,12,1987,8,female,282,112,57,41,102,40,61,1,41
1774022,29,1,1984,9,male,547,115,47,41,7,41,4,0,3
1500726,45,26,1968,7,male,380,114,40,42,50,42,29,0,21
1040570,39,11,1974,12,female,1692,115,79,41,124,41,111,0,13
1713817,34,29,1979,4,male,324,114,88,44,7,0,3,44,4
1094317,16,13,1997,9,female,134,112,93,43,56,43,40,0,16
1295255,19,1,1994,1,male,150,115,74,44,31,44,30,0,1
1049638,38,26,1975,2,male,538,115,62,45,151,23,61,22,90
1437747,25,16,1988,8,male,769,112,66,45,13,45,1,0,12
1726993,32,30,1981,7,female,566,115,91,45,37,45,13,0,24
1444734,37,8,1976,5,male,56,112,74,45,50,45,24,0,26
1425194,21,17,1992,7,male,96,112,94,47,44,47,27,0,17
1315429,32,21,1981,7,female,408,114,61,46,32,46,29,0,3
1704450,52,4,1961,3,female,443,114,60,46,46,46,36,0,10
1771721,103,10,1910,10,female,1245,114,81,47,58,47,55,0,3
1855199,18,27,1995,7,male,499,113,60,47,73,47,51,0,22
1232380,25,1,1988,1,female,459,114,48,46,130,46,62,0,68
1169092,22,27,1991,6,female,713,114,74,49,79,27,59,22,20
1949638,30,3,1983,1,female,703,113,58,49,59,45,37,4,22
1343309,64,22,1949,4,female,1705,114,64,48,33,36,11,12,22
1652546,16,11,1997,11,female,20,114,92,48,2,48,1,0,1
1550745,56,9,1957,5,female,2381,112,33,51,45,7,25,44,20
1759838,25,3,1988,2,male,63,112,102,50,27,42,19,8,8
1960957,29,30,1984,3,male,458,115,86,50,24,50,16,0,8
1218266,18,26,1995,11,male,382,112,81,52,3,4,0,48,3
1036567,21,14,1992,2,male,160,112,50,52,24,34,18,18,6
1857944,26,20,1987,3,male,360,115,110,52,5,52,5,0,0
1463370,48,27,1965,12,male,1797,112,47,53,31,53,31,0,0
2166843,48,24,1965,9,female,420,113,80,53,89,53,20,0,69
1638299,18,31,1995,7,male,571,115,104,55,0,0,0,55,0
1525555,25,23,1988,3,female,573,114,61,55,11,2,3,53,8
1398266,39,5,1974,7,male,212,113,15,54,181,0,8,54,173
1803744,18,10,1995,5,female,472,112,93,55,33,33,22,22,11
1549459,76,17,1937,9,female,272,114,80,55,39,20,12,35,27
1374562,72,16,1941,11,female,1680,113,54,55,137,11,100,44,37
1421199,18,13,1995,3,male,299,112,71,54,49,45,28,9,21
1730049,26,27,1987,4,female,219,115,42,55,179,44,88,11,91
1502068,93,12,1920,7,female,1453,113,51,54,150,42,96,12,54
1950958,20,27,1993,9,female,471,112,55,57,4,1,2,56,2
1767738,20,5,1993,1,male,175,113,90,58,0,34,0,24,0
1229549,37,22,1976,12,male,250,114,42,57,18,32,6,25,12
1778462,80,6,1933,12,male,272,115,77,56,40,27,26,29,14
1573741,46,19,1967,12,male,388,112,77,57,96,24,70,33,26
1774385,39,19,1974,12,male,772,112,111,56,3,51,0,5,3
1687347,16,20,1997,9,female,118,114,12,56,11,51,6,5,5
2104134,26,4,1987,4,female,377,115,67,56,22,56,17,0,5
1451122,29,19,1984,11,male,348,115,71,58,59,58,58,0,1
1391439,28,31,1985,12,male,356,114,63,59,1,29,0,30,1
1046418,53,10,1960,1,male,653,114,99,60,0,60,0,0,0
1529914,20,8,1993,11,female,410,114,49,63,53,25,33,38,20
1022799,48,6,1965,1,female,2024,113,38,63,173,42,109,21,64
1867103,19,4,1994,9,male,40,115,48,61,66,53,48,8,18
2108942,15,1,1998,4,male,95,114,102,61,18,61,17,0,1
1364551,18,3,1995,3,female,47,114,39,61,52,61,38,0,14
2130829,63,5,1950,10,male,101,115,97,65,40,3,19,62,21
1590198,64,17,1949,8,female,1589,114,53,64,17,52,8,12,9
1648074,27,1,1986,8,female,654,113,26,64,42,62,39,2,3
1831946,14,28,1999,8,female,194,114,88,64,21,64,9,0,12
1292423,32,8,1981,5,male,408,115,87,64,16,64,10,0,6
2144876,26,5,1987,10,female,226,112,92,64,47,64,17,0,30
1611510,73,20,1940,12,male,485,115,97,65,95,65,93,0,2
1433180,103,5,1910,5,male,1208,112,104,67,11,63,10,4,1
1900166,18,12,1995,2,female,141,112,26,67,70,58,39,9,31
1838530,100,16,1913,8,female,1777,112,88,66,34,66,19,0,15
1854302,26,5,1987,1,male,225,112,52,66,111,66,67,0,44
1070985,57,9,1956,4,female,1766,114,73,70,32,4,12,66,20
1312707,54,12,1959,12,female,726,114,70,71,55,0,4,71,51
1455009,57,15,1956,2,female,270,115,35,69,201,0,62,69,139
2098963,66,16,1947,5,male,2333,112,65,69,68,36,46,33,22
1792401,50,17,1963,5,female,948,112,45,70,32,70,17,0,15
1044166,93,30,1920,11,male,1740,113,59,70,15,70,8,0,7
1922757,55,14,1958,2,female,656,112,56,71,73,71,51,0,22
1224989,46,6,1967,7,female,412,112,78,69,109,69,94,0,15
2124528,63,7,1950,5,female,194,112,41,73,30,1,12,72,18
1693959,44,1,1969,7,female,411,114,38,73,80,0,42,73,38
1168601,62,13,1951,1,female,278,112,86,73,116,0,35,73,81
1422008,17,29,1996,7,male,253,113,68,74,177,62,128,12,49
1432980,16,6,1997,1,male,302,115,23,73,26,73,23,0,3
1050550,20,17,1993,11,male,543,112,46,72,22,72,20,0,2
2022317,23,10,1990,1,male,178,115,68,73,23,73,21,0,2
1419765,43,19,1970,8,female,765,115,59,72,15,72,8,0,7
1075962,65,22,1948,10,male,1545,112,58,74,13,74,11,0,2
1646972,103,8,1910,8,male,1450,113,71,72,209,72,146,0,63
1037871,22,20,1991,11,male,139,112,94,76,52,20,25,56,27
1684611,16,19,1997,6,male,668,114,17,75,13,75,13,0,0
1476731,22,23,1991,6,female,563,115,58,75,14,75,7,0,7
1840759,14,17,1999,3,female,241,112,69,80,44,76,38,4,6
1134007,28,30,1985,10,male,184,114,87,78,43,74,29,4,14
1558209,18,20,1995,6,female,231,112,60,79,27,79,17,0,10
1003420,58,29,1955,11,female,1471,114,71,78,28,78,27,0,1
1316721,27,30,1986,10,male,506,112,24,78,118,78,100,0,18
1759332,40,27,1973,11,male,478,115,85,78,145,78,135,0,10
1495644,55,2,1958,5,female,304,112,100,80,289,80,228,0,61
1550176,60,1,1953,3,male,1864,113,71,84,112,53,50,31,62
1110426,75,19,1938,4,female,1535,114,44,82,67,33,22,49,45
1932638,20,14,1993,2,male,534,115,99,84,5,84,4,0,1
1819434,20,22,1993,11,female,718,115,90,83,52,83,39,0,13
1667423,19,8,1994,8,female,203,112,81,83,116,83,73,0,43
1534296,19,24,1994,4,male,311,115,92,87,1,87,0,0,1
1870442,18,7,1995,5,female,554,115,51,86,26,86,26,0,0
2074514,24,2,1989,6,female,523,114,53,85,64,85,31,0,33
1579637,30,19,1983,2,male,396,113,86,85,221,85,151,0,70
2027226,67,13,1946,9,male,783,113,55,88,190,0,99,88,91
1921305,25,26,1988,9,male,265,114,82,89,8,77,5,12,3
1324841,24,17,1989,5,female,380,112,85,90,43,87,16,3,27
2044155,50,14,1963,4,male,624,112,53,91,13,91,11,0,2
1465438,14,3,1999,10,male,35,112,84,88,51,88,22,0,29
1192136,26,9,1987,8,female,126,115,32,91,34,91,32,0,2
2023779,27,22,1986,1,male,792,112,89,95,50,52,27,43,23
2164901,69,16,1944,10,female,1390,112,48,93,70,66,33,27,37
1511695,18,11,1995,3,male,72,114,95,95,54,76,22,19,32
1319843,24,20,1989,5,male,591,114,86,92,37,85,29,7,8
2018931,21,13,1992,3,male,645,115,76,95,69,94,38,1,31
1581401,58,11,1955,11,female,176,115,24,95,92,88,78,7,14
1764969,25,11,1988,2,male,199,115,47,93,50,93,38,0,12
1614626,46,19,1967,12,female,792,114,34,94,39,94,16,0,23
2041883,52,20,1961,3,male,1603,115,58,94,27,94,20,0,7
1586420,39,24,1974,8,female,587,114,79,94,109,94,46,0,63
1570946,42,22,1971,4,female,624,112,83,96,54,0,15,96,39
1148814,54,19,1959,10,male,753,112,54,99,59,0,4,99,55
1416112,13,29,2000,2,male,510,113,85,97,11,95,11,2,0
2059790,19,21,1994,8,female,43,112,47,99,64,97,49,2,15
1684105,21,22,1992,10,male,398,114,91,97,68,95,19,2,49
2168871,57,11,1956,8,female,1745,115,47,98,61,80,20,18,41
1901694,30,19,1983,8,female,63,113,102,96,82,96,67,0,15
1716636,20,17,1993,1,female,126,115,31,96,231,96,185,0,46
1282914,69,12,1944,10,male,746,114,92,103,7,0,3,103,4
1909637,30,29,1983,8,female,576,115,30,103,125,100,69,3,56
1334257,34,18,1979,11,male,453,115,103,103,11,103,11,0,0
2175505,60,23,1953,6,female,355,115,80,102,44,102,21,0,23
1454917,30,6,1983,3,female,217,114,64,100,128,100,25,0,103
2147863,20,10,1993,7,male,126,112,101,106,3,57,2,49,1
2151269,19,22,1994,10,male,690,115,72,109,35,78,23,31,12
1152850,52,3,1961,11,female,464,114,56,108,53,53,38,55,15
1147610,19,1,1994,10,male,539,114,53,107,29,90,14,17,15
1722795,113,1,1900,12,male,1794,114,51,106,159,85,113,21,46
1584067,17,8,1996,5,female,281,115,45,105,7,105,7,0,0
1368784,16,24,1997,3,male,458,112,51,109,64,109,37,0,27
1064693,18,10,1995,5,female,851,112,55,108,31,108,13,0,18
1269804,62,8,1951,10,male,2128,112,25,106,22,106,15,0,7
1935015,74,21,1939,7,female,1688,115,38,107,33,107,26,0,7
1915942,29,27,1984,1,female,440,115,65,106,141,106,90,0,51
1720040,48,25,1965,10,female,1872,113,64,113,158,16,117,97,41
1732995,25,1,1988,1,female,274,113,94,110,36,107,25,3,11
1644941,21,15,1992,10,female,427,114,46,110,118,92,81,18,37
2082697,69,9,1944,10,female,1772,114,26,111,126,109,76,2,50
1478288,34,5,1979,5,male,188,112,95,111,102,111,95,0,7
1412251,31,2,1982,3,female,458,114,77,112,469,112,456,0,13
1113193,39,16,1974,3,female,553,112,92,119,109,50,82,69,27
1796840,19,21,1994,12,male,13,115,107,117,86,93,43,24,43
1653358,36,19,1977,10,male,239,114,80,116,117,113,85,3,32
1981167,49,29,1964,7,male,357,115,86,114,12,114,4,0,8
1575554,49,28,1964,5,male,424,113,106,121,1,0,0,121,1
1326690,43,22,1970,6,female,1719,115,55,124,229,2,72,122,157
1646544,16,10,1997,5,female,40,114,108,120,55,81,48,39,7
1449750,24,21,1989,11,female,163,115,73,122,29,122,15,0,14
1193353,21,13,1992,4,female,36,115,112,127,152,112,46,15,106
1362968,19,17,1994,2,female,634,113,55,128,247,127,69,1,178
2047514,19,1,1994,5,male,193,113,104,128,41,128,13,0,28
1058654,35,11,1978,6,female,381,114,55,126,40,126,40,0,0
1621983,34,8,1979,1,male,167,114,103,135,82,74,75,61,7
1127431,42,16,1971,9,male,728,112,73,132,100,132,63,0,37
2129511,39,27,1974,8,female,531,115,57,138,54,2,16,136,38
1974440,63,1,1950,10,female,1290,112,82,140,94,4,56,136,38
1532012,52,23,1961,10,female,577,115,59,139,332,0,24,139,308
1791584,33,28,1980,6,female,529,114,77,140,118,88,54,52,64
2140555,20,15,1993,11,female,226,114,78,141,108,138,56,3,52
1402315,57,5,1956,7,male,1434,113,46,141,60,140,38,1,22
2079778,17,27,1996,12,male,14,113,100,137,1,137,0,0,1
1099127,22,27,1991,9,male,253,115,109,139,4,139,4,0,0
1713007,28,24,1985,2,female,558,113,53,138,11,138,9,0,2
1645353,18,5,1995,2,male,80,113,68,141,44,141,35,0,9
1454803,23,20,1990,5,female,165,113,66,138,64,138,42,0,22
1971310,27,28,1986,9,male,258,114,91,142,53,142,9,0,44
1622498,22,1,1991,1,female,408,113,59,139,145,139,123,0,22
1502188,52,4,1961,5,female,373,114,88,145,46,12,21,133,25
1951230,18,1,1995,9,female,332,112,97,150,191,128,143,22,48
1208786,38,11,1975,8,female,199,113,99,150,129,127,60,23,69
1461641,45,7,1968,3,female,536,113,63,146,31,146,30,0,1
1554055,23,25,1990,10,female,558,115,43,148,103,148,72,0,31
1179706,36,25,1977,12,female,1212,115,51,147,129,147,111,0,18
1918395,40,30,1973,10,female,240,112,84,147,115,147,115,0,0
1105436,108,1,1905,1,male,1166,113,70,149,106,149,72,0,34
1233524,108,17,1905,3,male,1373,115,36,157,31,0,12,157,19
1128357,53,26,1960,5,female,1802,115,71,154,181,13,126,141,55
1920107,16,23,1997,4,female,238,112,70,151,164,136,92,15,72
1414068,38,6,1975,6,female,1758,114,40,157,113,153,71,4,42
2078829,32,1,1981,7,male,640,115,60,155,41,155,21,0,20
1593815,55,2,1958,3,female,702,112,89,157,34,157,24,0,10
1430015,57,16,1956,6,female,1707,112,33,152,165,152,121,0,44
1207788,30,11,1983,8,female,1022,112,41,162,133,87,66,75,67
1077356,15,28,1998,3,male,129,114,78,164,25,138,10,26,15
2126986,57,29,1956,1,male,366,114,110,162,28,152,18,10,10
1094247,60,14,1953,10,female,1718,115,58,161,199,141,158,20,41
2105405,51,10,1962,6,female,306,114,84,162,652,125,360,37,292
1402634,51,1,1962,9,male,497,112,87,159,21,159,14,0,7
1621309,24,9,1989,2,male,545,112,77,159,48,159,33,0,15
1567165,61,28,1952,10,male,590,113,56,164,76,164,69,0,7
1289876,55,8,1958,4,male,653,112,61,163,120,163,36,0,84
2082832,62,25,1951,6,male,1059,112,16,166,37,0,2,166,35
1574408,14,1,1999,1,female,104,112,88,171,81,86,47,85,34
1831481,18,17,1995,11,male,132,112,89,171,63,116,39,55,24
2102596,19,17,1994,3,female,433,115,86,168,181,147,90,21,91
1088614,27,3,1986,5,female,47,115,83,170,662,124,358,46,304
1270864,22,25,1991,1,female,304,112,50,168,111,168,95,0,16
1614155,29,3,1984,12,female,354,115,65,169,121,169,107,0,14
1014945,64,24,1949,11,male,679,114,87,172,144,172,36,0,108
1921889,49,28,1964,5,female,136,113,87,170,939,170,590,0,349
1930718,30,23,1983,1,male,306,115,82,180,36,0,8,180,28
1959967,88,15,1925,3,female,2033,115,36,173,317,0,59,173,258
1927609,48,6,1965,10,male,395,114,83,176,57,120,22,56,35
1991555,21,10,1992,10,male,457,113,85,180,146,98,98,82,48
2160905,28,18,1985,12,female,13,115,86,179,158,86,67,93,91
1731883,19,21,1994,10,female,241,112,70,179,277,178,189,1,88
1160788,40,21,1973,12,male,119,113,98,176,2,176,2,0,0
1513763,31,27,1982,7,male,65,114,88,173,125,173,107,0,18
1655666,57,4,1956,12,female,473,115,86,190,82,15,27,175,55
1194214,108,1,1905,1,male,1443,114,83,187,61,0,20,187,41
1451071,24,16,1989,12,female,1099,112,45,189,123,180,101,9,22
1910076,22,21,1991,10,female,705,113,90,182,4,182,4,0,0
2175410,66,23,1947,9,female,1353,114,41,184,10,184,9,0,1
1039104,99,30,1914,10,female,1167,114,52,182,12,182,12,0,0
1021168,15,1,1998,1,female,319,113,49,194,94,21,60,173,34
1851097,103,4,1910,11,female,711,113,74,193,49,1,23,192,26
1655229,28,5,1985,12,male,517,112,103,195,105,195,88,0,17
1835106,61,9,1952,2,male,950,115,42,201,69,0,43,201,26
1761814,60,1,1953,1,male,1573,115,75,204,236,50,45,154,191
1612192,35,31,1978,8,female,1077,113,52,203,88,203,55,0,33
1245409,54,8,1959,11,female,373,113,104,209,102,209,73,0,29
1186471,34,20,1979,4,female,719,113,79,205,246,205,207,0,39
1261596,44,17,1969,4,female,643,115,71,206,302,206,110,0,192
1252627,20,12,1993,6,male,460,112,91,213,18,195,17,18,1
1603012,28,4,1985,6,female,182,114,64,219,322,205,94,14,228
1668096,54,12,1959,9,female,1153,114,47,212,56,212,54,0,2
1227602,14,23,1999,9,male,92,115,85,226,96,97,42,129,54
1624605,88,1,1925,1,female,1831,113,85,231,12,203,10,28,2
1809135,40,5,1973,6,male,135,112,50,225,386,206,309,19,77
2000273,108,12,1905,1,female,226,115,86,236,162,0,25,236,137
1767599,30,28,1983,2,female,386,113,38,236,246,132,123,104,123
1695584,34,23,1979,8,female,449,113,62,244,189,69,130,175,59
1491680,25,29,1988,3,male,189,114,59,236,72,233,43,3,29
2166688,48,2,1965,8,female,1115,113,71,254,133,137,86,117,47
1948764,19,3,1994,10,female,460,114,82,250,149,220,121,30,28
1336905,25,23,1988,9,male,139,113,68,256,111,256,89,0,22
1360258,18,19,1995,3,female,147,113,39,274,450,40,75,234,375
1351094,20,3,1993,9,male,791,114,50,275,60,101,27,174,33
2103822,59,15,1954,7,male,1456,114,48,275,130,164,37,111,93
1612767,24,30,1989,12,female,510,114,80,272,36,262,24,10,12
1829939,43,3,1970,11,female,387,115,52,272,143,252,120,20,23
1152733,25,6,1988,4,female,293,113,74,261,267,209,133,52,134
1648786,47,15,1966,7,female,1556,112,80,264,199,251,153,13,46
1760176,18,12,1995,9,male,89,112,73,264,111,264,104,0,7
1068806,32,8,1981,5,male,181,113,92,268,121,268,85,0,36
1083676,55,24,1958,1,female,1347,112,98,270,45,270,25,0,20
1995653,35,5,1978,5,female,82,115,108,271,337,271,254,0,83
1543860,19,7,1994,11,female,630,113,50,292,313,100,199,192,114
1180741,53,6,1960,3,female,845,115,79,281,157,265,74,16,83
1078149,33,27,1980,6,female,50,112,87,277,128,277,108,0,20
1181288,59,3,1954,1,female,943,114,52,294,178,0,17,294,161
1238364,63,5,1950,12,female,1769,112,61,296,72,38,40,258,32
1656638,62,5,1951,10,female,150,114,69,299,102,1,27,298,75
1126326,19,29,1994,4,female,155,115,94,295,154,281,118,14,36
1471027,34,20,1979,1,female,845,112,72,295,350,278,237,17,113
1670366,52,10,1961,11,female,505,114,97,304,44,304,44,0,0
1161208,47,6,1966,2,female,1755,114,40,319,188,217,95,102,93
1998836,52,15,1961,2,female,2215,113,56,309,138,180,53,129,85
2111966,21,11,1992,8,female,426,113,70,315,320,194,149,121,171
1078727,113,10,1900,11,female,1473,114,72,315,332,210,126,105,206
1210103,22,8,1991,7,female,222,115,98,319,344,319,174,0,170
1056503,28,28,1985,8,male,396,114,99,328,144,20,37,308,107
1614406,49,21,1964,4,female,38,114,61,343,118,343,73,0,45
1672328,48,16,1965,6,female,1219,113,42,346,560,346,458,0,102
1775069,49,23,1964,6,male,422,115,82,352,71,0,26,352,45
1729515,26,7,1987,11,male,341,112,109,367,41,336,40,31,1
1412701,43,23,1970,4,female,640,115,46,358,384,356,245,2,139
1611842,36,24,1977,5,male,556,112,31,367,524,367,494,0,30
1910652,69,22,1944,7,female,462,112,72,380,378,0,93,380,285
1206743,17,10,1996,5,female,852,112,55,393,247,224,35,169,212
1289202,39,9,1974,3,female,472,112,76,393,81,393,76,0,5
1479857,52,24,1961,6,female,449,112,66,380,149,380,124,0,25
1079109,32,17,1981,4,female,272,113,91,380,429,380,294,0,135
2102889,21,13,1992,7,male,548,113,24,420,222,216,138,204,84
1609302,103,26,1910,12,male,2156,113,39,399,341,139,209,260,132
1187119,22,11,1991,4,female,404,113,54,399,237,399,122,0,115
1763461,35,14,1978,7,female,387,112,80,414,262,414,107,0,155
2023162,35,4,1978,8,female,273,113,101,427,399,4,115,423,284
1775298,72,29,1941,3,male,1162,113,79,429,428,426,417,3,11
1765194,34,20,1979,3,female,309,113,84,441,305,441,122,0,183
1308816,53,1,1960,5,female,1343,113,70,424,436,424,262,0,174
1485754,71,12,1942,1,male,1280,114,68,477,40,67,27,410,13
1967671,20,25,1993,8,male,107,115,53,453,67,350,33,103,34
1189770,22,6,1991,11,female,95,112,54,468,66,379,49,89,17
1661563,35,23,1978,3,female,477,112,56,466,89,443,27,23,62
1095618,31,24,1982,9,male,245,115,62,454,285,410,216,44,69
1640148,68,18,1945,3,female,72,112,68,458,240,458,222,0,18
1589507,31,19,1982,6,female,56,113,104,458,367,458,289,0,78
2014672,33,19,1980,9,female,440,114,84,480,422,480,411,0,11
1067853,54,16,1959,10,female,1558,114,24,478,362,478,336,0,26
1711065,19,6,1994,6,male,666,114,84,484,27,331,20,153,7
1354636,21,21,1992,1,female,598,115,77,502,3,321,1,181,2
2061473,48,7,1965,5,female,1683,113,49,484,114,392,86,92,28
1488718,15,31,1998,7,female,134,115,41,504,1107,441,675,63,432
1275828,14,30,1999,7,female,319,115,75,518,30,516,21,2,9
1711940,27,20,1986,1,male,299,115,53,493,78,493,60,0,18
1617188,27,10,1986,1,female,535,115,43,492,301,492,291,0,10
1271395,27,13,1986,2,female,246,113,43,535,75,27,39,508,36
1673583,62,14,1951,11,female,996,115,42,521,200,14,111,507,89
1671747,27,7,1986,2,female,1320,115,50,545,768,299,396,246,372
1897159,33,15,1980,5,male,251,114,67,527,1542,512,1117,15,425
1258216,91,10,1922,4,male,707,112,76,603,16,7,2,596,14
1142231,19,28,1994,10,female,642,114,89,574,222,470,196,104,26
2009908,21,9,1992,6,female,295,114,90,581,60,581,31,0,29
1383290,25,20,1988,9,male,151,112,94,569,182,569,114,0,68
1401038,40,16,1973,11,female,255,114,97,627,287,410,205,217,82
1437974,49,10,1964,1,male,862,115,48,619,960,166,437,453,523
1034620,47,1,1966,6,male,213,114,87,610,61,609,41,1,20
2052548,63,8,1950,7,female,1501,114,76,649,142,645,77,4,65
2045070,37,10,1976,3,male,386,115,82,636,262,636,172,0,90
1270240,49,29,1964,10,female,349,115,56,611,165,611,140,0,25
1266591,64,30,1949,11,female,1257,114,34,700,30,0,11,700,19
1877577,53,26,1960,8,female,555,114,68,717,450,0,68,717,382
2036392,26,12,1987,4,female,1211,112,96,717,275,335,121,382,154
1264097,48,23,1965,8,female,1701,112,64,705,265,705,78,0,187
1377544,51,11,1962,2,female,1554,114,62,671,370,671,245,0,125
1199074,67,28,1946,3,female,1191,115,98,672,255,672,180,0,75
1578595,34,15,1979,10,female,234,113,63,670,731,670,602,0,129
2123920,16,1,1997,10,female,282,113,41,732,930,1,118,731,812
1975042,21,21,1992,6,female,194,113,88,795,43,229,19,566,24
2152873,71,8,1942,3,female,1677,114,36,773,147,516,75,257,72
1245264,69,8,1944,10,male,959,115,40,750,565,474,87,276,478
1772447,60,20,1953,4,female,1000,115,35,776,31,576,26,200,5
1805250,65,5,1948,6,female,1693,113,32,782,387,680,127,102,260
1105384,35,17,1978,8,female,74,113,102,757,213,757,86,0,127
1623216,27,19,1986,1,female,346,114,77,795,561,795,207,0,354
2189706,18,21,1995,9,male,30,114,93,986,91,0,69,986,22
1678595,21,27,1992,7,male,212,112,84,895,387,216,219,679,168
1528050,16,7,1997,9,female,326,114,67,960,912,288,152,672,760
2147467,20,17,1993,9,female,1870,115,58,938,684,819,471,119,213
2134106,23,18,1990,12,female,188,112,18,895,1338,688,754,207,584
1560499,63,7,1950,2,female,313,114,104,983,90,983,67,0,23
2152160,26,19,1987,7,female,86,113,90,900,321,900,190,0,131
2133801,60,3,1953,12,female,347,113,89,1023,255,0,22,1023,233
2191350,67,17,1946,3,male,85,112,96,1129,241,0,7,1129,234
2105419,32,4,1981,10,female,195,112,99,1114,283,1112,194,2,89
1266063,20,15,1993,11,female,1634,112,63,1142,558,588,133,554,425
1531024,48,24,1965,11,female,298,115,76,1172,579,390,219,782,360
1523807,64,4,1949,11,female,1905,113,43,1208,179,1145,46,63,133
1695245,48,14,1965,11,female,1453,112,37,1224,257,997,177,227,80
2026888,56,9,1957,2,female,1567,113,29,1243,135,1238,101,5,34
1127624,29,22,1984,4,female,572,115,70,1253,602,1253,271,0,331
1777703,65,26,1948,9,female,831,113,62,1201,377,1201,170,0,207
1932101,23,7,1990,4,female,270,114,82,1225,1137,1225,782,0,355
1580213,68,24,1945,11,female,938,115,52,1315,259,0,36,1315,223
1884890,56,16,1957,12,male,843,114,73,1309,544,875,202,434,342
1987340,51,12,1962,8,female,1505,115,56,1402,627,1402,437,0,190
2038667,58,2,1955,7,female,577,113,75,1653,80,0,13,1653,67
1540390,24,24,1989,12,male,552,113,71,1631,376,62,121,1569,255
1319579,73,12,1940,6,female,1673,112,31,1799,568,43,359,1756,209
2097162,51,26,1962,9,female,816,112,83,1546,404,1546,361,0,43
1462664,47,10,1966,4,male,456,115,74,1923,253,0,87,1923,166
1002224,65,5,1948,7,female,1607,113,50,2277,690,0,406,2277,284
1202683,108,13,1905,11,female,839,114,53,2000,454,371,280,1629,174
1172006,34,18,1979,5,male,175,115,58,1944,448,1306,229,638,219
1591998,53,5,1960,5,female,848,112,86,2028,953,452,341,1576,612
2016596,29,7,1984,4,male,396,112,65,2190,380,2046,224,144,156
1074256,21,10,1992,3,female,459,114,89,2632,839,2400,430,232,409
1234666,21,21,1992,8,female,612,112,63,2947,3188,2650,2247,297,941
1016342,22,12,1991,7,female,717,114,84,2643,125,2638,114,5,11
1470600,32,14,1981,7,female,1159,114,69,3228,590,3210,454,18,136
1278163,52,15,1961,5,female,321,113,75,2696,452,2696,404,0,48
1619940,23,8,1990,9,female,310,115,38,5635,354,5635,237,0,117
1980424,109,16,1904,3,male,1610,120,34,0,157,0,88,0,69
1974782,20,2,1993,4,male,250,118,62,1,0,0,0,1,0
1472393,26,23,1987,3,male,462,119,80,1,0,0,0,1,0
1341372,29,5,1984,12,male,304,120,45,1,0,0,0,1,0
1335102,32,12,1981,9,male,1340,120,100,1,0,0,0,1,0
1398055,42,22,1971,9,male,421,120,20,1,0,0,0,1,0
1631070,53,10,1960,1,female,473,116,94,1,0,0,0,1,0
1482706,50,19,1963,12,male,482,116,89,1,1,0,0,1,1
2080839,14,12,1999,3,male,74,120,110,1,7,0,1,1,6
1427991,16,2,1997,6,male,445,120,84,1,3,0,2,1,1
2184928,19,7,1994,11,male,341,116,102,1,2,0,0,1,2
1573795,20,17,1993,11,female,410,116,78,1,5,0,1,1,4
1512274,19,17,1994,7,male,193,118,102,1,6,0,4,1,2
1453956,28,11,1985,7,male,433,118,65,1,2,0,0,1,2
2014251,36,1,1977,6,male,1884,117,46,1,8,0,7,1,1
1351586,43,8,1970,7,male,483,120,112,1,25,0,14,1,11
1616429,48,27,1965,11,male,677,117,57,1,20,0,4,1,16
1019492,50,13,1963,5,female,365,116,13,1,16,0,8,1,8
1645737,55,5,1958,9,female,593,120,86,1,6,0,2,1,4
1485892,66,30,1947,1,female,457,119,75,1,3,0,2,1,1
2081029,66,29,1947,4,female,499,119,67,1,4,0,0,1,4
1272840,66,8,1947,10,female,812,120,29,1,2,0,0,1,2
1298258,73,11,1940,4,male,1391,120,27,1,118,0,90,1,28
1657351,15,26,1998,3,male,220,116,57,1,0,1,0,0,0
1638977,16,10,1997,4,male,578,119,68,1,0,1,0,0,0
1616078,17,31,1996,10,male,847,117,39,1,0,1,0,0,0
1186628,18,23,1995,5,male,295,119,97,1,0,1,0,0,0
1065086,18,4,1995,6,female,436,120,39,1,0,1,0,0,0
1191936,19,1,1994,1,male,814,119,82,1,0,1,0,0,0
1390852,21,11,1992,2,male,646,119,113,1,0,1,0,0,0
1853352,21,6,1992,5,female,242,119,8,1,0,1,0,0,0
1185993,23,15,1990,11,male,158,117,100,1,0,1,0,0,0
2026998,23,14,1990,12,female,350,119,43,1,0,1,0,0,0
1346214,22,14,1991,7,female,546,117,69,1,0,1,0,0,0
2045526,24,21,1989,8,male,763,117,53,1,0,1,0,0,0
1152175,25,15,1988,8,male,670,119,52,1,0,1,0,0,0
1204977,27,4,1986,2,female,370,120,19,1,0,1,0,0,0
1137555,30,20,1983,12,male,843,116,40,1,0,1,0,0,0
1490870,32,12,1981,11,male,936,119,56,1,0,1,0,0,0
1513659,33,3,1980,2,male,434,120,25,1,0,1,0,0,0
1083319,59,13,1954,7,female,537,118,67,1,0,1,0,0,0
2168667,68,21,1945,8,male,642,120,53,1,0,1,0,0,0
1864608,14,23,1999,3,male,284,118,51,1,1,1,0,0,1
1221256,18,1,1995,2,male,251,118,108,1,1,1,1,0,0
1900536,21,3,1992,9,male,372,117,103,1,1,1,0,0,1
1174940,30,15,1983,10,male,300,117,64,1,1,1,1,0,0
1992187,33,8,1980,4,male,454,118,88,1,1,1,1,0,0
1992210,48,12,1965,3,female,438,116,56,1,1,1,1,0,0
1221463,108,21,1905,5,male,243,116,91,1,1,1,1,0,0
1959809,17,12,1996,2,female,452,117,76,1,3,1,2,0,1
2050593,18,18,1995,1,female,85,120,36,1,2,1,1,0,1
1423802,19,30,1994,6,male,467,118,105,1,6,1,5,0,1
1846872,19,13,1994,10,male,451,120,60,1,5,1,5,0,0
1526367,20,28,1993,2,male,236,117,49,1,14,1,12,0,2
1304984,21,18,1992,1,male,67,116,108,1,3,1,2,0,1
1121482,21,15,1992,5,male,492,118,87,1,87,1,51,0,36
1201442,21,30,1992,10,female,7,118,81,1,40,1,31,0,9
1383153,21,1,1992,11,male,804,120,56,1,9,1,8,0,1
1073775,22,28,1991,1,male,544,117,84,1,2,1,0,0,2
1672656,22,19,1991,5,male,322,116,81,1,7,1,2,0,5
1060754,24,3,1989,11,female,447,118,72,1,2,1,1,0,1
1991894,25,25,1988,10,male,925,116,42,1,13,1,11,0,2
2052409,27,24,1986,6,male,324,120,67,1,9,1,9,0,0
1955272,27,26,1986,7,male,441,120,112,1,3,1,0,0,3
1801694,27,8,1986,10,male,813,117,51,1,2,1,2,0,0
1769010,29,11,1984,11,male,488,119,53,1,2,1,2,0,0
1770577,33,6,1980,7,female,518,120,44,1,5,1,4,0,1
1315295,34,28,1979,8,male,358,119,92,1,2,1,2,0,0
1505990,53,12,1960,8,male,1085,117,58,1,17,1,11,0,6
1826670,108,11,1905,11,male,102,118,93,1,2,1,2,0,0
1631639,108,6,1905,9,female,1121,117,21,1,5,1,5,0,0
1363190,18,12,1995,6,female,210,118,84,2,0,0,0,2,0
1859086,21,27,1992,7,male,177,117,106,2,0,0,0,2,0
1024951,31,12,1982,12,male,871,120,75,2,0,0,0,2,0
1859618,51,26,1962,4,female,731,117,63,2,1,0,0,2,1
2110363,42,20,1971,7,male,287,117,75,2,2,0,0,2,2
2050295,20,22,1993,3,male,607,116,56,2,23,0,19,2,4
1179371,23,17,1990,4,male,213,118,84,2,7,0,1,2,6
1117739,29,2,1984,7,male,430,120,86,2,8,0,2,2,6
1478314,44,26,1969,11,female,488,117,69,2,12,0,11,2,1
2097047,67,3,1946,4,female,731,117,97,2,18,0,7,2,11
2003654,77,25,1936,12,female,1546,116,3,2,5,0,1,2,4
1126298,17,10,1996,7,female,321,119,94,2,12,1,7,1,5
1830228,38,1,1975,5,male,757,117,71,2,8,1,8,1,0
1325511,16,10,1997,7,male,535,116,82,2,0,2,0,0,0
1133637,17,1,1996,10,male,246,120,88,2,0,2,0,0,0
1082739,18,25,1995,6,male,414,119,109,2,0,2,0,0,0
1011049,20,22,1993,1,male,448,116,68,2,0,2,0,0,0
1163991,20,25,1993,3,male,503,120,41,2,0,2,0,0,0
1494071,23,14,1990,2,male,598,118,71,2,0,2,0,0,0
1075242,25,14,1988,2,male,272,117,99,2,0,2,0,0,0
1335063,25,14,1988,8,female,648,116,55,2,0,2,0,0,0
1257944,27,10,1986,12,male,950,120,85,2,0,2,0,0,0
1073050,27,3,1986,8,male,600,119,104,2,0,2,0,0,0
1567664,31,20,1982,4,female,537,120,19,2,0,2,0,0,0
1765397,31,12,1982,7,female,487,118,22,2,0,2,0,0,0
1079301,38,22,1975,9,male,2297,119,19,2,0,2,0,0,0
1963864,43,24,1970,9,male,485,116,45,2,0,2,0,0,0
2031573,25,17,1988,1,female,241,119,74,2,1,2,1,0,0
1505307,36,2,1977,12,male,471,120,82,2,1,2,1,0,0
2024177,40,29,1973,7,male,1124,116,63,2,1,2,1,0,0
1213278,42,6,1971,9,male,481,117,81,2,1,2,1,0,0
1532747,85,23,1928,3,male,559,118,71,2,1,2,0,0,1
1528979,27,29,1986,8,male,401,120,82,2,2,2,2,0,0
2010891,54,11,1959,9,male,1509,120,34,2,2,2,2,0,0
1872597,14,26,1999,9,male,363,117,82,2,4,2,2,0,2
1704022,15,29,1998,7,male,195,118,85,2,9,2,1,0,8
1283127,17,20,1996,12,male,899,117,55,2,31,2,27,0,4
1970292,17,19,1996,9,male,229,116,96,2,17,2,10,0,7
2022460,22,27,1991,9,female,325,120,62,2,3,2,3,0,0
1546776,23,1,1990,1,male,179,120,83,2,9,2,5,0,4
1480724,24,29,1989,10,male,707,119,83,2,7,2,7,0,0
2143417,26,27,1987,11,male,320,116,98,2,66,2,47,0,19
1117183,26,15,1987,12,male,357,118,76,2,6,2,3,0,3
1310563,26,14,1987,3,male,403,116,85,2,4,2,4,0,0
1232107,28,24,1985,6,female,482,119,89,2,5,2,3,0,2
1414601,29,25,1984,2,male,805,117,92,2,6,2,4,0,2
1521868,40,8,1973,8,female,1048,116,25,2,15,2,10,0,5
1912542,55,16,1958,4,male,1343,119,30,2,13,2,13,0,0
1811774,65,22,1948,10,male,1273,120,21,2,36,2,22,0,14
1395977,108,15,1905,8,female,1256,118,88,2,5,2,4,0,1
2043771,16,10,1997,10,male,408,118,108,3,1,0,0,3,1
1789457,60,1,1953,10,male,282,118,106,3,1,0,0,3,1
1514568,108,9,1905,2,male,1689,120,62,3,1,0,0,3,1
1965405,20,25,1993,3,male,549,118,43,3,2,0,1,3,1
1108578,51,16,1962,1,female,1796,117,43,3,4,0,0,3,4
1421409,59,2,1954,12,female,327,118,43,3,31,0,8,3,23
1872749,15,28,1998,8,NA,213,116,35,3,1,2,0,1,1
1176988,15,29,1998,9,male,171,120,98,3,3,1,3,2,0
2010034,17,25,1996,7,female,155,116,76,3,62,1,26,2,36
1716164,103,15,1910,1,male,1044,119,35,3,59,1,21,2,38
2133710,14,4,1999,9,male,159,119,73,3,0,3,0,0,0
1447605,16,22,1997,3,male,269,117,92,3,1,3,1,0,0
1868162,25,29,1988,6,male,193,120,118,3,1,3,1,0,0
1437426,68,10,1945,1,female,1117,117,79,3,1,3,0,0,1
1850553,15,2,1998,1,male,765,119,71,3,2,3,2,0,0
1384746,19,16,1994,4,male,206,118,91,3,3,3,3,0,0
2173835,27,31,1986,10,female,525,118,19,3,2,3,1,0,1
1477173,29,3,1984,7,male,578,116,83,3,2,3,2,0,0
2168112,29,18,1984,9,male,403,118,110,3,4,3,2,0,2
1410971,14,27,1999,7,female,22,118,100,3,8,3,4,0,4
1884174,20,14,1993,2,male,175,116,99,3,13,3,10,0,3
1644816,21,10,1992,3,female,176,116,76,3,7,3,7,0,0
1207285,23,22,1990,1,female,123,120,97,3,10,3,8,0,2
1111673,24,9,1989,9,male,544,116,52,3,6,3,1,0,5
1679779,25,12,1988,8,male,603,119,108,3,7,3,4,0,3
1229283,28,20,1985,6,male,636,120,98,3,227,3,216,0,11
1266831,30,9,1983,9,male,354,116,56,3,16,3,7,0,9
1119343,34,14,1979,12,male,701,119,40,3,15,3,13,0,2
1055176,34,19,1979,3,male,288,117,50,3,41,3,32,0,9
2185404,50,6,1963,8,female,130,116,87,3,6,3,3,0,3
1228826,83,20,1930,6,male,702,119,41,3,9,3,2,0,7
2016928,108,1,1905,10,female,785,119,40,3,15,3,10,0,5
2178176,17,1,1996,12,male,226,117,87,4,0,0,0,4,0
1756975,18,3,1995,11,male,124,117,113,4,1,0,0,4,1
1322591,67,24,1946,10,male,289,117,91,4,2,0,1,4,1
2141692,61,3,1952,8,male,80,119,116,4,4,0,4,4,0
1422332,14,28,1999,4,male,312,116,93,4,8,0,7,4,1
1696190,22,16,1991,9,male,304,116,72,4,11,0,4,4,7
1753476,60,26,1953,8,male,473,117,111,4,32,0,15,4,17
2097806,61,8,1952,5,male,1805,119,82,4,24,0,14,4,10
2168760,103,4,1910,11,male,2106,119,56,4,132,2,56,2,76
1546929,25,29,1988,12,male,232,118,104,4,2,3,1,1,1
2007227,23,26,1990,9,male,141,120,72,4,21,3,11,1,10
1518871,25,1,1988,1,male,100,116,78,4,8,3,3,1,5
1140371,16,23,1997,2,female,392,118,61,4,0,4,0,0,0
1162870,21,20,1992,4,male,415,119,76,4,0,4,0,0,0
1949417,18,28,1995,12,male,424,116,73,4,1,4,1,0,0
1864854,18,9,1995,6,male,391,118,74,4,1,4,1,0,0
1263912,26,5,1987,5,male,682,119,91,4,2,4,2,0,0
2045519,19,21,1994,12,male,464,118,21,4,3,4,3,0,0
1618452,20,9,1993,2,male,481,119,46,4,5,4,3,0,2
1175661,22,30,1991,7,female,451,119,41,4,4,4,4,0,0
2076480,19,10,1994,3,female,250,120,99,4,10,4,7,0,3
1303346,20,14,1993,9,male,257,117,72,4,7,4,7,0,0
1073588,21,27,1992,4,male,322,119,65,4,31,4,24,0,7
1227763,28,8,1985,5,male,401,118,27,4,44,4,10,0,34
2069551,30,5,1983,11,male,192,119,43,4,8,4,5,0,3
1322380,32,25,1981,12,female,286,116,76,4,22,4,21,0,1
1751666,31,15,1982,5,male,475,119,56,4,19,4,9,0,10
2067071,32,3,1981,7,male,192,118,84,4,12,4,4,0,8
1581429,38,23,1975,9,female,659,116,64,4,7,4,7,0,0
1637704,47,2,1966,2,male,326,119,75,4,15,4,13,0,2
2081338,24,3,1989,3,male,194,119,110,5,0,0,0,5,0
1880035,63,28,1950,8,female,1277,117,98,5,0,0,0,5,0
1907932,64,30,1949,1,female,579,119,83,5,2,0,2,5,0
1215529,36,19,1977,7,male,236,117,69,5,5,0,1,5,4
1712875,43,23,1970,3,female,1309,119,37,5,6,0,1,5,5
2151569,47,14,1966,9,male,485,117,89,5,9,0,0,5,9
1300375,54,24,1959,6,female,200,118,109,5,14,0,11,5,3
1298971,61,21,1952,7,female,112,120,77,5,11,0,4,5,7
1421944,15,24,1998,12,male,556,118,33,5,2,3,1,2,1
1032156,63,24,1950,3,male,1159,117,46,5,6,3,4,2,2
1256690,13,9,2000,5,female,111,117,35,5,12,1,5,4,7
2177590,25,26,1988,6,male,424,118,106,5,0,5,0,0,0
1339637,16,3,1997,11,male,311,118,52,5,3,5,3,0,0
1612747,16,12,1997,11,male,195,120,51,5,3,5,3,0,0
1662338,26,19,1987,5,male,589,116,106,5,3,5,1,0,2
1248182,30,3,1983,7,female,472,117,41,5,1,5,0,0,1
1258020,100,18,1913,11,male,433,117,58,5,2,5,1,0,1
1902769,34,20,1979,6,male,151,116,102,5,6,5,4,0,2
1001572,15,26,1998,6,male,444,116,67,5,10,5,8,0,2
1015592,17,8,1996,2,male,339,116,93,5,30,5,27,0,3
1931719,26,2,1987,10,male,608,118,99,5,9,5,2,0,7
1574809,37,21,1976,5,female,172,119,49,5,15,5,15,0,0
1736506,58,11,1955,4,male,735,119,52,5,10,5,6,0,4
2150399,65,16,1948,10,female,721,117,49,5,26,5,7,0,19
2057447,26,8,1987,4,male,685,119,105,6,3,1,3,5,0
1248443,28,23,1985,5,male,557,120,51,6,5,0,1,6,4
1231609,68,5,1945,4,male,579,120,72,6,31,0,5,6,26
1243620,14,2,1999,4,male,330,119,73,6,0,2,0,4,0
1022292,40,3,1973,5,male,388,117,100,6,0,2,0,4,0
2113191,15,15,1998,12,female,319,117,60,6,2,4,0,2,2
1886338,29,20,1984,11,male,382,116,77,6,7,3,6,3,1
2052318,29,11,1984,10,male,569,118,62,6,0,5,0,1,0
1476080,18,24,1995,3,female,185,116,26,6,0,6,0,0,0
1532265,27,28,1986,6,male,27,120,109,6,0,6,0,0,0
1769374,108,18,1905,6,male,1515,119,83,6,0,6,0,0,0
1382539,18,1,1995,1,male,401,119,64,6,1,6,1,0,0
1456712,19,29,1994,7,male,268,117,91,6,2,6,0,0,2
1854506,31,26,1982,2,female,185,116,107,6,1,6,1,0,0
1724444,19,30,1994,4,male,508,117,64,6,5,6,4,0,1
1131990,26,1,1987,1,male,107,117,101,6,5,6,4,0,1
2132778,39,5,1974,3,male,670,119,78,6,4,6,4,0,0
1653712,20,28,1993,1,male,391,119,58,6,46,6,27,0,19
1832727,21,25,1992,1,male,170,118,34,6,25,6,17,0,8
1983728,22,22,1991,8,female,462,116,71,6,40,6,29,0,11
1374996,35,31,1978,7,female,370,118,74,6,27,6,24,0,3
1642877,18,9,1995,5,female,539,116,38,7,1,0,0,7,1
1514783,19,16,1994,1,male,617,120,95,7,0,0,0,7,0
1950293,35,6,1978,9,male,562,118,62,7,0,0,0,7,0
1545665,26,3,1987,3,male,683,119,46,7,3,0,2,7,1
1045204,24,17,1989,9,male,202,117,84,7,8,0,0,7,8
1370432,29,17,1984,7,male,984,119,49,7,12,0,4,7,8
1568024,64,20,1949,8,female,1478,119,43,7,20,1,9,6,11
1213737,43,24,1970,12,male,399,119,110,7,0,5,0,2,0
1952249,23,17,1990,5,male,611,117,83,7,4,5,0,2,4
1557157,29,7,1984,7,male,950,118,56,7,1,6,0,1,1
1141821,40,25,1973,7,male,172,118,101,7,2,6,2,1,0
1299240,18,6,1995,2,male,788,119,59,7,0,7,0,0,0
1971584,78,10,1935,1,male,1864,116,48,7,0,7,0,0,0
1354541,103,13,1910,8,female,1257,120,87,7,0,7,0,0,0
1175869,16,25,1997,9,male,642,120,71,7,3,7,2,0,1
1932450,20,28,1993,4,female,37,116,38,7,3,7,1,0,2
1459232,29,26,1984,5,male,1451,120,49,7,3,7,1,0,2
1241265,16,7,1997,7,male,376,117,99,7,5,7,4,0,1
1736387,23,26,1990,9,male,1115,118,61,7,6,7,5,0,1
2117637,29,26,1984,11,female,419,116,74,7,8,7,6,0,2
1843802,59,29,1954,3,male,1607,117,55,7,6,7,4,0,2
1038494,77,14,1936,7,female,627,119,88,7,7,7,7,0,0
1381009,20,13,1993,11,male,588,117,68,7,13,7,9,0,4
1929754,23,29,1990,3,male,231,117,91,7,33,7,22,0,11
1764526,61,22,1952,9,female,682,120,75,7,44,7,26,0,18
1475946,19,1,1994,1,male,403,118,79,8,0,0,0,8,0
1139242,49,6,1964,4,male,461,119,85,8,0,0,0,8,0
1248888,15,23,1998,4,male,26,117,114,8,4,0,0,8,4
1167180,16,4,1997,6,male,307,119,96,8,3,0,0,8,3
1976818,39,23,1974,12,female,1124,116,106,8,6,0,4,8,2
1743563,75,29,1938,10,female,1788,119,41,8,33,1,26,7,7
1852869,57,9,1956,9,male,1313,119,39,8,4,5,2,3,2
1902897,58,10,1955,10,male,544,118,110,8,4,3,4,5,0
1156563,63,1,1950,1,male,282,118,85,8,5,2,0,6,5
2146846,16,20,1997,11,male,125,120,102,8,22,3,1,5,21
1393687,25,21,1988,12,female,745,116,63,8,2,6,1,2,1
1664468,64,12,1949,1,male,171,119,89,8,3,7,3,1,0
1156161,19,1,1994,7,female,175,116,71,8,1,8,1,0,0
1725598,39,4,1974,4,female,711,119,79,8,3,8,3,0,0
1949542,33,9,1980,12,male,1729,118,30,8,7,8,5,0,2
1950560,17,3,1996,11,female,356,116,54,8,34,8,21,0,13
1203265,18,19,1995,12,female,526,117,64,8,97,8,78,0,19
2191803,21,4,1992,6,male,381,116,96,8,23,8,9,0,14
2152055,24,4,1989,3,female,574,116,78,8,63,8,38,0,25
1805128,26,2,1987,10,male,530,116,57,8,25,8,20,0,5
1270014,42,26,1971,9,male,290,120,47,8,23,8,18,0,5
2062874,49,9,1964,6,female,944,118,39,8,61,8,33,0,28
1996396,15,27,1998,7,male,375,119,58,9,1,0,0,9,1
2151814,15,21,1998,5,male,218,118,108,9,4,0,0,9,4
1272783,75,3,1938,12,female,1342,118,18,9,3,0,0,9,3
1692428,25,27,1988,9,male,1168,117,38,9,10,0,0,9,10
1998137,15,23,1998,2,male,220,116,98,9,1,5,1,4,0
1845006,24,16,1989,5,male,155,120,62,9,3,2,2,7,1
1749268,19,16,1994,9,female,456,118,73,9,6,5,4,4,2
1330189,27,5,1986,1,female,601,119,27,9,74,8,57,1,17
1430848,33,17,1980,5,male,850,116,77,9,38,8,31,1,7
1758312,74,22,1939,6,female,1606,120,29,9,43,8,11,1,32
2126287,50,14,1963,11,male,267,117,110,9,1,9,1,0,0
1556308,103,12,1910,12,male,1647,120,49,9,2,9,0,0,2
1189461,20,15,1993,8,male,369,117,89,9,8,9,7,0,1
1623949,23,28,1990,8,male,330,116,82,9,12,9,9,0,3
1102831,25,19,1988,5,male,586,116,61,9,8,9,4,0,4
1997601,21,4,1992,8,female,603,120,57,9,70,9,60,0,10
1367935,54,12,1959,8,female,423,117,69,9,74,9,53,0,21
1109296,57,9,1956,8,female,261,119,103,9,15,9,13,0,2
1167424,68,3,1945,1,male,1024,120,80,9,60,9,55,0,5
2003813,14,25,1999,9,male,370,120,78,10,5,0,0,10,5
2185205,55,26,1958,12,male,701,119,16,10,7,0,1,10,6
1918585,15,13,1998,4,male,219,116,78,10,4,4,4,6,0
1148936,23,8,1990,5,male,323,120,90,10,5,2,4,8,1
1556760,25,4,1988,10,male,479,119,52,10,13,6,6,4,7
1133053,19,15,1994,6,female,495,117,92,10,0,10,0,0,0
1373890,22,19,1991,9,male,234,119,89,10,1,10,1,0,0
2174137,21,9,1992,11,female,340,120,63,10,11,10,7,0,4
1671194,18,17,1995,4,male,490,116,72,10,28,10,24,0,4
1911008,27,26,1986,11,male,722,120,56,10,26,10,15,0,11
1004484,26,16,1987,4,male,317,116,38,10,78,10,70,0,8
2004963,34,2,1979,7,male,330,120,69,10,88,10,54,0,34
1556040,43,2,1970,5,female,277,118,83,10,76,10,55,0,21
2017251,48,26,1965,10,male,294,120,75,10,23,10,16,0,7
1875377,22,21,1991,10,male,295,120,96,11,3,0,0,11,3
1812762,20,3,1993,6,male,8,116,111,11,7,0,6,11,1
2139724,22,27,1991,11,male,146,118,20,11,15,0,2,11,13
1505626,57,12,1956,11,female,1262,116,48,11,199,1,45,10,154
1805620,24,15,1989,1,male,299,116,85,11,16,10,1,1,15
1152851,29,24,1984,3,male,419,119,91,11,9,8,8,3,1
1365041,46,8,1967,8,male,1365,119,63,11,11,8,7,3,4
1560868,28,28,1985,2,male,316,118,89,11,0,11,0,0,0
1978732,17,12,1996,12,male,488,119,45,11,6,11,6,0,0
1249581,23,8,1990,9,male,317,119,102,11,6,11,5,0,1
1199671,26,3,1987,10,male,636,116,22,11,3,11,2,0,1
1706647,20,8,1993,11,female,143,116,87,11,23,11,21,0,2
1026250,30,27,1983,7,male,59,116,102,11,26,11,18,0,8
1113578,67,15,1946,3,male,1308,120,87,12,2,0,2,12,0
1683779,54,24,1959,12,female,605,116,58,12,10,0,3,12,7
1501934,18,15,1995,4,male,278,116,87,12,22,0,4,12,18
1134990,28,13,1985,2,female,462,120,36,12,19,8,5,4,14
1666863,16,28,1997,12,female,231,116,4,12,1,12,0,0,1
1694795,17,14,1996,2,male,259,119,95,12,1,12,1,0,0
1074148,28,19,1985,7,male,417,120,109,12,1,12,1,0,0
1571411,14,17,1999,7,male,53,120,74,12,2,12,2,0,0
2015007,17,26,1996,7,male,224,117,96,12,7,12,7,0,0
2154024,23,29,1990,1,female,450,116,17,12,3,12,2,0,1
2005686,26,5,1987,1,male,407,118,89,12,7,12,6,0,1
1242583,24,13,1989,11,male,686,117,70,12,16,12,13,0,3
1688771,25,14,1988,7,male,564,117,39,12,8,12,4,0,4
1290848,32,15,1981,8,female,429,117,29,12,80,12,41,0,39
1408301,102,11,1911,11,male,497,116,92,13,1,0,1,13,0
1694256,36,7,1977,4,male,786,119,71,13,4,12,1,1,3
1759307,17,29,1996,4,female,219,119,65,13,0,13,0,0,0
1574527,16,13,1997,8,male,309,117,48,13,10,13,10,0,0
1250442,18,2,1995,2,male,99,116,97,13,12,13,7,0,5
1949883,24,27,1989,7,male,240,120,108,13,14,13,14,0,0
1448328,53,23,1960,9,female,56,116,54,14,18,2,16,12,2
1290166,53,6,1960,7,female,270,120,74,14,47,9,17,5,30
1313552,27,4,1986,8,female,337,118,107,14,1,14,1,0,0
1341852,15,7,1998,7,female,268,116,33,14,13,14,0,0,13
1981283,64,6,1949,6,male,913,118,80,14,10,14,10,0,0
1012234,15,21,1998,7,female,572,119,83,14,38,14,22,0,16
2174721,18,19,1995,10,female,392,116,80,14,35,14,23,0,12
1515991,34,19,1979,11,male,126,117,106,14,28,14,28,0,0
1371906,35,22,1978,11,female,298,118,52,14,81,14,65,0,16
1972496,15,3,1998,8,female,471,118,81,15,1,1,0,14,1
1585532,15,23,1998,8,male,141,118,95,15,0,0,0,15,0
1305322,20,28,1993,10,male,507,117,79,15,18,0,11,15,7
2126086,24,27,1989,2,male,580,117,84,15,14,0,0,15,14
1910354,36,30,1977,4,male,840,118,86,15,26,0,8,15,18
1759875,24,2,1989,5,male,472,120,89,15,1,14,1,1,0
2126553,27,13,1986,9,male,726,117,70,15,1,15,0,0,1
1405949,38,11,1975,11,male,236,119,106,15,2,15,2,0,0
2146051,19,24,1994,6,male,27,118,104,15,14,15,7,0,7
1027244,25,27,1988,6,male,438,119,69,15,16,15,11,0,5
1023009,25,19,1988,7,female,725,117,35,15,12,15,12,0,0
1686424,42,11,1971,4,male,559,117,35,15,22,15,6,0,16
1240170,22,29,1991,6,female,376,118,74,15,25,15,19,0,6
1842711,23,3,1990,6,female,330,119,39,15,29,15,10,0,19
1223563,52,16,1961,7,female,621,116,95,16,67,0,18,16,49
1524609,27,5,1986,2,male,399,117,95,16,46,6,5,10,41
1294191,29,2,1984,4,male,215,116,112,16,1,16,1,0,0
2023983,46,5,1967,5,male,423,118,81,16,0,16,0,0,0
1712428,23,24,1990,12,male,346,116,94,16,7,16,6,0,1
1723737,36,10,1977,5,male,418,118,95,16,4,16,4,0,0
1426962,57,2,1956,2,male,1445,120,25,16,14,16,13,0,1
1698792,21,26,1992,9,male,202,117,77,16,25,16,16,0,9
1804577,31,11,1982,7,female,659,120,51,16,55,16,31,0,24
1215608,97,2,1916,7,male,303,116,74,17,188,0,64,17,124
1013382,19,19,1994,9,male,84,120,96,17,3,4,2,13,1
2047214,21,25,1992,7,male,462,116,73,17,14,4,9,13,5
1140259,47,15,1966,4,female,33,117,37,17,63,4,21,13,42
1857258,18,29,1995,7,female,101,117,77,17,5,17,5,0,0
1369354,20,31,1993,5,male,587,117,96,18,12,13,3,5,9
1152258,26,1,1987,5,male,444,118,82,18,3,18,2,0,1
1016403,19,21,1994,2,male,643,116,84,18,17,18,15,0,2
2141533,23,4,1990,6,female,474,116,42,18,37,18,24,0,13
1256673,37,19,1976,8,female,698,118,55,18,68,18,67,0,1
1427880,47,15,1966,5,female,715,118,72,18,283,18,225,0,58
1188607,46,6,1967,4,male,813,118,52,19,1,0,0,19,1
1830089,36,1,1977,9,female,346,116,84,19,8,0,3,19,5
1695977,29,23,1984,4,female,694,120,93,19,23,19,10,0,13
2045561,29,25,1984,5,male,427,116,66,19,13,19,12,0,1
1174822,32,1,1981,11,male,362,116,76,19,24,19,17,0,7
1156423,36,13,1977,7,male,67,117,72,19,36,19,28,0,8
1464884,47,5,1966,5,female,418,119,43,19,164,19,94,0,70
1729224,15,18,1998,8,male,253,116,101,20,0,0,0,20,0
1905149,16,15,1997,5,female,305,119,62,20,1,0,1,20,0
1003225,30,29,1983,7,female,522,117,72,20,8,0,5,20,3
1648093,18,17,1995,6,male,431,119,68,20,38,14,18,6,20
1795486,14,1,1999,4,female,450,119,53,20,4,16,0,4,4
1172731,30,6,1983,6,male,300,117,91,20,3,20,1,0,2
1124252,22,14,1991,1,male,571,120,68,20,139,20,136,0,3
1104248,50,23,1963,5,male,402,120,46,20,44,20,38,0,6
1579076,64,19,1949,7,male,369,120,86,21,27,0,6,21,21
1968115,21,15,1992,1,female,458,117,55,21,71,4,28,17,43
1284091,33,2,1980,9,male,551,116,26,21,3,21,3,0,0
1916459,18,16,1995,5,male,285,116,85,21,5,21,5,0,0
1986722,22,3,1991,7,female,584,116,9,21,12,21,12,0,0
1641869,29,24,1984,2,female,890,120,44,21,8,21,7,0,1
1731155,91,22,1922,2,male,224,117,89,21,9,21,9,0,0
1011604,24,31,1989,1,female,708,120,27,21,13,21,11,0,2
1410523,27,8,1986,6,female,541,119,69,21,37,21,35,0,2
1684177,42,25,1971,2,female,324,116,80,21,204,21,129,0,75
1869811,25,4,1988,8,male,398,117,55,22,0,22,0,0,0
1467995,23,25,1990,11,female,788,119,38,22,5,22,4,0,1
1814034,47,8,1966,1,male,462,119,56,22,4,22,3,0,1
1080339,98,15,1915,5,male,312,118,84,22,9,22,9,0,0
1666890,36,30,1977,7,female,411,118,48,22,35,22,28,0,7
2160876,86,6,1927,7,female,403,120,104,23,4,0,3,23,1
1976089,21,30,1992,5,male,400,116,61,23,20,0,1,23,19
1745947,19,15,1994,3,male,249,117,64,23,39,4,29,19,10
1271518,27,26,1986,1,male,732,118,53,23,1,16,1,7,0
1387880,108,12,1905,3,female,2110,117,63,23,11,20,8,3,3
2000831,16,12,1997,10,female,311,116,75,23,19,23,15,0,4
1737546,23,20,1990,5,male,620,116,34,23,20,23,12,0,8
2008995,18,29,1995,5,male,662,120,87,23,59,23,21,0,38
1271610,20,17,1993,2,male,559,117,65,23,48,23,44,0,4
1612378,55,5,1958,4,female,323,120,104,23,55,23,51,0,4
1122415,20,6,1993,9,male,388,118,63,24,4,0,1,24,3
1387908,68,7,1945,6,male,169,119,109,24,13,24,13,0,0
1697316,19,10,1994,1,male,388,119,79,24,32,24,21,0,11
1626431,29,21,1984,10,male,291,116,91,24,36,24,28,0,8
1272592,37,18,1976,4,male,1263,117,54,24,47,24,43,0,4
1900929,52,1,1961,9,female,371,116,42,25,6,0,3,25,3
1953680,57,23,1956,10,female,672,116,61,25,41,0,11,25,30
1673946,24,11,1989,2,male,709,119,54,25,28,24,18,1,10
1326807,29,28,1984,8,male,743,117,34,25,1,25,1,0,0
1803781,30,25,1983,4,male,232,118,111,25,2,25,2,0,0
1838113,21,23,1992,4,female,297,119,44,25,6,25,5,0,1
1204447,13,7,2000,2,female,224,119,45,25,60,25,28,0,32
1892894,23,29,1990,8,male,61,116,34,25,43,25,32,0,11
1052049,44,25,1969,6,male,611,118,12,26,7,0,1,26,6
1273882,16,6,1997,6,male,33,119,117,26,1,26,1,0,0
2063506,17,7,1996,8,male,603,118,62,27,3,0,1,27,2
1496224,108,23,1905,5,female,1168,116,61,27,16,17,7,10,9
2106115,26,3,1987,8,male,591,117,78,27,12,22,12,5,0
1983051,15,26,1998,6,female,236,119,81,27,9,27,9,0,0
1436846,16,24,1997,6,female,426,117,32,27,7,27,6,0,1
1109165,22,9,1991,3,male,571,119,46,27,23,27,13,0,10
1857891,29,1,1984,2,female,1224,116,47,27,41,27,17,0,24
1313989,53,21,1960,8,male,474,119,101,27,314,27,67,0,247
2149536,54,3,1959,6,female,439,116,61,27,61,27,28,0,33
1132182,22,13,1991,4,male,405,117,73,28,4,0,2,28,2
1852158,47,21,1966,1,female,1334,117,20,28,1,0,0,28,1
1683667,29,24,1984,3,male,1066,120,52,28,16,6,3,22,13
1644729,34,15,1979,6,female,362,117,77,28,39,18,16,10,23
2168866,21,2,1992,1,male,154,120,79,28,17,26,10,2,7
1864269,31,12,1982,6,male,20,116,108,28,34,22,18,6,16
1717324,108,7,1905,2,male,929,117,99,28,0,28,0,0,0
1910275,26,1,1987,1,male,496,120,27,28,6,28,2,0,4
2060574,20,7,1993,7,female,438,116,49,28,40,28,40,0,0
1362586,26,11,1987,12,male,217,119,93,28,40,28,40,0,0
1060393,70,30,1943,8,female,1335,118,35,28,22,28,14,0,8
1789770,56,27,1957,5,male,96,120,98,29,7,28,6,1,1
1874293,41,16,1972,3,female,780,120,67,29,25,28,7,1,18
1513222,20,23,1993,1,female,282,119,38,29,2,29,1,0,1
1569498,26,13,1987,12,male,95,119,86,29,3,29,2,0,1
1213629,45,8,1968,8,female,55,120,103,29,29,29,28,0,1
2083586,53,24,1960,5,female,557,117,65,29,88,29,79,0,9
1031901,96,5,1917,8,female,2076,118,61,31,2,0,2,31,0
1762807,108,14,1905,11,male,216,118,96,30,8,0,8,30,0
1226345,54,2,1959,3,female,824,120,46,30,29,0,5,30,24
1991013,30,21,1983,10,female,102,116,108,31,16,28,11,3,5
2161296,48,27,1965,1,male,88,120,57,30,102,29,67,1,35
1689720,22,30,1991,10,male,471,117,69,31,1,31,1,0,0
1637426,30,17,1983,12,male,191,119,47,30,1,30,1,0,0
1098676,65,23,1948,1,female,2124,119,61,31,5,31,3,0,2
1628260,14,25,1999,3,female,103,119,78,31,7,31,7,0,0
1306513,47,4,1966,10,male,83,119,107,31,13,31,8,0,5
1614428,68,30,1945,7,female,1812,118,18,30,15,30,9,0,6
1537899,108,7,1905,4,female,1409,116,84,30,13,30,9,0,4
1500838,34,5,1979,3,female,173,116,98,30,35,30,19,0,16
1038167,57,19,1956,10,male,648,116,94,31,24,31,20,0,4
1930065,59,14,1954,3,male,676,117,66,32,16,31,11,1,5
2013560,20,1,1993,1,female,391,119,52,32,14,32,11,0,3
1091714,38,30,1975,9,male,449,120,96,32,14,32,9,0,5
1500527,32,25,1981,6,male,477,117,98,32,22,32,17,0,5
1823302,30,31,1983,3,male,373,116,89,33,5,33,3,0,2
1138489,29,18,1984,1,female,465,120,86,33,12,33,10,0,2
1285530,29,6,1984,3,female,86,120,115,33,7,33,6,0,1
2110050,18,17,1995,10,female,460,118,54,33,25,33,18,0,7
1001014,27,15,1986,1,female,743,116,42,33,31,33,26,0,5
1379861,23,26,1990,8,male,158,118,55,33,94,33,82,0,12
1432702,30,11,1983,4,male,454,116,54,34,33,2,18,32,15
1881838,25,1,1988,7,male,578,116,80,34,86,31,38,3,48
1589938,21,10,1992,7,male,310,116,99,34,5,34,5,0,0
1604430,22,17,1991,11,female,574,119,73,34,9,34,9,0,0
1906327,27,29,1986,1,female,297,117,40,34,27,34,6,0,21
1740163,39,2,1974,9,male,862,117,45,34,34,34,26,0,8
1550418,23,23,1990,4,male,604,116,81,35,20,2,10,33,10
1948912,28,16,1985,4,female,441,119,82,36,27,8,14,28,13
1178624,27,25,1986,5,male,347,116,83,35,122,34,95,1,27
1554678,53,27,1960,7,female,1951,118,44,36,68,30,41,6,27
1946270,54,29,1959,10,male,1385,118,36,35,62,28,46,7,16
1541155,22,1,1991,1,male,55,117,106,36,5,36,5,0,0
1442645,23,1,1990,1,male,545,120,95,35,4,35,2,0,2
1840354,25,15,1988,6,male,253,117,109,36,20,36,11,0,9
2135497,19,11,1994,4,male,65,119,115,35,25,35,14,0,11
1003532,60,11,1953,11,female,1709,118,58,36,81,36,56,0,25
1045754,43,5,1970,12,male,370,116,85,37,4,37,2,0,2
1871844,19,27,1994,2,male,760,118,92,37,30,37,26,0,4
2019174,20,21,1993,12,male,770,117,72,39,23,0,12,39,11
2177680,60,1,1953,4,female,1468,118,63,38,16,0,2,38,14
1033243,29,22,1984,5,female,324,117,60,39,20,18,8,21,12
1961218,108,9,1905,9,female,1487,120,48,39,119,35,100,4,19
1820676,15,22,1998,1,female,602,116,68,40,26,24,13,16,13
2152247,55,10,1958,3,female,896,119,79,40,93,14,61,26,32
1892995,17,19,1996,2,male,658,118,60,40,31,34,17,6,14
2052384,24,2,1989,4,male,703,119,80,40,0,40,0,0,0
2120409,75,3,1938,1,male,1046,120,71,42,37,0,18,42,19
2067661,81,19,1932,8,female,512,117,94,41,39,0,5,41,34
1699213,19,10,1994,12,male,255,118,79,41,17,38,16,3,1
2059176,23,10,1990,4,male,127,116,104,41,20,38,11,3,9
2184155,25,9,1988,5,male,607,118,76,41,10,40,6,1,4
1765317,27,20,1986,4,female,230,116,82,42,20,32,17,10,3
1754355,23,15,1990,10,male,402,118,53,41,186,40,119,1,67
1715469,25,20,1988,3,male,1639,116,60,41,63,32,49,9,14
1953093,48,29,1965,11,male,585,116,85,42,12,42,10,0,2
1111919,88,24,1925,4,male,23,120,115,44,19,0,14,44,5
1587240,22,8,1991,4,male,155,117,105,43,19,14,6,29,13
1254354,42,23,1971,8,female,13,120,79,43,34,25,17,18,17
1709406,45,3,1968,2,female,686,119,81,45,50,42,22,3,28
1145716,35,29,1978,4,female,746,116,76,47,163,9,65,38,98
1394641,35,31,1978,10,female,454,116,46,46,110,2,73,44,37
1813490,29,18,1984,4,female,465,119,65,46,25,21,7,25,18
1383032,23,15,1990,5,male,505,118,84,46,0,45,0,1,0
2117356,32,1,1981,6,female,428,119,99,46,18,46,12,0,6
1784043,21,7,1992,2,male,503,116,24,47,67,47,61,0,6
1116947,45,15,1968,10,male,1461,116,45,48,75,0,34,48,41
2071056,18,12,1995,6,male,121,118,99,49,27,49,8,0,19
1252718,29,25,1984,10,male,830,116,96,49,9,49,8,0,1
2127813,23,7,1990,7,male,244,116,68,50,5,40,1,10,4
1552926,52,23,1961,3,female,214,118,81,50,15,49,12,1,3
1844012,23,15,1990,2,female,279,117,89,50,34,50,17,0,17
1591063,25,8,1988,5,male,294,120,82,53,20,10,19,43,1
1421316,65,23,1948,11,female,1190,116,37,53,63,1,29,52,34
1940745,33,30,1980,4,male,597,117,94,53,80,29,49,24,31
1989877,60,3,1953,11,male,1492,116,15,53,79,50,47,3,32
1224694,35,30,1978,9,female,1318,118,59,53,112,52,70,1,42
1364125,24,20,1989,3,female,325,120,54,53,24,53,14,0,10
1793999,55,28,1958,9,female,143,119,90,53,16,53,14,0,2
1455180,101,23,1912,2,female,2425,118,63,52,12,52,8,0,4
1008191,21,26,1992,6,male,1147,116,68,52,44,52,36,0,8
1653950,14,9,1999,5,female,459,117,68,54,9,0,1,54,8
2141642,42,20,1971,12,female,752,120,43,54,20,10,11,44,9
1784273,56,3,1957,8,female,1921,116,49,54,46,18,17,36,29
1066452,19,11,1994,2,male,213,116,106,54,3,47,2,7,1
1419486,22,7,1991,5,female,446,120,45,55,39,55,35,0,4
1632552,26,10,1987,7,male,353,117,97,55,215,55,215,0,0
1175246,33,2,1980,6,female,355,119,110,56,20,3,10,53,10
1706201,94,22,1919,1,male,58,120,109,57,44,0,11,57,33
1132190,26,2,1987,9,female,561,117,89,57,24,39,15,18,9
1680822,20,4,1993,6,female,115,118,92,56,241,22,94,34,147
2039326,33,29,1980,9,female,495,118,92,58,40,56,28,2,12
1071763,39,28,1974,7,female,341,116,89,58,72,53,41,5,31
1334126,66,3,1947,3,male,264,118,88,57,5,57,3,0,2
2059973,18,13,1995,5,male,273,117,95,56,94,56,49,0,45
2168173,20,17,1993,8,female,472,116,36,60,192,37,19,23,173
1629450,45,14,1968,9,female,300,117,92,60,154,39,82,21,72
1680372,19,3,1994,4,male,312,116,106,59,5,59,5,0,0
1851853,17,23,1996,12,female,305,116,73,60,23,60,18,0,5
2080439,23,13,1990,7,female,576,116,37,59,159,59,73,0,86
1517140,32,16,1981,8,male,90,117,67,59,336,59,299,0,37
1022475,19,15,1994,7,female,183,118,76,61,5,3,4,58,1
1604158,59,11,1954,7,female,963,116,97,61,9,0,3,61,6
1231174,44,8,1969,1,male,710,116,84,61,17,0,12,61,5
1296709,59,1,1954,9,male,1699,120,61,61,13,60,6,1,7
1461387,19,28,1994,2,male,686,120,23,62,2,62,1,0,1
1313616,17,3,1996,11,male,239,116,74,63,37,63,10,0,27
1817117,27,20,1986,5,male,265,120,55,63,33,63,19,0,14
1167658,18,1,1995,3,male,286,117,94,63,115,63,101,0,14
2172715,53,28,1960,1,female,530,120,62,62,301,62,190,0,111
1693583,19,15,1994,10,male,232,117,27,65,131,51,68,14,63
1133527,25,20,1988,1,female,646,117,54,64,158,57,146,7,12
2150131,20,4,1993,3,female,590,116,33,65,14,65,11,0,3
1138085,18,30,1995,3,female,395,117,48,64,69,64,65,0,4
1636942,28,29,1985,8,female,340,118,106,65,60,65,54,0,6
1682388,27,19,1986,8,female,358,118,59,68,7,1,3,67,4
1322650,75,11,1938,11,male,621,118,92,66,0,0,0,66,0
1402965,76,21,1937,10,male,992,119,88,66,6,0,4,66,2
1769716,33,15,1980,8,male,343,119,86,66,32,5,19,61,13
1472228,57,14,1956,4,female,503,119,73,68,60,13,24,55,36
1919019,101,21,1912,9,female,704,118,28,66,56,37,15,29,41
1392088,27,8,1986,6,male,158,117,111,67,49,67,18,0,31
1669669,56,3,1957,12,male,432,119,67,67,86,67,73,0,13
1955811,42,28,1971,6,female,185,119,44,67,109,67,96,0,13
1720530,26,5,1987,7,male,577,117,96,70,71,22,18,48,53
1935406,18,19,1995,10,male,523,117,112,71,22,69,16,2,6
1154274,103,10,1910,4,male,527,120,69,70,41,51,27,19,14
1717475,32,14,1981,10,male,123,117,68,70,35,70,29,0,6
1589294,66,21,1947,11,female,1947,117,49,69,49,69,29,0,20
1593073,29,20,1984,5,male,615,116,87,70,112,70,56,0,56
2094393,51,12,1962,12,male,479,118,74,71,155,71,144,0,11
1603151,15,17,1998,7,female,301,119,85,72,161,10,78,62,83
1185301,36,28,1977,9,female,591,117,53,72,169,31,87,41,82
1616150,39,7,1974,5,female,23,120,90,72,147,29,60,43,87
1631559,80,12,1933,11,male,1310,118,97,74,7,74,4,0,3
1746263,25,2,1988,2,male,191,116,83,74,110,74,72,0,38
1799906,66,18,1947,3,female,1461,119,54,72,84,72,42,0,42
1895809,21,10,1992,5,male,487,120,84,77,11,77,9,0,2
1823415,30,26,1983,9,male,410,118,83,75,4,75,4,0,0
1577571,105,9,1908,7,male,926,116,52,75,12,75,10,0,2
1085259,20,10,1993,3,female,359,116,84,77,17,77,5,0,12
1332729,23,10,1990,2,male,138,118,84,75,48,75,34,0,14
1719509,23,11,1990,8,female,19,117,4,76,118,76,77,0,41
2160772,34,19,1979,3,female,560,119,25,76,152,76,106,0,46
1046882,22,21,1991,11,male,626,120,75,80,9,79,9,1,0
1211805,57,22,1956,11,female,346,120,18,78,100,71,40,7,60
1933239,18,25,1995,9,male,476,118,75,84,19,10,12,74,7
1941159,63,30,1950,5,female,791,117,69,83,51,37,15,46,36
1444557,26,11,1987,9,female,487,116,46,83,13,83,8,0,5
1814680,62,21,1951,3,female,1028,117,27,81,10,81,8,0,2
1174713,25,24,1988,7,female,467,120,63,84,46,84,46,0,0
1380296,45,12,1968,7,male,413,119,60,82,421,82,188,0,233
1217385,69,7,1944,11,female,1467,119,40,87,79,1,52,86,27
1819199,54,29,1959,5,male,356,118,74,86,15,34,7,52,8
1848954,108,16,1905,1,female,247,116,44,87,41,49,17,38,24
1748364,47,1,1966,1,female,1877,116,65,86,83,69,69,17,14
1089991,55,10,1958,11,female,1921,119,46,85,77,79,30,6,47
1914558,23,28,1990,4,female,378,120,75,86,34,86,20,0,14
2141227,49,25,1964,1,female,91,116,32,86,192,86,174,0,18
1592333,28,1,1985,9,male,349,117,58,91,37,41,12,50,25
1765572,46,7,1967,5,female,569,119,53,91,56,90,36,1,20
1444866,34,26,1979,4,female,894,119,54,89,128,89,63,0,65
1053902,28,27,1985,6,male,323,118,67,91,220,91,138,0,82
1771656,48,12,1965,12,male,353,116,63,91,170,91,75,0,95
1583884,57,5,1956,9,female,1023,118,54,88,181,88,152,0,29
1133544,20,3,1993,3,male,264,119,68,95,14,57,7,38,7
2002287,83,8,1930,9,male,1875,120,86,93,753,42,423,51,330
1629478,26,2,1987,11,female,339,119,82,96,7,15,5,81,2
1552030,60,29,1953,9,female,730,120,41,97,247,0,46,97,201
2022804,24,30,1989,1,female,218,118,66,99,182,70,73,29,109
1709864,21,2,1992,4,male,143,118,96,96,206,85,107,11,99
1822533,17,18,1996,8,male,341,117,63,97,27,97,19,0,8
1495460,19,8,1994,6,male,465,120,50,99,41,99,19,0,22
1103622,37,7,1976,4,male,506,118,45,98,39,98,38,0,1
1832385,17,4,1996,1,male,559,116,55,96,92,96,43,0,49
1913556,43,28,1970,9,male,943,116,57,97,93,97,72,0,21
1551195,66,15,1947,12,female,321,120,54,98,94,98,68,0,26
1467934,67,12,1946,5,female,1790,119,81,102,38,6,15,96,23
1480626,54,6,1959,8,female,1636,117,78,101,88,60,72,41,16
1717082,24,16,1989,11,male,268,118,92,100,0,93,0,7,0
1717318,22,15,1991,11,male,196,117,52,104,49,83,15,21,34
1527551,51,24,1962,6,male,501,120,62,102,20,78,4,24,16
1893955,46,1,1967,7,female,114,120,63,100,83,100,60,0,23
1330312,25,19,1988,4,female,914,119,40,107,175,91,46,16,129
1682675,58,15,1955,4,female,1374,119,51,107,56,107,26,0,30
1764056,51,4,1962,9,male,1048,120,42,108,107,108,72,0,35
1670738,15,3,1998,10,male,740,117,95,110,0,109,0,1,0
1672805,108,2,1905,6,male,1278,117,38,111,13,111,12,0,1
2115033,36,29,1977,11,female,439,116,41,110,32,110,32,0,0
1221983,41,22,1972,12,female,307,117,69,110,75,110,61,0,14
1508898,43,25,1970,12,female,52,120,53,118,241,2,79,116,162
1654591,24,25,1989,11,female,198,116,45,116,86,61,60,55,26
1974459,30,8,1983,6,female,242,118,84,119,71,101,45,18,26
1230967,61,20,1952,3,female,2012,118,73,116,40,107,18,9,22
1818452,17,13,1996,11,female,169,116,99,118,19,118,18,0,1
1594335,22,10,1991,1,male,407,116,71,119,9,119,7,0,2
1297112,43,21,1970,11,male,310,117,87,120,17,0,1,120,16
1852182,52,31,1961,7,female,633,120,72,122,109,23,12,99,97
1182921,20,21,1993,2,female,100,118,109,120,24,45,7,75,17
1729034,28,16,1985,9,male,500,116,73,121,54,63,39,58,15
2176515,60,10,1953,8,female,1570,116,38,121,43,116,17,5,26
1718519,38,14,1975,1,female,1050,117,87,122,96,120,67,2,29
2041801,52,19,1961,11,male,1296,117,60,120,65,120,12,0,53
1782800,48,18,1965,7,female,899,119,65,123,226,123,132,0,94
1762921,55,8,1958,3,male,1768,116,45,128,66,82,22,46,44
1084211,19,4,1994,11,female,386,118,36,129,245,76,73,53,172
1242875,24,29,1989,7,female,270,119,72,126,553,105,305,21,248
1544035,15,15,1998,7,female,438,119,109,130,1,130,0,0,1
1025615,30,2,1983,12,female,406,119,28,127,14,127,11,0,3
1477044,57,16,1956,12,female,712,116,73,127,33,127,28,0,5
2062600,57,28,1956,7,female,771,117,24,132,73,81,28,51,45
1983035,47,7,1966,11,female,2315,117,55,134,154,95,113,39,41
1382615,14,26,1999,9,male,371,120,89,133,7,98,6,35,1
2181604,33,5,1980,9,female,532,117,57,132,125,102,61,30,64
1843130,48,7,1965,1,male,32,119,61,135,105,117,35,18,70
1144724,56,25,1957,2,female,1769,118,68,132,253,110,149,22,104
2166672,101,10,1912,10,female,716,119,42,135,115,135,103,0,12
1337716,17,16,1996,5,female,385,117,48,141,155,2,82,139,73
2106300,31,14,1982,10,female,380,118,59,141,268,10,76,131,192
1222094,67,9,1946,5,female,2226,120,62,137,202,43,82,94,120
1841341,48,1,1965,8,male,289,119,85,137,223,110,92,27,131
2042642,34,24,1979,11,male,151,118,110,138,4,138,0,0,4
1604065,21,14,1992,9,female,207,118,29,143,299,143,277,0,22
1149157,54,22,1959,9,female,756,119,36,145,96,0,28,145,68
1043556,57,6,1956,6,female,90,119,102,149,14,147,9,2,5
1674910,17,1,1996,5,female,136,117,85,146,145,145,90,1,55
1606384,23,24,1990,8,male,118,120,108,149,19,149,11,0,8
1024341,18,9,1995,9,male,55,120,74,151,189,100,156,51,33
1501513,27,6,1986,8,female,699,116,78,153,73,149,45,4,28
1575752,18,24,1995,2,female,226,118,87,152,148,113,113,39,35
1291246,56,2,1957,5,male,346,117,84,156,60,156,26,0,34
1093732,24,14,1989,9,male,315,118,88,152,102,152,42,0,60
1261199,32,27,1981,10,female,833,117,67,156,156,156,140,0,16
1988490,39,30,1974,7,female,508,117,39,157,190,157,178,0,12
1800650,100,1,1913,11,male,1113,118,83,152,116,152,114,0,2
1202320,50,3,1963,4,female,495,117,82,158,133,1,45,157,88
1975474,52,8,1961,3,male,603,120,97,160,168,1,47,159,121
1482045,38,11,1975,9,female,1856,119,65,162,42,114,11,48,31
1068470,55,27,1958,4,female,1512,118,48,163,157,124,133,39,24
1599249,49,3,1964,5,female,1048,118,57,163,325,146,121,17,204
1597923,16,3,1997,3,female,140,120,69,159,329,158,117,1,212
1862587,22,22,1991,5,male,89,118,104,164,221,164,202,0,19
1753692,47,17,1966,5,female,302,120,44,159,145,159,92,0,53
1421231,61,12,1952,3,female,1713,118,69,168,66,1,55,167,11
1890767,16,23,1997,8,female,380,118,66,166,71,34,34,132,37
1075505,59,24,1954,9,female,448,120,93,168,62,81,36,87,26
1657522,93,21,1920,12,female,1660,117,68,165,87,62,34,103,53
2190760,49,21,1964,5,female,467,116,74,171,67,129,52,42,15
2044763,24,1,1989,1,male,484,118,58,166,14,166,11,0,3
1157275,33,23,1980,12,female,84,118,98,167,17,167,17,0,0
1259145,100,3,1913,4,female,192,118,106,168,8,168,1,0,7
2030049,19,5,1994,5,male,369,116,65,166,117,166,49,0,68
1920219,25,15,1988,8,female,122,120,82,166,186,166,176,0,10
2058410,55,30,1958,6,female,800,120,59,165,230,165,153,0,77
1756543,50,29,1963,10,female,521,117,65,174,18,0,11,174,7
1821354,69,28,1944,11,female,2172,117,89,175,20,60,5,115,15
1671358,32,18,1981,2,female,260,120,62,177,304,88,130,89,174
1275585,60,25,1953,4,female,442,117,69,178,15,178,11,0,4
2004525,27,29,1986,9,male,646,116,76,175,92,175,64,0,28
1347741,29,5,1984,3,female,503,119,92,174,192,174,189,0,3
1912831,55,14,1958,4,male,412,117,108,186,108,0,25,186,83
1561378,27,5,1986,11,female,302,120,93,187,43,116,33,71,10
2024906,69,26,1944,4,female,1543,119,69,190,103,40,25,150,78
1672660,24,7,1989,7,female,991,120,67,183,159,128,101,55,58
1808354,15,14,1998,3,female,337,118,58,187,45,186,16,1,29
2116751,35,23,1978,7,female,512,119,78,189,81,188,62,1,19
1696344,28,5,1985,9,male,354,120,96,186,66,186,28,0,38
1166217,38,4,1975,10,female,994,118,72,190,165,190,112,0,53
1993280,30,2,1983,5,female,483,116,56,182,448,182,342,0,106
1941142,77,11,1936,2,female,469,119,99,194,68,0,37,194,31
1988047,19,27,1994,3,female,263,116,84,195,32,87,16,108,16
1139595,26,6,1987,1,male,1465,120,43,198,17,143,9,55,8
1609582,59,23,1954,10,female,848,116,55,191,79,115,51,76,28
1695121,30,5,1983,5,male,340,117,43,199,160,74,33,125,127
1086799,32,28,1981,8,male,1037,116,45,198,170,40,37,158,133
1441885,39,27,1974,8,female,1495,120,87,197,223,189,155,8,68
1830970,14,7,1999,2,male,399,116,39,199,29,199,20,0,9
1225524,35,1,1978,6,male,462,116,91,192,35,192,25,0,10
1873498,28,21,1985,7,female,200,116,63,191,566,191,198,0,368
1486630,26,15,1987,9,female,243,120,38,201,71,15,37,186,34
1406632,27,7,1986,9,male,358,118,71,208,58,0,3,208,55
1572993,68,7,1945,6,female,1877,119,52,209,50,78,32,131,18
1069407,108,24,1905,11,female,1245,118,77,207,46,58,35,149,11
1701222,27,10,1986,10,female,291,117,78,203,22,198,9,5,13
1737785,20,18,1993,6,male,374,120,93,206,7,204,6,2,1
1483150,20,10,1993,6,female,738,118,82,211,76,211,39,0,37
1944069,27,19,1986,4,male,413,116,73,201,58,201,16,0,42
1900318,46,1,1967,7,female,529,119,93,210,87,210,71,0,16
2005426,45,6,1968,10,male,188,120,94,206,251,206,220,0,31
2020220,45,29,1968,6,female,401,119,76,217,139,0,68,217,71
1924621,79,1,1934,1,NA,2083,119,46,212,69,103,15,109,54
1544767,27,2,1986,4,male,301,117,93,212,308,197,42,15,266
2033115,71,24,1942,7,female,390,118,74,232,27,8,15,224,12
1791819,69,18,1944,6,male,383,120,40,228,102,0,31,228,71
1234870,30,16,1983,6,female,195,119,54,222,189,186,133,36,56
1412549,60,2,1953,6,female,715,120,86,229,22,229,22,0,0
1434774,48,6,1965,2,female,492,116,85,230,52,230,47,0,5
2092654,35,3,1978,12,female,589,120,56,224,182,224,143,0,39
1721140,63,17,1950,1,female,1533,119,19,235,138,0,18,235,120
1762828,20,1,1993,1,female,675,119,69,246,172,122,92,124,80
1583496,49,5,1964,4,female,1334,120,62,237,160,163,118,74,42
1023820,21,4,1992,1,female,519,117,56,243,11,243,7,0,4
1349875,20,15,1993,11,female,15,119,117,246,42,246,35,0,7
1111178,17,11,1996,9,male,331,118,74,254,13,226,13,28,0
1996176,24,18,1989,2,female,188,117,70,252,104,227,62,25,42
1566460,63,14,1950,1,male,1857,118,71,247,149,223,99,24,50
1112660,29,16,1984,10,female,168,119,87,249,711,249,500,0,211
1724082,26,8,1987,12,female,509,116,58,274,16,274,13,0,3
1683900,23,3,1990,1,male,646,117,78,263,151,263,147,0,4
1149673,28,1,1985,2,male,183,117,45,269,51,269,41,0,10
1824951,23,7,1990,7,male,387,116,57,282,89,4,57,278,32
1272474,56,7,1957,3,female,1344,118,85,278,85,47,19,231,66
1575192,14,6,1999,11,male,196,120,83,281,113,80,42,201,71
1699148,26,9,1987,9,female,502,117,88,278,111,117,31,161,80
1931780,41,25,1972,4,female,205,120,82,282,8,270,6,12,2
1652333,30,8,1983,12,female,497,119,56,278,138,264,79,14,59
1783080,55,27,1958,7,female,597,120,70,277,74,237,56,40,18
1262417,43,23,1970,7,female,1292,116,61,287,174,287,100,0,74
2057782,84,29,1929,12,female,1008,119,79,278,173,278,154,0,19
1094132,17,18,1996,3,male,142,119,80,296,15,22,8,274,7
1528843,25,8,1988,10,female,409,119,53,297,41,276,33,21,8
1463523,39,13,1974,11,female,760,117,54,302,131,298,101,4,30
1372734,49,29,1964,10,female,126,116,61,313,55,0,4,313,51
1407225,44,5,1969,9,female,125,116,102,324,10,319,2,5,8
1706292,52,20,1961,9,female,1015,118,65,323,331,304,103,19,228
1624967,27,19,1986,11,female,334,116,69,321,517,291,240,30,277
1083074,18,23,1995,3,female,545,119,100,319,130,318,81,1,49
1173673,19,8,1994,6,male,359,116,82,323,99,323,94,0,5
1735071,41,15,1972,6,male,362,120,58,324,60,324,53,0,7
2056339,49,1,1964,9,female,629,119,69,320,361,320,323,0,38
2064591,69,3,1944,8,male,1686,119,28,344,99,55,48,289,51
1060202,17,5,1996,3,male,326,120,81,332,242,225,91,107,151
2055629,28,26,1985,11,female,691,116,55,334,285,212,52,122,233
1372043,27,6,1986,1,female,562,120,80,329,47,321,41,8,6
1973448,66,7,1947,9,male,1477,117,53,335,153,313,31,22,122
1862618,43,9,1970,9,female,126,120,98,329,312,327,122,2,190
2179003,28,27,1985,9,female,158,117,47,341,162,341,52,0,110
1661404,32,15,1981,5,female,311,120,104,328,167,328,33,0,134
2134416,59,17,1954,8,female,581,118,74,345,198,345,173,0,25
2144039,32,28,1981,8,male,642,118,61,337,354,337,278,0,76
1879593,40,2,1973,10,female,314,117,111,354,5,0,0,354,5
1228280,54,18,1959,1,female,570,117,78,352,143,0,100,352,43
1639087,103,28,1910,11,female,1935,117,71,366,356,0,177,366,179
2088232,40,20,1973,4,male,241,116,28,367,202,338,145,29,57
1790777,18,6,1995,2,male,170,118,90,353,226,329,137,24,89
1201966,66,13,1947,3,female,1759,116,41,357,565,325,248,32,317
1431309,32,6,1981,9,male,539,116,69,359,243,359,187,0,56
1583421,55,22,1958,7,male,48,119,75,363,350,363,172,0,178
1985225,94,28,1919,6,male,1739,118,43,385,15,0,1,385,14
1503086,51,15,1962,6,female,299,120,52,391,179,374,128,17,51
1935663,46,22,1967,5,male,645,118,69,370,598,354,454,16,144
1625337,48,9,1965,2,female,432,120,82,386,498,383,217,3,281
1109892,21,20,1992,3,male,311,117,91,383,9,383,8,0,1
2010055,35,27,1978,12,female,203,116,60,386,170,386,151,0,19
1478532,36,14,1977,5,female,195,119,91,383,433,383,265,0,168
1326429,16,9,1997,12,female,861,118,45,413,103,54,40,359,63
1682772,29,14,1984,10,male,320,116,72,415,87,0,11,415,76
1107832,46,16,1967,7,female,456,116,97,421,174,54,55,367,119
1072367,30,8,1983,2,female,645,118,64,401,214,296,155,105,59
1583021,48,12,1965,8,female,1612,117,43,418,230,390,149,28,81
2083234,56,26,1957,8,female,1482,116,26,406,291,358,204,48,87
1071012,51,18,1962,7,female,553,116,63,405,421,404,337,1,84
1639178,35,29,1978,10,female,227,116,109,412,364,412,267,0,97
1065740,49,10,1964,10,female,331,120,100,426,24,0,11,426,13
1161036,71,10,1942,9,female,776,120,82,437,70,0,22,437,48
2193408,58,27,1955,8,female,543,117,60,445,127,3,66,442,61
1945400,16,4,1997,2,female,589,119,58,449,378,10,119,439,259
1290827,19,22,1994,7,female,202,119,66,427,549,71,285,356,264
1975475,39,13,1974,7,female,254,116,76,432,149,96,43,336,106
1943702,67,24,1946,1,female,1552,119,66,422,716,236,89,186,627
1134618,99,14,1914,3,male,1278,116,40,426,66,426,16,0,50
1610633,51,13,1962,3,female,251,119,100,432,211,432,168,0,43
1980331,25,15,1988,4,female,591,120,50,441,464,441,443,0,21
1857692,64,19,1949,1,female,55,119,28,438,766,438,428,0,338
2119564,41,16,1972,8,female,557,116,80,478,23,184,19,294,4
1536658,23,26,1990,3,female,236,120,94,474,11,399,10,75,1
2087977,28,5,1985,9,female,495,117,37,510,320,1,237,509,83
1508990,16,20,1997,5,female,478,118,75,489,567,336,288,153,279
2044589,90,20,1923,11,female,40,117,82,500,59,464,34,36,25
1287472,41,17,1972,3,female,932,118,66,504,152,504,83,0,69
2173841,20,29,1993,10,female,474,119,70,554,214,295,88,259,126
1116028,54,29,1959,10,female,1166,119,82,544,122,351,44,193,78
1876574,16,27,1997,7,female,221,119,97,541,551,239,199,302,352
1037591,22,23,1991,12,female,314,118,74,540,516,281,115,259,401
1200964,55,28,1958,2,male,835,120,36,525,13,489,3,36,10
1358476,14,1,1999,3,male,40,117,77,533,30,533,28,0,2
1267526,35,23,1978,5,female,184,118,96,547,308,547,245,0,63
1782714,49,9,1964,11,female,1204,117,60,541,424,541,313,0,111
1522534,86,28,1927,10,male,790,120,41,575,56,67,26,508,30
1649224,62,17,1951,11,female,1264,117,29,586,295,84,156,502,139
1099608,45,8,1968,10,female,1756,117,58,572,401,114,176,458,225
1636409,57,28,1956,3,female,961,117,43,573,97,533,78,40,19
1176864,60,30,1953,9,female,627,118,76,588,442,588,210,0,232
1165198,61,26,1952,10,male,192,118,60,646,369,0,71,646,298
1887737,64,30,1949,6,female,1366,117,69,616,289,0,181,616,108
2070671,74,23,1939,6,female,667,118,52,632,311,0,101,632,210
2043136,23,7,1990,10,female,125,119,97,636,215,329,153,307,62
1297229,69,23,1944,12,female,1714,117,41,623,257,598,153,25,104
1242432,27,18,1986,11,female,94,118,85,654,304,654,199,0,105
1016601,107,10,1906,6,female,1194,118,58,692,72,0,7,692,65
2046127,27,24,1986,1,female,260,119,95,704,194,704,153,0,41
1981711,27,5,1986,3,male,127,120,85,721,410,721,222,0,188
1214415,108,1,1905,1,male,437,118,102,773,304,0,117,773,187
1058054,53,3,1960,1,male,108,118,80,736,228,736,188,0,40
1993145,41,18,1972,4,male,326,117,80,753,587,753,525,0,62
1413706,79,26,1934,11,female,714,119,101,879,441,0,177,879,264
2155539,53,12,1960,7,female,1363,117,68,807,133,504,67,303,66
1248498,19,27,1994,4,female,1008,116,55,878,853,518,331,360,522
1133530,29,30,1984,7,female,667,120,82,866,727,557,335,309,392
2087382,28,25,1985,3,female,458,119,48,843,1098,838,939,5,159
1219017,57,29,1956,5,female,875,119,17,940,207,0,110,940,97
1415768,43,3,1970,2,female,313,119,52,892,270,604,155,288,115
1910806,57,10,1956,2,female,1506,119,72,913,398,387,266,526,132
1590299,40,18,1973,7,female,387,117,55,894,473,894,325,0,148
1139996,38,28,1975,7,female,190,119,66,897,895,897,754,0,141
1194098,21,4,1992,3,male,655,117,17,1079,1181,760,596,319,585
1666617,33,10,1980,3,female,418,117,92,1020,201,991,144,29,57
2062916,15,23,1998,10,female,271,116,30,1000,80,1000,56,0,24
1862644,56,23,1957,1,female,1170,119,66,1279,500,0,37,1279,463
1584823,63,23,1950,10,male,160,118,93,1218,171,1218,128,0,43
1693242,29,29,1984,10,male,490,117,112,1177,665,1177,513,0,152
2099711,75,7,1938,5,female,577,118,86,1384,40,0,4,1384,36
1544755,43,10,1970,11,female,599,116,47,1467,417,0,88,1467,329
1556123,65,1,1948,3,male,1668,118,69,1310,320,5,249,1305,71
1476663,18,6,1995,3,male,844,116,86,1387,1323,1311,948,76,375
1447071,34,15,1979,6,female,262,116,108,1488,1266,1404,1029,84,237
1421295,55,7,1958,7,female,1461,120,53,1770,412,927,238,843,174
1602107,36,15,1977,1,female,136,117,89,1622,366,1586,49,36,317
2028244,42,27,1971,9,male,223,118,57,1783,370,1783,305,0,65
1430237,67,1,1946,12,female,533,119,88,2058,722,0,9,2058,713
1295354,18,23,1995,5,female,525,119,58,2773,889,538,335,2235,554
1789857,38,22,1975,2,female,240,119,74,2681,4648,271,1045,2410,3603
1415313,31,12,1982,5,female,468,116,52,5683,174,5471,97,212,77
1262868,21,27,1992,7,female,1448,120,26,9690,1679,8323,376,1367,1303
1317692,49,4,1964,12,female,58,116,93,8873,1698,8872,1352,1,346
1901170,40,27,1973,7,female,90,116,23,3630,898,3630,847,0,51
2145922,61,9,1952,11,male,1423,121,36,3,0,0,0,3,0
1696471,27,20,1986,5,male,626,124,58,3,1,0,0,3,1
1142150,62,20,1951,5,male,1755,121,42,3,4,0,1,3,3
2190781,55,7,1958,5,male,1623,123,40,3,11,0,5,3,6
1883647,14,10,1999,5,male,142,123,109,3,3,2,2,1,1
1783033,51,11,1962,3,male,1184,122,33,3,10,2,4,1,6
1591260,53,12,1960,10,female,1343,123,39,3,82,2,39,1,43
1785932,108,28,1905,1,male,1023,123,72,3,104,2,80,1,24
1294509,19,4,1994,7,male,317,121,84,3,0,3,0,0,0
1410844,23,27,1990,12,male,249,122,89,3,0,3,0,0,0
1712065,24,16,1989,9,male,467,122,61,3,0,3,0,0,0
2069817,42,21,1971,9,female,520,123,88,3,0,3,0,0,0
2039533,51,18,1962,10,male,282,123,87,3,0,3,0,0,0
1933437,38,28,1975,7,male,488,123,56,3,1,3,1,0,0
1575085,16,8,1997,12,male,308,121,80,3,3,3,3,0,0
2068252,16,14,1997,3,male,294,124,118,3,4,3,2,0,2
1156010,20,26,1993,1,male,737,121,84,3,2,3,2,0,0
1492161,24,10,1989,1,male,512,121,87,3,4,3,3,0,1
1901688,27,26,1986,6,male,239,121,107,3,2,3,1,0,1
2166787,15,6,1998,12,male,132,124,95,3,7,3,3,0,4
1069413,16,27,1997,12,female,295,123,58,3,9,3,9,0,0
1276125,20,26,1993,6,female,392,122,6,3,132,3,122,0,10
1184290,21,26,1992,5,male,310,124,89,3,17,3,9,0,8
1964051,21,30,1992,9,male,414,122,95,3,34,3,8,0,26
2019828,24,2,1989,1,male,661,121,57,3,9,3,4,0,5
1219500,27,15,1986,4,male,454,121,52,3,13,3,13,0,0
1765863,29,29,1984,10,female,969,121,54,3,6,3,4,0,2
2191318,31,27,1982,9,male,297,123,91,3,5,3,5,0,0
1529971,48,20,1965,4,female,226,124,90,3,5,3,4,0,1
1286334,54,24,1959,12,male,1369,124,88,3,21,3,1,0,20
1388382,17,18,1996,11,male,518,123,66,4,0,0,0,4,0
1168833,18,21,1995,7,male,188,121,108,4,0,0,0,4,0
1464952,78,28,1935,8,female,1960,123,84,4,0,0,0,4,0
1576420,108,1,1905,1,male,1201,123,75,4,0,0,0,4,0
1852112,28,14,1985,6,male,436,122,80,4,1,0,0,4,1
1041659,93,24,1920,11,male,456,121,49,4,2,0,1,4,1
1354957,102,29,1911,9,female,1429,121,62,4,2,0,0,4,2
1489062,108,31,1905,8,male,1069,124,73,4,24,0,8,4,16
1721419,14,21,1999,5,male,525,123,69,4,0,1,0,3,0
1819378,21,21,1992,5,male,289,122,92,4,0,2,0,2,0
1005125,26,6,1987,4,male,428,121,115,4,0,3,0,1,0
1464185,20,14,1993,11,male,148,123,91,4,0,4,0,0,0
1514199,19,2,1994,5,female,482,123,44,4,0,4,0,0,0
1579879,19,8,1994,6,female,583,121,62,4,0,4,0,0,0
2044688,23,15,1990,10,male,107,123,82,4,2,4,2,0,0
1532889,32,14,1981,6,male,376,124,113,4,4,4,3,0,1
1302776,16,5,1997,9,male,653,123,67,4,10,4,9,0,1
1973230,17,19,1996,5,female,868,122,29,4,12,4,3,0,9
1010956,23,11,1990,3,female,235,124,99,4,10,4,10,0,0
1776764,26,10,1987,8,female,646,124,58,4,613,4,338,0,275
1942196,29,14,1984,6,male,1109,123,82,4,143,4,136,0,7
2025372,33,20,1980,9,male,214,124,107,4,32,4,10,0,22
1728617,35,18,1978,7,female,689,124,48,4,8,4,8,0,0
1347781,100,21,1913,3,male,512,123,81,4,8,4,6,0,2
2174602,16,20,1997,9,male,27,123,109,5,5,0,2,5,3
1989908,103,1,1910,1,male,1495,124,51,5,24,0,11,5,13
1951019,21,19,1992,8,male,424,122,85,5,0,3,0,2,0
1181458,17,1,1996,5,male,228,121,60,5,45,2,32,3,13
1898994,38,15,1975,2,male,631,122,90,5,29,4,8,1,21
1791838,63,2,1950,4,male,1979,122,59,5,81,4,62,1,19
2132493,18,18,1995,12,male,1685,123,49,5,0,5,0,0,0
1533553,26,1,1987,1,male,439,121,114,5,0,5,0,0,0
1055927,38,28,1975,5,male,495,122,9,5,0,5,0,0,0
1811474,39,1,1974,9,male,404,124,73,5,0,5,0,0,0
1180892,100,1,1913,1,female,1746,122,54,5,0,5,0,0,0
1113189,15,11,1998,9,male,185,121,23,5,2,5,2,0,0
1214542,20,27,1993,7,male,141,124,108,5,2,5,1,0,1
1076260,22,6,1991,12,male,316,124,106,5,1,5,1,0,0
1874327,98,28,1915,9,female,670,122,49,5,2,5,1,0,1
1844269,17,30,1996,8,male,55,123,112,5,4,5,2,0,2
1095552,34,19,1979,9,male,119,124,113,5,5,5,1,0,4
1207666,22,18,1991,6,female,244,121,55,5,39,5,22,0,17
1448170,29,19,1984,1,male,825,123,65,5,73,5,60,0,13
1627800,103,18,1910,1,female,994,123,67,5,43,5,32,0,11
1424487,31,3,1982,1,female,1181,123,48,6,0,0,0,6,0
1129814,47,31,1966,5,male,1375,122,61,6,2,0,1,6,1
1087716,66,1,1947,1,male,1537,122,19,6,2,0,2,6,0
1322756,86,19,1927,5,female,816,122,57,6,11,0,2,6,9
1620684,20,26,1993,9,male,120,122,82,6,61,5,37,1,24
1199437,31,22,1982,7,female,372,121,66,6,9,5,3,1,6
1742720,20,22,1993,12,male,475,124,74,6,0,6,0,0,0
2040935,21,1,1992,1,male,104,122,110,6,0,6,0,0,0
1371432,105,13,1908,3,male,1264,124,53,6,0,6,0,0,0
1744067,13,19,2000,2,male,224,121,100,6,2,6,1,0,1
1337134,22,11,1991,7,male,276,123,75,6,2,6,2,0,0
1970948,23,8,1990,4,male,647,121,56,6,5,6,5,0,0
1431403,25,25,1988,3,female,546,121,98,6,17,6,7,0,10
1712677,32,15,1981,10,male,345,123,89,6,67,6,54,0,13
1537884,74,4,1939,11,female,687,121,72,7,1,0,1,7,0
2137523,46,2,1967,1,male,505,122,10,7,9,1,4,6,5
1328285,14,1,1999,5,male,486,123,87,7,0,7,0,0,0
1173569,35,19,1978,3,female,176,121,54,7,8,7,7,0,1
1086146,23,17,1990,10,male,380,122,97,7,72,7,46,0,26
1371340,31,6,1982,7,male,533,124,110,7,21,7,18,0,3
1263542,49,11,1964,8,male,1944,124,44,7,30,7,15,0,15
1045330,108,28,1905,12,male,604,122,68,7,24,7,17,0,7
1958204,103,1,1910,1,female,523,121,100,8,0,0,0,8,0
1482359,75,9,1938,9,female,1117,122,21,8,7,0,0,8,7
2093128,17,5,1996,7,male,360,123,102,8,11,5,0,3,11
1155706,48,1,1965,1,female,708,121,48,8,3,7,2,1,1
1772492,20,15,1993,7,male,1464,122,78,8,120,7,28,1,92
1477880,35,10,1978,2,female,622,123,37,8,29,7,26,1,3
1237666,23,5,1990,4,male,328,124,94,8,1,8,1,0,0
1046137,26,31,1987,5,male,1542,124,74,8,3,8,2,0,1
1239880,17,15,1996,9,male,548,121,54,8,10,8,0,0,10
2145287,21,1,1992,1,female,305,121,20,8,10,8,5,0,5
2103889,39,6,1974,9,male,289,124,99,8,7,8,6,0,1
1864431,45,7,1968,6,female,393,122,114,8,10,8,2,0,8
1034605,18,15,1995,9,male,151,123,111,9,0,0,0,9,0
1211964,18,24,1995,5,male,315,123,85,9,2,0,2,9,0
2026650,28,10,1985,7,male,495,121,98,9,3,1,3,8,0
1509604,26,8,1987,2,male,473,123,92,9,7,0,3,9,4
1801356,29,9,1984,9,male,39,123,114,9,49,0,36,9,13
1200031,43,7,1970,12,male,700,123,75,9,2,8,1,1,1
1794739,23,19,1990,3,male,361,122,83,9,1,9,1,0,0
1526726,27,19,1986,8,male,490,122,23,9,0,9,0,0,0
1156461,18,14,1995,7,female,366,121,64,9,4,9,4,0,0
1971325,24,13,1989,4,female,164,123,107,9,2,9,2,0,0
1060879,26,29,1987,5,female,477,123,73,9,2,9,2,0,0
1625838,30,30,1983,10,male,93,122,88,9,2,9,2,0,0
1120310,33,10,1980,4,male,460,121,99,9,3,9,3,0,0
1390971,18,25,1995,1,male,218,122,87,9,6,9,2,0,4
1946096,23,6,1990,10,male,344,123,96,9,8,9,8,0,0
1539657,45,11,1968,2,male,183,124,103,9,8,9,2,0,6
1949611,108,20,1905,11,female,215,123,47,9,13,9,13,0,0
1908218,25,11,1988,7,male,194,122,51,9,14,9,8,0,6
2102374,62,24,1951,7,female,1362,123,31,9,21,9,21,0,0
1462031,53,28,1960,5,female,978,122,96,10,28,7,16,3,12
1928701,20,3,1993,10,female,283,124,97,10,3,8,2,2,1
1264011,14,14,1999,8,female,411,124,52,10,1,10,0,0,1
2081956,34,29,1979,1,male,469,123,111,10,0,10,0,0,0
1029415,18,28,1995,8,male,245,121,89,10,3,10,1,0,2
1246660,26,3,1987,11,male,207,121,105,10,6,10,3,0,3
1375599,19,21,1994,8,male,229,124,116,10,14,10,6,0,8
1295004,52,6,1961,12,male,698,124,70,10,10,10,6,0,4
1135326,30,28,1983,6,male,540,122,27,10,28,10,27,0,1
1117895,23,6,1990,1,male,82,122,112,11,4,0,0,11,4
1471720,32,5,1981,5,male,203,123,64,11,2,0,0,11,2
1628016,21,9,1992,8,male,221,122,76,11,12,0,7,11,5
1968400,82,14,1931,4,male,1935,122,35,11,13,0,3,11,10
1962417,19,7,1994,11,female,100,123,107,11,10,11,10,0,0
2074657,18,15,1995,9,female,101,121,79,11,18,11,6,0,12
1483856,19,5,1994,8,female,217,124,25,11,17,11,14,0,3
1084959,22,10,1991,10,female,349,121,64,11,32,11,20,0,12
1667053,44,22,1969,8,female,294,122,87,11,170,11,81,0,89
2142003,17,6,1996,9,male,388,123,106,12,0,0,0,12,0
1116495,17,21,1996,10,male,350,122,97,12,1,1,0,11,1
2120455,74,17,1939,12,male,755,122,85,12,0,0,0,12,0
1644756,59,27,1954,4,female,1762,123,46,12,26,0,4,12,22
1763948,69,30,1944,7,male,326,121,104,12,34,0,13,12,21
2184472,108,16,1905,4,female,1016,123,72,12,44,0,18,12,26
1980282,29,3,1984,1,male,288,123,117,12,12,8,9,4,3
1886108,37,1,1976,1,male,501,122,72,12,39,4,13,8,26
1918664,25,6,1988,3,male,325,124,100,12,5,11,5,1,0
2110172,23,7,1990,7,male,566,123,66,12,0,12,0,0,0
1734030,37,30,1976,11,male,524,122,88,12,10,12,10,0,0
1691844,103,8,1910,7,female,70,122,43,12,15,12,8,0,7
2118009,51,16,1962,12,male,987,123,36,12,29,12,23,0,6
1747763,70,20,1943,12,male,1107,123,79,13,9,0,3,13,6
2081591,14,2,1999,11,male,94,123,108,13,34,0,14,13,20
2001688,79,18,1934,7,female,1713,123,44,13,7,3,5,10,2
1399947,65,2,1948,2,male,2248,121,67,13,15,7,11,6,4
1977278,26,27,1987,12,male,538,123,102,13,2,11,1,2,1
1868298,58,3,1955,9,female,1320,122,52,13,31,12,19,1,12
1044277,41,19,1972,11,male,472,122,94,13,2,13,2,0,0
1880188,83,4,1930,11,male,219,123,47,13,6,13,3,0,3
1391141,19,25,1994,7,female,236,122,78,13,9,13,7,0,2
2103599,21,29,1992,6,female,295,122,41,13,100,13,65,0,35
2024339,54,10,1959,1,male,757,124,44,14,0,2,0,12,0
1480176,22,4,1991,12,male,286,124,81,14,6,2,0,12,6
1232081,94,1,1919,3,male,1010,124,73,14,7,0,3,14,4
1223080,21,8,1992,11,male,524,123,77,14,4,13,3,1,1
1085752,16,17,1997,4,male,676,122,85,14,25,11,18,3,7
1201928,24,16,1989,6,male,504,124,95,14,8,14,8,0,0
1644764,31,3,1982,3,male,564,124,70,14,7,14,4,0,3
1797705,68,12,1945,1,male,446,124,8,14,3,14,3,0,0
1466339,24,5,1989,10,male,522,124,28,14,12,14,8,0,4
1968734,27,10,1986,3,male,484,123,78,14,18,14,5,0,13
2160783,41,31,1972,1,male,354,123,92,14,9,14,5,0,4
1375883,50,30,1963,7,male,136,123,115,14,11,14,8,0,3
1344732,56,10,1957,10,female,932,124,86,14,25,14,4,0,21
1195928,14,24,1999,4,male,432,121,96,15,6,0,0,15,6
1032071,46,12,1967,3,female,407,122,94,15,17,0,10,15,7
2092443,16,9,1997,1,female,382,124,62,15,4,13,4,2,0
1611673,37,9,1976,4,male,619,122,108,15,1,15,1,0,0
2076124,71,17,1942,3,male,950,121,94,15,1,15,1,0,0
1484810,19,20,1994,9,male,505,124,109,15,5,15,5,0,0
1547742,20,23,1993,5,male,475,121,90,15,6,15,3,0,3
1324512,103,13,1910,12,male,951,123,71,15,5,15,5,0,0
1830328,18,7,1995,6,male,537,121,50,15,10,15,9,0,1
1779699,25,28,1988,10,male,568,123,101,15,12,15,2,0,10
1162854,59,15,1954,7,male,1774,121,73,15,21,15,12,0,9
1570081,76,1,1937,9,female,1430,122,73,15,11,15,6,0,5
1953566,20,2,1993,2,female,70,123,109,15,97,15,66,0,31
2043698,34,6,1979,6,male,700,124,54,15,38,15,31,0,7
1943150,27,6,1986,1,male,544,124,72,16,6,0,3,16,3
1899845,28,1,1985,6,male,262,122,52,16,5,0,0,16,5
1528417,18,13,1995,7,male,230,124,40,16,21,0,1,16,20
2131830,21,9,1992,5,male,465,124,92,16,15,9,8,7,7
1186358,53,12,1960,11,male,1319,124,81,16,2,13,1,3,1
1263397,22,13,1991,12,male,324,122,84,16,0,16,0,0,0
1018937,42,19,1971,3,female,280,121,80,16,32,16,20,0,12
1205849,16,26,1997,8,female,331,122,40,17,1,0,1,17,0
1794350,27,28,1986,8,male,143,121,85,17,135,8,70,9,65
1225020,18,4,1995,3,female,271,124,13,17,2,17,1,0,1
2055969,29,14,1984,2,male,77,123,36,17,0,17,0,0,0
2188291,19,14,1994,9,male,141,123,59,17,20,17,9,0,11
1018960,33,30,1980,8,male,91,122,59,17,13,17,10,0,3
1489317,15,3,1998,2,male,592,121,81,17,50,17,38,0,12
1473774,47,16,1966,12,male,296,124,62,18,63,17,42,1,21
1763523,18,3,1995,9,female,516,123,3,18,9,18,6,0,3
1270704,16,14,1997,9,male,573,123,90,18,17,18,17,0,0
1711937,23,29,1990,1,female,387,124,90,18,21,18,19,0,2
1799434,24,4,1989,8,male,502,124,88,18,26,18,12,0,14
1547354,25,3,1988,12,female,271,124,28,18,38,18,38,0,0
1464885,18,21,1995,10,male,169,124,45,19,2,18,2,1,0
1359994,54,18,1959,10,female,1471,123,54,19,23,14,12,5,11
1075669,62,27,1951,11,male,907,124,105,20,0,0,0,20,0
1336495,63,17,1950,8,female,490,122,102,20,82,0,21,20,61
1661201,18,8,1995,1,male,165,124,39,20,20,8,6,12,14
1005070,19,15,1994,1,male,266,123,65,20,11,20,9,0,2
1986156,23,8,1990,7,female,212,122,115,20,7,20,2,0,5
1781794,18,26,1995,2,female,239,122,77,20,15,20,11,0,4
1364588,40,18,1973,6,female,673,121,105,21,11,11,9,10,2
1591988,59,17,1954,6,female,1163,124,101,21,9,6,0,15,9
1155699,26,8,1987,4,male,615,124,83,21,2,21,2,0,0
2175641,19,6,1994,3,female,230,122,64,21,27,21,21,0,6
1477991,20,2,1993,10,male,861,121,83,21,18,21,13,0,5
1305179,23,5,1990,9,male,315,123,85,22,2,0,1,22,1
1119629,16,2,1997,8,female,96,124,86,22,3,9,1,13,2
1301377,25,10,1988,9,male,151,123,105,22,3,22,1,0,2
1785579,108,4,1905,3,female,263,121,63,22,5,22,5,0,0
1835032,25,28,1988,11,male,294,123,77,22,30,22,27,0,3
1460351,19,23,1994,3,male,460,121,81,22,46,22,39,0,7
1049677,62,4,1951,5,male,1341,122,69,22,45,22,40,0,5
1990799,42,2,1971,10,female,105,124,80,23,24,23,17,0,7
1939601,28,16,1985,4,male,261,123,85,23,57,23,44,0,13
1315750,24,25,1989,3,female,322,124,63,24,47,0,22,24,25
1987528,39,30,1974,7,male,578,122,78,24,49,0,38,24,11
1303673,23,7,1990,11,male,48,122,104,24,102,11,56,13,46
1660241,22,26,1991,7,female,85,121,45,24,13,24,9,0,4
1720923,20,15,1993,1,male,335,121,93,24,15,24,12,0,3
1781176,25,5,1988,9,female,290,123,92,24,16,24,16,0,0
1053032,22,29,1991,10,male,177,123,98,24,93,24,86,0,7
1919662,28,7,1985,6,male,200,124,105,24,48,24,34,0,14
1515335,57,12,1956,2,male,1742,122,72,25,15,1,10,24,5
1546755,37,7,1976,11,male,110,124,99,25,4,25,1,0,3
1744906,55,7,1958,4,female,542,122,49,26,20,0,3,26,17
1058717,15,29,1998,6,male,150,124,85,26,8,26,8,0,0
2139027,26,11,1987,7,female,222,121,87,26,14,26,11,0,3
1609829,48,23,1965,3,male,485,121,78,26,41,26,28,0,13
1357758,23,6,1990,9,male,1254,121,71,27,3,0,1,27,2
1542473,66,21,1947,11,male,1884,123,66,27,5,0,2,27,3
2157183,38,13,1975,6,male,639,121,38,27,65,16,25,11,40
1102882,21,25,1992,10,male,288,124,91,27,26,25,17,2,9
2061922,83,1,1930,4,male,1891,124,73,27,25,22,13,5,12
1200328,25,16,1988,12,male,529,124,72,27,1,27,1,0,0
1799568,26,1,1987,5,male,150,122,77,27,1,27,1,0,0
2008419,58,8,1955,8,male,1398,122,68,28,2,0,1,28,1
1651630,36,3,1977,5,female,376,122,101,28,142,0,53,28,89
1397587,56,23,1957,12,male,170,121,83,28,59,0,13,28,46
1200863,19,15,1994,7,female,501,123,52,28,3,28,2,0,1
1096653,20,10,1993,1,female,787,122,69,28,5,28,5,0,0
2098263,18,16,1995,2,male,120,121,74,29,7,15,3,14,4
1716318,57,28,1956,5,male,290,124,94,29,11,29,7,0,4
1388536,22,6,1991,11,male,124,123,114,29,29,29,28,0,1
1633354,68,23,1945,3,male,1552,123,65,29,38,29,29,0,9
1631459,22,1,1991,8,male,66,121,92,29,48,29,27,0,21
2057827,25,7,1988,1,male,224,121,54,31,0,0,0,31,0
2079099,25,22,1988,6,male,414,124,64,31,14,23,2,8,12
2094589,33,7,1980,1,male,490,121,81,30,34,24,25,6,9
1561880,35,8,1978,9,male,384,123,87,30,19,26,14,4,5
1196272,27,20,1986,11,female,327,123,91,30,23,30,22,0,1
1844680,100,27,1913,1,male,1817,124,71,30,69,30,62,0,7
1060225,14,6,1999,10,female,300,124,103,32,28,32,17,0,11
1059313,32,20,1981,5,male,185,121,49,33,210,12,137,21,73
2152404,21,10,1992,12,female,422,121,94,33,161,33,100,0,61
1849584,17,14,1996,8,male,453,124,94,34,0,0,0,34,0
2166694,22,24,1991,11,male,1114,121,52,34,35,33,31,1,4
1983315,27,1,1986,1,male,476,123,112,34,26,34,13,0,13
2174290,27,21,1986,4,female,245,122,67,34,22,34,22,0,0
1380050,29,3,1984,4,female,229,121,93,34,22,34,5,0,17
1802117,29,20,1984,11,male,512,121,90,35,33,21,32,14,1
1071388,20,8,1993,11,female,263,122,86,36,76,25,31,11,45
2127081,23,15,1990,6,male,558,124,92,36,188,14,40,22,148
2022218,36,23,1977,4,male,151,122,90,36,10,36,10,0,0
1903493,30,15,1983,4,male,987,124,67,35,32,35,17,0,15
1684982,38,6,1975,12,female,72,123,37,37,68,25,47,12,21
1291530,18,1,1995,2,male,37,122,120,37,6,37,4,0,2
1836021,20,13,1993,10,female,36,124,123,37,1,37,1,0,0
1086607,22,30,1991,11,male,142,124,112,37,20,37,20,0,0
1119055,13,24,2000,5,male,64,123,112,37,43,37,40,0,3
1024080,17,25,1996,6,male,28,121,115,37,44,37,24,0,20
1010082,67,2,1946,3,female,1561,123,57,37,39,37,22,0,17
1057077,33,23,1980,2,female,647,124,62,38,23,7,15,31,8
1603649,103,2,1910,2,male,209,122,98,39,36,3,2,36,34
1579972,18,15,1995,5,male,140,122,28,38,57,35,50,3,7
1146318,38,20,1975,9,female,535,123,36,39,2,39,0,0,2
1701371,52,8,1961,3,female,1559,124,63,38,13,38,6,0,7
1759872,60,24,1953,1,male,1530,123,104,40,5,24,4,16,1
1985311,85,28,1928,2,male,2023,122,83,40,52,23,33,17,19
1359391,13,4,2000,3,male,242,122,53,40,7,39,2,1,5
2110873,22,11,1991,12,female,128,123,102,42,58,10,16,32,42
1707144,21,19,1992,11,male,87,121,20,42,144,34,51,8,93
1713951,54,2,1959,8,male,504,124,44,41,7,41,1,0,6
1964115,15,17,1998,12,male,266,123,112,42,34,42,22,0,12
1418704,26,25,1987,2,female,205,122,90,41,70,41,47,0,23
2166236,55,30,1958,4,male,1850,123,73,41,65,41,64,0,1
1802887,15,3,1998,7,female,241,121,57,43,6,3,4,40,2
2182916,64,1,1949,3,male,756,121,87,44,13,0,7,44,6
1894987,107,5,1906,1,female,556,124,54,44,34,0,0,44,34
2112500,67,5,1946,8,male,203,121,108,44,95,0,49,44,46
1389396,23,15,1990,11,male,308,123,85,43,34,22,27,21,7
1439334,31,16,1982,5,male,974,122,73,43,45,36,21,7,24
2109176,22,12,1991,4,male,29,123,108,44,52,44,49,0,3
1143449,20,16,1993,9,male,255,124,82,45,12,5,4,40,8
1466946,39,25,1974,12,female,62,122,88,45,93,45,65,0,28
2154215,15,11,1998,12,female,298,122,87,46,36,0,18,46,18
1701211,29,24,1984,3,female,1435,124,42,46,60,43,49,3,11
1843285,89,19,1924,6,male,636,123,33,47,73,35,50,12,23
2078804,15,26,1998,5,male,86,123,90,46,22,46,14,0,8
1656232,17,23,1996,5,male,149,122,113,47,58,47,49,0,9
1398559,62,5,1951,9,female,502,122,57,47,109,47,66,0,43
1230360,44,12,1969,12,male,908,123,49,48,18,4,1,44,17
1672946,56,1,1957,10,female,778,123,101,48,83,0,19,48,64
1838303,50,3,1963,10,female,358,121,95,48,44,14,11,34,33
1765117,15,18,1998,4,male,181,121,98,48,15,48,11,0,4
2177708,23,17,1990,6,male,256,124,14,51,0,0,0,51,0
1982924,51,25,1962,12,male,405,121,77,50,41,0,15,50,26
1082445,69,5,1944,3,female,433,121,59,51,72,0,42,51,30
1175323,61,11,1952,9,male,819,124,84,50,23,32,11,18,12
2192341,14,4,1999,6,female,198,123,61,50,100,45,52,5,48
1104900,32,6,1981,4,female,496,122,92,51,0,51,0,0,0
1970026,29,24,1984,1,male,1231,121,62,51,12,51,10,0,2
1494507,19,27,1994,11,male,431,123,85,52,4,36,0,16,4
1195088,20,18,1993,1,female,399,124,61,53,59,31,37,22,22
1219537,64,14,1949,8,female,1681,121,91,53,44,11,9,42,35
1197101,30,5,1983,7,male,540,121,113,52,144,14,29,38,115
1529352,25,1,1988,8,male,967,124,46,52,15,50,6,2,9
1087684,22,19,1991,3,female,509,122,57,52,34,51,30,1,4
2076521,25,30,1988,10,male,14,124,123,52,6,52,6,0,0
1443352,25,26,1988,10,male,228,123,98,53,24,53,6,0,18
1397462,36,6,1977,6,male,460,122,71,53,65,53,49,0,16
1357683,60,17,1953,1,female,2304,123,50,53,41,53,36,0,5
1625529,27,4,1986,5,female,121,124,93,52,229,52,141,0,88
1344708,18,10,1995,1,male,262,122,110,54,0,0,0,54,0
1553527,20,7,1993,8,male,273,121,83,55,11,55,10,0,1
1637790,26,18,1987,3,male,318,121,63,54,9,54,9,0,0
1508867,33,16,1980,8,male,28,123,118,55,10,55,10,0,0
2111035,38,16,1975,3,male,1183,124,51,55,75,55,47,0,28
1606383,64,20,1949,1,female,1026,124,91,58,15,0,12,58,3
1003011,94,1,1919,1,male,1793,122,82,57,40,31,21,26,19
2163457,57,12,1956,2,male,1063,123,69,57,94,36,68,21,26
1875289,34,3,1979,6,female,869,123,96,56,58,47,36,9,22
1599362,60,2,1953,4,female,602,121,81,56,25,56,10,0,15
1901965,44,14,1969,12,male,318,122,97,56,46,56,30,0,16
1944053,49,29,1964,2,male,178,121,87,56,111,56,64,0,47
1285092,19,4,1994,1,male,267,124,65,59,16,43,14,16,2
1937996,13,30,2000,1,male,8,123,106,59,55,59,26,0,29
1163000,30,31,1983,7,female,268,123,87,59,89,59,55,0,34
2076534,49,4,1964,12,male,1698,124,63,60,181,60,126,0,55
1066809,14,10,1999,5,female,100,124,66,61,11,2,0,59,11
1050481,22,4,1991,4,female,302,124,72,62,61,43,26,19,35
1133550,42,4,1971,12,female,361,124,102,62,83,56,44,6,39
1681805,18,1,1995,9,male,430,122,78,63,0,63,0,0,0
1179066,22,16,1991,9,male,126,123,102,62,23,62,18,0,5
1396396,65,15,1948,4,female,624,122,75,61,14,61,7,0,7
1013941,24,1,1989,9,female,571,121,72,61,46,61,36,0,10
1303116,58,29,1955,12,male,351,123,101,65,64,0,48,65,16
1379831,53,23,1960,1,female,497,121,81,64,62,13,14,51,48
1728753,25,10,1988,4,female,57,121,116,65,112,41,53,24,59
1214514,29,6,1984,12,male,1892,122,49,64,24,52,9,12,15
1054621,65,2,1948,11,male,1560,122,48,68,75,37,19,31,56
1916442,34,14,1979,6,male,237,123,81,67,4,67,3,0,1
1151580,36,2,1977,10,male,285,121,87,70,91,18,78,52,13
2151421,58,2,1955,7,male,1517,122,97,71,57,46,19,25,38
1430180,21,11,1992,9,male,912,124,114,70,1487,22,1362,48,125
1632434,60,29,1953,6,female,1749,121,73,71,123,41,70,30,53
1011564,22,13,1991,10,male,467,123,71,70,95,69,61,1,34
1754329,35,5,1978,10,male,139,122,106,71,92,71,57,0,35
1028893,52,18,1961,6,male,390,124,26,71,53,71,45,0,8
1890765,64,21,1949,5,male,271,123,23,71,677,71,521,0,156
1007664,67,15,1946,12,male,414,123,84,72,159,0,11,72,148
1306109,30,20,1983,11,female,485,124,99,74,157,53,108,21,49
1883850,16,9,1997,3,female,461,121,49,72,2,71,2,1,0
2178362,64,26,1949,12,female,1377,121,87,76,12,0,8,76,4
1757788,59,5,1954,7,female,1482,121,40,75,119,34,62,41,57
1606705,50,27,1963,1,male,1738,124,45,76,80,65,71,11,9
2007082,46,28,1967,9,male,545,122,84,76,30,76,28,0,2
1703077,57,15,1956,1,male,252,124,54,79,5,0,2,79,3
1315727,54,24,1959,9,female,360,121,111,78,72,0,18,78,54
1429076,73,5,1940,10,female,1969,124,74,78,138,22,82,56,56
1951969,53,24,1960,6,female,1987,122,54,80,37,78,27,2,10
1931277,55,27,1958,12,male,311,121,106,80,45,72,23,8,22
1948627,21,22,1992,3,female,113,123,97,80,85,67,58,13,27
1437566,17,26,1996,4,male,494,124,58,78,38,78,36,0,2
1694003,19,22,1994,10,female,278,121,100,78,42,78,37,0,5
1322556,23,8,1990,9,female,265,122,79,80,36,80,35,0,1
1941001,26,23,1987,3,female,522,123,67,80,78,80,62,0,16
1010230,25,27,1988,6,female,170,124,94,78,150,78,78,0,72
2019245,54,13,1959,1,female,1734,121,40,84,70,31,48,53,22
1230695,22,9,1991,8,male,559,124,66,83,20,83,14,0,6
1706179,23,15,1990,8,female,465,123,29,84,121,84,118,0,3
1588594,21,8,1992,11,female,526,122,96,87,33,61,21,26,12
1259759,30,24,1983,7,female,801,123,69,86,18,84,13,2,5
1663386,22,18,1991,10,female,218,121,37,85,59,84,43,1,16
1738373,22,7,1991,8,female,383,124,56,87,80,87,75,0,5
1925446,28,23,1985,10,male,574,122,83,87,81,87,79,0,2
1521096,25,10,1988,3,male,370,122,73,88,43,0,24,88,19
1980963,51,19,1962,1,male,519,123,107,90,34,0,4,90,30
1459373,45,24,1968,2,female,629,122,58,88,121,0,42,88,79
1249810,56,25,1957,1,female,437,123,114,91,59,0,4,91,55
1822081,23,3,1990,2,male,108,123,87,91,123,30,27,61,96
1851645,19,24,1994,11,female,290,122,43,88,117,84,81,4,36
1941751,55,1,1958,5,female,278,123,113,91,66,74,34,17,32
1759036,17,22,1996,7,male,615,124,106,89,144,83,107,6,37
1659780,23,4,1990,3,male,410,124,100,88,1,88,1,0,0
2092251,24,10,1989,10,male,779,122,85,90,103,90,36,0,67
1285087,19,13,1994,1,male,318,124,39,92,12,15,6,77,6
1810383,51,5,1962,5,female,1285,122,64,94,53,0,36,94,17
1961204,57,18,1956,5,male,154,122,121,94,71,4,27,90,44
1018786,20,1,1993,2,male,449,123,60,95,44,94,23,1,21
2018080,108,10,1905,10,female,140,122,58,95,137,80,85,15,52
1212368,42,18,1971,3,male,178,121,104,97,33,89,25,8,8
1220613,28,21,1985,12,female,618,122,62,98,75,98,35,0,40
1645991,47,21,1966,7,female,499,122,48,101,166,8,26,93,140
1800221,66,26,1947,12,male,721,121,66,104,118,40,38,64,80
2013060,17,20,1996,12,male,239,124,101,102,5,98,4,4,1
1045183,21,11,1992,11,male,168,122,77,107,117,33,64,74,53
1137336,17,20,1996,3,male,480,122,101,105,24,76,23,29,1
2155756,15,2,1998,8,male,343,122,39,106,67,87,16,19,51
1502830,35,4,1978,1,male,266,124,100,109,9,109,7,0,2
1123806,18,25,1995,5,male,166,122,44,109,108,109,57,0,51
1456856,26,28,1987,6,female,621,124,95,108,104,108,66,0,38
1859439,60,6,1953,1,female,1009,123,65,108,114,108,73,0,41
1567648,27,17,1986,2,male,765,121,86,110,96,56,51,54,45
1379084,54,10,1959,3,female,2010,123,48,112,172,45,138,67,34
1553596,50,27,1963,4,male,546,122,48,112,124,87,57,25,67
2171680,15,17,1998,1,female,172,123,91,111,191,104,122,7,69
2144893,32,1,1981,1,male,302,122,109,113,18,113,8,0,10
1045261,30,15,1983,11,female,321,124,75,110,51,110,41,0,10
1595596,47,30,1966,4,female,1283,122,55,111,41,111,34,0,7
2011319,40,28,1973,10,female,369,123,97,115,157,11,73,104,84
1826231,66,28,1947,11,male,973,121,71,114,137,0,65,114,72
1438725,35,15,1978,10,male,526,124,60,119,63,51,45,68,18
1024649,20,10,1993,7,female,295,124,83,114,7,112,5,2,2
1365313,22,3,1991,5,female,139,122,109,116,222,96,109,20,113
1758820,23,29,1990,4,male,394,123,105,124,4,0,1,124,3
1047469,73,18,1940,3,male,1402,124,28,120,1,6,1,114,0
1986883,47,6,1966,12,female,737,123,70,123,79,60,34,63,45
2095781,100,20,1913,12,male,191,122,78,120,104,41,69,79,35
1352782,29,28,1984,9,female,476,124,85,120,144,116,90,4,54
1743336,19,5,1994,12,male,308,121,71,124,47,124,45,0,2
2152105,38,17,1975,6,female,366,122,82,122,56,122,26,0,30
2072745,64,14,1949,12,female,1784,122,96,128,112,13,59,115,53
1360321,103,2,1910,11,male,2009,121,100,126,23,58,2,68,21
1173571,29,28,1984,4,female,1070,124,50,130,112,54,32,76,80
1394578,29,8,1984,6,female,1182,121,84,128,437,118,290,10,147
1107835,20,13,1993,10,female,172,121,46,126,58,126,45,0,13
2100775,24,6,1989,10,female,762,121,73,130,79,130,74,0,5
1542565,108,3,1905,1,male,880,122,48,129,43,129,27,0,16
2164119,24,6,1989,6,male,562,122,66,136,182,64,108,72,74
1147210,19,3,1994,12,female,575,122,54,133,153,130,68,3,85
1342616,17,15,1996,12,male,228,122,102,133,2,133,2,0,0
1874538,23,10,1990,1,male,526,124,110,134,0,134,0,0,0
1951686,37,30,1976,6,male,243,124,82,131,70,131,31,0,39
2118548,67,17,1946,10,female,131,122,112,134,119,134,100,0,19
2081649,18,26,1995,8,male,225,121,59,142,6,60,4,82,2
2189651,69,25,1944,7,male,1699,124,56,139,1,52,0,87,1
1495806,68,17,1945,10,female,1544,122,78,143,73,75,30,68,43
1203552,53,12,1960,10,female,316,124,75,140,125,38,77,102,48
1113260,68,27,1945,8,female,1496,124,73,140,121,46,51,94,70
1114816,52,3,1961,7,female,352,123,38,143,25,128,7,15,18
2150553,23,22,1990,5,female,565,121,66,139,147,107,50,32,97
2105286,14,7,1999,12,female,593,121,105,142,65,141,10,1,55
1392206,39,6,1974,6,male,329,121,66,141,71,141,61,0,10
1092262,56,21,1957,9,female,170,121,92,148,58,0,26,148,32
1855247,66,25,1947,1,male,780,121,58,148,25,2,7,146,18
1947303,20,22,1993,4,male,537,124,77,150,21,150,9,0,12
1509086,23,6,1990,4,male,398,122,63,146,3,146,3,0,0
1204037,20,1,1993,1,male,230,124,23,148,83,148,56,0,27
1495342,26,18,1987,7,female,144,122,105,149,75,149,59,0,16
1093500,46,10,1967,7,male,524,124,85,151,12,30,2,121,10
2147120,27,10,1986,7,male,411,121,35,155,72,113,35,42,37
2180472,19,9,1994,5,female,1008,121,76,153,152,112,56,41,96
1919334,30,25,1983,3,male,741,124,59,154,33,154,31,0,2
1924273,38,7,1975,11,male,310,121,98,161,3,0,3,161,0
1473923,60,23,1953,11,female,1580,121,71,162,55,0,16,162,39
1962306,61,17,1952,2,female,1474,121,57,161,225,119,84,42,141
1250756,100,8,1913,9,male,1194,123,53,161,12,160,11,1,1
1198051,23,29,1990,3,male,304,124,83,160,33,160,22,0,11
2105336,57,8,1956,5,female,861,121,71,162,93,162,72,0,21
1702899,25,1,1988,4,male,53,123,68,172,123,0,45,172,78
1249239,22,13,1991,5,female,491,124,94,169,15,161,6,8,9
1345739,26,1,1987,1,male,344,121,99,167,69,167,24,0,45
1956963,26,15,1987,4,female,289,122,29,167,351,167,237,0,114
2155658,69,10,1944,3,female,913,123,35,176,55,0,19,176,36
2000936,63,27,1950,9,male,1754,121,54,178,220,8,104,170,116
1302768,19,12,1994,7,male,109,122,114,179,37,128,24,51,13
1232315,57,22,1956,4,female,1126,122,53,179,472,40,248,139,224
2008558,52,1,1961,1,male,746,122,71,177,72,138,26,39,46
2080786,24,7,1989,11,female,422,121,53,176,173,176,157,0,16
1297334,113,1,1900,1,female,1144,124,43,188,14,0,1,188,13
2025698,21,13,1992,3,female,377,123,62,189,47,18,26,171,21
1815174,28,6,1985,2,male,558,122,56,190,172,128,99,62,73
2158328,53,14,1960,7,female,1760,124,52,184,181,162,117,22,64
1772474,34,19,1979,2,male,77,124,103,185,22,185,22,0,0
1182332,46,22,1967,9,female,1158,123,43,190,193,190,128,0,65
1833332,66,15,1947,4,male,1269,122,48,194,115,0,38,194,77
1400514,28,10,1985,4,female,311,122,63,196,189,127,98,69,91
1712648,30,26,1983,2,male,516,123,72,193,111,176,106,17,5
1259142,33,11,1980,11,male,835,121,52,194,35,179,18,15,17
1954724,62,5,1951,4,male,1085,122,64,197,86,177,64,20,22
1370069,48,15,1965,3,female,181,123,95,195,174,147,128,48,46
1390760,55,9,1958,1,female,1503,122,51,194,132,194,102,0,30
1269137,49,28,1964,3,female,625,124,49,204,122,4,71,200,51
1291456,21,16,1992,10,male,306,124,64,209,152,131,94,78,58
2073830,15,16,1998,2,male,188,124,95,201,324,41,154,160,170
1022836,108,4,1905,7,female,280,122,55,203,173,169,134,34,39
1817393,19,13,1994,12,female,344,124,58,202,0,202,0,0,0
2117353,52,23,1961,9,female,972,123,41,209,12,209,12,0,0
1319784,33,12,1980,9,male,380,123,89,209,62,209,48,0,14
1455574,51,28,1962,5,male,828,123,9,215,141,40,91,175,50
1780497,28,18,1985,11,male,506,124,58,217,34,217,32,0,2
1108182,57,20,1956,11,male,485,123,79,229,23,4,6,225,17
1041169,22,1,1991,1,male,395,121,47,222,32,48,15,174,17
1653869,57,13,1956,9,female,1636,121,54,227,76,213,59,14,17
1730795,31,8,1982,2,female,436,123,57,231,174,225,85,6,89
2052695,50,13,1963,9,male,398,121,81,230,53,230,13,0,40
1394652,42,20,1971,12,female,242,121,33,230,307,230,193,0,114
1751895,18,1,1995,1,female,330,124,33,222,786,222,473,0,313
1140354,59,1,1954,5,male,428,122,99,236,167,0,82,236,85
1856294,64,22,1949,5,female,1776,121,96,245,159,14,73,231,86
1852889,19,29,1994,11,female,303,121,75,242,81,242,78,0,3
1007233,27,15,1986,10,female,569,122,78,236,270,236,203,0,67
2080116,47,21,1966,6,female,297,123,39,242,209,242,183,0,26
1905510,28,7,1985,1,female,1365,124,56,250,538,18,276,232,262
2178526,55,4,1958,9,female,1811,122,68,254,118,229,85,25,33
1764885,27,4,1986,1,male,174,123,33,259,51,259,34,0,17
1582824,36,16,1977,11,female,583,123,111,255,143,255,114,0,29
1970977,63,23,1950,6,female,2137,124,68,272,167,254,104,18,63
1578230,26,1,1987,1,male,136,121,101,273,37,273,24,0,13
1760472,31,26,1982,7,female,613,124,95,262,690,262,620,0,70
1398063,102,1,1911,1,female,2360,121,115,277,247,78,138,199,109
1072604,21,16,1992,7,female,286,124,96,292,194,250,119,42,75
1083557,70,9,1943,4,female,379,121,99,282,50,282,39,0,11
1340548,31,2,1982,5,female,785,121,24,293,88,289,65,4,23
1600895,24,27,1989,8,male,221,124,104,294,12,294,8,0,4
1293073,23,8,1990,3,female,358,123,68,306,166,306,59,0,107
1945626,49,4,1964,1,female,572,122,108,302,88,302,78,0,10
2165485,62,28,1951,6,male,594,122,102,326,69,326,33,0,36
1623825,18,17,1995,9,female,154,123,60,312,242,312,120,0,122
1933594,37,18,1976,1,male,516,121,102,318,266,318,221,0,45
1866362,43,30,1970,3,female,83,121,79,343,84,0,6,343,78
2106818,19,24,1994,6,male,348,121,84,329,314,327,199,2,115
1785170,77,26,1936,6,female,443,122,46,368,562,0,52,368,510
2180881,19,21,1994,7,female,2020,123,75,350,291,206,98,144,193
1610392,27,17,1986,10,female,416,121,71,349,224,135,131,214,93
1350232,38,16,1975,7,female,506,122,60,369,259,81,87,288,172
2096747,49,23,1964,11,female,353,121,72,375,215,0,112,375,103
1602914,50,4,1963,4,male,141,121,68,384,138,0,38,384,100
1227457,26,3,1987,6,female,292,123,99,372,86,293,44,79,42
1574823,72,23,1941,3,female,1606,121,72,373,220,363,149,10,71
2137536,51,1,1962,9,female,505,121,102,378,249,378,207,0,42
1254527,56,9,1957,9,female,2267,121,51,373,374,373,325,0,49
1629104,73,18,1940,11,female,644,122,55,376,432,376,267,0,165
1839989,54,24,1959,12,female,484,121,76,400,41,0,4,400,37
1295483,92,5,1921,10,female,1929,123,30,398,189,284,130,114,59
1538515,60,6,1953,4,female,847,122,85,404,10,398,5,6,5
1006264,27,10,1986,1,female,68,122,58,403,510,403,385,0,125
2094131,101,24,1912,9,male,363,124,110,438,1,28,1,410,0
1661874,26,17,1987,4,male,194,123,33,435,58,435,54,0,4
1281917,19,2,1994,12,female,427,123,93,448,345,448,95,0,250
1431149,55,3,1958,3,female,1116,121,70,422,616,422,430,0,186
1942951,64,11,1949,7,male,824,123,98,454,16,452,14,2,2
1822309,25,22,1988,1,male,653,122,83,473,212,473,184,0,28
1564056,30,19,1983,12,male,337,121,82,471,90,471,56,0,34
2106820,43,8,1970,8,female,406,121,68,463,341,463,274,0,67
2104769,39,11,1974,2,female,35,123,117,490,469,70,160,420,309
1403074,21,23,1992,12,female,427,124,72,484,81,474,56,10,25
1860427,64,16,1949,4,male,507,123,81,513,96,485,60,28,36
2009947,35,12,1978,2,female,1046,124,41,519,589,511,460,8,129
2161615,64,13,1949,8,female,2138,122,76,486,686,440,440,46,246
1432030,44,9,1969,6,female,976,124,58,489,67,489,47,0,20
1807908,37,18,1976,9,female,658,122,80,539,343,306,238,233,105
1015051,29,11,1984,11,female,403,121,86,531,469,522,427,9,42
2080233,68,6,1945,5,female,829,121,13,557,640,524,536,33,104
2092636,14,14,1999,4,female,223,121,31,540,37,536,35,4,2
1002235,47,20,1966,7,female,331,124,80,548,94,548,14,0,80
1380538,46,5,1967,1,female,287,124,82,520,486,520,323,0,163
1459386,37,25,1976,3,female,545,123,35,608,202,411,102,197,100
1716155,18,20,1995,2,male,212,122,76,646,667,93,229,553,438
1716331,62,25,1951,11,female,1779,124,71,661,352,456,140,205,212
1473367,31,30,1982,5,female,355,123,101,635,1120,463,801,172,319
1234304,14,9,1999,3,male,66,121,56,666,9,153,3,513,6
1517557,31,5,1982,6,female,302,121,82,697,139,194,32,503,107
1303182,50,23,1963,1,female,824,121,97,664,121,329,57,335,64
1959873,60,2,1953,4,female,949,122,84,726,506,318,291,408,215
2068421,15,9,1998,10,female,379,123,84,698,97,663,69,35,28
1496841,34,30,1979,6,female,140,124,98,699,862,570,564,129,298
1163711,25,10,1988,10,male,341,124,48,684,520,684,422,0,98
1231961,47,26,1966,6,female,418,124,32,771,241,0,79,771,162
1124623,50,3,1963,3,male,883,122,73,855,260,855,187,0,73
1570402,47,28,1966,7,male,580,122,82,868,561,868,290,0,271
1474627,27,31,1986,5,male,345,123,45,917,132,0,91,917,41
1354624,59,16,1954,2,female,1306,121,67,898,35,95,28,803,7
1599785,40,3,1973,5,male,163,121,28,932,415,837,140,95,275
1252631,19,1,1994,5,female,946,121,61,979,852,798,160,181,692
1461998,59,15,1954,5,female,1811,124,42,985,132,981,94,4,38
1368496,18,10,1995,3,female,652,121,51,902,29,902,26,0,3
1817725,43,10,1970,12,female,1174,123,89,946,464,946,373,0,91
2179710,61,3,1952,10,female,1264,122,30,981,308,981,211,0,97
1672347,13,21,2000,1,female,101,124,92,1129,240,1129,145,0,95
1780840,66,13,1947,3,female,535,124,50,1134,146,0,104,1134,42
1274751,103,1,1910,1,female,996,123,45,1213,373,715,232,498,141
1838445,43,9,1970,5,female,488,122,77,1132,172,1130,109,2,63
2149012,58,2,1955,4,female,610,123,89,1416,202,0,89,1416,113
1234086,44,2,1969,2,female,301,122,67,1457,1074,27,392,1430,682
1841604,67,18,1946,12,female,1787,124,81,1338,409,664,102,674,307
1311881,37,5,1976,8,female,204,123,111,1364,599,1315,239,49,360
1021018,47,25,1966,1,male,414,124,89,1301,913,1300,256,1,657
1929301,91,11,1922,10,male,92,122,80,1466,17,1466,5,0,12
1046367,37,12,1976,12,male,196,123,52,1316,273,1316,56,0,217
2163423,19,6,1994,6,female,65,122,71,1603,266,1226,115,377,151
1498441,25,27,1988,4,female,932,121,91,1768,332,1768,301,0,31
1990195,68,17,1945,8,male,37,123,101,1732,334,1732,324,0,10
1179482,47,5,1966,9,female,200,122,29,1886,189,1863,52,23,137
1650798,46,13,1967,9,male,935,123,50,1900,639,1855,516,45,123
2004993,69,19,1944,12,female,513,121,104,2235,163,2233,52,2,111
2035950,50,6,1963,4,male,586,122,58,2032,158,2032,114,0,44
1521451,57,10,1956,10,female,231,123,98,3326,2453,0,98,3326,2355
2022275,21,3,1992,11,male,361,122,81,2697,1234,2676,480,21,754
1150195,28,17,1985,8,male,284,121,76,2846,550,2846,123,0,427
1346628,33,25,1980,12,male,104,124,89,2505,691,2505,625,0,66
1409983,47,8,1966,10,female,4,123,61,3331,1200,3331,468,0,732
1355065,54,12,1959,4,female,1115,124,16,3322,1633,3322,1528,0,105
1134356,42,1,1971,5,female,243,123,69,6951,7782,1168,2396,5783,5386
1514364,13,17,2000,4,male,165,129,74,4,28,4,15,0,13
1773673,21,25,1992,1,male,497,128,91,4,180,4,143,0,37
1300910,21,8,1992,3,female,360,126,29,4,6,4,5,0,1
1076599,22,21,1991,9,male,584,127,81,4,9,4,9,0,0
1274920,24,27,1989,4,male,483,129,107,4,8,4,6,0,2
1942326,25,19,1988,1,female,1008,126,55,4,8,4,8,0,0
1426125,26,22,1987,8,male,135,127,91,4,12,4,11,0,1
1989460,31,22,1982,11,male,1362,128,115,4,22,4,22,0,0
1249339,32,12,1981,1,male,134,128,65,4,7,4,3,0,4
1754909,32,28,1981,3,male,539,125,85,4,6,4,6,0,0
2055768,58,2,1955,2,female,1692,126,34,4,20,4,6,0,14
2072616,66,3,1947,5,female,507,126,59,5,0,0,0,5,0
2098376,20,26,1993,6,male,363,129,106,5,1,0,1,5,0
1020917,103,30,1910,12,female,1431,127,67,5,1,0,0,5,1
1728137,40,12,1973,3,male,208,128,67,5,10,0,1,5,9
1456288,17,19,1996,8,male,476,127,87,5,1,1,0,4,1
1237615,18,11,1995,1,male,217,128,81,5,0,5,0,0,0
1010783,32,23,1981,3,male,523,128,117,5,0,5,0,0,0
1566606,103,9,1910,5,male,515,128,95,5,0,5,0,0,0
1503676,17,1,1996,2,male,190,126,93,5,1,5,1,0,0
1911518,30,28,1983,2,female,701,127,25,5,1,5,1,0,0
1242952,47,14,1966,9,male,109,127,122,5,1,5,1,0,0
2095470,20,25,1993,11,female,240,126,37,5,7,5,5,0,2
1067015,28,15,1985,4,male,182,127,110,5,4,5,4,0,0
2179184,29,15,1984,10,male,608,125,82,5,6,5,5,0,1
1023519,21,2,1992,2,male,184,125,112,5,32,5,26,0,6
1978860,23,2,1990,8,male,187,126,118,5,11,5,7,0,4
2189143,29,4,1984,5,male,670,128,44,5,190,5,154,0,36
1847757,36,16,1977,4,male,577,125,97,5,9,5,2,0,7
1392820,51,21,1962,11,male,2008,127,72,5,367,5,236,0,131
1563119,14,1,1999,1,male,397,127,93,6,8,0,0,6,8
1679477,21,21,1992,3,male,340,126,106,6,19,0,1,6,18
1628685,35,26,1978,11,male,280,127,94,6,198,0,1,6,197
1631860,58,1,1955,1,male,1096,127,74,6,23,0,5,6,18
1913379,108,28,1905,10,male,2120,126,39,6,31,1,23,5,8
1281190,28,9,1985,11,male,776,127,41,6,0,3,0,3,0
1332207,19,3,1994,3,male,668,127,66,6,22,3,15,3,7
2012711,85,20,1928,9,female,1371,126,12,6,9,4,9,2,0
1539553,17,19,1996,6,male,35,126,114,6,3,6,3,0,0
1139130,25,23,1988,4,male,66,126,111,6,3,6,2,0,1
1370380,27,22,1986,8,female,498,126,68,6,2,6,2,0,0
1467272,33,24,1980,4,male,565,126,91,6,1,6,1,0,0
1899542,61,15,1952,11,female,1131,125,55,6,6,6,3,0,3
1857325,24,23,1989,1,male,607,125,74,6,45,6,36,0,9
1357118,25,1,1988,1,male,27,126,104,6,14,6,5,0,9
1521609,27,14,1986,6,female,257,129,100,6,17,6,17,0,0
1282526,28,20,1985,6,female,753,127,60,6,14,6,12,0,2
1424612,52,26,1961,10,female,332,126,106,6,15,6,15,0,0
2077770,108,10,1905,10,female,327,126,59,6,94,6,41,0,53
2157152,17,15,1996,8,male,310,125,93,7,1,0,0,7,1
2093276,19,26,1994,3,male,444,128,83,7,0,0,0,7,0
2066108,24,25,1989,10,male,426,126,116,7,1,0,0,7,1
1183406,49,15,1964,5,male,855,125,51,7,0,0,0,7,0
2142052,113,1,1900,1,female,1356,125,68,7,1,0,0,7,1
1875081,108,23,1905,4,male,511,126,56,7,4,0,0,7,4
1296219,33,8,1980,10,female,362,129,111,7,41,1,32,6,9
1164486,24,11,1989,4,male,560,129,116,7,2,5,2,2,0
1221242,54,26,1959,2,male,1783,125,94,7,25,3,12,4,13
1276328,17,20,1996,12,female,110,125,73,7,0,7,0,0,0
1925436,19,17,1994,2,male,648,126,89,7,1,7,1,0,0
1616200,21,15,1992,7,male,603,127,106,7,0,7,0,0,0
1902431,21,1,1992,1,male,281,127,115,7,2,7,2,0,0
1946426,18,19,1995,5,male,280,125,64,7,253,7,175,0,78
1196743,19,20,1994,6,male,57,126,123,7,12,7,6,0,6
1976960,20,21,1993,5,female,257,126,21,7,12,7,10,0,2
1624052,24,12,1989,4,male,350,126,96,7,37,7,17,0,20
1152498,38,23,1975,11,female,211,125,106,7,17,7,12,0,5
2134105,23,6,1990,9,male,467,128,106,8,3,0,1,8,2
1063583,37,5,1976,7,male,290,125,61,8,2,0,0,8,2
1505542,20,16,1993,8,female,373,127,123,8,5,0,1,8,4
1512323,108,14,1905,5,male,1517,127,73,8,21,0,8,8,13
1666192,24,18,1989,12,male,762,125,79,8,2,3,0,5,2
2127301,31,14,1982,2,male,440,128,122,8,3,6,1,2,2
1260184,17,25,1996,6,male,51,127,115,8,1,8,1,0,0
2167171,20,31,1993,5,male,501,128,80,8,0,8,0,0,0
1244261,49,5,1964,5,female,240,126,35,8,1,8,1,0,0
1728674,18,9,1995,4,male,50,126,109,8,8,8,7,0,1
1794380,40,13,1973,2,female,538,126,99,8,7,8,5,0,2
1734177,22,30,1991,10,male,372,126,92,8,19,8,17,0,2
2083416,28,25,1985,3,male,664,126,92,8,53,8,31,0,22
1383568,39,5,1974,3,male,318,129,26,8,39,8,39,0,0
1528251,49,20,1964,5,male,703,129,83,9,0,0,0,9,0
1378561,65,11,1948,4,female,1547,125,39,9,5,1,2,8,3
2020052,31,14,1982,5,male,665,129,50,9,6,0,0,9,6
1048092,24,4,1989,3,male,619,125,63,9,17,0,11,9,6
1181752,37,10,1976,6,male,157,126,120,9,24,0,17,9,7
1303874,18,2,1995,9,male,789,125,66,9,5,3,2,6,3
1831236,25,15,1988,4,female,315,125,40,9,2,6,1,3,1
1778467,72,4,1941,6,male,1621,128,93,9,61,3,28,6,33
1405617,17,15,1996,7,male,529,125,75,9,3,9,2,0,1
1463432,19,3,1994,6,male,270,127,50,9,2,9,0,0,2
1465338,108,1,1905,1,female,1956,126,53,9,2,9,2,0,0
2109119,24,6,1989,9,male,298,125,86,9,6,9,6,0,0
1114177,37,25,1976,4,male,242,125,61,9,12,9,12,0,0
1546372,16,24,1997,2,male,192,128,70,9,16,9,11,0,5
1743303,22,8,1991,1,male,579,129,61,9,22,9,6,0,16
1739985,35,30,1978,8,male,654,126,103,9,19,9,5,0,14
1948918,37,4,1976,2,male,508,128,61,9,19,9,13,0,6
1656559,16,8,1997,9,male,289,125,90,10,5,0,1,10,4
1574723,51,12,1962,3,female,353,128,127,10,3,0,1,10,2
1979628,48,9,1965,3,male,523,126,81,10,55,9,38,1,17
2068156,17,28,1996,8,male,140,126,120,10,1,10,1,0,0
2010417,27,13,1986,12,male,81,126,103,10,1,10,1,0,0
1320194,30,20,1983,12,male,560,128,64,10,0,10,0,0,0
1894663,28,6,1985,12,female,213,129,62,10,2,10,0,0,2
1870112,14,1,1999,1,male,141,127,111,10,14,10,13,0,1
1726081,21,17,1992,4,male,549,127,110,10,8,10,8,0,0
1019546,40,26,1973,10,female,290,127,108,10,90,10,28,0,62
1115475,59,26,1954,11,female,1213,127,47,10,93,10,69,0,24
1658530,20,20,1993,4,male,1062,126,89,11,6,0,6,11,0
1244753,41,10,1972,3,male,654,125,78,11,30,0,17,11,13
1852680,25,22,1988,5,male,942,129,74,11,1,8,0,3,1
1292483,100,4,1913,1,male,487,128,111,11,13,8,12,3,1
2117438,16,14,1997,1,male,282,127,71,11,6,11,6,0,0
1182424,20,7,1993,11,male,319,129,44,11,2,11,2,0,0
2025633,23,20,1990,5,male,412,125,70,11,16,11,9,0,7
1494609,14,17,1999,7,male,107,126,55,11,52,11,36,0,16
1409704,19,2,1994,3,male,529,127,73,11,50,11,49,0,1
1728885,22,3,1991,6,male,616,129,35,11,165,11,104,0,61
1493811,13,6,2000,1,male,171,128,105,12,0,0,0,12,0
1642859,20,3,1993,10,male,36,126,11,12,1,0,0,12,1
1145373,108,10,1905,3,female,1173,128,74,12,1,1,0,11,1
1686740,60,27,1953,1,male,1502,127,47,12,2,0,0,12,2
1489121,28,3,1985,10,male,607,128,82,12,11,0,5,12,6
1485285,38,8,1975,12,male,820,125,77,12,22,0,11,12,11
1208200,65,8,1948,12,male,362,129,84,12,38,0,19,12,19
2020097,26,24,1987,4,male,1261,126,8,12,3,4,1,8,2
1000975,25,24,1988,7,male,711,129,40,12,69,4,17,8,52
2146826,24,31,1989,12,male,214,127,107,12,0,12,0,0,0
1100672,23,22,1990,2,male,686,129,54,12,0,12,0,0,0
1914140,27,17,1986,10,female,244,128,71,12,5,12,5,0,0
1849971,14,6,1999,10,male,118,128,72,12,8,12,6,0,2
1818642,16,30,1997,11,male,222,126,91,12,10,12,8,0,2
1505606,22,2,1991,12,male,192,127,92,12,15,12,6,0,9
1705062,24,25,1989,10,male,199,125,77,12,9,12,9,0,0
1535133,62,19,1951,8,female,1579,129,29,12,14,12,12,0,2
1753739,17,14,1996,9,male,27,127,78,12,20,12,18,0,2
1755619,19,11,1994,8,female,33,125,18,12,20,12,11,0,9
1336690,23,18,1990,10,male,573,127,72,13,8,3,3,10,5
2090369,25,26,1988,6,female,37,128,86,13,26,5,17,8,9
1837488,15,27,1998,7,male,18,128,28,13,0,13,0,0,0
1008713,20,18,1993,3,male,172,125,124,13,1,13,1,0,0
1551005,41,24,1972,3,female,289,127,76,13,3,13,2,0,1
2021696,28,26,1985,11,male,145,127,93,13,22,13,7,0,15
1312328,52,27,1961,10,female,1704,129,42,13,43,13,26,0,17
1278367,70,28,1943,2,female,1611,129,47,13,34,13,16,0,18
2039593,36,10,1977,1,male,1267,128,62,14,2,3,2,11,0
1611419,17,24,1996,12,male,512,129,100,14,0,14,0,0,0
2130537,20,17,1993,3,male,283,128,84,14,4,14,2,0,2
1535360,25,24,1988,9,female,524,126,36,14,44,14,44,0,0
2114817,57,11,1956,10,male,1681,128,33,15,4,9,1,6,3
1343829,18,16,1995,12,female,306,129,89,15,14,11,12,4,2
1154388,29,22,1984,8,female,644,129,80,15,7,15,5,0,2
1281539,25,23,1988,11,male,338,125,57,15,12,15,7,0,5
2137360,24,19,1989,10,female,402,129,87,15,15,15,9,0,6
1578165,24,19,1989,10,male,257,125,27,15,33,15,25,0,8
1262245,41,15,1972,5,male,73,125,36,15,174,15,23,0,151
1630804,27,3,1986,8,male,374,128,38,16,14,3,13,13,1
1918410,57,9,1956,1,male,796,125,75,16,26,0,8,16,18
2057515,37,11,1976,3,male,2122,127,56,16,11,15,8,1,3
1560012,106,23,1907,9,female,246,128,76,16,1,16,1,0,0
1427233,19,14,1994,7,male,381,129,100,16,5,16,4,0,1
1733136,56,1,1957,1,male,648,128,109,16,4,16,3,0,1
1720445,34,29,1979,9,female,448,126,94,16,13,16,9,0,4
1745069,40,28,1973,9,male,665,128,48,16,10,16,8,0,2
1011147,15,29,1998,6,female,64,129,70,16,195,16,163,0,32
1613554,77,10,1936,4,male,20,127,110,17,188,0,139,17,49
1727259,33,4,1980,11,female,280,127,85,17,2,17,2,0,0
2060814,17,13,1996,12,male,139,125,116,17,8,17,3,0,5
1965969,24,14,1989,6,male,310,126,113,17,3,17,3,0,0
1329871,30,1,1983,2,female,416,126,83,17,4,17,1,0,3
1236349,25,25,1988,3,female,138,125,98,17,17,17,10,0,7
1803719,39,12,1974,1,female,126,125,82,17,63,17,58,0,5
2050716,15,14,1998,10,female,149,126,70,18,39,0,18,18,21
1766880,38,23,1975,5,male,388,125,92,18,0,15,0,3,0
1617732,30,2,1983,4,male,1021,126,60,18,507,15,442,3,65
1638770,27,17,1986,12,male,195,126,109,18,4,18,1,0,3
1017638,22,25,1991,4,male,260,129,68,19,0,0,0,19,0
1849094,25,14,1988,9,male,330,128,77,19,26,19,19,0,7
1271120,32,30,1981,1,female,491,129,58,19,25,19,16,0,9
1869174,37,26,1976,8,male,353,129,67,20,80,0,31,20,49
1840222,19,26,1994,1,female,335,125,55,20,3,12,1,8,2
2168658,34,5,1979,5,male,224,127,113,20,3,12,0,8,3
1975318,32,7,1981,1,male,191,128,114,20,18,17,16,3,2
1212545,14,12,1999,12,male,210,126,90,20,3,20,3,0,0
2108329,54,5,1959,4,female,355,125,99,20,7,20,4,0,3
1971151,26,16,1987,6,male,267,127,59,20,38,20,34,0,4
1388980,22,25,1991,10,male,229,128,106,21,6,0,3,21,3
1774842,53,5,1960,5,female,381,125,40,21,11,2,5,19,6
1150882,113,19,1900,11,male,1476,127,40,21,15,0,2,21,13
1039245,42,28,1971,10,female,530,125,79,21,31,20,22,1,9
1399836,16,24,1997,5,female,426,125,88,21,2,21,1,0,1
2180149,34,10,1979,7,male,557,127,68,21,23,21,15,0,8
1123472,25,27,1988,4,male,927,129,52,22,70,15,46,7,24
1434231,25,6,1988,6,male,188,128,90,22,1,21,1,1,0
1561638,32,16,1981,3,female,1125,129,73,22,14,19,7,3,7
1080363,52,15,1961,6,male,760,127,62,22,56,21,35,1,21
1229037,16,2,1997,5,male,85,127,72,22,0,22,0,0,0
1429817,24,9,1989,9,male,526,125,62,22,0,22,0,0,0
1686633,56,2,1957,1,male,1250,125,33,22,25,22,7,0,18
1635704,14,3,1999,5,male,352,128,93,23,10,0,4,23,6
1949406,20,1,1993,9,male,132,125,102,23,33,16,16,7,17
1124885,26,30,1987,7,male,703,129,71,23,4,20,3,3,1
1032918,40,18,1973,9,female,669,125,100,23,5,23,5,0,0
1940598,103,17,1910,4,female,532,126,94,23,16,23,15,0,1
2112057,21,16,1992,4,female,429,127,4,23,54,23,39,0,15
2108297,21,20,1992,7,female,481,126,98,23,39,23,24,0,15
1036550,103,29,1910,7,female,301,127,73,23,55,23,35,0,20
1561776,36,1,1977,1,female,69,125,104,24,59,16,48,8,11
1635541,26,21,1987,6,male,241,126,119,24,0,21,0,3,0
1290964,19,26,1994,6,female,170,129,79,24,30,22,23,2,7
1059928,22,30,1991,12,female,444,126,91,24,23,20,9,4,14
1731200,57,30,1956,6,female,2293,129,85,24,26,23,21,1,5
1914438,20,14,1993,4,male,167,127,90,24,0,24,0,0,0
1566361,30,24,1983,7,female,381,127,98,24,0,24,0,0,0
1713494,15,23,1998,3,male,36,129,124,24,12,24,7,0,5
1800411,18,28,1995,10,male,360,127,87,24,12,24,12,0,0
1005710,70,25,1943,1,male,1334,126,39,24,5,24,3,0,2
1344972,17,22,1996,6,male,301,126,80,25,5,7,3,18,2
2173843,24,15,1989,9,male,393,128,97,25,13,25,10,0,3
2011479,22,10,1991,7,female,254,125,69,25,23,25,22,0,1
1484897,26,1,1987,1,female,281,127,90,25,83,25,50,0,33
1593311,55,8,1958,4,female,1114,129,73,25,54,25,23,0,31
1942029,38,8,1975,12,male,410,127,96,26,35,0,1,26,34
2044945,56,22,1957,10,female,287,127,92,26,38,1,10,25,28
1667041,18,2,1995,6,female,674,126,66,26,56,19,44,7,12
1629537,20,19,1993,2,male,278,129,112,26,14,26,12,0,2
2138510,31,30,1982,6,male,311,128,117,26,16,26,15,0,1
1076838,44,20,1969,5,female,1329,126,34,26,39,26,24,0,15
1199109,48,25,1965,3,male,404,125,47,27,75,0,22,27,53
2039977,15,18,1998,12,male,187,128,72,27,24,17,6,10,18
1520432,21,21,1992,1,male,650,126,88,27,2,26,0,1,2
1836506,47,25,1966,5,male,1131,125,96,27,15,25,5,2,10
2055910,34,18,1979,4,male,273,128,33,27,1,27,0,0,1
1428113,95,20,1918,5,female,978,128,42,27,0,27,0,0,0
1986529,15,9,1998,10,male,146,127,92,27,35,27,25,0,10
1774684,47,18,1966,9,male,110,129,34,27,20,27,19,0,1
1281759,85,14,1928,3,male,1527,128,35,28,5,0,0,28,5
2136822,18,20,1995,11,male,1479,126,66,28,34,12,18,16,16
2125887,19,15,1994,12,female,586,127,87,28,32,24,19,4,13
1380113,27,12,1986,3,male,398,129,97,28,18,27,15,1,3
1863531,18,24,1995,7,male,337,126,94,28,9,28,6,0,3
1089782,32,1,1981,7,male,443,126,91,28,14,28,10,0,4
1619169,20,3,1993,3,male,182,126,100,29,1,1,0,28,1
1756691,29,7,1984,1,female,433,126,69,29,4,0,0,29,4
1028846,17,25,1996,3,male,92,127,113,29,28,23,19,6,9
1451499,18,17,1995,1,male,341,126,67,29,5,29,2,0,3
1355859,25,17,1988,6,female,515,127,109,29,49,29,40,0,9
1589384,103,7,1910,6,male,916,129,64,31,29,26,20,5,9
1314412,31,3,1982,2,male,743,126,64,31,0,31,0,0,0
1282107,25,6,1988,12,male,76,127,64,31,30,31,30,0,0
1208055,33,18,1980,5,female,869,128,37,32,6,30,4,2,2
1263647,16,2,1997,4,female,190,125,58,32,21,29,8,3,13
1630558,20,15,1993,4,male,932,128,78,32,3,32,1,0,2
1834753,24,5,1989,9,male,245,125,80,32,5,32,2,0,3
1375372,30,1,1983,9,male,746,126,90,32,16,32,4,0,12
1487600,31,15,1982,7,male,571,127,39,32,38,32,37,0,1
2055284,26,24,1987,9,female,314,126,82,32,70,32,53,0,17
1469683,53,1,1960,5,male,655,129,56,32,193,32,172,0,21
1107168,63,31,1950,8,female,893,126,38,32,149,32,114,0,35
1205131,74,4,1939,7,male,463,129,98,33,12,0,5,33,7
1604691,35,26,1978,8,male,340,126,86,33,46,0,22,33,24
1127657,20,4,1993,10,male,311,127,93,33,60,9,16,24,44
1610463,37,13,1976,9,female,548,129,34,33,63,11,30,22,33
1844168,23,23,1990,7,male,428,125,83,33,7,25,3,8,4
1332266,20,5,1993,1,male,308,127,66,33,91,29,67,4,24
1682930,17,25,1996,10,male,274,127,117,33,4,33,4,0,0
1430817,26,19,1987,1,female,302,125,80,33,34,33,27,0,7
1688283,39,19,1974,12,male,1240,126,32,33,23,33,11,0,12
1064602,56,23,1957,3,female,998,125,89,33,34,33,22,0,12
1270830,50,10,1963,5,female,1280,127,19,34,23,0,2,34,21
1596307,62,30,1951,4,male,1538,127,33,34,29,29,24,5,5
2093529,37,1,1976,1,male,500,129,54,34,21,34,15,0,6
1040453,30,11,1983,5,female,583,125,46,34,58,34,56,0,2
1950416,77,23,1936,3,male,311,129,42,35,48,0,7,35,41
1654771,27,26,1986,5,female,867,127,65,36,24,13,18,23,6
1504510,16,21,1997,8,female,388,129,64,35,16,34,8,1,8
2166907,21,17,1992,10,male,116,125,74,36,86,31,60,5,26
1853936,23,18,1990,1,female,105,126,98,36,28,36,25,0,3
1821036,28,20,1985,5,female,385,126,88,36,118,36,60,0,58
1641347,16,17,1997,8,male,412,126,76,37,0,0,0,37,0
1257319,23,25,1990,10,male,349,126,104,37,4,2,3,35,1
1120987,15,9,1998,1,male,97,128,63,37,80,22,35,15,45
1501067,44,22,1969,10,male,863,125,71,37,14,37,13,0,1
1063574,56,10,1957,10,female,738,127,88,37,26,37,25,0,1
1635615,55,7,1958,10,male,989,125,37,37,150,37,115,0,35
1818374,22,11,1991,7,female,134,126,98,38,21,0,5,38,16
1871638,40,18,1973,8,female,533,125,85,39,29,0,4,39,25
1608165,25,8,1988,12,male,433,127,36,39,0,26,0,13,0
1401430,61,5,1952,11,female,1534,127,54,39,1,24,0,15,1
1787749,93,5,1920,1,female,1758,127,32,38,17,15,10,23,7
1994401,16,3,1997,2,female,129,125,23,38,48,15,18,23,30
1261148,53,8,1960,10,female,1301,128,89,38,10,35,3,3,7
1842493,23,7,1990,6,male,43,125,123,38,7,38,7,0,0
1285174,42,19,1971,11,female,461,129,78,38,82,38,63,0,19
1761338,102,18,1911,9,female,2051,129,18,40,9,0,3,40,6
2180946,19,16,1994,2,male,312,125,79,40,22,16,11,24,11
1216418,63,20,1950,3,male,458,128,61,40,32,28,11,12,21
1209804,60,29,1953,6,male,1415,126,64,40,129,14,77,26,52
1046251,38,14,1975,9,male,353,129,26,40,26,32,13,8,13
1018055,14,21,1999,3,female,528,125,64,40,2,40,2,0,0
1148453,21,5,1992,1,male,233,125,69,40,17,40,11,0,6
2078562,25,19,1988,8,male,68,129,122,42,2,1,0,41,2
1669438,56,24,1957,11,male,454,128,50,41,52,0,1,41,51
1701527,62,23,1951,7,male,1040,128,107,41,23,41,4,0,19
1904622,49,17,1964,1,male,578,125,68,42,32,42,16,0,16
1065284,100,19,1913,6,male,1590,129,51,41,26,41,9,0,17
1112676,93,23,1920,1,female,1656,127,70,43,27,0,5,43,22
2088643,17,12,1996,1,male,683,126,88,44,14,27,7,17,7
1394627,32,17,1981,10,female,439,126,42,44,16,37,7,7,9
1903896,14,11,1999,1,female,93,126,102,44,41,37,3,7,38
1183276,24,12,1989,2,male,1019,128,30,43,50,35,21,8,29
1770355,20,23,1993,10,female,657,125,86,44,29,44,26,0,3
1365913,21,31,1992,5,female,778,128,69,45,105,35,95,10,10
1689706,48,25,1965,7,male,356,127,93,45,1,45,1,0,0
1974551,20,6,1993,6,male,254,126,109,45,35,45,14,0,21
1317970,39,14,1974,11,female,526,125,59,45,37,45,30,0,7
1099340,48,5,1965,3,female,342,129,91,45,32,45,32,0,0
1278490,103,1,1910,1,male,307,127,96,45,59,45,37,0,22
1340296,29,11,1984,11,male,182,125,122,45,81,45,71,0,10
1292198,19,24,1994,8,male,140,125,72,46,27,0,8,46,19
1570758,18,4,1995,8,female,515,127,36,47,12,17,7,30,5
1883018,23,6,1990,12,male,192,127,98,46,9,33,7,13,2
1942785,14,27,1999,5,female,177,129,58,46,7,45,4,1,3
1631194,34,20,1979,3,male,212,126,82,46,2,46,2,0,0
1702902,24,17,1989,12,male,505,125,82,46,8,46,7,0,1
1531800,28,30,1985,11,male,329,129,74,47,14,47,13,0,1
1287381,36,7,1977,8,female,949,127,54,47,25,47,23,0,2
1201106,68,1,1945,8,male,1342,129,32,49,37,0,15,49,22
1537174,108,17,1905,8,male,2186,127,105,49,43,18,24,31,19
1719238,42,19,1971,5,female,453,125,71,48,17,46,6,2,11
1573752,16,12,1997,10,female,255,128,98,49,56,48,44,1,12
1450343,19,18,1994,6,male,295,125,54,49,31,43,20,6,11
1750967,18,5,1995,8,male,221,128,95,48,26,48,13,0,13
1721400,32,28,1981,12,female,329,125,65,48,17,48,12,0,5
1208050,33,4,1980,6,male,144,126,94,48,8,48,7,0,1
1321960,24,5,1989,1,male,1059,126,66,48,38,48,25,0,13
1618590,23,1,1990,1,female,108,125,78,49,284,49,102,0,182
1205971,44,24,1969,1,female,239,127,57,48,92,48,85,0,7
1545057,22,20,1991,5,female,508,128,65,51,646,40,471,11,175
1239923,100,16,1913,5,female,1678,128,34,51,4,51,3,0,1
2174178,23,2,1990,11,male,303,129,116,50,50,50,36,0,14
1839473,23,1,1990,12,female,130,127,92,50,38,50,36,0,2
1657422,25,27,1988,9,female,674,128,57,51,66,51,58,0,8
2112762,49,17,1964,11,male,242,127,91,50,32,50,27,0,5
1228575,52,1,1961,8,female,1533,126,57,50,36,50,28,0,8
1000799,17,12,1996,1,male,568,127,66,52,52,0,27,52,25
2087959,89,19,1924,6,male,70,128,90,52,47,0,25,52,22
2000210,61,23,1952,11,male,481,125,110,52,112,10,69,42,43
1369578,40,7,1973,2,female,753,129,73,52,61,33,11,19,50
1506877,29,3,1984,2,female,319,125,85,53,81,47,56,6,25
1724362,30,11,1983,6,male,976,129,43,53,37,53,36,0,1
1637444,19,13,1994,8,female,165,128,98,52,94,52,55,0,39
1905973,24,31,1989,7,male,557,125,51,53,163,53,90,0,73
1442313,17,29,1996,9,male,451,127,76,54,3,19,2,35,1
1602234,50,20,1963,5,female,725,128,88,55,12,48,9,7,3
1269144,15,15,1998,3,male,383,125,40,54,65,54,27,0,38
1697027,19,16,1994,9,male,192,127,81,55,96,55,44,0,52
1092328,23,5,1990,6,male,387,128,105,57,14,40,9,17,5
1659435,35,20,1978,9,male,173,126,73,58,24,25,10,33,14
1493418,44,21,1969,9,male,275,129,73,57,71,35,12,22,59
1941137,34,10,1979,1,male,290,129,119,57,136,37,49,20,87
2156626,63,13,1950,8,female,1466,126,78,58,85,56,37,2,48
2186146,19,12,1994,4,male,125,127,108,58,13,58,11,0,2
1104799,21,8,1992,10,male,328,128,98,57,26,57,22,0,4
1351626,23,1,1990,1,male,322,128,74,58,30,58,19,0,11
1737359,40,25,1973,1,female,407,128,82,58,42,58,24,0,18
1908228,50,19,1963,12,female,2131,128,57,60,100,55,63,5,37
2105400,18,9,1995,12,male,566,126,76,60,2,60,2,0,0
1031350,20,7,1993,12,male,236,126,82,60,65,60,43,0,22
1326542,26,14,1987,2,male,97,129,103,60,76,60,62,0,14
1349800,14,31,1999,12,male,37,128,26,61,19,58,18,3,1
1523861,19,14,1994,1,male,406,129,90,62,42,62,35,0,7
1071163,25,11,1988,12,male,185,125,101,61,46,61,44,0,2
1992970,38,16,1975,8,male,285,126,107,65,11,58,8,7,3
1985798,22,6,1991,2,female,267,129,104,65,12,65,11,0,1
1431283,52,23,1961,1,female,513,126,96,65,21,65,13,0,8
1634171,20,18,1993,8,female,606,126,52,65,97,65,42,0,55
1207989,29,15,1984,3,male,397,128,78,64,145,64,84,0,61
2044855,20,25,1993,6,male,396,127,87,67,14,0,2,67,12
1987887,48,30,1965,1,male,600,125,68,66,20,0,8,66,12
1915893,34,22,1979,8,female,350,126,62,68,164,9,20,59,144
1381700,36,30,1977,3,male,75,125,113,66,18,65,15,1,3
1083785,23,16,1990,3,male,601,128,85,67,136,55,82,12,54
1668183,17,2,1996,8,male,54,127,102,67,9,67,9,0,0
1267961,25,1,1988,1,male,214,129,106,66,4,66,2,0,2
1427376,34,23,1979,1,male,417,128,104,67,29,67,26,0,3
1623021,19,10,1994,11,male,303,127,48,67,303,67,277,0,26
1523487,63,25,1950,1,male,451,125,110,71,31,0,8,71,23
1347864,79,3,1934,2,female,1235,126,52,70,13,0,9,70,4
1887002,62,14,1951,7,female,2217,126,18,71,12,38,5,33,7
1999809,19,3,1994,9,male,581,125,68,69,52,36,22,33,30
1084400,63,12,1950,12,female,407,127,102,70,28,65,9,5,19
1522367,24,1,1989,8,female,128,126,77,71,331,58,164,13,167
1008547,31,25,1982,9,male,407,126,106,70,50,70,47,0,3
2032935,42,14,1971,11,female,223,127,47,71,82,71,61,0,21
1251107,42,2,1971,4,male,742,129,28,71,45,71,34,0,11
1283763,20,30,1993,12,female,519,126,35,74,5,3,1,71,4
1151954,68,23,1945,8,female,1711,126,74,74,24,0,12,74,12
1012605,16,12,1997,10,female,396,129,46,73,53,0,0,73,53
2092499,55,5,1958,12,male,1350,127,53,73,71,25,60,48,11
2028460,43,1,1970,11,male,730,127,81,73,28,62,19,11,9
1887917,50,11,1963,6,male,77,125,114,74,42,68,29,6,13
1677829,31,21,1982,8,female,663,126,55,73,102,71,99,2,3
1735012,37,25,1976,1,female,480,129,91,72,77,71,57,1,20
1538850,18,19,1995,2,male,210,127,57,73,9,73,4,0,5
1423222,18,3,1995,1,male,319,129,94,72,58,72,47,0,11
1393752,27,11,1986,6,male,715,125,73,74,120,74,115,0,5
1761517,55,1,1958,8,female,2198,125,43,77,129,13,50,64,79
1081460,65,7,1948,3,female,474,127,81,75,149,0,52,75,97
1731341,19,22,1994,8,male,126,127,105,76,138,34,84,42,54
1591707,33,15,1980,6,female,96,128,126,76,21,76,19,0,2
1820354,15,13,1998,9,female,110,127,85,77,65,77,54,0,11
1337051,83,28,1930,5,female,1414,128,34,78,4,0,1,78,3
2076114,40,24,1973,11,male,304,128,37,78,39,0,13,78,26
1757074,35,25,1978,9,male,597,126,106,78,37,46,4,32,33
1626529,38,1,1975,8,male,515,127,82,78,14,78,7,0,7
1588328,72,3,1941,6,male,1323,127,56,79,40,79,31,0,9
1814800,18,22,1995,11,female,118,125,91,78,56,78,50,0,6
1129678,15,17,1998,12,male,457,127,41,83,35,0,0,83,35
1657405,64,5,1949,8,male,684,127,102,83,18,2,5,81,13
1298368,59,5,1954,7,female,816,125,76,84,345,0,171,84,174
1299759,14,31,1999,1,female,438,126,56,84,77,60,57,24,20
1339888,27,11,1986,12,female,302,126,81,82,172,50,80,32,92
1019085,27,26,1986,5,male,1389,125,106,81,161,51,122,30,39
1793304,18,10,1995,5,female,534,127,43,81,68,77,33,4,35
2087538,36,7,1977,1,male,532,126,71,83,130,70,57,13,73
1819145,54,2,1959,9,female,358,128,102,84,294,69,246,15,48
1816218,23,4,1990,4,male,16,125,112,81,17,81,14,0,3
1883710,32,15,1981,5,female,455,129,91,84,24,84,23,0,1
1855273,48,9,1965,1,female,687,125,81,82,19,82,14,0,5
2057918,36,27,1977,12,male,357,126,57,84,99,84,53,0,46
1067162,36,23,1977,6,female,417,126,85,81,50,81,35,0,15
1462816,67,13,1946,11,female,1718,126,24,81,114,81,106,0,8
1011910,20,4,1993,2,female,302,128,103,81,157,81,86,0,71
1420433,25,6,1988,8,female,230,125,88,83,154,83,134,0,20
1440322,27,2,1986,8,female,545,125,83,84,134,84,79,0,55
1937352,66,3,1947,12,female,1497,126,34,84,262,84,252,0,10
1704579,58,2,1955,12,female,268,125,93,85,120,3,37,82,83
1693269,15,10,1998,6,male,208,128,117,86,67,24,44,62,23
1315717,18,12,1995,1,female,384,127,89,86,154,85,76,1,78
1223033,46,23,1967,9,female,301,127,76,85,23,85,19,0,4
1595772,18,19,1995,2,female,471,129,63,85,249,85,55,0,194
1703295,41,5,1972,5,female,614,128,83,87,155,87,146,0,9
1263224,22,11,1991,4,male,125,128,119,91,1,84,1,7,0
1838905,22,23,1991,1,male,248,128,51,90,113,87,99,3,14
1335741,33,27,1980,4,female,792,127,92,90,122,68,68,22,54
1232825,54,12,1959,5,female,485,125,80,89,84,88,67,1,17
1207177,101,3,1912,11,female,2337,129,88,88,1,88,0,0,1
1820217,15,17,1998,10,female,484,129,69,90,339,90,205,0,134
1293551,61,15,1952,8,male,814,125,119,93,4,1,3,92,1
1837118,35,4,1978,4,male,333,128,108,94,120,94,89,0,31
1714535,67,27,1946,11,female,780,126,49,92,75,92,47,0,28
1591604,84,8,1929,12,female,1154,129,50,97,24,0,11,97,13
1211070,46,18,1967,8,male,915,125,76,98,37,37,20,61,17
1653807,25,10,1988,5,male,1031,129,23,97,30,81,21,16,9
1540213,18,3,1995,10,male,262,129,108,96,32,96,24,0,8
1642553,25,8,1988,8,male,202,125,106,97,144,97,115,0,29
1498731,34,16,1979,11,male,309,127,105,96,86,96,79,0,7
2142014,40,18,1973,2,male,302,128,83,96,64,96,22,0,42
2073879,17,13,1996,10,male,147,125,98,100,38,5,30,95,8
1743555,53,27,1960,4,female,1831,128,64,103,102,98,26,5,76
1362085,68,20,1945,7,female,1698,125,64,103,116,83,71,20,45
1511674,28,19,1985,11,female,276,127,79,107,65,3,34,104,31
1606927,20,6,1993,12,male,583,129,82,107,71,62,25,45,46
1328860,21,9,1992,12,female,237,129,82,107,79,58,37,49,42
1391294,101,3,1912,7,female,540,126,86,109,9,109,9,0,0
1992025,21,22,1992,3,male,1704,128,86,109,46,109,20,0,26
1130137,26,18,1987,4,male,535,128,88,105,25,105,22,0,3
1738257,62,19,1951,11,male,1570,128,42,106,43,106,42,0,1
1108780,30,10,1983,6,female,392,128,67,106,65,106,38,0,27
1216030,58,6,1955,12,female,659,126,68,113,141,8,43,105,98
1696185,63,6,1950,4,female,545,129,114,110,10,66,2,44,8
1726004,15,23,1998,1,male,253,127,74,110,193,45,109,65,84
1215569,68,21,1945,1,male,1031,125,51,111,2,97,2,14,0
1604748,21,23,1992,3,female,1020,127,79,111,117,90,67,21,50
1779418,38,9,1975,5,male,672,126,68,112,69,100,37,12,32
1087753,29,26,1984,4,male,66,129,109,111,37,111,34,0,3
1947982,59,23,1954,8,female,1155,128,33,119,50,42,15,77,35
1246354,66,14,1947,8,female,1686,125,70,116,232,75,92,41,140
1179598,16,18,1997,5,female,435,127,66,115,66,98,42,17,24
1293995,48,21,1965,1,female,1007,128,25,116,51,114,33,2,18
1423204,28,9,1985,4,male,796,128,91,117,92,93,62,24,30
1232681,17,31,1996,5,female,461,125,47,117,89,116,83,1,6
1049062,39,29,1974,11,female,723,127,108,118,14,118,10,0,4
1529010,45,10,1968,11,male,151,129,101,114,8,114,6,0,2
1840122,53,23,1960,1,male,154,125,78,117,6,117,3,0,3
1989050,29,16,1984,10,female,98,128,81,114,88,114,70,0,18
1011096,35,22,1978,3,male,557,125,110,116,105,116,13,0,92
1559947,18,24,1995,10,male,368,126,65,123,156,20,76,103,80
2045872,19,20,1994,12,male,322,125,75,124,20,25,14,99,6
2119509,19,22,1994,2,female,200,126,83,120,154,59,57,61,97
1430639,26,28,1987,5,male,484,128,55,123,62,98,43,25,19
1453917,15,9,1998,9,male,146,127,77,120,4,120,4,0,0
1391209,64,5,1949,6,female,293,125,40,121,1,121,0,0,1
2143520,45,13,1968,6,male,692,125,78,120,86,120,75,0,11
1355481,43,1,1970,1,male,193,127,88,126,23,0,6,126,17
1526441,108,1,1905,1,male,2042,127,84,126,64,0,0,126,64
2004278,62,10,1951,5,female,1593,128,82,128,93,7,40,121,53
1517359,19,19,1994,4,male,268,129,101,127,51,117,43,10,8
2010882,20,7,1993,1,male,355,128,116,130,17,130,15,0,2
1723070,25,4,1988,12,female,402,127,104,129,78,129,57,0,21
1343234,25,15,1988,5,female,315,127,61,129,50,129,35,0,15
1032754,47,9,1966,10,female,1465,125,64,129,67,129,51,0,16
1035719,38,7,1975,4,female,315,128,106,126,84,126,62,0,22
1616675,99,25,1914,9,female,973,126,108,127,329,127,266,0,63
1997661,23,26,1990,5,female,134,128,66,136,186,38,96,98,90
2006105,23,3,1990,8,female,120,125,35,134,393,58,192,76,201
1055673,17,13,1996,12,male,266,127,77,134,108,123,55,11,53
1243245,20,25,1993,7,male,46,129,107,131,153,128,46,3,107
2085410,44,17,1969,5,female,139,125,75,131,172,131,45,0,127
1447118,35,28,1978,5,female,360,129,71,140,102,90,62,50,40
2117086,47,9,1966,12,female,582,129,84,139,164,81,121,58,43
1201300,77,1,1936,4,male,124,128,97,142,106,69,49,73,57
2160960,47,26,1966,3,male,1104,127,61,137,230,137,167,0,63
1707699,16,10,1997,10,female,138,128,95,150,24,1,1,149,23
2015182,30,26,1983,3,female,192,128,65,149,32,53,22,96,10
1459020,31,10,1982,12,female,710,126,71,150,402,42,167,108,235
1527330,31,26,1982,6,female,585,127,117,149,115,129,80,20,35
1326032,20,16,1993,11,male,183,126,112,148,35,147,35,1,0
1230317,15,26,1998,11,female,784,129,102,147,0,147,0,0,0
1172381,63,30,1950,12,male,852,125,75,147,10,147,8,0,2
1368012,53,2,1960,4,female,197,127,103,144,61,144,6,0,55
1391151,61,7,1952,12,female,1800,127,48,153,19,4,14,149,5
1368131,24,28,1989,10,male,269,126,100,153,100,149,90,4,10
1976560,25,11,1988,3,male,472,127,110,151,56,151,50,0,6
1300422,32,11,1981,5,male,429,126,48,152,33,152,24,0,9
1444537,33,1,1980,1,male,136,129,111,156,29,156,16,0,13
1425175,52,6,1961,9,female,421,125,63,157,65,157,62,0,3
1952069,24,15,1989,11,female,82,125,89,152,95,152,83,0,12
1962978,27,5,1986,11,male,558,126,92,151,104,151,76,0,28
1017213,35,3,1978,11,female,247,126,73,151,163,151,97,0,66
1029203,24,2,1989,9,female,433,126,116,158,82,32,44,126,38
1379718,68,9,1945,9,female,25,127,100,163,101,102,76,61,25
1090811,19,6,1994,12,female,422,125,72,164,13,164,13,0,0
2150371,72,11,1941,3,female,1766,125,88,168,12,0,7,168,5
1709838,19,20,1994,11,female,222,126,46,168,330,0,25,168,305
2007988,49,28,1964,11,female,1608,129,46,170,175,57,94,113,81
1069343,36,16,1977,3,male,505,129,100,171,95,151,83,20,12
1756255,20,13,1993,10,male,411,129,75,171,333,157,226,14,107
1524291,27,2,1986,11,female,134,126,107,171,83,171,67,0,16
1731701,67,22,1946,1,female,1348,128,57,170,49,170,26,0,23
1438730,15,13,1998,6,female,90,129,98,166,432,166,144,0,288
1246495,69,1,1944,10,female,1406,128,96,178,236,0,35,178,201
1018638,108,1,1905,8,male,268,128,86,180,128,150,73,30,55
1655161,63,19,1950,2,female,1562,125,62,177,29,177,20,0,9
2064618,17,10,1996,3,female,167,129,37,181,42,181,16,0,26
1348870,33,20,1980,2,female,668,126,98,177,224,177,131,0,93
1439347,36,29,1977,9,male,362,126,88,185,386,13,106,172,280
1688574,41,1,1972,3,male,651,128,94,183,587,78,228,105,359
1286236,33,25,1980,6,female,584,126,85,184,294,144,99,40,195
1561281,50,25,1963,3,female,527,128,64,182,82,182,40,0,42
2046090,55,2,1958,8,female,203,127,32,184,55,184,35,0,20
1403404,59,28,1954,4,male,485,126,95,186,85,186,60,0,25
1647634,24,4,1989,2,male,387,129,58,200,97,0,7,200,90
2019951,52,9,1961,2,female,236,129,73,198,119,0,51,198,68
2092574,58,12,1955,4,female,993,125,81,200,115,0,14,200,101
1600970,41,22,1972,8,female,935,129,70,197,167,44,49,153,118
1619484,18,29,1995,5,female,973,126,92,197,98,148,35,49,63
1255309,77,10,1936,6,female,106,128,87,199,31,198,14,1,17
1521385,26,3,1987,7,female,126,126,39,198,220,198,208,0,12
2080077,77,17,1936,10,female,1595,127,69,209,208,0,58,209,150
1840594,63,16,1950,9,male,1382,129,37,201,430,0,125,201,305
1700464,16,17,1997,8,female,200,126,81,208,159,89,70,119,89
1812523,34,2,1979,8,female,119,128,65,204,212,60,63,144,149
1244049,33,23,1980,1,female,1070,128,75,209,399,88,125,121,274
2090389,66,27,1947,1,female,1665,129,91,211,50,210,32,1,18
2016092,36,30,1977,12,female,259,129,114,210,1,210,1,0,0
1694343,56,3,1957,5,male,1355,127,31,202,279,202,201,0,78
1510039,38,9,1975,10,male,990,128,72,219,75,2,8,217,67
1833844,35,3,1978,9,female,519,128,104,212,149,14,91,198,58
1575698,21,23,1992,2,female,758,127,49,212,188,204,105,8,83
1722352,26,13,1987,7,male,206,128,109,217,8,217,1,0,7
1407669,30,2,1983,5,male,174,126,88,216,34,216,33,0,1
1233062,32,1,1981,2,male,445,126,80,217,106,217,58,0,48
1286594,52,29,1961,6,female,1097,127,82,214,66,214,40,0,26
1336133,68,23,1945,2,male,804,129,109,223,53,0,33,223,20
1817832,56,21,1957,7,female,587,129,35,229,15,179,8,50,7
1318483,24,27,1989,6,male,203,125,56,230,11,230,8,0,3
1834457,37,25,1976,8,female,255,128,75,224,14,224,11,0,3
1303146,23,10,1990,8,male,399,128,49,229,79,229,50,0,29
1786587,25,5,1988,6,female,601,129,93,223,135,223,78,0,57
1781577,28,13,1985,11,female,515,129,91,230,75,230,54,0,21
1466529,32,28,1981,8,female,409,126,55,232,123,232,115,0,8
1636666,65,1,1948,11,female,1021,128,51,222,71,222,67,0,4
1977152,29,6,1984,5,male,293,126,108,227,165,227,98,0,67
1540630,36,18,1977,6,female,537,125,61,225,166,225,76,0,90
1931772,65,1,1948,3,female,1190,125,78,227,163,227,89,0,74
1568004,108,23,1905,8,female,213,128,108,239,18,9,4,230,14
1929025,61,17,1952,4,female,1470,127,80,239,51,45,7,194,44
1620004,18,2,1995,1,male,343,126,115,246,33,83,22,163,11
1028843,108,25,1905,3,female,44,125,116,246,150,91,71,155,79
1836690,22,24,1991,4,male,118,125,58,243,35,181,27,62,8
1855913,19,9,1994,8,female,153,128,120,234,109,214,55,20,54
1517196,49,19,1964,7,female,1402,129,37,237,461,175,306,62,155
1072227,59,31,1954,12,female,385,126,57,234,162,233,116,1,46
1231857,54,9,1959,6,female,172,128,103,245,8,245,3,0,5
1090902,25,22,1988,10,male,10,125,124,237,763,237,750,0,13
1478159,45,10,1968,2,female,717,126,72,253,168,6,67,247,101
1502425,104,8,1909,10,male,1690,127,84,250,186,33,26,217,160
1590601,60,17,1953,10,female,1133,128,69,257,189,173,138,84,51
1838915,30,15,1983,9,female,605,126,57,259,144,259,103,0,41
1625115,44,20,1969,4,female,236,129,113,259,71,259,52,0,19
1766448,100,13,1913,12,female,985,127,81,248,313,248,266,0,47
1727151,55,14,1958,11,female,661,128,66,272,58,25,33,247,25
1234969,50,14,1963,5,female,426,126,64,265,166,12,102,253,64
1097121,53,30,1960,5,female,1520,127,38,266,94,56,68,210,26
1266225,57,10,1956,7,female,1024,126,37,269,90,160,55,109,35
1117187,63,6,1950,11,female,1512,128,35,265,118,73,65,192,53
2140669,33,21,1980,4,female,27,126,10,274,986,187,705,87,281
1696529,18,21,1995,4,female,364,126,84,269,84,268,81,1,3
1687319,25,6,1988,10,male,219,127,105,263,4,263,2,0,2
1629773,18,4,1995,10,female,591,129,69,263,116,263,71,0,45
1684697,54,5,1959,6,female,96,128,65,277,152,0,28,277,124
1611110,93,29,1920,4,female,1116,129,97,277,56,0,13,277,43
1099040,22,5,1991,1,female,433,129,91,291,205,56,72,235,133
1616502,59,24,1954,3,female,1789,128,99,285,178,205,112,80,66
1601532,32,1,1981,1,male,285,129,123,287,72,287,24,0,48
1719499,40,4,1973,6,female,727,126,82,285,81,285,21,0,60
2045563,61,21,1952,3,female,370,128,73,297,69,0,39,297,30
1348505,14,13,1999,2,female,129,129,40,303,59,164,42,139,17
1823393,16,20,1997,4,female,435,126,81,296,288,100,162,196,126
1370022,35,3,1978,9,female,289,126,64,301,344,95,106,206,238
1340404,25,12,1988,5,male,277,128,37,304,6,304,5,0,1
2079129,17,6,1996,12,female,343,129,80,308,164,308,107,0,57
1688750,28,19,1985,4,female,372,129,56,303,89,303,81,0,8
1393643,21,21,1992,12,female,259,129,38,308,508,308,289,0,219
1850640,42,23,1971,7,female,401,125,113,325,42,178,35,147,7
1200475,22,2,1991,9,female,510,128,105,326,427,101,128,225,299
1700271,44,11,1969,6,female,1777,126,83,327,148,327,51,0,97
1382410,63,6,1950,10,male,292,125,91,310,157,310,85,0,72
1750818,58,5,1955,3,female,487,125,68,334,14,0,9,334,5
1096462,67,30,1946,6,male,773,127,66,336,9,0,1,336,8
1117910,62,22,1951,8,female,1297,126,93,345,106,93,41,252,65
1181509,28,24,1985,4,female,113,128,101,335,178,320,150,15,28
1152115,100,13,1913,10,male,831,126,71,334,171,276,103,58,68
1453278,16,24,1997,5,male,621,125,24,336,0,336,0,0,0
1796310,22,8,1991,9,female,593,129,106,346,233,346,225,0,8
1954625,28,3,1985,8,male,165,128,111,343,409,343,348,0,61
1569828,32,4,1981,12,female,323,126,70,365,1321,289,927,76,394
1787847,45,23,1968,9,male,373,125,61,367,179,367,105,0,74
1620103,53,14,1960,9,female,2011,129,35,352,221,352,64,0,157
1832187,25,27,1988,5,female,360,127,50,387,49,234,31,153,18
1481104,23,22,1990,3,female,740,129,96,381,68,374,44,7,24
1464281,29,8,1984,6,male,412,128,74,386,63,386,52,0,11
1690859,47,3,1966,4,male,1454,125,73,393,380,393,315,0,65
2086588,16,21,1997,4,female,467,127,50,405,398,0,110,405,288
1276295,16,11,1997,3,female,818,129,64,412,354,284,205,128,149
1485672,34,25,1979,10,female,728,125,72,417,141,376,96,41,45
1705220,14,8,1999,5,female,125,126,101,425,33,133,8,292,25
1957262,35,2,1978,4,female,908,129,74,449,83,341,44,108,39
2019132,63,23,1950,12,female,810,129,100,442,198,413,118,29,80
2154996,25,18,1988,11,female,359,125,65,433,836,429,679,4,157
1908483,57,5,1956,3,female,130,126,97,451,150,451,127,0,23
1511568,55,22,1958,10,female,1695,127,77,467,150,0,16,467,134
1692845,67,20,1946,3,female,957,127,94,476,304,0,116,476,188
1205966,18,23,1995,1,female,396,129,113,476,380,211,210,265,170
1767928,33,20,1980,2,female,374,125,82,469,96,449,73,20,23
2117039,53,19,1960,8,female,1158,127,28,457,142,457,76,0,66
1466754,49,7,1964,3,female,636,125,89,503,65,19,55,484,10
1683167,48,8,1965,8,female,280,128,86,488,210,7,189,481,21
1548014,19,15,1994,12,female,62,129,93,515,393,3,176,512,217
2118631,31,7,1982,7,female,1732,126,56,502,308,294,208,208,100
1319534,42,13,1971,12,female,426,128,68,488,481,287,244,201,237
1969515,36,6,1977,1,female,1642,126,70,486,206,429,164,57,42
1367065,65,13,1948,5,male,711,125,37,495,280,427,193,68,87
2112705,15,8,1998,10,male,284,126,74,490,398,394,202,96,196
1016999,51,6,1962,6,male,127,128,117,489,3,489,1,0,2
1958398,47,2,1966,1,male,464,126,76,489,694,489,534,0,160
1338286,62,18,1951,7,female,1193,128,82,537,184,80,118,457,66
1182926,60,30,1953,3,female,1070,126,16,544,265,535,43,9,222
1023011,31,23,1982,4,female,351,129,104,544,778,544,509,0,269
1263206,18,24,1995,2,female,298,125,59,579,640,268,292,311,348
1383476,21,12,1992,10,female,788,128,67,603,166,590,87,13,79
1316232,62,5,1951,4,female,538,127,91,606,29,605,25,1,4
1131534,25,1,1988,8,female,691,128,78,586,178,586,171,0,7
1284941,55,8,1958,1,female,761,127,75,651,64,0,20,651,44
1693182,15,27,1998,7,male,42,126,123,616,55,607,48,9,7
1967187,18,8,1995,8,female,211,129,100,656,97,568,67,88,30
2147985,49,11,1964,3,female,871,129,46,640,497,639,182,1,315
1183210,33,7,1980,3,male,192,125,109,656,90,656,45,0,45
2142311,44,21,1969,3,male,291,126,54,650,256,650,207,0,49
1728518,49,27,1964,4,female,1299,125,65,683,476,4,170,679,306
2022477,39,15,1974,9,female,1205,127,77,676,698,327,394,349,304
1567952,40,1,1973,9,female,54,127,104,704,618,263,329,441,289
1732312,52,29,1961,6,female,696,128,79,687,396,560,217,127,179
1333418,22,5,1991,3,female,99,126,115,686,427,598,305,88,122
1878947,51,6,1962,1,female,334,129,98,713,1308,689,928,24,380
1946246,33,16,1980,5,female,1040,127,79,686,214,686,142,0,72
1419473,58,11,1955,7,female,493,125,106,750,319,438,241,312,78
1914659,22,30,1991,11,female,1335,129,49,742,1076,421,568,321,508
1097951,24,15,1989,8,male,28,128,120,739,966,616,762,123,204
1556252,22,16,1991,1,female,724,128,64,795,233,788,107,7,126
2107209,56,7,1957,4,female,1711,129,66,731,351,724,269,7,82
1271012,53,9,1960,1,female,1078,129,87,730,248,730,114,0,134
1380838,34,14,1979,11,female,428,127,98,747,612,747,550,0,62
1194985,45,8,1968,8,female,1012,128,61,867,475,852,242,15,233
1723033,60,3,1953,12,female,1083,128,65,859,396,704,111,155,285
1369019,18,15,1995,12,male,150,129,46,820,41,820,31,0,10
1044286,53,17,1960,12,female,766,128,69,965,222,0,98,965,124
1715681,108,9,1905,9,female,1280,125,66,885,701,377,341,508,360
2129213,64,29,1949,3,female,1619,129,96,884,227,714,99,170,128
1999578,28,14,1985,4,female,432,129,70,917,594,792,253,125,341
1273832,18,26,1995,10,male,296,129,96,912,39,912,36,0,3
1409829,25,8,1988,8,male,124,128,115,921,248,921,186,0,62
1304674,67,5,1946,9,female,479,128,17,1034,688,0,130,1034,558
1288917,23,25,1990,11,male,401,125,96,1109,28,1009,8,100,20
1940140,47,4,1966,10,female,187,126,95,1041,102,1040,61,1,41
1257270,39,6,1974,1,female,258,126,56,1057,497,1057,257,0,240
2066518,66,28,1947,5,male,240,126,24,1173,632,0,175,1173,457
1255032,37,22,1976,5,female,989,128,100,1231,692,783,236,448,456
1784817,56,16,1957,8,male,784,128,69,1228,452,611,160,617,292
1626924,28,12,1985,5,female,152,128,91,1262,407,1257,315,5,92
1897717,51,3,1962,2,male,227,126,94,1219,15,1219,15,0,0
1682103,39,21,1974,12,female,680,125,77,1442,1177,46,477,1396,700
1381391,23,15,1990,5,female,46,127,104,1506,241,938,104,568,137
1242236,24,10,1989,4,male,193,129,99,1351,48,1351,44,0,4
1577864,34,7,1979,11,male,347,126,91,1535,543,72,131,1463,412
2096379,22,27,1991,3,female,628,127,82,1566,1194,690,169,876,1025
1912710,52,10,1961,2,female,1731,129,87,1756,1851,421,572,1335,1279
1754348,34,6,1979,6,female,1829,126,65,1622,449,1280,314,342,135
1585438,61,26,1952,12,female,1387,128,49,1564,450,1544,338,20,112
1438366,53,25,1960,6,female,810,129,85,1838,206,1838,146,0,60
1923394,50,22,1963,7,female,790,127,45,1966,201,196,46,1770,155
1724369,63,4,1950,6,female,1991,129,52,2198,582,158,250,2040,332
1584532,52,26,1961,4,female,702,129,93,1895,124,395,32,1500,92
1299538,62,24,1951,10,male,721,126,79,2156,67,2156,37,0,30
1246195,41,17,1972,4,female,318,128,100,1883,1026,1883,181,0,845
1949444,43,5,1970,3,female,210,127,75,2818,3936,447,2417,2371,1519
1223305,19,23,1994,4,female,318,129,93,2671,31,2671,28,0,3
1591357,13,23,2000,1,female,135,127,89,3872,358,3603,193,269,165
1941724,17,3,1996,2,male,315,133,20,3,70,3,17,0,53
2149499,17,13,1996,3,male,420,130,77,3,16,3,5,0,11
1675649,17,10,1996,9,male,563,132,89,3,8,3,3,0,5
1846275,18,30,1995,8,female,636,133,84,3,10,3,4,0,6
2037084,18,11,1995,9,female,131,131,74,3,57,3,47,0,10
2153139,21,4,1992,4,female,112,130,122,3,8,3,4,0,4
1406192,23,1,1990,1,male,369,131,56,3,23,3,10,0,13
1836093,23,25,1990,2,male,639,133,78,3,47,3,42,0,5
1228196,26,1,1987,1,male,633,130,99,3,54,3,51,0,3
1531569,26,10,1987,10,female,507,132,98,3,6,3,3,0,3
1901418,28,10,1985,11,male,574,134,90,3,8,3,4,0,4
1189636,28,20,1985,3,male,401,131,91,3,41,3,27,0,14
1501338,51,18,1962,6,female,263,134,108,3,9,3,9,0,0
1553458,98,11,1915,10,female,335,134,95,3,46,3,37,0,9
1243740,108,22,1905,2,female,1486,133,33,3,13,3,13,0,0
1205070,14,14,1999,9,male,240,132,98,4,0,0,0,4,0
1145390,20,12,1993,4,male,619,134,105,4,3,0,2,4,1
2073855,17,26,1996,7,male,188,131,40,4,6,0,0,4,6
1287002,47,31,1966,10,female,796,130,61,4,14,0,5,4,9
1952991,52,10,1961,9,female,734,134,92,4,69,0,50,4,19
1769773,63,25,1950,6,female,205,134,113,4,32,0,0,4,32
1228000,14,15,1999,12,male,266,130,35,4,0,1,0,3,0
1806924,15,4,1998,9,male,351,132,80,4,2,3,1,1,1
1229974,62,7,1951,10,male,2061,130,49,4,1,3,1,1,0
1608125,51,12,1962,9,male,789,131,76,4,33,3,19,1,14
1025915,17,18,1996,3,male,355,130,123,4,0,4,0,0,0
1190078,19,8,1994,8,male,594,133,95,4,0,4,0,0,0
1075644,24,9,1989,12,female,559,130,8,4,0,4,0,0,0
1649883,25,14,1988,12,male,7,132,129,4,0,4,0,0,0
1022235,27,27,1986,9,male,696,133,110,4,2,4,2,0,0
1304894,33,7,1980,6,female,334,133,61,4,1,4,1,0,0
1884749,101,15,1912,2,male,372,130,51,4,1,4,0,0,1
1918236,22,3,1991,1,male,587,133,74,4,3,4,3,0,0
1904044,36,14,1977,5,male,222,133,118,4,4,4,4,0,0
1871399,103,22,1910,11,male,770,130,89,4,4,4,4,0,0
1585655,103,21,1910,9,male,1327,132,53,4,4,4,2,0,2
1161241,14,7,1999,7,male,73,132,99,4,28,4,16,0,12
1795834,19,1,1994,11,male,373,131,48,4,65,4,24,0,41
1093656,25,12,1988,7,male,502,133,93,4,9,4,9,0,0
1403951,30,5,1983,11,male,164,132,91,4,10,4,10,0,0
1383378,60,22,1953,10,male,323,130,93,4,13,4,12,0,1
1546539,15,19,1998,2,female,283,131,64,5,0,0,0,5,0
1874923,23,14,1990,2,male,298,131,92,5,3,0,0,5,3
1260052,49,25,1964,2,male,645,134,56,5,2,0,1,5,1
1053103,72,1,1941,3,male,991,131,117,5,2,0,1,5,1
1899500,15,11,1998,11,male,408,131,49,5,16,0,1,5,15
1212225,59,3,1954,6,male,888,131,89,5,19,0,5,5,14
1739933,18,8,1995,10,female,365,133,109,5,4,1,0,4,4
1417958,42,26,1971,8,male,490,132,59,5,5,1,1,4,4
1837550,18,27,1995,8,female,173,134,84,5,39,3,22,2,17
1473935,24,19,1989,8,male,244,134,68,5,15,2,2,3,13
1752059,28,13,1985,7,female,320,134,83,5,19,1,14,4,5
1061349,24,2,1989,1,male,101,130,102,5,5,4,0,1,5
2168276,16,21,1997,12,male,632,130,50,5,0,5,0,0,0
2120764,18,21,1995,10,male,290,130,89,5,0,5,0,0,0
1966559,30,31,1983,7,male,54,132,96,5,3,5,3,0,0
2026210,24,17,1989,7,male,319,130,80,5,5,5,4,0,1
1953409,26,1,1987,1,male,313,133,117,5,4,5,4,0,0
1126012,22,21,1991,9,female,921,132,15,5,14,5,11,0,3
1455287,31,11,1982,12,female,175,130,112,5,47,5,43,0,4
1522334,35,26,1978,5,male,361,130,82,5,23,5,19,0,4
1394055,99,14,1914,2,male,445,130,68,5,9,5,9,0,0
1596797,18,8,1995,7,male,97,131,125,6,1,1,0,5,1
1632888,18,24,1995,1,female,229,132,91,6,4,1,1,5,3
1264594,75,22,1938,11,female,1440,134,34,6,4,0,2,6,2
1263657,57,17,1956,9,male,1596,130,76,6,28,0,17,6,11
1528782,42,6,1971,8,male,65,133,35,6,56,4,37,2,19
1524799,28,30,1985,4,female,377,134,52,6,0,5,0,1,0
1058171,15,26,1998,3,female,317,131,100,6,34,5,23,1,11
1946927,38,27,1975,5,female,317,131,116,6,65,5,40,1,25
1453905,23,25,1990,11,male,514,132,70,6,0,6,0,0,0
1262529,25,23,1988,2,male,425,132,125,6,0,6,0,0,0
1238141,27,20,1986,12,male,651,134,103,6,0,6,0,0,0
1496319,43,26,1970,5,male,682,131,44,6,0,6,0,0,0
1861595,47,1,1966,12,female,614,130,75,6,0,6,0,0,0
1520198,18,12,1995,5,male,197,131,119,6,2,6,1,0,1
1312565,27,26,1986,8,male,544,132,60,6,1,6,0,0,1
1732523,24,2,1989,2,male,492,131,101,6,7,6,3,0,4
1759917,25,9,1988,9,male,376,133,105,6,4,6,4,0,0
1983612,103,4,1910,2,male,881,132,93,6,5,6,5,0,0
1569260,14,8,1999,1,male,548,131,54,6,15,6,13,0,2
1341909,18,18,1995,6,female,315,132,61,6,36,6,20,0,16
1192548,20,6,1993,4,female,286,131,78,6,19,6,16,0,3
2146812,25,5,1988,7,male,220,130,105,6,117,6,93,0,24
1803378,25,24,1988,8,male,266,132,72,6,16,6,11,0,5
2112468,27,31,1986,12,male,93,132,114,6,65,6,18,0,47
1889407,26,8,1987,6,male,475,131,50,6,30,6,27,0,3
1128855,29,21,1984,3,male,569,133,113,6,13,6,8,0,5
1285151,50,7,1963,2,male,442,134,79,6,93,6,76,0,17
2107947,51,24,1962,9,female,730,133,87,6,13,6,12,0,1
1976036,52,15,1961,8,female,858,130,82,6,15,6,6,0,9
1800144,55,6,1958,4,male,2017,131,63,6,64,6,19,0,45
1950628,61,14,1952,11,male,651,133,40,6,23,6,11,0,12
1387015,108,1,1905,1,female,1477,131,21,6,20,6,16,0,4
2148335,16,13,1997,2,male,215,133,70,7,3,0,0,7,3
1981856,58,30,1955,1,female,1660,132,14,7,4,0,1,7,3
1649624,38,31,1975,8,male,1366,131,84,7,3,5,2,2,1
1547749,21,22,1992,9,male,258,132,95,7,7,4,2,3,5
1832089,32,10,1981,1,male,653,132,99,7,19,4,9,3,10
1731960,49,17,1964,7,male,2229,131,76,7,27,2,2,5,25
1490436,21,7,1992,1,male,917,131,60,7,2,7,2,0,0
1059361,24,18,1989,2,female,657,132,67,7,2,7,2,0,0
1986629,21,30,1992,11,male,518,130,110,7,11,7,3,0,8
1038372,24,7,1989,7,male,111,132,55,7,20,7,14,0,6
1468232,13,25,2000,1,male,591,132,94,8,1,0,0,8,1
1686977,17,30,1996,3,male,209,131,101,8,0,0,0,8,0
1714579,20,14,1993,5,male,264,133,124,8,0,1,0,7,0
1933201,102,21,1911,9,male,12,130,129,8,4,0,0,8,4
1668732,16,4,1997,5,female,346,131,71,8,7,0,4,8,3
1436034,18,3,1995,4,male,396,131,60,8,3,5,3,3,0
1460413,33,1,1980,12,male,621,133,59,8,69,2,25,6,44
1008689,19,4,1994,12,female,543,134,79,8,0,8,0,0,0
1686903,18,31,1995,3,male,310,130,53,8,3,8,1,0,2
1467511,36,16,1977,3,male,291,131,29,8,3,8,3,0,0
1134800,71,12,1942,8,male,1167,132,33,8,8,8,4,0,4
1019731,61,11,1952,11,male,1311,133,56,8,49,8,39,0,10
1421762,69,24,1944,10,male,1828,130,118,8,71,8,20,0,51
1626783,44,4,1969,7,male,603,131,21,9,0,0,0,9,0
1382580,86,24,1927,4,female,1646,132,47,9,6,0,6,9,0
1242526,15,25,1998,9,male,353,133,71,9,14,0,1,9,13
1816206,55,7,1958,6,male,1461,131,38,9,69,1,40,8,29
1001591,26,4,1987,2,male,245,130,65,9,44,3,37,6,7
1467828,47,16,1966,3,male,587,133,12,9,18,3,6,6,12
1789385,39,24,1974,2,male,583,133,75,9,3,8,2,1,1
1315412,23,20,1990,1,male,637,132,112,9,0,9,0,0,0
1917898,39,14,1974,4,male,644,133,80,9,1,9,1,0,0
1938368,101,28,1912,12,female,124,134,88,9,4,9,4,0,0
1573961,16,17,1997,10,male,282,133,117,9,8,9,8,0,0
1432034,27,1,1986,2,male,854,133,71,9,6,9,3,0,3
2155050,20,25,1993,5,male,1076,133,37,9,25,9,17,0,8
1302983,25,15,1988,6,male,178,133,87,9,20,9,17,0,3
1878364,48,13,1965,5,male,270,131,97,10,20,3,12,7,8
2120267,51,9,1962,3,female,1269,132,81,10,43,7,25,3,18
1095132,30,23,1983,1,male,506,130,48,10,4,9,1,1,3
1673497,28,27,1985,8,male,255,132,97,10,52,9,15,1,37
1887739,26,3,1987,3,male,286,131,122,10,6,10,0,0,6
1461103,52,8,1961,12,female,1254,132,52,10,14,10,10,0,4
1077468,19,1,1994,1,male,292,132,62,10,20,10,20,0,0
1544194,58,10,1955,6,female,1621,134,59,10,48,10,32,0,16
1492137,15,3,1998,9,male,121,134,95,11,2,0,0,11,2
1635766,26,2,1987,2,male,87,131,115,11,7,0,3,11,4
1949642,30,23,1983,4,male,673,133,43,11,13,0,7,11,6
1127341,102,1,1911,1,male,1441,130,27,11,10,0,3,11,7
1449702,31,3,1982,9,male,342,132,70,11,21,2,11,9,10
2137284,23,1,1990,1,male,530,134,85,11,0,3,0,8,0
1267318,16,21,1997,4,male,136,132,118,11,9,11,9,0,0
1892168,17,23,1996,4,female,299,132,86,11,7,11,5,0,2
1193434,25,14,1988,2,male,392,131,114,11,8,11,6,0,2
1791548,29,28,1984,8,male,284,133,71,11,18,11,15,0,3
2001216,43,30,1970,9,male,1680,133,87,11,22,11,21,0,1
1059898,21,15,1992,12,male,203,133,120,12,2,1,2,11,0
1390363,15,13,1998,5,male,346,132,95,12,1,11,1,1,0
1774951,13,12,2000,2,male,252,132,58,12,9,10,8,2,1
1613128,18,12,1995,3,male,391,130,41,12,32,10,23,2,9
2039440,24,11,1989,6,male,280,132,63,12,0,12,0,0,0
1427415,24,10,1989,10,male,406,131,84,12,3,12,3,0,0
1732414,36,24,1977,8,male,76,132,44,12,4,12,4,0,0
1761403,50,5,1963,6,male,284,130,51,12,4,12,1,0,3
1381109,31,13,1982,7,male,1075,130,93,12,13,12,13,0,0
1352228,103,26,1910,2,male,597,130,101,12,13,12,13,0,0
1924219,56,6,1957,3,male,775,132,94,13,8,0,5,13,3
2187252,108,21,1905,8,female,64,133,32,13,11,0,3,13,8
1213158,54,4,1959,10,male,505,132,72,13,40,0,19,13,21
1136867,23,11,1990,6,female,161,130,121,13,19,7,14,6,5
2005352,20,8,1993,9,female,174,132,36,13,33,6,15,7,18
2070713,25,28,1988,5,male,358,131,118,13,0,12,0,1,0
1611443,15,4,1998,12,male,273,132,66,13,2,13,2,0,0
1160593,51,6,1962,5,male,652,131,92,13,5,13,0,0,5
2112713,21,5,1992,9,male,303,131,101,13,13,13,3,0,10
1330010,39,13,1974,10,male,1910,131,89,13,14,13,11,0,3
1670272,81,25,1932,12,male,709,134,56,13,16,13,11,0,5
1514559,23,28,1990,11,male,296,132,117,14,3,0,1,14,2
1811298,28,2,1985,5,female,320,130,98,14,30,0,1,14,29
1929518,33,31,1980,12,male,545,132,68,14,128,0,50,14,78
1542919,33,4,1980,7,male,265,132,127,14,7,7,3,7,4
1508549,17,12,1996,10,male,590,132,79,14,15,10,6,4,9
1746468,15,8,1998,12,male,305,132,82,14,1,14,1,0,0
1568235,23,16,1990,7,male,613,134,32,14,0,14,0,0,0
2078840,32,18,1981,8,male,717,132,72,14,0,14,0,0,0
1322178,20,11,1993,1,male,648,133,77,14,5,14,3,0,2
1090082,83,15,1930,9,female,1144,133,83,14,12,14,5,0,7
1795324,24,5,1989,12,female,387,133,75,14,27,14,20,0,7
1661235,36,13,1977,7,male,287,133,108,14,113,14,90,0,23
2130600,38,23,1975,12,male,323,131,79,14,41,14,28,0,13
1386412,43,10,1970,2,male,120,130,87,14,23,14,20,0,3
2035588,13,2,2000,1,male,80,133,112,15,2,0,0,15,2
1671046,59,27,1954,2,female,417,132,106,15,59,0,48,15,11
1869703,19,16,1994,7,male,288,131,77,15,15,8,13,7,2
1707752,55,14,1958,9,female,1143,134,89,15,276,6,196,9,80
1371859,23,2,1990,12,female,641,132,98,15,0,15,0,0,0
1181596,25,1,1988,7,male,121,134,62,15,0,15,0,0,0
1900377,27,10,1986,10,male,641,132,46,15,11,15,8,0,3
1883987,33,30,1980,6,female,163,133,104,15,16,15,11,0,5
1041568,19,12,1994,8,male,331,131,106,15,96,15,67,0,29
1734208,21,20,1992,4,female,1920,130,80,15,43,15,36,0,7
1384595,53,12,1960,1,female,321,132,50,15,77,15,32,0,45
1465869,23,16,1990,10,male,238,131,96,16,8,0,4,16,4
1303101,30,27,1983,6,male,392,131,100,16,13,0,2,16,11
1203983,106,6,1907,5,male,2025,131,58,16,10,1,6,15,4
1407165,17,27,1996,6,male,107,130,112,16,62,2,25,14,37
1875165,57,5,1956,5,male,1443,131,77,16,36,1,8,15,28
1330034,19,13,1994,4,male,65,131,62,16,4,13,4,3,0
1148891,37,2,1976,1,male,359,134,98,16,12,12,12,4,0
1240652,14,11,1999,3,female,320,130,33,16,44,15,39,1,5
2157731,21,12,1992,11,male,740,131,95,16,22,16,4,0,18
1686101,22,12,1991,1,female,346,134,95,16,11,16,10,0,1
1346584,18,25,1995,8,male,353,130,74,16,72,16,71,0,1
1241845,23,12,1990,12,male,585,133,85,16,33,16,20,0,13
1326129,16,8,1997,7,male,438,133,97,17,10,0,0,17,10
1994210,70,11,1943,5,female,860,132,53,17,174,0,66,17,108
1562979,54,10,1959,8,male,1013,130,55,17,0,11,0,6,0
1151596,16,8,1997,8,female,51,131,107,17,16,13,13,4,3
1896070,28,28,1985,5,male,630,130,54,17,40,13,5,4,35
2121751,24,19,1989,10,male,293,133,112,17,2,17,2,0,0
1939920,18,2,1995,5,male,222,134,87,17,61,17,57,0,4
1468616,18,2,1995,6,male,140,132,59,17,36,17,28,0,8
1737651,56,14,1957,8,male,975,130,5,17,339,17,260,0,79
2170954,42,18,1971,1,male,462,133,81,18,0,0,0,18,0
1465633,19,16,1994,3,male,273,132,114,18,22,3,4,15,18
1504224,20,11,1993,4,male,265,132,99,18,8,17,3,1,5
1521434,21,25,1992,2,male,356,133,35,18,17,18,9,0,8
1144825,73,5,1940,12,male,934,133,73,19,26,0,3,19,23
1469024,58,26,1955,5,male,1354,134,78,19,5,15,2,4,3
1286996,23,8,1990,4,male,565,130,92,19,7,19,1,0,6
1778930,108,2,1905,11,female,876,131,38,19,9,19,8,0,1
1779609,29,19,1984,10,female,381,134,83,19,19,19,18,0,1
1818193,30,21,1983,8,male,591,134,74,19,13,19,4,0,9
1307078,15,29,1998,4,male,331,133,96,19,45,19,39,0,6
1466109,44,16,1969,7,female,368,130,98,19,41,19,41,0,0
2143069,19,10,1994,11,male,270,131,87,20,3,0,0,20,3
1559768,68,1,1945,3,male,157,130,81,20,140,0,3,20,137
1323321,14,21,1999,12,female,243,130,76,20,0,13,0,7,0
1113920,57,23,1956,1,female,1276,130,73,20,22,13,16,7,6
1647978,37,10,1976,8,female,785,131,89,20,8,16,5,4,3
1816592,108,15,1905,5,male,1305,132,85,20,6,17,2,3,4
1979767,15,15,1998,12,male,226,131,79,20,12,20,11,0,1
1282832,19,25,1994,7,male,480,130,13,20,9,20,8,0,1
2137191,22,10,1991,8,female,878,130,43,21,31,15,14,6,17
1850036,17,14,1996,6,female,509,133,78,21,2,21,2,0,0
2192608,55,23,1958,2,male,521,130,32,21,2,21,2,0,0
1640471,103,11,1910,5,male,527,134,33,21,9,21,9,0,0
1756804,22,15,1991,6,female,299,134,31,22,3,0,1,22,2
2132298,24,20,1989,11,male,59,132,99,22,2,4,1,18,1
2084728,21,4,1992,8,female,530,134,116,22,9,2,2,20,7
2150953,18,24,1995,11,male,362,133,117,22,6,6,6,16,0
1624419,14,7,1999,2,male,327,132,64,22,3,19,1,3,2
1543568,23,1,1990,7,female,100,132,82,22,3,20,1,2,2
1331042,23,27,1990,4,female,839,130,92,22,113,21,77,1,36
1912323,25,4,1988,7,male,393,131,97,22,10,22,5,0,5
1045011,53,3,1960,2,female,925,131,84,22,8,22,6,0,2
2066287,62,7,1951,3,female,1910,133,78,22,9,22,2,0,7
2048614,68,19,1945,7,male,352,134,91,22,12,22,12,0,0
1625991,55,7,1958,2,female,366,133,66,23,3,0,1,23,2
1823099,33,1,1980,1,male,286,130,103,23,24,0,2,23,22
1069176,61,28,1952,1,male,224,132,88,23,72,0,8,23,64
1023100,30,15,1983,3,male,27,131,126,23,3,9,1,14,2
1353127,20,19,1993,12,male,436,133,99,23,34,7,4,16,30
1443716,18,5,1995,7,male,311,133,82,23,7,23,5,0,2
1496802,20,1,1993,1,male,231,132,115,24,6,13,5,11,1
1604594,24,19,1989,11,female,242,134,91,24,0,19,0,5,0
1828447,63,16,1950,5,female,1615,134,43,24,62,23,16,1,46
1470496,25,29,1988,12,male,302,130,117,24,3,24,3,0,0
1460200,41,4,1972,1,female,1278,130,88,24,11,24,5,0,6
1891585,24,10,1989,8,male,317,134,42,24,35,24,29,0,6
2189361,19,9,1994,7,male,478,133,62,24,56,24,19,0,37
1800163,38,2,1975,5,male,248,132,41,24,42,24,34,0,8
1920564,51,12,1962,1,female,1854,130,61,24,469,24,362,0,107
1687953,93,31,1920,3,female,810,133,96,25,15,0,6,25,9
1290396,37,29,1976,9,female,471,134,42,25,47,4,16,21,31
2081185,20,13,1993,4,male,30,132,130,25,14,9,11,16,3
1088584,25,13,1988,12,male,584,130,63,25,18,23,15,2,3
1279393,15,17,1998,1,female,292,132,58,25,1,25,1,0,0
1211574,108,2,1905,2,male,390,130,102,25,12,25,10,0,2
1652044,37,15,1976,2,male,630,133,103,25,23,25,22,0,1
1110215,98,27,1915,10,male,802,132,58,26,7,15,1,11,6
1610450,16,19,1997,9,female,453,132,84,26,8,26,7,0,1
1834922,21,14,1992,9,male,425,134,70,26,5,26,2,0,3
2165034,26,2,1987,10,male,193,131,113,26,37,26,34,0,3
1275220,23,19,1990,6,female,324,130,61,27,0,0,0,27,0
1024637,72,23,1941,7,female,386,132,111,27,0,0,0,27,0
1586940,31,15,1982,1,female,543,131,105,27,26,25,17,2,9
1436021,18,25,1995,9,male,542,134,119,27,3,27,2,0,1
1627965,20,10,1993,10,male,686,133,124,27,5,27,5,0,0
1509029,23,17,1990,7,female,62,133,12,27,24,27,24,0,0
1736290,54,14,1959,9,female,125,134,102,28,348,28,307,0,41
1766421,43,12,1970,6,female,412,134,94,29,55,3,31,26,24
1038512,15,29,1998,1,male,329,133,105,29,29,28,12,1,17
2072339,23,15,1990,6,male,474,134,107,29,1,29,1,0,0
1561030,72,8,1941,5,male,1329,133,61,30,13,1,5,29,8
1507404,15,21,1998,11,female,743,133,22,31,85,0,1,31,84
1582789,34,14,1979,1,male,305,132,104,30,100,0,76,30,24
1589983,63,1,1950,1,male,650,131,103,31,49,0,20,31,29
1952371,24,9,1989,9,male,543,131,71,31,7,10,4,21,3
1914270,108,25,1905,9,male,1279,130,83,31,40,10,32,21,8
1459113,43,26,1970,7,male,337,132,41,30,74,17,60,13,14
1349834,19,18,1994,1,male,192,133,95,31,29,29,23,2,6
1319787,19,4,1994,6,male,471,134,106,31,36,30,32,1,4
1971911,23,16,1990,10,female,220,131,93,30,23,29,14,1,9
1411741,25,8,1988,8,female,343,131,42,31,75,23,34,8,41
1545713,16,25,1997,4,male,238,131,90,31,2,31,2,0,0
1149083,20,5,1993,7,male,430,131,103,31,4,31,4,0,0
2120200,19,10,1994,6,male,30,134,73,31,21,31,21,0,0
1482795,23,13,1990,6,male,40,131,124,31,28,31,28,0,0
1290519,23,3,1990,1,female,344,132,114,31,66,31,49,0,17
1483724,24,9,1989,2,male,340,131,97,32,79,21,57,11,22
1080686,46,11,1967,2,female,144,130,86,33,114,18,21,15,93
1967859,26,18,1987,10,male,642,133,127,33,3,33,1,0,2
1366705,56,5,1957,4,male,1142,130,80,33,12,33,1,0,11
1859220,15,28,1998,2,female,236,134,103,33,127,33,62,0,65
2080791,17,15,1996,1,female,368,134,55,34,20,32,14,2,6
1009008,45,30,1968,1,male,307,132,64,35,5,0,2,35,3
1353297,33,16,1980,2,female,568,134,107,35,18,35,15,0,3
1457506,20,18,1993,12,female,646,130,52,36,37,36,31,0,6
1651893,26,1,1987,9,female,300,132,16,35,83,35,71,0,12
1396839,55,18,1958,4,female,1689,130,63,37,30,1,20,36,10
1596604,56,16,1957,1,female,456,134,121,37,62,0,48,37,14
1191274,14,19,1999,3,male,240,131,76,37,1,37,1,0,0
1266732,18,4,1995,3,male,378,131,100,37,16,37,14,0,2
1486829,44,8,1969,6,male,854,130,93,37,15,37,13,0,2
1531117,24,5,1989,5,male,183,131,101,38,7,2,4,36,3
1610813,25,7,1988,9,male,672,131,49,38,69,10,41,28,28
1007078,14,16,1999,4,male,440,133,27,39,0,31,0,8,0
1979193,16,21,1997,1,male,606,130,84,38,41,36,25,2,16
1013673,24,26,1989,4,male,224,131,76,38,14,38,2,0,12
1011134,103,15,1910,3,male,930,130,84,38,22,38,18,0,4
1585522,15,24,1998,8,male,70,130,115,40,6,40,6,0,0
1880408,16,3,1997,1,male,592,131,30,42,69,15,37,27,32
2014372,48,21,1965,5,female,948,131,70,41,156,39,38,2,118
1040653,108,1,1905,1,NA,1586,131,60,41,4,41,4,0,0
1701243,15,10,1998,2,female,124,133,63,41,9,41,3,0,6
1835700,33,31,1980,12,male,721,132,94,42,14,42,14,0,0
1450519,22,23,1991,8,female,90,134,56,42,50,42,42,0,8
2176204,24,23,1989,6,female,167,131,111,41,56,41,55,0,1
1808568,24,22,1989,8,female,411,133,90,41,80,41,77,0,3
1687933,27,20,1986,10,male,516,132,38,43,21,0,4,43,17
1306701,28,8,1985,1,female,542,131,95,44,10,8,2,36,8
1384601,18,8,1995,7,male,544,133,54,43,21,15,8,28,13
1318753,35,20,1978,1,male,506,133,71,44,17,29,11,15,6
1464672,29,10,1984,10,male,539,131,70,43,75,19,41,24,34
1705438,33,16,1980,8,male,649,134,72,44,4,34,4,10,0
1730769,67,5,1946,6,male,1489,132,33,43,5,37,3,6,2
1898131,22,17,1991,6,female,1040,130,89,44,1,44,1,0,0
2103175,23,6,1990,2,male,586,132,77,43,0,43,0,0,0
1523612,58,11,1955,7,female,749,134,75,43,15,43,10,0,5
1663563,18,28,1995,2,female,892,133,88,44,49,44,23,0,26
1206499,26,5,1987,2,male,179,133,105,44,37,44,34,0,3
2108023,36,7,1977,10,male,205,131,102,44,34,44,20,0,14
1288946,38,25,1975,5,female,729,134,114,44,44,44,42,0,2
1577379,43,19,1970,1,male,521,131,102,43,45,43,34,0,11
1089847,26,26,1987,11,male,331,130,76,44,96,44,91,0,5
1041848,47,24,1966,5,female,2287,133,67,44,284,44,143,0,141
1330893,72,2,1941,12,female,466,130,84,45,1,0,1,45,0
2002626,49,26,1964,1,female,394,132,53,45,25,0,2,45,23
2064600,18,24,1995,11,female,131,132,125,45,66,22,17,23,49
2029600,14,22,1999,10,male,293,134,92,45,12,43,7,2,5
1165242,65,7,1948,10,male,1743,134,40,45,76,37,42,8,34
1449410,16,30,1997,6,male,289,131,75,45,2,45,2,0,0
1522787,22,1,1991,1,male,266,130,114,45,14,45,5,0,9
1479576,90,8,1923,12,male,2198,134,96,45,9,45,9,0,0
1919752,32,31,1981,12,female,196,133,113,45,54,45,37,0,17
1274160,46,25,1967,1,female,173,133,56,45,94,45,64,0,30
1037866,25,12,1988,12,female,315,130,77,46,1,46,0,0,1
1550003,16,20,1997,8,female,306,130,81,46,47,46,37,0,10
1414635,29,4,1984,7,female,451,132,82,46,37,46,34,0,3
1962533,25,16,1988,9,male,228,133,26,48,0,3,0,45,0
1873161,18,4,1995,9,female,149,133,117,49,17,0,2,49,15
2027292,59,26,1954,1,female,1603,132,77,49,23,0,4,49,19
1686394,35,29,1978,10,female,310,131,72,49,36,0,11,49,25
1245033,52,20,1961,5,female,163,131,81,48,40,5,23,43,17
1981143,59,24,1954,8,male,1707,130,24,49,61,0,25,49,36
1529390,27,16,1986,9,female,236,134,19,48,58,34,42,14,16
1364878,23,17,1990,11,male,558,132,84,49,123,32,70,17,53
1906603,19,25,1994,12,male,367,130,66,50,21,8,6,42,15
1374900,20,24,1993,5,male,253,131,81,51,57,0,22,51,35
1692569,19,20,1994,4,female,578,131,99,50,89,24,45,26,44
1800629,58,6,1955,7,male,546,131,81,51,146,17,27,34,119
1712338,18,7,1995,9,female,1646,132,35,50,64,45,45,5,19
1543081,84,23,1929,4,female,2352,134,85,50,54,50,30,0,24
1308631,20,22,1993,1,male,342,134,77,51,174,51,57,0,117
1156092,25,23,1988,3,male,147,132,60,51,181,51,177,0,4
1116074,66,8,1947,2,female,745,133,74,53,72,1,17,52,55
1205374,43,23,1970,4,male,548,131,115,52,58,50,22,2,36
2068608,46,8,1967,9,male,1129,131,65,53,48,50,32,3,16
1351946,16,6,1997,12,female,229,132,64,52,18,52,16,0,2
1366967,18,10,1995,8,male,354,130,105,52,47,52,33,0,14
1193625,108,8,1905,10,female,135,130,118,55,44,0,4,55,40
2137928,24,7,1989,8,female,703,130,48,55,32,52,16,3,16
1949676,42,4,1971,8,female,384,134,81,55,340,50,105,5,235
1646317,20,19,1993,11,female,549,130,54,54,163,54,99,0,64
1762735,34,6,1979,2,male,1730,131,40,56,29,54,14,2,15
1758946,73,2,1940,2,female,1639,134,76,57,217,53,146,4,71
1849833,37,23,1976,6,male,88,130,118,57,1,57,0,0,1
1856218,24,18,1989,7,male,572,133,83,56,17,56,11,0,6
1585641,47,6,1966,12,male,35,133,59,56,22,56,19,0,3
1397396,20,14,1993,2,male,226,130,108,57,47,57,46,0,1
1010723,23,2,1990,3,female,165,132,118,58,46,58,16,0,30
1857071,15,30,1998,1,male,618,134,91,59,4,24,1,35,3
1600073,67,27,1946,12,female,1692,132,46,59,11,19,7,40,4
1160638,21,27,1992,6,male,558,134,89,59,68,54,51,5,17
1252124,26,18,1987,8,male,532,131,118,59,0,59,0,0,0
1984839,32,9,1981,6,male,159,134,103,60,1,60,1,0,0
1759266,77,1,1936,6,male,1632,133,51,59,165,59,132,0,33
2113391,17,14,1996,9,female,450,131,80,63,11,0,1,63,10
1304236,62,2,1951,11,female,980,134,87,62,86,0,11,62,75
1336902,22,1,1991,2,male,355,132,73,61,69,53,44,8,25
1882539,93,30,1920,8,female,888,132,59,63,54,59,28,4,26
1473087,23,10,1990,10,female,165,132,61,61,123,54,74,7,49
1215309,54,13,1959,5,female,2245,134,78,61,33,61,7,0,26
1118462,14,20,1999,2,male,331,133,71,63,118,63,94,0,24
1627530,36,3,1977,6,male,425,134,118,62,102,62,81,0,21
2093941,32,19,1981,12,male,246,132,83,64,131,8,38,56,93
1621566,32,19,1981,3,female,254,131,62,64,30,64,25,0,5
1124046,90,18,1923,2,male,1204,130,84,67,88,0,12,67,76
1139056,60,17,1953,2,female,1593,130,73,68,133,10,26,58,107
2012085,36,16,1977,1,female,171,130,89,67,56,67,17,0,39
1535481,100,27,1913,6,female,339,130,67,67,111,67,105,0,6
1438791,108,25,1905,2,female,2009,134,58,70,11,9,3,61,8
1410357,44,15,1969,11,female,437,130,104,69,201,6,133,63,68
1786181,102,5,1911,4,female,2261,131,81,71,114,0,21,71,93
1106989,32,18,1981,6,male,964,133,98,69,0,69,0,0,0
1890206,26,26,1987,2,male,307,132,74,71,32,71,23,0,9
1462438,43,5,1970,3,male,659,131,98,69,21,69,15,0,6
1843655,29,6,1984,3,female,466,134,47,70,92,70,58,0,34
1008396,31,5,1982,12,female,658,132,66,70,72,70,55,0,17
1965746,34,12,1979,1,male,505,131,60,69,145,69,35,0,110
1183638,70,12,1943,3,female,1692,134,70,74,125,0,18,74,107
1784955,21,3,1992,5,female,614,130,67,74,98,18,27,56,71
2174862,45,25,1968,7,female,395,132,120,72,2,70,1,2,1
2180270,24,28,1989,11,female,191,132,115,74,19,72,10,2,9
1237943,15,24,1998,3,female,39,132,78,73,26,73,12,0,14
1377899,22,2,1991,8,female,645,132,13,72,30,72,24,0,6
1734106,26,30,1987,12,female,478,130,41,72,21,72,18,0,3
1275883,26,12,1987,6,male,329,133,126,72,36,72,29,0,7
2036004,50,13,1963,12,female,674,132,78,77,13,0,2,77,11
1689074,51,6,1962,10,female,2199,132,22,77,48,59,27,18,21
1031042,22,11,1991,11,female,470,134,72,76,25,76,23,0,2
1745645,76,22,1937,7,male,2266,134,45,76,28,76,22,0,6
1095300,103,31,1910,12,male,1918,130,51,76,38,76,26,0,12
1350800,45,6,1968,8,male,378,130,103,76,73,76,48,0,25
1416651,52,18,1961,6,female,954,130,75,80,1,1,1,79,0
1099396,106,17,1907,9,male,1062,133,67,79,61,0,26,79,35
1519568,93,15,1920,6,female,897,131,51,79,28,41,19,38,9
1812649,40,21,1973,5,female,16,134,118,79,132,48,74,31,58
1193166,17,2,1996,2,female,414,133,92,80,57,58,28,22,29
1113439,20,31,1993,10,female,262,132,62,78,112,72,81,6,31
1840113,24,5,1989,10,male,873,134,67,79,81,65,46,14,35
1739251,25,20,1988,4,female,183,132,94,79,107,75,56,4,51
1349228,52,10,1961,11,male,905,133,96,78,1,78,1,0,0
1173117,68,20,1945,2,male,626,133,117,80,3,80,1,0,2
2135301,22,16,1991,5,male,297,132,83,78,20,78,13,0,7
1434340,55,15,1958,8,female,691,131,91,79,33,79,11,0,22
1757567,52,28,1961,1,female,1662,133,76,81,13,0,7,81,6
1310951,30,8,1983,8,male,554,130,85,83,24,58,14,25,10
1386916,16,13,1997,7,female,145,130,79,81,109,19,31,62,78
1184861,22,27,1991,2,female,1212,133,65,82,21,80,7,2,14
1463957,103,16,1910,9,male,1077,130,102,81,36,81,15,0,21
1238821,38,31,1975,5,male,646,133,46,82,380,82,300,0,80
1744930,21,20,1992,8,male,221,132,106,87,60,86,30,1,30
1936051,61,19,1952,9,female,1641,134,106,86,62,83,60,3,2
1354306,36,11,1977,7,male,108,132,125,87,7,87,6,0,1
1731763,57,23,1956,5,female,691,134,54,87,39,87,17,0,22
1657246,22,9,1991,2,female,174,132,61,85,95,85,78,0,17
1279890,23,30,1990,10,male,269,134,76,87,126,87,72,0,54
2001367,45,21,1968,6,female,714,131,85,85,76,85,45,0,31
2178668,76,29,1937,3,male,1107,132,52,87,114,87,105,0,9
1249989,35,26,1978,12,female,616,132,55,89,178,7,5,82,173
1424036,17,15,1996,5,male,574,134,97,88,13,22,6,66,7
1335459,18,20,1995,9,male,25,132,123,90,27,25,16,65,11
1827849,15,1,1998,6,male,201,134,88,88,96,71,31,17,65
2165173,26,8,1987,11,female,1036,133,102,88,237,74,202,14,35
1056975,18,21,1995,12,female,312,132,67,90,42,90,41,0,1
1835537,42,6,1971,8,female,1066,131,85,95,29,8,16,87,13
1654107,65,13,1948,12,male,1003,132,61,95,132,0,62,95,70
1997263,103,10,1910,10,male,987,134,103,93,69,0,23,93,46
1639253,16,8,1997,5,male,113,133,102,93,15,63,15,30,0
1250232,86,20,1927,3,female,1642,134,69,94,34,46,12,48,22
1598732,19,8,1994,6,female,472,132,89,93,19,88,10,5,9
1072648,16,7,1997,10,female,391,130,59,95,76,71,46,24,30
1815444,14,29,1999,5,male,174,133,100,93,7,93,7,0,0
1875270,49,30,1964,4,male,790,134,81,94,11,94,7,0,4
1638255,29,15,1984,8,female,424,130,115,94,46,94,34,0,12
1491915,29,14,1984,8,male,355,132,105,93,56,93,56,0,0
1149123,24,19,1989,9,female,100,130,94,93,145,93,131,0,14
1442205,63,7,1950,7,female,82,130,74,99,48,0,7,99,41
1330018,18,17,1995,10,male,316,130,112,99,19,52,8,47,11
1500248,67,9,1946,12,female,1277,132,49,96,19,20,17,76,2
1635217,18,4,1995,6,male,185,132,123,96,88,82,25,14,63
1053970,27,18,1986,11,female,503,132,95,96,41,96,37,0,4
1757269,28,3,1985,12,male,29,130,127,99,56,99,51,0,5
1225678,30,1,1983,9,female,295,131,53,99,94,99,55,0,39
1243956,59,15,1954,5,male,638,130,50,103,69,20,34,83,35
1280485,50,6,1963,10,female,648,130,89,103,38,99,37,4,1
1171714,30,24,1983,8,female,399,134,101,101,32,101,25,0,7
1193633,22,2,1991,2,female,629,132,87,101,112,101,110,0,2
1508936,14,18,1999,2,female,81,134,64,105,13,105,11,0,2
1940494,17,2,1996,8,male,156,131,126,108,16,108,15,0,1
1430983,34,24,1979,4,male,446,131,103,107,60,107,53,0,7
1399721,50,3,1963,6,male,887,130,87,107,26,107,24,0,2
1864705,18,1,1995,7,male,409,134,74,106,122,106,102,0,20
1575361,25,18,1988,4,male,118,133,104,107,79,107,35,0,44
1739993,33,15,1980,4,male,387,132,115,105,116,105,90,0,26
1252342,54,4,1959,5,male,449,130,109,110,63,11,31,99,32
1732570,15,1,1998,12,male,224,131,48,111,24,25,13,86,11
1238971,16,30,1997,1,male,230,134,87,111,51,66,24,45,27
1265325,21,5,1992,4,male,624,131,86,113,10,110,3,3,7
1052608,23,22,1990,10,male,489,130,77,110,25,103,18,7,7
1227487,21,9,1992,7,male,387,131,88,113,116,111,41,2,75
1948304,26,12,1987,10,male,566,131,65,112,82,107,65,5,17
1343915,17,14,1996,2,male,178,130,117,117,2,0,0,117,2
1862794,21,31,1992,3,male,536,131,125,114,7,0,0,114,7
2055702,25,18,1988,9,male,364,132,75,115,15,86,6,29,9
1941076,38,23,1975,1,male,178,131,92,118,31,117,25,1,6
1236097,17,9,1996,11,female,564,130,29,119,12,119,12,0,0
1522084,23,14,1990,10,male,444,133,76,117,56,117,36,0,20
1699159,18,12,1995,7,female,442,132,111,124,70,4,28,120,42
2054020,69,21,1944,10,female,565,132,70,124,200,0,39,124,161
2144442,26,7,1987,7,female,519,134,77,122,110,62,93,60,17
1249245,47,13,1966,5,female,488,131,107,124,112,58,71,66,41
1982314,68,13,1945,6,female,2257,132,57,120,21,109,16,11,5
2103388,27,6,1986,10,female,334,130,100,120,216,120,214,0,2
1705522,17,18,1996,3,female,637,134,39,128,24,124,21,4,3
1501118,19,29,1994,10,male,680,130,61,127,52,117,23,10,29
1738199,59,12,1954,8,male,1065,130,106,128,71,126,51,2,20
1350109,41,7,1972,9,female,573,132,70,126,155,115,121,11,34
1162745,20,21,1993,7,female,578,134,37,128,27,128,22,0,5
1283632,33,12,1980,6,male,420,132,78,128,60,128,42,0,18
1148096,28,3,1985,2,male,600,130,98,126,85,126,62,0,23
1383663,48,28,1965,4,female,758,131,21,136,82,0,37,136,45
2047323,20,17,1993,1,male,149,131,57,136,73,136,48,0,25
1330566,22,26,1991,2,female,626,134,48,133,211,133,210,0,1
1066735,18,4,1995,2,male,398,133,60,141,44,109,14,32,30
2133652,26,5,1987,2,male,119,130,115,139,117,139,98,0,19
2122538,45,28,1968,2,female,1205,134,55,138,243,138,177,0,66
2181638,15,22,1998,4,male,110,130,107,147,68,19,31,128,37
1359349,56,9,1957,11,female,1018,132,78,146,58,15,27,131,31
1337738,28,8,1985,3,male,494,132,47,147,132,16,13,131,119
1378025,22,12,1991,3,male,284,130,99,148,114,69,38,79,76
1079693,56,17,1957,11,male,56,132,104,148,108,59,42,89,66
1848354,57,15,1956,5,male,769,133,33,144,99,29,7,115,92
1920127,49,7,1964,2,male,1476,131,76,146,59,146,46,0,13
1331486,22,16,1991,11,female,212,134,71,157,17,47,12,110,5
1711821,28,21,1985,9,female,315,134,121,155,92,97,82,58,10
2020608,68,15,1945,3,male,1201,132,60,154,90,38,68,116,22
1700555,20,19,1993,8,female,9,130,101,157,105,77,50,80,55
1124160,58,16,1955,7,female,2068,134,74,152,253,51,151,101,102
2104066,39,29,1974,10,female,185,134,106,157,64,157,50,0,14
1055744,37,14,1976,8,female,360,133,66,159,79,158,58,1,21
2156116,14,14,1999,1,male,486,131,49,162,38,162,37,0,1
1392290,22,4,1991,7,male,83,133,126,162,67,162,65,0,2
1648286,50,10,1963,5,female,1469,131,35,163,204,163,160,0,44
1113322,25,25,1988,2,female,95,132,110,164,404,164,354,0,50
1930581,48,16,1965,5,female,580,133,80,165,189,21,49,144,140
1373402,67,26,1946,12,female,1712,130,66,166,91,125,55,41,36
1337160,58,8,1955,8,female,576,130,103,171,180,147,57,24,123
2115583,17,9,1996,8,male,324,130,13,166,1,166,0,0,1
1485075,43,15,1970,4,male,319,134,124,167,15,167,14,0,1
1386524,23,25,1990,2,female,522,133,61,169,85,169,75,0,10
1209661,67,5,1946,8,male,89,130,96,172,69,172,33,0,36
1195952,45,14,1968,2,female,1303,132,94,174,38,3,14,171,24
1854901,113,23,1900,10,female,1702,133,49,177,90,14,69,163,21
1859416,66,23,1947,9,female,1586,131,103,173,28,71,13,102,15
2003539,53,5,1960,1,male,919,132,78,173,263,84,194,89,69
1292873,52,15,1961,2,male,866,130,102,178,129,161,80,17,49
2124511,34,13,1979,5,female,307,130,121,180,296,177,173,3,123
1303444,33,27,1980,2,male,1190,134,38,177,5,177,5,0,0
1863926,18,9,1995,12,female,131,130,98,177,34,177,20,0,14
2068486,29,2,1984,7,female,359,132,101,175,73,175,50,0,23
1624038,26,20,1987,6,female,328,131,80,175,125,175,113,0,12
1551022,27,25,1986,1,female,1964,130,57,173,242,173,217,0,25
2168087,28,2,1985,9,female,289,130,69,175,232,175,211,0,21
1675190,33,31,1980,1,male,403,131,97,175,247,175,220,0,27
1879479,17,3,1996,5,male,57,130,117,189,157,119,88,70,69
2091734,103,20,1910,10,female,1548,133,96,185,263,92,158,93,105
1496269,26,24,1987,7,male,216,131,128,183,17,178,15,5,2
1210241,64,2,1949,10,male,845,132,92,196,35,0,10,196,25
1637446,62,15,1951,8,female,687,134,80,197,31,79,5,118,26
1474613,21,24,1992,4,male,619,131,86,199,203,87,52,112,151
2056913,50,30,1963,9,male,678,133,58,191,20,164,10,27,10
1271981,30,9,1983,1,male,475,131,21,196,76,189,75,7,1
1371657,29,6,1984,6,female,564,134,50,193,304,177,186,16,118
1423800,65,11,1948,6,male,1949,134,64,191,14,190,7,1,7
1539609,14,26,1999,6,male,307,133,92,199,135,199,72,0,63
1396111,19,6,1994,12,female,485,130,87,209,184,171,154,38,30
1360762,40,15,1973,4,female,1677,133,61,211,244,205,206,6,38
2000637,44,17,1969,8,male,696,130,82,203,295,170,173,33,122
2005276,65,12,1948,11,female,1486,132,66,204,124,204,55,0,69
1948229,25,30,1988,9,female,318,132,79,216,168,20,85,196,83
1393180,47,4,1966,8,female,704,131,64,212,219,23,13,189,206
1623962,44,8,1969,8,female,2398,132,68,220,130,101,48,119,82
2048763,19,28,1994,10,male,45,133,127,219,237,145,159,74,78
1359874,34,23,1979,5,female,520,133,66,213,221,78,130,135,91
1321015,38,12,1975,2,female,456,132,84,214,46,185,37,29,9
1588494,56,21,1957,6,female,1474,131,57,216,106,175,61,41,45
1912832,26,5,1987,2,female,339,133,56,212,61,212,41,0,20
1287988,47,29,1966,7,female,308,130,102,212,84,212,54,0,30
1955966,50,11,1963,1,male,1407,131,84,215,81,215,42,0,39
2033892,47,1,1966,8,female,970,130,21,226,970,5,306,221,664
1485581,46,24,1967,1,female,857,134,37,225,21,116,10,109,11
2007914,20,29,1993,12,male,1438,132,97,227,128,115,76,112,52
2004272,49,12,1964,11,female,1104,130,91,231,258,163,161,68,97
1660688,23,6,1990,9,male,646,133,116,223,228,187,111,36,117
1686443,34,5,1979,1,female,666,130,45,230,321,225,294,5,27
1711333,96,17,1917,9,male,876,132,62,224,165,168,109,56,56
1304651,25,22,1988,1,female,178,134,85,227,130,227,43,0,87
1440036,30,3,1983,1,male,618,134,52,225,126,225,124,0,2
1832235,15,9,1998,8,male,208,133,94,235,86,186,70,49,16
1715544,41,14,1972,8,female,817,130,76,239,98,188,46,51,52
1270094,37,13,1976,2,male,604,132,114,242,214,240,166,2,48
2021837,31,28,1982,11,female,133,133,41,236,466,236,250,0,216
1560248,36,15,1977,8,male,334,133,65,252,55,0,21,252,34
1158163,60,2,1953,10,female,722,134,84,249,135,0,51,249,84
2146452,62,28,1951,4,female,1251,134,123,250,97,0,25,250,72
1699667,42,20,1971,4,female,1697,130,42,248,251,17,101,231,150
1059225,65,31,1948,1,female,969,130,78,260,309,0,129,260,180
1427308,56,24,1957,11,male,250,134,106,250,225,250,173,0,52
1329650,72,13,1941,5,female,574,132,78,264,54,0,10,264,44
2033997,55,9,1958,1,male,693,132,71,266,172,46,70,220,102
1271438,15,29,1998,11,female,638,133,77,262,208,255,189,7,19
1174315,32,16,1981,7,male,313,130,77,267,33,267,19,0,14
1704763,37,15,1976,12,male,412,131,102,275,14,275,11,0,3
1684796,55,22,1958,3,female,1255,130,87,265,37,265,17,0,20
1986506,28,12,1985,12,male,766,134,97,272,111,272,108,0,3
1907934,42,6,1971,9,female,341,131,93,262,245,262,160,0,85
2161959,42,29,1971,6,female,1218,134,37,285,378,62,100,223,278
1219487,71,6,1942,5,female,590,131,75,286,22,282,13,4,9
1625775,15,6,1998,8,female,407,130,62,286,67,245,40,41,27
1903151,20,27,1993,11,female,80,133,43,285,386,278,266,7,120
1804336,31,15,1982,8,female,2027,131,57,285,259,283,168,2,91
1810435,56,18,1957,6,female,324,133,122,282,22,282,13,0,9
1577879,59,5,1954,10,female,739,133,36,296,141,0,39,296,102
2165289,19,16,1994,9,male,143,131,125,300,21,157,8,143,13
1173412,21,18,1992,4,female,550,130,77,300,68,203,25,97,43
1637220,108,19,1905,8,female,1862,132,72,302,279,79,229,223,50
1743396,39,6,1974,1,female,987,132,70,298,64,278,44,20,20
1891437,108,14,1905,8,male,1529,134,38,300,120,258,70,42,50
2188211,28,28,1985,8,female,180,134,90,299,377,240,317,59,60
1358359,33,16,1980,2,female,174,132,98,293,542,287,303,6,239
1473344,17,27,1996,9,female,80,134,77,305,97,305,87,0,10
1797444,30,24,1983,4,female,166,133,116,301,172,301,151,0,21
1095755,63,1,1950,1,female,2136,131,65,303,145,303,118,0,27
1440227,22,8,1991,8,male,685,134,96,315,306,182,154,133,152
1796292,30,2,1983,11,male,402,130,87,316,59,241,41,75,18
1214046,63,2,1950,11,female,1898,132,47,321,237,303,122,18,115
2037915,15,5,1998,5,male,310,131,72,311,42,311,40,0,2
1129658,28,9,1985,9,male,1076,130,44,310,282,310,231,0,51
1638939,45,3,1968,6,female,462,131,99,330,107,161,45,169,62
1825912,64,15,1949,8,female,1398,130,67,369,155,1,5,368,150
1505983,59,11,1954,4,female,573,130,80,356,325,16,61,340,264
1861808,65,2,1948,5,female,1532,133,49,353,221,0,15,353,206
1144224,22,30,1991,12,female,440,132,70,356,347,117,150,239,197
1304578,65,27,1948,6,female,1038,130,38,352,70,301,42,51,28
1440013,37,27,1976,6,male,443,132,78,353,0,353,0,0,0
1602380,60,22,1953,7,female,700,132,123,370,13,0,3,370,10
1186868,60,7,1953,8,female,1017,132,100,372,50,1,3,371,47
2190231,103,12,1910,2,female,588,130,20,370,169,254,30,116,139
1580657,21,15,1992,2,male,322,132,79,372,257,229,56,143,201
1290769,16,25,1997,6,female,442,130,73,380,529,288,321,92,208
1882307,18,10,1995,2,male,261,132,66,385,29,385,28,0,1
1253356,49,14,1964,2,female,796,130,69,406,64,359,23,47,41
2096748,49,20,1964,9,male,790,131,98,407,64,334,42,73,22
1508142,15,25,1998,8,male,148,130,99,419,71,396,50,23,21
1468662,72,8,1941,9,male,33,134,97,406,21,406,7,0,14
2042285,21,7,1992,3,male,493,130,75,397,148,397,139,0,9
1541276,24,6,1989,9,male,158,130,111,408,241,408,205,0,36
2117500,37,25,1976,4,female,608,134,70,408,77,408,44,0,33
1474629,14,13,1999,11,female,153,132,82,413,444,413,325,0,119
1799553,44,26,1969,3,male,304,133,102,451,187,321,108,130,79
1469176,42,7,1971,3,female,788,134,50,431,633,279,245,152,388
1894307,48,24,1965,6,female,1086,134,73,435,342,277,97,158,245
1532982,20,16,1993,6,male,144,133,116,433,20,433,20,0,0
1104161,18,1,1995,7,female,243,132,98,434,74,434,67,0,7
1972324,61,11,1952,8,male,700,130,87,432,387,432,350,0,37
1600568,65,30,1948,6,female,222,133,99,459,126,0,48,459,78
1711890,32,6,1981,10,male,828,132,122,457,337,290,281,167,56
1574543,17,27,1996,11,male,475,132,93,478,177,423,144,55,33
1874003,52,30,1961,9,female,258,131,97,472,201,431,122,41,79
1993268,25,1,1988,1,male,237,133,104,461,22,461,13,0,9
1086347,24,13,1989,2,female,2100,133,85,467,257,467,223,0,34
1507161,35,25,1978,2,male,542,130,44,471,297,471,292,0,5
1589468,49,20,1964,8,female,781,132,77,510,178,0,75,510,103
1210124,55,4,1958,12,female,533,133,58,500,165,34,100,466,65
1986625,21,10,1992,6,female,401,132,74,518,122,512,66,6,56
1624576,40,25,1973,10,male,612,134,50,518,268,420,201,98,67
1946392,17,15,1996,2,male,472,131,61,503,20,503,17,0,3
1779175,30,1,1983,4,female,143,134,28,492,124,492,112,0,12
1866789,65,11,1948,3,female,323,131,117,504,262,504,121,0,141
1083091,78,2,1935,9,female,192,130,100,555,527,0,148,555,379
1328409,42,17,1971,7,male,535,134,119,530,180,311,149,219,31
1809072,28,10,1985,1,female,289,132,86,527,6,522,3,5,3
1937129,24,23,1989,1,female,737,130,59,543,315,540,191,3,124
1031330,23,16,1990,9,female,63,133,87,559,387,554,184,5,203
2122376,25,7,1988,11,female,97,133,114,527,124,527,112,0,12
1794152,25,1,1988,1,male,260,130,92,557,120,557,92,0,28
1053329,51,30,1962,8,female,505,133,99,561,209,561,185,0,24
1770078,70,17,1943,11,female,2388,130,41,582,243,0,139,582,104
1349538,44,19,1969,4,female,1381,131,26,570,956,475,585,95,371
1501573,51,1,1962,1,male,1318,132,56,604,268,604,138,0,130
1611240,62,31,1951,12,female,673,134,82,625,121,0,50,625,71
2021336,64,18,1949,1,male,334,133,78,663,135,0,20,663,115
1166339,47,7,1966,4,female,886,130,53,614,720,1,276,613,444
1728030,29,8,1984,2,male,199,131,74,625,91,616,78,9,13
1466107,58,29,1955,10,female,1888,133,80,618,278,571,167,47,111
1397813,66,24,1947,4,female,1683,133,22,650,346,626,306,24,40
1986713,41,2,1972,4,female,319,134,105,612,22,612,20,0,2
2008957,47,12,1966,1,female,168,133,66,641,93,641,81,0,12
1571534,65,30,1948,8,female,1068,133,105,657,62,657,47,0,15
1567251,17,1,1996,1,male,74,130,117,645,332,645,214,0,118
1655228,24,1,1989,1,male,342,131,98,642,179,642,118,0,61
1403897,59,18,1954,1,female,603,131,21,660,470,660,273,0,197
1962053,21,9,1992,3,female,336,133,108,716,49,454,20,262,29
1511321,47,29,1966,3,female,2179,132,51,703,811,492,402,211,409
1348890,49,20,1964,1,female,1667,131,56,711,808,708,425,3,383
2003119,30,9,1983,5,female,337,134,96,706,306,706,204,0,102
1881854,62,1,1951,2,female,1267,132,80,752,162,0,71,752,91
1181591,68,9,1945,4,female,1199,134,111,763,382,32,178,731,204
1746163,22,27,1991,6,female,1957,133,50,748,581,205,305,543,276
1984089,61,9,1952,5,female,44,133,125,783,390,749,286,34,104
1402757,15,25,1998,8,male,481,131,53,734,28,734,4,0,24
1258795,23,2,1990,4,female,759,132,74,821,177,10,42,811,135
1294080,17,4,1996,10,female,161,132,89,805,1162,14,577,791,585
1318547,53,29,1960,6,female,1837,134,64,804,508,18,129,786,379
1939788,108,24,1905,8,male,1489,132,45,806,775,173,317,633,458
1783750,25,21,1988,12,female,256,132,89,872,638,872,576,0,62
1775193,50,7,1963,9,female,866,130,62,822,1285,822,1133,0,152
1740184,70,15,1943,6,female,944,130,69,938,280,0,104,938,176
1192168,16,27,1997,9,female,66,132,100,916,405,318,67,598,338
2133279,24,2,1989,1,male,250,133,57,930,252,638,74,292,178
1199450,38,25,1975,9,female,671,132,86,913,333,726,166,187,167
1993894,61,2,1952,8,female,208,130,91,958,296,958,206,0,90
1274098,63,17,1950,9,female,1541,131,40,946,291,946,223,0,68
2107969,68,29,1945,11,female,213,133,101,947,160,947,146,0,14
1174919,103,15,1910,10,male,1334,130,80,969,612,969,556,0,56
1086782,50,21,1963,3,female,194,131,71,1090,164,0,31,1090,133
2072126,67,23,1946,12,male,644,130,75,1068,400,474,229,594,171
1536467,45,17,1968,9,female,659,133,51,998,756,961,304,37,452
2167756,14,30,1999,12,female,130,131,71,1239,102,1198,34,41,68
1328337,25,31,1988,3,female,564,130,92,1202,649,1100,618,102,31
1199935,54,19,1959,9,female,495,134,110,1166,174,1166,105,0,69
1955819,70,17,1943,10,female,1656,133,49,1203,156,1203,64,0,92
1258794,29,25,1984,6,male,207,133,64,1512,535,1512,375,0,160
1303857,45,27,1968,1,male,574,130,79,1388,462,1388,372,0,90
2113324,78,5,1935,7,female,874,133,111,1529,1064,144,227,1385,837
1647159,22,3,1991,9,female,904,134,58,1709,3330,284,1743,1425,1587
1340955,43,29,1970,5,female,113,130,95,1788,168,1788,96,0,72
1610730,16,10,1997,3,male,70,134,57,2194,492,1688,403,506,89
1117404,16,12,1997,7,female,551,133,114,3065,1397,2579,1126,486,271
1536746,16,20,1997,11,female,490,134,96,3129,0,3129,0,0,0
1541740,33,19,1980,9,female,273,134,111,2825,3,2825,2,0,1
2052567,67,13,1946,8,female,950,131,62,3394,477,3394,441,0,36
1315335,52,10,1961,7,female,250,133,33,7424,2090,0,250,7424,1840
1738688,27,13,1986,12,female,131,134,65,4411,1701,4411,1508,0,193
1060233,33,29,1980,8,male,962,135,61,4,3,4,3,0,0
1106879,64,30,1949,9,female,1007,139,105,4,5,4,2,0,3
1678763,19,20,1994,7,male,403,138,52,4,17,4,11,0,6
1680433,25,28,1988,5,female,248,135,39,4,6,4,5,0,1
2189396,28,18,1985,11,male,199,135,107,4,29,4,11,0,18
1987856,33,10,1980,10,male,34,138,133,4,11,4,11,0,0
1819070,54,2,1959,3,male,950,139,40,4,62,4,52,0,10
2157872,68,1,1945,3,male,1095,135,41,4,8,4,8,0,0
1536389,34,15,1979,11,female,450,137,77,5,0,0,0,5,0
1812793,17,25,1996,6,male,184,136,127,5,1,0,0,5,1
1771534,14,4,1999,1,female,266,139,63,5,4,0,1,5,3
2051884,21,10,1992,5,male,363,136,132,5,0,4,0,1,0
2169700,25,27,1988,8,female,364,135,43,5,0,5,0,0,0
1740924,39,21,1974,11,male,336,139,47,5,0,5,0,0,0
1377674,16,1,1997,12,male,290,135,23,5,3,5,3,0,0
1408437,15,24,1998,5,female,170,136,69,5,7,5,7,0,0
1298122,36,12,1977,5,male,612,138,13,5,7,5,6,0,1
1399465,37,3,1976,8,female,210,139,129,5,5,5,3,0,2
1205998,103,30,1910,1,female,1807,135,65,5,6,5,0,0,6
1745918,20,8,1993,9,female,111,137,127,5,47,5,24,0,23
1406316,28,26,1985,7,female,216,135,22,5,36,5,13,0,23
1657638,57,15,1956,9,male,1693,138,81,5,69,5,50,0,19
1728127,61,21,1952,8,male,1705,135,47,5,20,5,10,0,10
2158406,23,11,1990,2,male,158,137,114,6,2,0,2,6,0
1062713,40,21,1973,5,female,362,137,32,6,1,0,0,6,1
1036025,19,15,1994,4,male,756,136,110,6,5,0,2,6,3
1368965,16,2,1997,2,male,346,137,80,6,11,1,6,5,5
1222080,23,18,1990,12,male,322,138,83,6,48,0,27,6,21
2136253,16,7,1997,1,female,588,136,26,6,7,5,3,1,4
1987151,26,30,1987,12,male,931,135,92,6,34,5,21,1,13
1194929,17,22,1996,9,male,250,137,40,6,0,6,0,0,0
2161031,19,1,1994,12,male,405,136,65,6,2,6,2,0,0
1592366,20,28,1993,6,male,166,135,116,6,3,6,3,0,0
2170667,25,8,1988,7,male,261,138,129,6,1,6,1,0,0
1412494,19,16,1994,11,female,553,138,86,6,4,6,2,0,2
1075307,19,19,1994,5,male,174,139,122,6,7,6,7,0,0
1690218,23,1,1990,1,male,32,135,133,6,8,6,5,0,3
2180300,29,21,1984,4,female,665,137,97,6,7,6,6,0,1
1180178,103,16,1910,8,male,429,135,118,6,4,6,4,0,0
1461096,16,25,1997,4,male,554,135,66,6,21,6,9,0,12
2153391,16,17,1997,6,male,357,135,101,6,9,6,9,0,0
2041507,19,22,1994,8,male,229,135,115,6,19,6,16,0,3
1496687,22,22,1991,4,female,66,135,29,6,28,6,28,0,0
1857062,26,21,1987,8,female,163,135,103,6,61,6,49,0,12
1170729,32,24,1981,3,male,257,138,95,6,30,6,3,0,27
2182004,14,24,1999,1,male,138,135,123,7,0,1,0,6,0
1741266,19,14,1994,7,female,215,136,86,7,2,0,1,7,1
1147932,41,26,1972,7,male,339,137,93,7,6,1,6,6,0
1218203,24,23,1989,9,female,343,137,62,7,54,1,12,6,42
1655073,53,28,1960,10,male,722,139,51,7,46,0,35,7,11
1274012,14,3,1999,9,male,376,137,63,7,11,3,10,4,1
2061055,24,30,1989,1,male,543,137,75,7,13,3,5,4,8
1158990,43,2,1970,5,female,756,136,51,7,13,3,4,4,9
1898752,18,8,1995,4,male,709,137,127,7,0,7,0,0,0
1697631,19,15,1994,7,male,249,135,103,7,0,7,0,0,0
1187600,27,24,1986,10,male,220,137,90,7,1,7,1,0,0
1812589,30,24,1983,9,male,118,136,106,7,1,7,1,0,0
1600165,14,12,1999,1,male,133,136,97,7,5,7,5,0,0
2129907,24,8,1989,8,male,413,135,87,7,7,7,7,0,0
1978096,25,12,1988,8,male,155,136,107,7,7,7,7,0,0
1388328,33,27,1980,8,male,199,139,103,7,8,7,4,0,4
1503226,54,25,1959,11,female,879,139,78,7,8,7,3,0,5
1693461,15,18,1998,8,male,267,135,40,7,256,7,126,0,130
1345096,18,22,1995,7,male,182,139,110,7,30,7,30,0,0
1074944,18,27,1995,9,male,104,139,112,7,15,7,14,0,1
1882968,20,25,1993,12,female,675,135,64,7,22,7,17,0,5
2028490,20,10,1993,4,female,350,138,72,7,32,7,16,0,16
2117773,20,6,1993,10,male,316,135,92,7,17,7,15,0,2
1903527,27,16,1986,12,male,320,139,77,7,22,7,16,0,6
1525215,44,23,1969,5,female,599,135,110,7,25,7,24,0,1
1046965,20,9,1993,9,male,207,137,110,8,0,0,0,8,0
1109413,25,14,1988,5,male,240,136,131,8,0,1,0,7,0
1261563,29,5,1984,3,female,348,138,71,8,6,0,0,8,6
1931993,31,13,1982,9,male,110,138,93,8,6,0,0,8,6
1820601,41,22,1972,9,male,269,138,98,8,11,1,5,7,6
1787507,29,19,1984,12,male,536,137,105,8,53,1,20,7,33
1270308,18,16,1995,2,male,1107,138,37,8,0,3,0,5,0
1641099,19,25,1994,6,male,585,137,82,8,1,4,0,4,1
1846269,18,22,1995,8,male,496,138,22,8,0,6,0,2,0
1176088,34,9,1979,7,male,191,135,68,8,3,8,1,0,2
1580886,21,29,1992,7,male,196,138,47,8,6,8,6,0,0
2068393,35,15,1978,7,male,934,135,57,8,6,8,6,0,0
1496592,16,9,1997,10,male,509,137,51,8,27,8,22,0,5
1525104,17,5,1996,10,female,269,135,124,8,14,8,14,0,0
1438638,63,31,1950,3,female,778,138,113,9,2,0,1,9,1
1824955,19,25,1994,9,male,362,135,120,9,10,1,2,8,8
1014598,78,18,1935,4,male,1792,138,51,9,9,0,6,9,3
2179998,36,16,1977,9,female,178,135,43,9,29,0,13,9,16
2015671,67,13,1946,10,male,1660,139,44,9,65,1,11,8,54
1355022,18,24,1995,3,female,204,136,64,9,26,6,18,3,8
1824104,48,29,1965,4,female,177,137,44,9,41,5,14,4,27
1009644,27,22,1986,10,male,630,138,80,9,5,8,3,1,2
1834174,24,17,1989,10,male,263,138,121,9,12,8,10,1,2
1926438,97,17,1916,11,male,912,139,118,9,0,9,0,0,0
1603887,28,25,1985,12,male,430,136,67,9,7,9,7,0,0
1897334,102,14,1911,2,male,850,139,106,9,7,9,0,0,7
1713848,19,19,1994,2,female,488,136,55,9,36,9,32,0,4
2155357,23,16,1990,8,male,391,136,107,9,25,9,19,0,6
1269250,85,23,1928,8,male,183,137,112,9,16,9,15,0,1
1846393,19,16,1994,2,female,336,137,69,10,1,0,0,10,1
2075881,76,8,1937,7,male,1523,138,38,10,14,0,3,10,11
1056280,46,15,1967,7,male,1047,139,35,10,14,2,4,8,10
2033330,53,4,1960,3,female,568,138,104,10,11,6,3,4,8
1181088,62,31,1951,8,female,103,137,96,10,1,9,0,1,1
1749391,18,1,1995,1,male,282,135,85,10,5,9,4,1,1
1380327,20,12,1993,9,male,481,139,119,10,22,9,18,1,4
1120364,20,15,1993,8,male,495,135,60,10,1,10,1,0,0
1295985,30,18,1983,6,female,567,136,33,10,1,10,0,0,1
1491145,19,16,1994,11,male,470,138,88,10,3,10,2,0,1
2043134,19,9,1994,9,male,509,139,73,10,3,10,3,0,0
1817740,27,10,1986,1,male,805,135,88,10,5,10,5,0,0
2065530,29,5,1984,10,female,111,137,114,10,6,10,3,0,3
1145638,19,6,1994,12,female,96,139,102,10,22,10,22,0,0
1732649,18,26,1995,5,female,220,135,67,10,16,10,9,0,7
1136837,19,25,1994,8,male,426,136,118,10,23,10,23,0,0
1860468,21,26,1992,5,male,497,135,58,10,36,10,29,0,7
1327174,17,13,1996,9,male,177,137,114,11,3,0,2,11,1
2159524,31,17,1982,8,male,306,135,93,11,12,0,4,11,8
1642025,40,23,1973,3,female,585,135,38,11,79,0,33,11,46
2173949,54,23,1959,4,female,572,137,76,11,37,0,9,11,28
1604206,36,15,1977,12,male,687,138,55,11,0,7,0,4,0
1028869,24,23,1989,8,male,499,138,77,11,7,3,3,8,4
1588884,20,17,1993,6,female,228,138,81,11,57,4,19,7,38
1219926,23,14,1990,3,female,735,135,106,11,50,3,20,8,30
1846404,28,26,1985,5,male,235,135,39,11,43,5,11,6,32
2104215,23,4,1990,9,male,606,138,66,11,2,8,1,3,1
1451813,25,1,1988,1,male,294,138,100,11,1,11,1,0,0
2182619,24,23,1989,9,male,562,138,69,11,3,11,1,0,2
1136402,17,3,1996,6,male,490,135,132,11,14,11,12,0,2
1114706,34,20,1979,2,female,113,137,104,11,21,11,17,0,4
2030693,75,27,1938,9,male,764,137,109,11,237,11,122,0,115
1549565,34,27,1979,12,male,244,138,49,12,1,0,0,12,1
1911753,18,15,1995,1,male,174,138,121,12,5,0,5,12,0
1230352,14,27,1999,9,female,283,139,84,12,1,5,0,7,1
1662301,18,11,1995,9,male,356,138,106,12,0,11,0,1,0
1565321,26,9,1987,5,female,561,136,66,12,40,10,18,2,22
1178231,26,6,1987,8,male,567,135,94,12,26,11,14,1,12
2057517,25,10,1988,2,male,261,136,115,12,5,12,4,0,1
1633274,20,24,1993,10,female,440,135,9,12,19,12,17,0,2
1515987,24,14,1989,9,male,336,136,49,12,24,12,17,0,7
1941499,38,4,1975,3,female,885,135,96,12,24,12,24,0,0
1603659,18,1,1995,1,male,523,137,102,13,12,0,6,13,6
1954657,23,25,1990,5,male,513,139,97,13,1,13,1,0,0
1572606,23,25,1990,9,female,155,135,117,13,0,13,0,0,0
1727961,25,9,1988,1,male,291,137,107,13,4,13,4,0,0
1828508,27,8,1986,11,female,299,138,81,13,6,13,4,0,2
1974891,55,19,1958,8,male,327,135,79,13,4,13,4,0,0
1447701,58,22,1955,10,female,129,138,135,13,3,13,1,0,2
1266766,14,25,1999,12,female,154,135,62,13,8,13,1,0,7
1594300,16,11,1997,4,male,254,138,120,13,10,13,5,0,5
1575196,19,3,1994,4,female,259,135,32,13,76,13,72,0,4
1498454,23,9,1990,9,female,571,138,39,13,71,13,43,0,28
1333024,17,2,1996,1,male,251,138,44,14,0,0,0,14,0
1046955,102,28,1911,12,female,778,138,72,14,5,2,0,12,5
1725485,25,28,1988,3,male,265,135,42,14,1,5,1,9,0
2065500,51,28,1962,5,male,739,135,24,14,10,5,6,9,4
1445131,16,9,1997,9,male,409,136,31,14,15,11,3,3,12
1599508,26,16,1987,9,male,791,138,65,14,2,14,2,0,0
1408695,15,21,1998,1,male,248,136,69,14,7,14,7,0,0
1545859,26,9,1987,3,male,184,138,123,14,3,14,3,0,0
1284878,32,22,1981,11,male,409,135,102,14,3,14,2,0,1
2178726,63,2,1950,4,male,638,136,93,14,8,14,6,0,2
1101287,54,16,1959,11,male,1836,139,32,14,19,14,16,0,3
1826656,108,18,1905,4,male,2355,135,76,14,18,14,16,0,2
1506450,31,7,1982,1,female,606,139,71,14,128,14,61,0,67
2058935,64,22,1949,10,male,1691,138,44,14,38,14,24,0,14
1979983,94,19,1919,1,female,1147,138,64,14,32,14,20,0,12
1964996,38,30,1975,6,female,1080,135,53,15,10,5,0,10,10
1843344,64,7,1949,1,female,1450,139,38,15,68,13,45,2,23
2142110,25,8,1988,8,male,678,138,35,15,56,15,7,0,49
1325951,14,10,1999,5,male,440,139,52,16,7,0,0,16,7
1242998,17,27,1996,9,male,958,136,71,16,3,3,1,13,2
1114723,19,31,1994,12,male,385,135,89,16,0,16,0,0,0
1349462,24,23,1989,12,female,713,138,47,16,1,16,0,0,1
1567273,50,11,1963,4,male,563,135,59,16,1,16,1,0,0
1106665,103,1,1910,9,male,375,139,108,16,0,16,0,0,0
1344746,31,3,1982,12,male,415,138,58,16,16,16,13,0,3
1538123,34,25,1979,7,female,200,135,95,16,14,16,12,0,2
1093714,27,4,1986,11,female,551,135,77,16,32,16,30,0,2
1407919,50,1,1963,1,male,196,139,81,16,28,16,27,0,1
1264114,83,5,1930,3,female,611,135,61,16,53,16,25,0,28
1178941,15,31,1998,7,male,890,136,65,17,10,0,4,17,6
1933463,52,14,1961,7,male,264,135,100,17,0,17,0,0,0
2054886,46,28,1967,2,male,955,135,100,17,18,17,16,0,2
1876329,51,29,1962,4,female,163,139,116,17,42,17,16,0,26
1189068,78,17,1935,11,male,725,139,118,18,1,1,0,17,1
1660461,16,4,1997,3,male,205,138,28,18,19,7,13,11,6
2031011,108,23,1905,11,female,1210,136,86,18,21,9,12,9,9
1562665,18,23,1995,5,male,277,135,108,18,42,7,5,11,37
1469037,108,23,1905,9,female,2008,138,58,18,4,15,4,3,0
1485096,15,28,1998,8,male,62,139,126,18,10,18,10,0,0
1799940,18,8,1995,11,female,304,139,95,18,5,18,4,0,1
1445482,23,18,1990,5,female,495,139,102,18,98,18,87,0,11
1681405,19,24,1994,2,male,382,135,69,19,33,0,6,19,27
1706664,25,14,1988,3,male,375,135,116,19,0,15,0,4,0
1168414,17,22,1996,7,male,273,139,110,19,10,16,10,3,0
2169014,47,18,1966,11,male,460,138,51,19,6,19,5,0,1
1217091,16,19,1997,3,male,233,139,106,19,24,19,22,0,2
2149654,17,2,1996,12,male,381,135,26,19,41,19,30,0,11
1638615,108,3,1905,10,female,1568,137,43,20,26,0,17,20,9
2114059,15,8,1998,1,female,412,139,61,20,64,7,36,13,28
1120708,14,31,1999,3,male,69,138,114,20,38,16,35,4,3
1330939,25,16,1988,8,male,732,137,89,20,3,20,2,0,1
1530347,48,18,1965,5,female,386,137,63,20,0,20,0,0,0
1958894,15,21,1998,8,male,365,136,90,20,5,20,5,0,0
1170886,18,2,1995,6,male,551,139,111,20,7,20,7,0,0
2141516,108,12,1905,5,male,235,138,126,20,25,20,6,0,19
1203417,31,15,1982,1,female,183,136,43,20,49,20,35,0,14
1578190,108,18,1905,5,male,1112,139,81,21,12,0,2,21,10
1513870,25,26,1988,11,female,575,137,40,21,28,21,11,0,17
1675849,62,22,1951,8,male,1475,139,36,21,17,21,11,0,6
1545923,22,5,1991,5,male,349,136,100,21,32,21,19,0,13
1685874,16,18,1997,11,female,277,138,67,22,3,0,3,22,0
1819841,29,6,1984,5,male,529,138,77,22,19,0,2,22,17
2192489,30,29,1983,6,female,674,137,60,22,55,0,20,22,35
1882284,19,21,1994,1,male,817,139,79,22,0,14,0,8,0
2138506,26,21,1987,11,male,42,136,90,22,0,20,0,2,0
1880627,30,9,1983,12,male,760,136,58,22,52,18,36,4,16
1831194,108,1,1905,1,male,849,135,66,22,58,21,13,1,45
1632209,17,13,1996,3,male,170,136,95,22,0,22,0,0,0
2063951,30,23,1983,9,female,82,138,47,22,12,22,10,0,2
1183153,16,29,1997,7,male,24,136,130,22,29,22,20,0,9
1765737,30,23,1983,11,female,425,136,51,22,26,22,10,0,16
1825445,108,20,1905,12,male,238,136,106,23,1,0,0,23,1
1192116,108,1,1905,9,male,846,137,96,23,10,0,2,23,8
1271149,29,11,1984,10,male,382,138,78,23,116,20,81,3,35
1983273,15,26,1998,8,female,430,139,35,23,0,23,0,0,0
1968233,18,25,1995,8,male,390,136,77,23,0,23,0,0,0
1860785,20,7,1993,7,male,631,137,102,23,7,23,4,0,3
2072468,22,6,1991,3,female,204,138,84,23,79,23,72,0,7
1215558,47,1,1966,4,female,690,137,95,23,54,23,50,0,4
2176952,16,25,1997,3,female,269,139,39,24,39,19,27,5,12
1424842,16,3,1997,4,male,55,138,119,24,16,24,16,0,0
1566697,102,20,1911,9,male,305,137,121,24,35,24,25,0,10
1070384,21,26,1992,2,male,559,136,117,25,3,1,3,24,0
2132081,63,2,1950,11,female,1621,135,71,25,10,0,3,25,7
1129361,59,10,1954,4,male,251,135,83,25,39,0,13,25,26
1437922,18,2,1995,10,male,474,137,99,25,1,12,1,13,0
1052623,18,17,1995,10,female,679,138,72,25,1,23,1,2,0
2022004,25,1,1988,2,male,352,137,99,25,7,25,4,0,3
1713880,22,21,1991,5,male,288,137,83,25,17,25,15,0,2
2003355,17,11,1996,6,male,285,139,81,26,3,26,3,0,0
1249177,21,30,1992,7,male,121,138,124,26,0,26,0,0,0
1349038,72,20,1941,12,female,1508,136,64,26,1,26,0,0,1
2126770,23,6,1990,1,female,455,136,65,26,69,26,67,0,2
1275253,19,9,1994,4,male,1189,135,78,27,1,8,1,19,0
1065899,26,23,1987,10,female,418,138,26,27,3,27,3,0,0
1750492,26,10,1987,3,male,129,135,80,27,12,27,8,0,4
1249328,108,28,1905,3,female,1311,137,87,27,13,27,10,0,3
1736817,27,17,1986,6,male,168,139,79,27,29,27,28,0,1
1035403,19,29,1994,12,male,569,138,75,27,42,27,39,0,3
1749343,47,14,1966,6,male,46,135,117,28,23,28,17,0,6
1770100,108,23,1905,9,male,153,135,72,28,51,28,51,0,0
1852066,32,30,1981,4,female,409,136,62,29,12,16,8,13,4
1485191,34,17,1979,6,female,466,139,47,29,6,25,4,4,2
1324917,43,23,1970,10,male,601,139,76,29,0,29,0,0,0
2087759,18,25,1995,4,female,290,139,85,29,16,29,16,0,0
2003379,24,18,1989,6,male,522,139,108,29,13,29,11,0,2
2047141,19,25,1994,7,female,279,136,42,29,171,29,168,0,3
1161374,16,1,1997,10,male,230,139,78,30,10,11,2,19,8
1103758,23,23,1990,10,female,473,137,79,30,14,27,9,3,5
1540689,29,18,1984,7,male,762,137,45,30,3,30,1,0,2
1322890,48,8,1965,3,male,1380,135,48,31,7,31,4,0,3
1515138,55,10,1958,4,female,1457,135,40,31,6,31,1,0,5
2128352,46,20,1967,5,male,307,136,48,30,41,30,34,0,7
1645406,47,11,1966,1,female,271,139,43,32,12,0,0,32,12
1353945,25,11,1988,8,female,283,135,116,32,46,5,14,27,32
1435120,69,4,1944,11,male,1039,135,54,32,112,3,71,29,41
1829246,45,1,1968,10,male,227,138,122,32,3,32,1,0,2
1054089,18,21,1995,10,female,206,136,114,33,6,33,1,0,5
1485760,50,22,1963,6,female,194,138,67,34,6,0,2,34,4
1529908,26,14,1987,8,male,452,135,91,34,23,1,12,33,11
1217793,33,10,1980,1,male,361,136,54,34,55,34,39,0,16
1193275,15,6,1998,7,male,462,137,83,36,37,11,24,25,13
1929370,25,8,1988,10,male,592,139,81,36,19,35,8,1,11
2061343,21,6,1992,9,male,45,139,102,35,28,32,21,3,7
2143920,26,28,1987,4,female,425,137,76,35,5,35,0,0,5
1204584,20,23,1993,5,female,380,136,91,36,18,36,18,0,0
1600232,103,4,1910,8,male,1430,136,72,36,16,36,10,0,6
1273486,17,11,1996,3,male,373,137,92,36,25,36,21,0,4
1753077,16,15,1997,12,male,369,135,85,37,54,0,20,37,34
2016110,24,12,1989,9,male,254,135,47,37,30,4,8,33,22
2033759,54,18,1959,3,female,521,135,75,37,27,0,12,37,15
1068009,46,28,1967,4,male,681,138,85,37,70,0,1,37,69
1017345,34,15,1979,9,male,437,136,50,37,14,13,12,24,2
1251219,33,28,1980,9,female,503,138,81,37,6,37,3,0,3
1231165,19,26,1994,4,female,221,138,73,37,9,37,9,0,0
2139190,24,16,1989,9,female,388,136,103,37,37,37,37,0,0
1168607,30,13,1983,2,male,529,135,109,37,33,37,12,0,21
1618824,27,28,1986,11,male,517,135,44,37,61,37,50,0,11
1283415,102,1,1911,1,female,1723,135,59,39,5,27,3,12,2
1255776,23,19,1990,12,male,272,137,103,38,64,37,38,1,26
2078211,18,9,1995,8,male,37,135,102,39,4,39,3,0,1
1617423,16,25,1997,1,male,483,139,81,39,9,39,7,0,2
2133196,55,15,1958,1,male,279,135,108,40,7,0,7,40,0
1161866,18,26,1995,9,male,235,137,101,40,94,0,19,40,75
2120262,37,11,1976,10,male,736,137,49,40,66,33,41,7,25
2036109,19,23,1994,11,male,314,136,106,40,2,40,0,0,2
1232374,16,6,1997,2,male,268,136,87,40,17,40,15,0,2
1407170,63,23,1950,6,female,816,139,72,42,21,0,5,42,16
1189433,63,12,1950,8,female,1009,138,60,42,10,0,4,42,6
1336494,73,25,1940,8,female,1181,136,98,42,29,0,13,42,16
1154101,28,19,1985,9,male,577,137,98,41,9,18,0,23,9
2011179,13,6,2000,2,male,78,135,112,42,32,29,17,13,15
1792715,24,21,1989,10,male,88,139,127,42,57,18,22,24,35
1435650,67,3,1946,11,female,1715,139,71,41,25,19,16,22,9
2075949,18,4,1995,6,male,391,137,86,42,10,33,4,9,6
1754890,19,19,1994,2,female,633,136,89,42,0,42,0,0,0
1210861,18,20,1995,10,male,559,137,79,42,45,42,33,0,12
2085848,22,24,1991,8,female,738,139,46,42,97,42,76,0,21
1090774,21,9,1992,8,female,859,138,69,44,157,24,106,20,51
1993042,112,1,1901,8,male,1719,136,97,43,19,41,16,2,3
1776144,21,29,1992,5,female,388,139,109,43,74,39,48,4,26
1187694,20,15,1993,7,male,823,136,123,43,5,43,5,0,0
1044173,87,2,1926,12,male,927,136,99,43,6,43,5,0,1
1583480,14,19,1999,7,male,134,136,88,43,13,43,13,0,0
1774155,108,22,1905,2,male,1729,136,91,44,16,44,6,0,10
1472417,36,4,1977,9,female,357,137,78,44,47,44,44,0,3
2030678,21,11,1992,9,female,455,138,42,43,132,43,130,0,2
1547464,73,13,1940,2,male,1370,138,98,45,21,0,3,45,18
1378790,23,6,1990,1,male,190,138,115,45,54,44,20,1,34
1652075,18,7,1995,4,male,143,137,119,45,15,45,7,0,8
1819610,32,19,1981,11,male,285,138,95,45,29,45,8,0,21
2058291,64,20,1949,8,female,1679,138,73,45,57,45,53,0,4
1266691,41,26,1972,4,female,645,136,81,47,6,36,3,11,3
1641363,108,29,1905,10,male,230,136,46,46,2,43,0,3,2
1986808,30,14,1983,11,male,1079,138,84,46,5,46,4,0,1
1057993,49,30,1964,3,female,152,139,132,46,0,46,0,0,0
1257015,36,7,1977,4,female,589,135,57,46,12,46,10,0,2
1340410,22,15,1991,6,female,229,137,86,48,18,0,2,48,16
1817648,36,6,1977,9,male,472,135,78,48,23,12,9,36,14
2015228,21,9,1992,12,female,1332,136,87,49,66,35,35,14,31
2000474,29,27,1984,12,female,614,138,77,48,53,32,29,16,24
1073290,32,27,1981,4,male,669,137,115,49,70,41,41,8,29
1382540,90,24,1923,8,female,1069,136,55,49,39,46,17,3,22
1844558,17,28,1996,4,female,484,139,25,49,42,49,25,0,17
1394061,21,8,1992,8,female,337,135,76,49,65,49,54,0,11
2078797,57,3,1956,10,female,624,138,43,51,101,0,26,51,75
1178555,19,7,1994,9,female,332,135,89,51,34,33,16,18,18
2084835,21,14,1992,11,male,173,137,100,50,47,31,26,19,21
1523093,14,14,1999,1,male,162,138,114,51,5,44,0,7,5
1535942,18,12,1995,11,female,491,138,96,51,7,48,6,3,1
2176259,50,12,1963,9,female,1001,137,64,50,54,46,28,4,26
1563477,19,14,1994,8,male,586,137,113,50,138,44,83,6,55
2121875,19,18,1994,11,female,263,136,71,51,17,51,12,0,5
1153176,28,12,1985,3,male,511,136,98,51,56,51,55,0,1
1799554,28,16,1985,10,male,282,138,61,53,26,7,8,46,18
1522224,28,24,1985,1,female,303,138,94,53,169,33,61,20,108
1903290,33,4,1980,4,male,62,137,68,52,119,33,112,19,7
1874883,32,24,1981,11,female,566,138,53,52,41,52,29,0,12
1449826,30,20,1983,4,male,514,135,99,52,97,52,62,0,35
1415254,21,10,1992,3,male,423,137,67,54,2,2,2,52,0
1385054,18,5,1995,11,female,470,136,71,55,39,31,13,24,26
1526119,46,19,1967,1,male,1411,138,54,54,170,27,37,27,133
1420339,19,1,1994,10,male,309,136,102,55,79,54,60,1,19
1665518,31,18,1982,8,female,203,135,93,55,30,55,28,0,2
1168282,25,1,1988,1,male,351,135,50,54,65,54,63,0,2
1959321,34,20,1979,2,male,831,138,70,54,49,54,39,0,10
1258275,36,25,1977,11,male,133,135,32,55,54,55,36,0,18
1596090,22,29,1991,11,female,621,136,80,56,141,31,35,25,106
1249603,27,13,1986,1,female,470,136,40,57,16,56,7,1,9
1773995,100,1,1913,1,male,428,138,101,56,94,52,76,4,18
1346882,23,19,1990,12,female,996,135,83,58,67,58,18,0,49
1240659,30,3,1983,7,male,437,136,91,56,54,56,32,0,22
1475234,103,12,1910,8,female,833,137,35,59,9,0,6,59,3
1866634,62,10,1951,4,female,1499,135,70,59,59,0,32,59,27
1707345,22,2,1991,3,male,383,137,85,59,74,41,47,18,27
1371882,15,12,1998,2,male,353,135,103,59,3,52,2,7,1
1215674,34,18,1979,1,female,252,135,118,59,32,47,19,12,13
1446747,26,22,1987,9,male,286,138,122,62,9,0,1,62,8
1603232,61,5,1952,6,female,657,136,119,62,28,0,9,62,19
1377028,14,31,1999,5,male,317,136,53,62,3,20,0,42,3
1138647,16,29,1997,8,male,269,138,118,62,0,29,0,33,0
1194403,57,5,1956,3,female,1948,136,47,62,30,29,10,33,20
1398135,14,18,1999,1,female,422,139,53,63,6,63,6,0,0
1499466,19,20,1994,8,male,385,138,81,61,0,61,0,0,0
1865685,25,8,1988,8,male,518,136,94,61,2,61,2,0,0
1170266,22,15,1991,4,male,543,135,77,62,34,62,29,0,5
1779697,103,29,1910,11,female,418,139,66,61,57,61,38,0,19
1042868,53,25,1960,11,male,267,139,46,65,155,1,60,64,95
1270766,19,14,1994,1,male,478,137,76,64,52,61,29,3,23
2048874,20,12,1993,2,female,215,139,115,64,38,64,30,0,8
1769854,22,10,1991,12,male,280,137,111,67,36,0,24,67,12
1952385,72,8,1941,9,female,523,137,109,68,62,0,38,68,24
1419734,47,23,1966,5,male,458,139,79,66,116,0,33,66,83
1132646,24,16,1989,6,female,262,138,104,67,68,37,31,30,37
1125991,20,19,1993,11,male,605,139,96,66,11,63,4,3,7
1407537,13,14,2000,7,male,110,136,51,66,0,66,0,0,0
1678632,32,14,1981,4,male,520,135,89,68,9,68,4,0,5
1802501,40,3,1973,6,male,666,138,81,67,72,67,67,0,5
2028952,19,4,1994,9,female,463,139,46,70,72,70,70,0,2
1307143,32,4,1981,4,male,800,138,66,70,224,70,220,0,4
1336703,41,22,1972,1,male,423,136,73,72,37,5,10,67,27
1768562,23,2,1990,10,male,829,137,66,72,96,0,2,72,94
2052034,51,10,1962,7,male,992,139,79,73,136,57,71,16,65
2040267,54,19,1959,7,female,254,136,82,73,231,69,151,4,80
2039872,18,21,1995,6,male,127,138,116,73,50,73,13,0,37
1628932,57,29,1956,12,female,597,139,125,76,28,1,1,75,27
1153614,16,16,1997,12,male,567,138,86,75,45,58,29,17,16
1989680,23,17,1990,2,female,361,137,63,76,13,73,6,3,7
1192313,75,4,1938,9,female,1445,138,88,76,44,56,24,20,20
1511520,59,10,1954,11,female,799,137,30,75,130,74,78,1,52
1306404,14,6,1999,8,male,224,137,88,75,12,75,12,0,0
1156325,20,10,1993,10,male,272,135,50,76,25,76,19,0,6
1881679,44,15,1969,2,male,258,136,81,77,61,77,41,0,20
1472866,93,27,1920,9,female,648,136,82,77,61,77,53,0,8
1880307,23,7,1990,12,female,97,138,44,77,350,77,242,0,108
1075730,56,23,1957,6,female,372,139,65,79,108,0,15,79,93
1111784,23,28,1990,9,female,467,139,98,78,29,53,14,25,15
1833166,65,17,1948,3,male,1717,139,67,79,16,23,3,56,13
1592064,14,18,1999,5,female,498,139,61,78,96,76,76,2,20
1244547,45,12,1968,2,female,236,135,93,80,128,79,61,1,67
1606100,28,16,1985,6,female,818,136,73,78,26,78,18,0,8
1894604,35,12,1978,10,female,561,139,106,80,19,80,12,0,7
1034003,22,26,1991,6,male,309,139,94,79,94,79,55,0,39
1001280,25,30,1988,3,female,206,138,32,78,63,78,52,0,11
1036315,36,10,1977,5,female,467,135,103,78,170,78,134,0,36
1907853,64,1,1949,4,female,614,136,98,81,13,0,3,81,10
1684943,53,7,1960,7,female,565,136,63,82,23,60,5,22,18
1370747,36,4,1977,1,female,366,135,65,81,59,78,37,3,22
1779371,18,25,1995,11,female,823,135,68,82,128,78,106,4,22
1114214,39,12,1974,4,female,2200,135,64,84,130,70,91,14,39
1217650,16,20,1997,8,male,259,138,110,82,10,82,9,0,1
2148019,29,18,1984,3,male,162,137,112,84,192,84,98,0,94
2098806,35,6,1978,8,female,128,136,106,81,467,81,397,0,70
1970353,107,3,1906,11,female,1823,139,35,85,114,50,19,35,95
2182247,28,2,1985,9,male,614,135,103,87,1,67,1,20,0
1821301,30,16,1983,6,male,340,136,120,86,43,86,39,0,4
1934043,23,26,1990,12,female,544,138,91,90,110,77,68,13,42
2034850,23,13,1990,2,male,465,137,57,95,144,82,79,13,65
2043245,56,26,1957,6,female,916,138,93,94,167,93,136,1,31
1049371,39,12,1974,7,female,337,137,94,92,24,92,12,0,12
1296379,26,28,1987,7,female,390,137,73,94,78,94,56,0,22
1840841,60,6,1953,11,female,844,138,85,98,72,5,29,93,43
2017585,59,22,1954,10,male,248,138,55,97,74,3,22,94,52
1491197,56,29,1957,5,male,46,136,53,98,136,70,83,28,53
2162002,23,23,1990,1,male,241,137,86,98,48,75,34,23,14
2113665,57,8,1956,3,male,1064,138,64,97,49,97,19,0,30
1263030,66,5,1947,11,male,422,138,93,99,203,99,114,0,89
1988833,113,12,1900,1,male,1723,138,72,101,281,0,102,101,179
1856172,61,30,1952,6,female,1122,138,88,104,91,33,41,71,50
1952215,21,28,1992,2,female,613,139,105,104,65,97,45,7,20
1378710,18,1,1995,12,male,237,139,107,100,2,100,0,0,2
1675871,19,30,1994,5,female,146,139,69,103,57,103,55,0,2
1103553,23,21,1990,1,female,151,138,92,102,78,102,53,0,25
1943852,55,11,1958,5,male,1022,137,67,103,87,103,54,0,33
1482785,62,26,1951,5,female,914,137,86,103,139,103,75,0,64
1600218,108,1,1905,1,male,1938,135,60,104,371,104,144,0,227
1092282,100,1,1913,9,male,1495,135,92,105,50,0,28,105,22
2014340,14,11,1999,5,female,405,138,58,109,7,98,2,11,5
1278789,26,20,1987,7,male,304,139,116,106,6,106,6,0,0
2112993,43,15,1970,1,male,1215,139,38,105,35,105,26,0,9
1119611,56,2,1957,11,female,145,135,93,112,165,8,30,104,135
2095829,103,1,1910,1,female,NA,137,52,110,74,0,21,110,53
1917845,27,17,1986,7,male,375,135,132,110,80,110,78,0,2
2075441,29,4,1984,1,female,145,135,75,114,23,114,15,0,8
2186387,60,27,1953,10,female,505,137,76,117,139,117,86,0,53
1436697,23,11,1990,2,male,538,135,75,123,29,120,15,3,14
1528277,27,5,1986,1,male,841,135,58,123,25,119,18,4,7
1943217,14,29,1999,12,male,232,138,79,122,158,95,97,27,61
1657446,18,7,1995,2,female,279,136,59,121,131,119,93,2,38
1800158,25,30,1988,10,female,119,137,94,128,57,92,42,36,15
1550025,17,30,1996,10,male,682,139,89,129,128,118,41,11,87
1318297,16,20,1997,3,female,490,137,68,127,278,125,259,2,19
1339414,51,12,1962,9,female,811,139,77,128,219,107,121,21,98
1060827,23,15,1990,4,female,263,138,28,126,25,126,21,0,4
1066727,27,4,1986,6,male,63,139,125,126,228,126,218,0,10
1928551,38,5,1975,9,male,235,136,103,134,3,28,0,106,3
1584996,32,1,1981,1,female,1337,137,48,134,63,103,30,31,33
1367952,45,29,1968,9,male,470,136,100,132,142,105,65,27,77
1000804,52,19,1961,2,female,875,137,110,134,58,133,46,1,12
1839761,14,30,1999,8,male,364,136,94,134,5,134,4,0,1
1863178,34,30,1979,10,female,232,138,102,142,42,4,28,138,14
1914912,23,29,1990,9,female,651,137,56,139,0,74,0,65,0
1517984,18,1,1995,6,male,336,135,54,138,76,133,59,5,17
1870992,28,17,1985,8,male,500,137,111,138,119,136,76,2,43
2079280,35,2,1978,9,female,927,135,56,140,226,122,115,18,111
1200129,27,20,1986,1,male,172,139,132,143,2,143,2,0,0
1291399,23,2,1990,2,female,205,136,48,141,85,141,46,0,39
1277572,20,31,1993,8,male,421,138,68,139,165,139,115,0,50
1598106,25,24,1988,8,female,144,135,43,140,209,140,190,0,19
2182113,21,6,1992,8,female,137,139,121,145,285,13,240,132,45
1749655,22,6,1991,11,female,54,139,130,149,177,147,154,2,23
1268443,42,14,1971,2,female,943,135,60,148,132,117,88,31,44
2056541,55,11,1958,12,female,719,136,27,150,377,109,106,41,271
1128610,16,18,1997,5,male,427,139,120,148,0,147,0,1,0
1767567,23,23,1990,7,male,287,137,89,146,9,146,7,0,2
1416708,25,20,1988,4,male,387,139,128,145,11,145,11,0,0
1659440,18,5,1995,10,female,89,136,100,150,37,150,25,0,12
1309470,23,23,1990,8,male,440,139,109,145,32,145,28,0,4
1800447,16,20,1997,8,female,283,135,95,151,21,143,15,8,6
1152708,38,13,1975,9,female,587,135,95,155,64,153,27,2,37
1445577,58,14,1955,8,female,980,138,58,156,349,113,172,43,177
1605402,24,7,1989,7,male,30,137,132,156,34,155,9,1,25
1858073,45,17,1968,5,male,308,136,87,151,32,151,11,0,21
1468478,22,18,1991,6,female,74,138,98,154,145,154,94,0,51
1254113,27,22,1986,10,female,832,135,58,160,170,113,136,47,34
1178616,49,8,1964,5,female,1841,136,108,160,138,82,61,78,77
1264742,29,24,1984,8,male,675,136,125,163,2,152,0,11,2
2107811,15,3,1998,5,male,82,139,93,161,94,161,64,0,30
1459712,15,20,1998,10,female,364,138,17,161,36,161,28,0,8
1545336,19,18,1994,4,female,451,136,77,158,48,158,35,0,13
1937569,54,15,1959,3,female,507,135,81,159,36,159,36,0,0
1754332,30,28,1983,2,female,187,138,112,161,159,161,51,0,108
1970142,38,8,1975,2,female,1953,135,78,170,310,85,226,85,84
1072588,33,1,1980,1,male,622,139,75,166,6,133,2,33,4
1491829,29,10,1984,11,female,218,135,73,172,118,162,81,10,37
1517672,29,23,1984,7,male,550,139,73,169,126,169,35,0,91
1892747,78,15,1935,9,male,1479,139,51,170,179,170,165,0,14
1527486,30,30,1983,5,female,151,135,101,181,155,83,53,98,102
1886160,16,30,1997,1,female,1100,139,81,178,14,160,3,18,11
1625503,20,21,1993,4,female,207,137,84,175,68,157,33,18,35
1998733,17,18,1996,10,male,168,135,110,181,27,181,22,0,5
1977724,26,20,1987,4,male,178,137,88,181,161,181,55,0,106
2117919,34,19,1979,1,female,2192,136,98,177,143,177,112,0,31
1352064,23,3,1990,8,male,260,138,85,187,5,99,4,88,1
1477251,64,23,1949,3,female,1127,136,54,184,49,79,13,105,36
1356981,57,27,1956,7,male,1141,135,54,189,119,108,68,81,51
1382673,19,26,1994,2,male,940,137,56,185,15,183,8,2,7
2000151,54,11,1959,11,female,1673,136,66,185,65,178,56,7,9
2175001,49,25,1964,2,female,1378,136,74,183,413,179,265,4,148
1982594,21,10,1992,7,male,478,136,57,188,27,188,18,0,9
1897554,92,28,1921,10,male,1274,139,75,192,248,38,152,154,96
1603722,66,1,1947,12,male,1342,136,89,194,205,136,81,58,124
1250000,21,9,1992,12,female,388,136,47,195,32,177,11,18,21
1425470,16,26,1997,2,male,539,136,89,192,238,181,172,11,66
1834868,21,18,1992,2,male,204,138,56,197,59,197,38,0,21
1760442,23,7,1990,1,male,366,136,102,200,50,200,50,0,0
1521145,32,7,1981,8,male,417,139,65,197,48,197,46,0,2
2129177,16,12,1997,1,male,248,135,73,205,32,1,10,204,22
1744965,23,29,1990,5,female,584,139,79,206,13,58,8,148,5
1025176,33,1,1980,7,female,600,139,79,205,373,126,110,79,263
1823535,68,29,1945,10,male,1688,136,48,211,234,203,130,8,104
1295716,20,11,1993,12,female,508,135,20,202,250,202,179,0,71
1902895,45,29,1968,10,female,260,139,105,210,217,210,118,0,99
1492112,54,22,1959,6,female,1294,138,62,220,200,92,97,128,103
1026384,20,18,1993,8,female,107,137,91,215,323,134,166,81,157
1223714,31,22,1982,1,female,401,137,80,217,146,215,101,2,45
1133691,25,31,1988,5,male,23,139,139,218,29,218,25,0,4
1966352,19,15,1994,9,male,5,136,124,215,37,215,27,0,10
2177472,18,28,1995,10,female,247,139,114,218,164,218,114,0,50
2101429,108,26,1905,3,male,249,135,64,224,78,158,27,66,51
1011087,30,5,1983,1,male,326,137,133,224,34,195,32,29,2
2185398,73,29,1940,10,male,565,135,109,235,38,0,17,235,21
1837109,57,6,1956,7,male,306,137,64,240,50,0,6,240,44
1031967,59,24,1954,2,female,1083,138,107,245,230,0,47,245,183
1969143,29,14,1984,9,male,649,137,86,235,77,94,9,141,68
2031808,24,26,1989,7,female,525,138,127,238,236,176,141,62,95
1517039,26,13,1987,2,female,118,136,116,246,256,246,234,0,22
1082765,20,13,1993,9,female,1521,137,76,247,336,31,75,216,261
1730244,108,13,1905,9,female,1865,139,95,251,184,214,112,37,72
1185063,59,28,1954,5,female,2305,135,65,253,421,190,185,63,236
1461909,34,2,1979,7,female,368,137,109,252,575,251,431,1,144
1769656,17,16,1996,2,female,107,136,124,255,39,255,34,0,5
1811570,104,19,1909,2,female,241,138,78,255,403,255,293,0,110
1225157,78,29,1935,4,female,1535,137,46,266,140,0,84,266,56
1553281,52,10,1961,2,female,1477,137,68,263,190,37,52,226,138
1253256,57,13,1956,9,female,1730,135,31,266,100,231,59,35,41
1304494,21,11,1992,5,female,755,136,80,261,254,240,136,21,118
1877600,24,25,1989,1,female,453,136,91,264,131,264,127,0,4
2189665,57,29,1956,1,female,966,137,77,261,308,261,216,0,92
1971129,51,20,1962,1,female,1290,139,68,281,160,127,127,154,33
1127660,14,31,1999,12,female,254,137,85,288,258,211,177,77,81
2019123,18,9,1995,10,male,274,135,99,286,47,286,35,0,12
1499472,48,25,1965,6,female,2128,139,48,279,134,279,118,0,16
1832633,49,16,1964,7,male,622,136,89,287,150,287,109,0,41
2056260,18,17,1995,8,female,456,137,102,280,176,280,164,0,12
2030852,107,20,1906,8,male,392,139,119,281,199,281,148,0,51
1256604,55,30,1958,9,female,294,136,66,281,450,281,220,0,230
1245225,21,19,1992,6,male,76,138,127,303,263,0,181,303,82
2137471,108,16,1905,1,female,65,137,125,296,15,235,12,61,3
2087762,36,19,1977,10,female,282,135,128,298,434,297,362,1,72
1913202,25,1,1988,1,female,160,139,86,305,116,305,33,0,83
1648313,18,12,1995,2,female,215,136,60,309,194,16,66,293,128
2006025,19,7,1994,2,male,53,137,111,309,290,22,119,287,171
1488390,42,18,1971,7,female,225,136,74,322,276,144,31,178,245
1759455,53,2,1960,1,female,1586,138,66,326,635,325,552,1,83
1187408,32,13,1981,11,female,71,138,46,314,117,314,112,0,5
1650682,34,12,1979,7,female,179,135,55,316,106,316,49,0,57
2102875,45,26,1968,11,male,346,139,26,318,110,318,76,0,34
1120698,38,19,1975,2,female,1651,137,33,311,475,311,342,0,133
2022221,26,10,1987,1,male,193,137,94,328,143,321,103,7,40
1242568,24,8,1989,9,female,308,136,61,328,678,282,437,46,241
1466050,25,8,1988,8,male,122,137,112,339,75,337,62,2,13
1324818,63,15,1950,2,female,1489,135,93,332,382,332,184,0,198
1154702,66,5,1947,12,female,1132,139,96,355,185,0,114,355,71
1828648,22,22,1991,8,male,187,135,69,353,77,177,28,176,49
1737795,52,25,1961,4,male,430,136,70,355,60,111,44,244,16
1476222,19,24,1994,8,female,321,135,71,362,140,338,48,24,92
1674129,31,16,1982,12,female,18,135,128,362,195,299,148,63,47
1905104,58,26,1955,11,female,207,135,101,350,101,327,92,23,9
2078101,66,11,1947,8,male,1077,138,99,390,85,0,15,390,70
1760545,20,5,1993,8,female,385,137,99,380,243,0,56,380,187
1888458,66,20,1947,6,female,395,138,104,386,391,1,107,385,284
2122537,16,8,1997,1,female,456,136,66,378,28,165,17,213,11
2000017,18,6,1995,8,male,79,135,100,387,145,221,93,166,52
1735751,38,19,1975,8,female,978,136,78,374,925,132,528,242,397
1172070,24,4,1989,7,female,240,137,40,386,143,386,85,0,58
1992403,25,10,1988,1,female,469,139,68,389,178,389,113,0,65
1845581,26,19,1987,2,female,503,136,89,390,67,390,26,0,41
1797477,27,14,1986,4,male,279,139,115,378,117,378,50,0,67
1726757,48,10,1965,5,female,272,136,62,380,145,380,107,0,38
2130024,36,27,1977,5,male,537,135,97,379,726,379,616,0,110
1089804,46,18,1967,5,female,1295,135,66,410,283,6,124,404,159
1917110,48,27,1965,9,female,496,138,43,416,328,0,119,416,209
1691727,95,30,1918,12,male,381,135,97,398,624,2,332,396,292
1016227,18,7,1995,11,female,396,137,111,408,602,136,277,272,325
2133885,26,28,1987,11,female,204,139,51,419,183,369,110,50,73
2026636,49,16,1964,5,female,358,137,94,448,20,448,11,0,9
2160691,45,21,1968,3,female,113,138,108,449,116,449,83,0,33
1682673,98,11,1915,6,male,1331,137,54,449,113,449,102,0,11
1012977,43,10,1970,10,female,675,137,93,424,738,424,581,0,157
1602420,52,4,1961,3,female,427,138,70,474,101,0,6,474,95
1264137,58,20,1955,4,female,1913,139,61,470,95,2,41,468,54
1578651,22,6,1991,1,female,363,139,75,476,594,243,260,233,334
1441175,63,14,1950,8,female,1184,139,90,461,152,370,120,91,32
1094688,19,16,1994,3,female,368,135,106,452,393,337,226,115,167
1606722,38,16,1975,9,female,1853,138,66,479,417,478,392,1,25
1969817,23,19,1990,5,female,385,135,89,496,262,26,85,470,177
1564971,17,3,1996,4,female,331,138,108,492,67,386,27,106,40
1349390,40,21,1973,8,female,121,139,125,515,168,509,122,6,46
1823378,52,23,1961,6,male,6,135,123,551,82,0,17,551,65
1386549,44,11,1969,3,female,790,136,33,552,1590,70,441,482,1149
1452643,28,12,1985,10,female,317,137,62,535,430,415,237,120,193
1039407,28,16,1985,4,male,98,139,131,546,83,546,76,0,7
2096862,20,9,1993,10,female,204,137,73,554,193,554,161,0,32
1005508,21,23,1992,8,male,19,136,125,541,217,541,203,0,14
1696125,25,8,1988,10,female,449,136,64,537,100,537,75,0,25
1711306,47,18,1966,3,female,471,135,78,558,220,558,153,0,67
1784410,25,1,1988,3,female,237,139,101,530,823,530,585,0,238
1605812,51,26,1962,7,female,468,137,111,585,65,0,11,585,54
1750042,18,10,1995,12,female,610,139,64,605,1072,221,208,384,864
2043894,13,13,2000,6,female,134,137,71,593,38,576,28,17,10
1982530,49,6,1964,3,female,1864,137,45,575,111,572,106,3,5
1245623,18,5,1995,3,female,223,138,111,581,58,581,43,0,15
1272274,61,17,1952,3,female,1652,139,58,632,231,0,93,632,138
1607688,26,20,1987,4,female,270,137,111,641,199,641,169,0,30
1066626,54,6,1959,10,female,1473,135,55,634,253,634,204,0,49
1090922,16,21,1997,5,female,442,136,91,673,350,132,158,541,192
1183560,57,21,1956,5,male,677,139,77,711,233,48,101,663,132
1425599,66,19,1947,7,female,971,138,110,686,230,0,29,686,201
1573974,20,1,1993,7,male,148,139,102,720,198,459,108,261,90
1322535,26,14,1987,4,female,325,139,82,722,775,692,658,30,117
1108524,25,13,1988,9,male,1783,138,109,691,60,691,24,0,36
1490755,46,23,1967,3,female,345,137,122,717,48,717,37,0,11
1029169,24,15,1989,1,male,574,139,61,706,164,706,89,0,75
1161578,46,7,1967,6,female,683,137,63,796,451,141,121,655,330
1407842,68,28,1945,6,female,1776,135,71,740,195,0,22,740,173
1446993,31,4,1982,11,female,286,135,94,737,209,716,91,21,118
2008855,18,20,1995,2,female,61,139,123,760,1072,748,840,12,232
1339904,36,22,1977,3,female,2141,135,54,755,486,732,214,23,272
1791203,44,12,1969,7,female,792,136,26,738,336,738,224,0,112
2072761,53,25,1960,10,female,334,135,105,822,806,609,555,213,251
1111776,26,7,1987,8,female,309,137,35,865,348,865,316,0,32
1598727,28,15,1985,1,female,222,137,86,823,358,823,245,0,113
1690497,54,14,1959,8,female,1488,139,83,844,212,844,202,0,10
1521161,25,7,1988,10,female,133,139,103,810,770,810,484,0,286
1315768,29,27,1984,10,female,721,139,64,849,841,849,602,0,239
1612340,108,1,1905,1,female,1625,139,70,957,186,0,44,957,142
1129324,58,31,1955,12,female,167,139,110,888,295,227,81,661,214
1401445,33,29,1980,1,female,789,135,72,947,1235,379,236,568,999
1554261,20,22,1993,11,female,636,135,98,916,1802,878,1045,38,757
1253452,30,4,1983,6,male,145,139,106,934,670,925,491,9,179
1769800,46,10,1967,10,male,572,137,109,904,5,904,5,0,0
1873671,51,27,1962,6,male,294,136,105,895,158,895,127,0,31
1324029,53,19,1960,8,female,571,139,113,1041,241,1,42,1040,199
1659792,16,18,1997,3,female,198,135,74,1003,578,862,436,141,142
1833374,56,15,1957,3,female,176,139,117,1052,686,999,493,53,193
1938113,55,3,1958,3,female,1556,137,74,996,405,996,282,0,123
1593707,55,29,1958,8,female,506,137,99,1128,283,1128,228,0,55
1889388,35,9,1978,3,female,59,135,123,1157,1222,1004,825,153,397
1428743,16,13,1997,7,female,655,138,53,1151,187,1151,173,0,14
1052624,103,28,1910,4,female,861,139,100,1279,41,1279,41,0,0
1804978,19,16,1994,9,female,618,138,106,1255,290,1255,259,0,31
1280811,66,6,1947,3,female,605,138,126,1322,132,0,26,1322,106
1668434,31,29,1982,12,female,547,139,45,1390,581,1384,478,6,103
1966398,41,4,1972,3,female,673,137,96,1402,92,1402,68,0,24
1173577,18,5,1995,4,female,567,137,52,1659,1078,1,139,1658,939
1180477,16,1,1997,2,female,1200,135,73,1586,951,427,220,1159,731
1958975,98,29,1915,10,female,98,137,49,1853,1124,1853,880,0,244
1935266,84,2,1929,9,female,70,138,102,1558,1324,1558,909,0,415
1004492,16,20,1997,10,female,33,139,119,2251,383,1684,256,567,127
1827097,58,28,1955,8,female,941,139,57,2050,2095,2047,190,3,1905
1911209,26,13,1987,5,male,484,138,96,2296,951,2296,517,0,434
1441803,50,8,1963,10,female,150,138,87,2104,360,2104,226,0,134
1596484,53,16,1960,11,female,544,136,111,2104,391,2104,270,0,121
1802879,31,21,1982,4,female,1078,138,57,3137,3154,0,407,3137,2747
1518416,51,21,1962,9,female,535,135,64,2751,409,1663,256,1088,153
1638042,22,30,1991,5,female,76,136,123,2380,33,2313,19,67,14
1681866,26,25,1987,7,female,124,138,81,2931,474,2820,235,111,239
1086226,33,12,1980,2,male,242,137,88,3930,1340,3169,965,761,375
1485912,25,2,1988,6,male,106,135,109,4183,84,4183,78,0,6
1771807,26,25,1987,10,male,546,142,123,3,7,3,6,0,1
1788225,28,20,1985,4,female,87,144,133,3,23,3,15,0,8
2147391,34,7,1979,10,male,707,142,89,3,6,3,4,0,2
1884884,54,14,1959,7,female,1020,140,12,3,9,3,8,0,1
2010770,59,10,1954,9,female,931,140,48,3,8,3,8,0,0
1338000,66,27,1947,12,female,1892,143,73,3,12,3,9,0,3
1553021,61,20,1952,6,male,1597,144,68,4,63,0,23,4,40
2060853,19,21,1994,7,male,585,144,45,4,1,1,0,3,1
1343619,51,5,1962,7,male,257,141,22,4,10,2,9,2,1
1417306,108,25,1905,4,female,1759,144,36,4,38,2,17,2,21
1836206,17,3,1996,11,male,66,141,128,4,4,3,1,1,3
1053082,17,8,1996,3,male,156,144,130,4,13,3,5,1,8
1686235,31,1,1982,3,male,196,142,61,4,1,4,1,0,0
1596728,108,12,1905,6,male,1112,141,65,4,1,4,1,0,0
1663802,16,8,1997,3,female,452,143,108,4,4,4,4,0,0
2072631,108,13,1905,6,male,480,140,112,4,5,4,5,0,0
2175175,20,16,1993,8,female,51,144,127,4,6,4,6,0,0
1170713,45,24,1968,7,male,550,143,73,4,9,4,7,0,2
1193009,16,16,1997,11,male,516,144,22,5,1,0,0,5,1
1911604,68,26,1945,10,female,1911,143,65,5,19,0,3,5,16
1024244,20,5,1993,3,male,554,140,62,5,2,1,2,4,0
1649208,24,15,1989,5,male,545,142,41,5,1,1,0,4,1
1644476,29,5,1984,1,male,1345,141,47,5,2,1,1,4,1
1997608,18,27,1995,7,male,589,143,100,5,32,4,9,1,23
1061305,19,20,1994,3,male,505,144,46,5,17,4,8,1,9
1297272,40,23,1973,11,male,998,142,79,5,32,4,23,1,9
1441515,19,4,1994,9,male,427,140,115,5,2,5,2,0,0
2149484,25,1,1988,1,male,225,142,132,5,1,5,1,0,0
1488130,16,20,1997,1,male,242,141,119,5,4,5,4,0,0
1014119,14,1,1999,11,male,45,143,132,5,21,5,4,0,17
1239168,22,23,1991,5,female,433,141,69,5,14,5,13,0,1
1225509,23,31,1990,7,male,125,141,113,5,51,5,36,0,15
2018316,28,16,1985,12,female,199,141,85,5,71,5,30,0,41
1085710,59,14,1954,9,female,725,142,52,5,118,5,67,0,51
1437946,65,1,1948,11,male,1881,144,10,5,13,5,13,0,0
2177228,68,1,1945,1,male,583,141,87,5,16,5,16,0,0
2081768,103,18,1910,6,female,142,141,109,5,10,5,0,0,10
1729540,108,21,1905,9,female,764,141,66,5,61,5,56,0,5
1534906,19,5,1994,11,male,374,141,119,6,2,0,0,6,2
2143190,17,13,1996,10,female,446,142,94,6,15,1,3,5,12
1363959,37,6,1976,8,male,363,140,88,6,117,0,56,6,61
1118338,23,5,1990,5,male,259,141,139,6,3,4,3,2,0
2051911,33,24,1980,4,male,511,141,90,6,27,4,13,2,14
2065569,30,12,1983,4,female,404,142,129,6,9,5,1,1,8
1328873,18,16,1995,1,male,360,140,69,6,0,6,0,0,0
1900218,13,27,2000,2,male,224,142,71,6,1,6,1,0,0
1913507,32,14,1981,2,female,1231,140,56,6,1,6,1,0,0
1841844,103,7,1910,1,female,1408,142,52,6,1,6,0,0,1
1704326,32,9,1981,4,female,704,142,51,6,6,6,6,0,0
2153909,33,29,1980,4,male,452,144,104,6,8,6,8,0,0
1656431,15,8,1998,1,male,429,144,28,6,31,6,10,0,21
1907451,22,20,1991,6,male,495,142,100,6,36,6,34,0,2
1923120,27,18,1986,11,female,341,142,66,6,22,6,20,0,2
1096389,37,28,1976,6,female,437,140,74,6,13,6,10,0,3
1685943,50,23,1963,10,male,1289,144,116,6,15,6,12,0,3
1109557,65,29,1948,9,female,1865,144,83,6,26,6,18,0,8
1413003,14,17,1999,2,male,620,140,56,7,6,0,3,7,3
1406154,21,1,1992,5,male,216,140,90,7,0,4,0,3,0
1550616,97,11,1916,2,male,1887,140,50,7,0,4,0,3,0
1142948,24,12,1989,8,male,234,142,94,7,25,4,18,3,7
1391561,23,30,1990,12,male,412,142,117,7,0,7,0,0,0
1212443,29,3,1984,12,male,209,141,52,7,0,7,0,0,0
1739621,21,10,1992,12,male,407,143,76,7,2,7,2,0,0
2001719,63,15,1950,4,male,464,144,87,7,3,7,2,0,1
1155904,108,31,1905,8,male,1028,141,72,7,4,7,1,0,3
1831372,16,20,1997,8,female,167,141,85,7,10,7,3,0,7
1236456,18,5,1995,7,female,283,142,103,7,30,7,23,0,7
1955293,23,30,1990,11,female,548,140,59,7,43,7,26,0,17
1937062,23,20,1990,11,male,416,141,61,7,34,7,20,0,14
1999533,25,1,1988,1,female,220,144,55,7,22,7,21,0,1
1764418,25,1,1988,1,male,215,144,93,7,82,7,50,0,32
1482044,58,7,1955,8,male,301,142,77,8,9,0,0,8,9
1158332,38,26,1975,8,male,799,143,10,8,25,0,12,8,13
1349320,24,14,1989,11,male,1997,140,45,8,11,5,8,3,3
1795585,16,13,1997,11,male,205,144,63,8,16,6,3,2,13
1241754,32,21,1981,7,male,815,140,66,8,0,8,0,0,0
2111528,48,23,1965,6,male,477,144,129,8,1,8,1,0,0
1004035,21,29,1992,7,male,452,143,30,8,7,8,7,0,0
2189256,23,18,1990,6,female,378,143,122,8,5,8,5,0,0
1268819,19,1,1994,8,female,112,140,91,8,71,8,11,0,60
1775955,20,7,1993,10,male,246,144,119,8,85,8,65,0,20
1992793,22,11,1991,10,male,88,143,126,8,79,8,58,0,21
1154512,27,25,1986,2,male,382,141,68,8,14,8,6,0,8
1408129,55,17,1958,1,female,766,141,100,8,33,8,32,0,1
2152542,16,25,1997,2,male,219,140,101,9,0,0,0,9,0
1476523,35,22,1978,12,male,674,141,54,9,1,0,1,9,0
1472328,18,13,1995,10,male,365,142,70,9,3,0,0,9,3
1804619,37,14,1976,1,female,473,142,116,9,10,0,8,9,2
1029732,103,29,1910,5,female,1426,144,49,9,1,4,1,5,0
1942425,23,1,1990,1,male,213,144,100,9,22,2,7,7,15
1077520,31,16,1982,2,male,947,142,81,9,1,9,1,0,0
1297985,15,10,1998,7,female,458,141,56,9,4,9,1,0,3
1116657,19,21,1994,8,male,536,144,52,9,5,9,4,0,1
1140861,30,15,1983,12,male,1913,142,67,9,12,9,12,0,0
2097562,19,29,1994,12,male,464,144,126,9,44,9,27,0,17
2003047,39,27,1974,8,male,575,141,53,9,38,9,25,0,13
1701314,54,10,1959,2,male,302,142,52,9,17,9,13,0,4
1457257,103,12,1910,3,female,965,140,36,9,43,9,42,0,1
1672972,75,4,1938,4,male,293,141,112,10,1,0,0,10,1
1889094,20,15,1993,1,male,201,140,123,10,4,1,1,9,3
1806045,58,18,1955,4,male,581,144,95,10,49,0,11,10,38
2188688,65,27,1948,4,male,934,143,97,10,5,5,1,5,4
1392212,108,21,1905,9,female,1813,142,83,10,3,4,1,6,2
2019625,18,4,1995,1,male,71,140,118,10,10,5,2,5,8
1371739,67,6,1946,8,female,1805,144,97,10,2,9,0,1,2
1793675,16,1,1997,2,male,330,141,85,10,0,10,0,0,0
1054944,21,2,1992,6,male,253,142,107,10,2,10,2,0,0
2089400,34,14,1979,9,male,321,142,100,10,3,10,3,0,0
1326691,31,27,1982,9,male,234,142,71,10,14,10,12,0,2
1849032,53,3,1960,6,female,1521,143,92,10,9,10,4,0,5
1415723,17,30,1996,11,male,33,144,110,10,92,10,86,0,6
2009088,23,22,1990,4,male,484,141,53,10,28,10,28,0,0
1765230,25,19,1988,2,female,510,141,74,10,29,10,16,0,13
1101842,30,2,1983,1,male,379,143,97,10,117,10,78,0,39
1971272,14,21,1999,6,male,490,142,55,11,1,0,0,11,1
2003712,24,10,1989,6,female,193,141,6,11,5,0,5,11,0
1445578,17,4,1996,9,female,336,143,106,11,15,10,13,1,2
1947113,20,14,1993,1,female,624,140,6,11,0,11,0,0,0
1047911,26,5,1987,2,female,446,143,42,11,0,11,0,0,0
1458096,17,27,1996,12,male,512,143,113,11,2,11,1,0,1
1523257,18,13,1995,8,male,422,142,63,11,2,11,2,0,0
1768975,45,19,1968,10,female,699,142,77,11,7,11,5,0,2
1201247,21,30,1992,4,female,319,144,121,11,46,11,44,0,2
2072514,29,20,1984,3,male,647,142,108,11,56,11,51,0,5
1653038,42,18,1971,5,female,305,142,60,12,2,0,0,12,2
1381557,61,25,1952,2,male,558,140,129,12,3,0,0,12,3
1633570,93,7,1920,4,male,2157,142,95,12,2,0,1,12,1
1780763,108,12,1905,12,female,395,140,52,12,264,0,101,12,163
1576584,35,22,1978,1,male,69,143,119,12,4,7,4,5,0
1709263,22,6,1991,6,male,90,144,124,12,30,4,17,8,13
1092106,16,21,1997,11,male,361,144,56,12,9,11,8,1,1
1763674,45,15,1968,8,male,1181,143,47,12,0,12,0,0,0
1761625,46,4,1967,7,female,47,140,125,12,1,12,1,0,0
1797424,14,4,1999,5,male,64,142,119,12,7,12,5,0,2
1746722,19,21,1994,4,male,254,140,70,12,6,12,1,0,5
2187899,55,2,1958,4,female,222,141,60,12,10,12,6,0,4
1937094,16,18,1997,9,male,220,141,106,12,63,12,29,0,34
1924254,27,27,1986,7,male,632,144,71,12,23,12,21,0,2
1714661,30,23,1983,8,female,279,143,53,12,36,12,25,0,11
1482319,35,6,1978,12,male,2143,141,59,12,34,12,29,0,5
1467456,61,22,1952,12,female,264,140,115,12,47,12,32,0,15
1399392,32,16,1981,5,male,385,144,72,13,36,0,13,13,23
1606560,54,24,1959,1,male,1149,142,76,13,24,0,15,13,9
1968518,28,21,1985,2,male,429,143,82,13,1,13,1,0,0
1678492,24,9,1989,9,male,294,143,99,13,4,13,4,0,0
1731201,18,21,1995,8,female,94,140,125,13,13,13,10,0,3
1995881,21,8,1992,3,male,305,143,123,13,10,13,10,0,0
1390260,14,9,1999,8,female,224,141,119,13,39,13,15,0,24
2102930,33,1,1980,1,male,226,143,59,13,25,13,13,0,12
1604448,73,6,1940,9,male,310,144,60,14,1,0,0,14,1
1329738,48,13,1965,8,female,524,143,90,14,5,0,2,14,3
1749477,52,20,1961,5,male,329,142,77,14,3,0,0,14,3
1870597,30,23,1983,3,female,516,140,70,14,18,5,9,9,9
2148879,30,27,1983,9,male,26,143,128,14,85,7,61,7,24
1729182,29,30,1984,4,female,198,140,111,14,1,14,1,0,0
1505969,48,18,1965,5,male,606,143,36,14,1,14,1,0,0
1626558,22,2,1991,5,male,224,144,129,14,6,14,6,0,0
2035370,21,4,1992,2,male,629,140,75,15,3,0,1,15,2
2181891,95,7,1918,4,male,1397,144,35,15,5,7,1,8,4
1381846,25,2,1988,11,female,307,142,42,15,49,8,30,7,19
1765389,108,18,1905,8,male,209,143,103,15,13,14,7,1,6
1142963,27,30,1986,5,female,374,144,96,15,25,13,23,2,2
1240499,22,26,1991,8,male,265,140,94,15,0,15,0,0,0
1253324,51,9,1962,11,male,1838,144,103,15,8,15,6,0,2
1452060,51,1,1962,3,male,1187,143,47,15,6,15,5,0,1
1154926,54,23,1959,4,male,1061,144,101,15,6,15,4,0,2
1449509,16,1,1997,6,male,221,142,115,15,16,15,14,0,2
1044315,21,26,1992,10,male,511,143,59,15,16,15,15,0,1
1757428,20,29,1993,6,male,47,144,137,15,27,15,25,0,2
1052013,38,23,1975,12,male,714,142,62,15,32,15,28,0,4
1526019,51,1,1962,8,male,1772,142,24,16,1,0,0,16,1
1778855,19,29,1994,12,male,17,142,102,16,85,9,20,7,65
1004977,35,9,1978,5,female,682,143,101,16,42,10,26,6,16
2021370,61,7,1952,12,male,916,144,115,16,84,8,56,8,28
1926568,14,8,1999,5,male,31,141,138,16,20,16,19,0,1
1186183,31,1,1982,1,male,244,142,66,16,112,16,82,0,30
1289407,103,25,1910,12,female,1824,144,106,17,25,0,2,17,23
1024868,32,24,1981,4,male,328,142,98,17,60,15,24,2,36
1807116,23,6,1990,6,male,426,141,79,17,0,17,0,0,0
1668942,51,24,1962,9,female,486,140,36,17,1,17,0,0,1
1373982,52,11,1961,2,female,583,142,84,17,6,17,4,0,2
1705880,27,11,1986,11,male,591,143,44,17,18,17,13,0,5
1211470,38,28,1975,12,female,284,143,51,17,14,17,10,0,4
1882069,16,22,1997,7,female,465,142,64,17,62,17,41,0,21
1729164,24,30,1989,3,male,153,140,104,17,36,17,25,0,11
1904049,43,17,1970,7,male,443,141,119,17,32,17,27,0,5
1436279,19,9,1994,10,male,385,143,125,18,1,0,1,18,0
1352938,88,17,1925,10,male,1330,140,89,18,6,0,3,18,3
1732577,27,1,1986,3,male,376,144,100,18,13,0,2,18,11
1918971,103,17,1910,12,female,1226,141,69,18,9,5,0,13,9
1682210,21,20,1992,11,male,821,142,99,18,109,8,74,10,35
1606716,17,28,1996,12,male,606,140,71,18,4,15,1,3,3
2078830,19,4,1994,7,male,1024,140,56,18,1,18,1,0,0
1657788,50,30,1963,10,female,311,140,108,18,13,18,13,0,0
2074834,19,10,1994,10,male,309,142,57,19,2,0,0,19,2
1920483,56,11,1957,7,male,699,144,105,19,2,0,0,19,2
2109626,59,28,1954,3,male,898,141,72,19,0,17,0,2,0
1696999,23,11,1990,5,male,4,142,142,19,19,16,10,3,9
1371931,20,10,1993,6,male,225,141,125,19,3,19,1,0,2
1130522,25,22,1988,9,male,182,144,122,19,2,19,2,0,0
1518637,19,15,1994,6,male,612,140,124,19,7,19,7,0,0
1991405,103,18,1910,4,male,393,140,105,19,11,19,11,0,0
2175090,30,13,1983,8,male,530,140,74,20,9,20,9,0,0
2014715,33,13,1980,1,male,931,144,84,20,135,20,97,0,38
2177039,34,14,1979,4,female,288,141,75,20,50,20,41,0,9
2121190,20,20,1993,1,male,464,142,13,21,20,15,2,6,18
1339161,63,17,1950,7,male,960,141,90,22,67,0,31,22,36
1109920,86,6,1927,3,female,1804,142,90,22,60,0,42,22,18
1384530,53,27,1960,1,female,188,141,138,22,18,6,10,16,8
1739733,26,8,1987,7,female,419,144,35,22,0,22,0,0,0
1734078,17,22,1996,2,male,339,140,78,22,13,22,9,0,4
1267927,36,3,1977,5,male,424,144,33,22,20,22,14,0,6
1657101,22,1,1991,4,male,279,140,124,22,33,22,30,0,3
1112262,50,27,1963,9,male,662,140,116,23,3,11,3,12,0
1173411,15,5,1998,2,male,539,143,56,23,7,8,4,15,3
1647881,21,10,1992,11,male,373,144,125,23,32,14,15,9,17
1525571,22,8,1991,11,male,672,140,43,23,13,23,11,0,2
1698780,23,18,1990,9,male,726,140,73,23,19,23,2,0,17
1860855,30,18,1983,7,male,396,142,66,24,0,0,0,24,0
1703812,32,4,1981,12,male,454,140,121,24,6,21,5,3,1
1582990,106,24,1907,4,male,1010,144,79,24,14,22,11,2,3
1634383,50,28,1963,5,female,390,143,22,24,59,23,32,1,27
2064674,18,18,1995,8,female,246,142,54,24,64,24,46,0,18
1503037,29,10,1984,11,male,200,142,139,24,85,24,45,0,40
2048486,19,2,1994,9,male,540,144,111,25,1,0,1,25,0
1690900,19,10,1994,10,male,542,141,28,25,32,25,23,0,9
1724075,26,1,1987,1,male,77,142,126,25,24,25,24,0,0
1788816,20,9,1993,1,male,1047,140,96,26,52,22,21,4,31
1230031,31,5,1982,12,male,378,141,126,26,0,26,0,0,0
2096792,22,17,1991,2,male,386,142,44,26,73,26,73,0,0
1173274,21,29,1992,10,male,668,143,68,27,7,26,5,1,2
1238270,16,15,1997,7,male,244,141,65,27,17,27,17,0,0
1239690,21,20,1992,9,male,239,141,94,27,59,27,41,0,18
1709187,99,26,1914,3,female,1377,141,61,27,42,27,34,0,8
1934791,51,28,1962,5,female,996,143,59,28,12,11,1,17,11
1111165,19,13,1994,4,male,284,141,139,28,36,22,27,6,9
1035924,23,5,1990,6,male,410,140,118,28,4,28,4,0,0
1025253,23,3,1990,3,female,211,140,103,29,1,0,1,29,0
1278044,62,7,1951,8,male,717,142,38,29,18,7,11,22,7
1677837,35,1,1978,3,male,656,143,88,29,49,28,19,1,30
1921007,21,28,1992,12,male,24,143,122,29,119,29,71,0,48
2020601,31,6,1982,7,male,1225,140,57,29,115,29,48,0,67
1569438,24,18,1989,1,male,524,140,71,31,10,1,3,30,7
1359513,28,9,1985,4,female,222,142,94,30,114,3,45,27,69
1360807,23,24,1990,11,female,522,142,88,30,81,20,32,10,49
1270224,25,13,1988,12,male,803,141,76,31,49,8,9,23,40
1629735,14,13,1999,2,male,601,144,98,31,1,31,1,0,0
1998254,24,19,1989,2,male,447,144,37,31,32,31,32,0,0
2141566,27,28,1986,10,female,829,140,47,30,23,30,9,0,14
1401016,34,19,1979,8,male,365,144,73,30,22,30,19,0,3
1774506,20,6,1993,3,male,154,144,82,32,11,30,5,2,6
1049800,38,22,1975,6,male,456,140,84,32,14,32,12,0,2
1184360,23,3,1990,12,male,783,143,82,32,45,32,34,0,11
2143196,21,28,1992,8,female,527,140,38,33,6,0,1,33,5
1050871,25,16,1988,4,male,515,142,66,33,8,1,1,32,7
1364800,15,22,1998,12,male,92,143,96,33,2,20,1,13,1
1170603,22,7,1991,1,male,271,144,40,33,5,31,3,2,2
1835970,37,1,1976,1,male,628,142,62,33,3,29,2,4,1
1123532,20,14,1993,11,male,582,140,81,33,0,33,0,0,0
1026757,23,23,1990,4,male,381,140,120,33,0,33,0,0,0
1595703,31,1,1982,12,male,406,144,89,33,25,33,5,0,20
1620404,95,21,1918,5,male,2215,140,50,33,27,33,20,0,7
1970335,25,26,1988,5,male,576,143,74,33,84,33,58,0,26
1366795,63,29,1950,9,female,1841,141,51,34,130,0,43,34,87
1285115,102,6,1911,12,male,404,144,112,34,3,29,3,5,0
1482756,17,30,1996,5,male,99,140,111,34,3,34,3,0,0
1862007,18,21,1995,2,male,622,142,54,34,2,34,2,0,0
1148087,58,18,1955,3,female,145,141,106,36,9,0,1,36,8
2123201,95,21,1918,9,male,1205,144,16,35,24,0,1,35,23
2134624,14,16,1999,1,female,358,144,107,36,0,23,0,13,0
1730296,52,30,1961,12,male,938,143,67,35,15,10,9,25,6
2148010,30,18,1983,2,female,719,144,70,35,145,11,69,24,76
1133425,22,23,1991,8,female,458,140,120,35,15,31,10,4,5
1096508,105,21,1908,8,female,1072,140,96,36,18,35,18,1,0
1125232,21,14,1992,1,female,251,144,12,35,0,35,0,0,0
1967128,17,1,1996,1,male,28,142,142,35,7,35,7,0,0
1940336,21,6,1992,11,female,975,144,13,36,38,36,32,0,6
1310707,31,25,1982,1,male,804,142,80,36,45,36,40,0,5
1620594,29,3,1984,5,male,196,140,48,37,14,30,13,7,1
2030055,17,14,1996,10,female,383,140,123,37,93,30,72,7,21
1160380,18,26,1995,10,female,448,143,47,37,18,37,16,0,2
1233745,19,25,1994,3,male,322,141,86,39,16,2,9,37,7
2048373,83,2,1930,3,male,2138,142,62,38,1,9,0,29,1
1156362,23,5,1990,8,male,427,143,95,38,5,38,5,0,0
2114356,17,25,1996,7,male,335,140,74,39,7,39,6,0,1
2068219,39,9,1974,10,male,792,142,58,39,18,39,13,0,5
1176576,25,22,1988,7,female,328,142,86,39,36,39,13,0,23
1337661,25,31,1988,12,female,222,143,98,38,88,38,88,0,0
1490237,46,13,1967,8,female,1517,143,86,40,55,40,44,0,11
1606228,18,8,1995,2,male,511,141,101,42,8,5,5,37,3
2168344,16,1,1997,1,male,612,141,70,41,49,0,26,41,23
2154076,75,20,1938,6,female,1035,142,99,42,43,0,15,42,28
1321555,33,26,1980,8,male,790,140,103,42,25,29,18,13,7
2155995,17,6,1996,6,male,748,141,100,41,7,34,5,7,2
1187128,55,7,1958,7,female,371,144,69,41,8,41,4,0,4
1427016,36,18,1977,4,female,148,140,98,42,44,42,28,0,16
1964473,60,2,1953,7,female,1307,141,37,43,32,3,16,40,16
1216843,20,9,1993,2,male,1365,142,59,44,21,22,15,22,6
1318713,21,23,1992,8,male,468,142,93,45,65,42,29,3,36
2098167,16,3,1997,3,female,318,143,14,45,11,45,11,0,0
1517004,18,15,1995,5,male,288,141,83,47,8,20,1,27,7
1156335,57,21,1956,4,female,583,144,22,46,60,20,8,26,52
1458434,22,6,1991,10,female,480,143,52,46,22,43,15,3,7
1694423,31,31,1982,8,female,205,143,55,47,16,47,7,0,9
1730242,51,26,1962,6,male,173,140,70,46,83,46,34,0,49
1853684,23,26,1990,12,male,219,141,123,49,61,0,17,49,44
2162165,93,1,1920,1,female,789,140,82,48,34,5,12,43,22
1764886,32,25,1981,6,female,390,143,91,49,44,44,22,5,22
1584138,15,8,1998,8,male,330,143,113,48,0,48,0,0,0
1872586,22,25,1991,5,female,638,144,108,49,10,49,6,0,4
1747231,35,29,1978,1,female,300,144,89,48,21,48,15,0,6
1492384,51,24,1962,3,male,475,140,106,49,23,49,3,0,20
1776441,36,9,1977,10,male,174,144,77,48,70,48,44,0,26
1248020,14,21,1999,5,female,50,144,101,49,157,49,138,0,19
1916044,108,17,1905,1,female,1900,144,114,50,13,0,8,50,5
1075593,63,15,1950,8,female,710,141,60,51,287,0,41,51,246
1979213,89,21,1924,12,male,1749,141,82,51,0,20,0,31,0
1268142,77,21,1936,9,female,635,141,118,51,29,51,25,0,4
1171790,25,16,1988,5,female,721,140,112,53,38,2,7,51,31
1979197,71,27,1942,6,male,918,140,74,52,107,10,71,42,36
1000776,59,9,1954,7,female,1566,142,76,52,148,32,83,20,65
1858881,18,29,1995,10,male,558,144,126,53,8,43,8,10,0
1769364,18,9,1995,8,female,423,142,65,53,11,48,11,5,0
1725337,60,19,1953,4,male,1652,142,70,53,109,50,55,3,54
1268782,82,21,1931,3,female,1555,140,67,52,32,52,18,0,14
1996201,25,9,1988,4,male,241,144,103,53,122,53,90,0,32
1230894,80,13,1933,2,male,265,141,70,54,134,0,40,54,94
1719065,36,8,1977,8,female,395,141,84,55,30,14,9,41,21
1021223,108,3,1905,9,female,1003,142,77,55,10,25,6,30,4
1567225,36,7,1977,9,female,161,144,88,55,18,41,3,14,15
1367735,69,11,1944,8,male,1541,141,65,55,29,50,16,5,13
1104778,27,11,1986,6,female,389,141,84,55,123,45,57,10,66
1290109,58,22,1955,9,male,669,144,118,55,15,55,5,0,10
1757699,21,2,1992,2,male,622,142,71,54,65,54,26,0,39
1070874,32,28,1981,8,male,259,144,111,54,290,54,210,0,80
1199473,108,18,1905,7,female,1842,140,37,56,29,7,15,49,14
1805750,68,25,1945,4,female,1882,143,72,58,284,11,175,47,109
1023238,20,5,1993,7,male,638,144,80,56,10,38,4,18,6
1321812,26,3,1987,11,female,643,144,51,56,64,21,22,35,42
1430056,59,9,1954,1,female,1384,141,30,58,61,38,19,20,42
1665134,21,1,1992,4,female,635,142,58,58,84,44,47,14,37
1883238,16,9,1997,9,male,215,143,113,56,17,56,17,0,0
1083911,21,9,1992,9,male,95,142,56,57,21,57,17,0,4
2006354,30,11,1983,8,male,276,140,94,57,63,57,53,0,10
1295911,68,8,1945,1,male,1754,140,81,60,146,22,68,38,78
1945619,26,29,1987,3,male,537,144,80,59,45,58,30,1,15
1496832,19,26,1994,12,male,506,144,99,61,41,0,12,61,29
2132589,47,21,1966,4,male,565,140,103,63,20,54,18,9,2
1191506,28,5,1985,8,male,726,141,38,62,95,57,77,5,18
2105647,22,24,1991,2,male,512,143,130,62,9,62,7,0,2
1333109,34,11,1979,11,male,207,141,83,63,48,63,32,0,16
1512224,60,23,1953,4,female,1534,141,31,65,66,58,40,7,26
2078448,16,25,1997,3,male,368,144,52,64,6,64,4,0,2
1667197,18,13,1995,6,male,344,141,92,64,17,64,15,0,2
2043950,27,7,1986,6,male,371,142,100,65,36,65,27,0,9
1562473,64,23,1949,12,male,1685,142,32,65,11,65,11,0,0
1299662,18,24,1995,5,female,418,143,95,65,50,65,26,0,24
1795623,25,1,1988,7,female,808,144,77,68,95,28,34,40,61
1849931,50,18,1963,1,male,157,142,62,69,20,10,8,59,12
1888469,60,19,1953,1,male,215,140,21,70,163,0,37,70,126
1912822,100,23,1913,2,female,1854,141,63,71,50,60,37,11,13
1595254,15,5,1998,1,male,608,141,41,70,7,70,4,0,3
1459010,24,8,1989,8,male,187,143,130,71,5,71,5,0,0
1003118,32,2,1981,7,female,603,144,23,69,81,69,68,0,13
1558993,26,7,1987,3,female,328,142,95,69,140,69,70,0,70
2103788,54,9,1959,11,female,1074,144,83,69,348,69,228,0,120
1439822,28,10,1985,12,female,238,142,93,72,58,71,26,1,32
2101994,38,9,1975,4,female,434,142,120,73,10,73,9,0,1
1492603,31,1,1982,1,male,544,144,87,72,26,72,10,0,16
1309170,17,9,1996,3,male,397,144,115,74,77,74,71,0,6
1691568,71,9,1942,8,female,1748,144,56,75,54,0,23,75,31
1828989,53,9,1960,10,female,1921,143,26,75,150,75,137,0,13
1093421,23,10,1990,2,female,164,141,104,79,48,2,26,77,22
1423064,29,5,1984,8,female,299,141,103,78,2,58,2,20,0
2099782,27,2,1986,11,male,617,142,84,79,42,67,26,12,16
1592118,19,1,1994,11,male,423,144,87,79,43,79,30,0,13
1544026,61,15,1952,12,female,133,142,124,80,94,80,53,0,41
2098191,43,14,1970,7,female,512,141,112,80,166,80,155,0,11
2062672,52,24,1961,9,male,1556,144,43,84,53,83,23,1,30
1927455,52,29,1961,10,female,1227,144,58,81,103,77,48,4,55
2040247,31,23,1982,6,male,104,143,89,81,34,81,6,0,28
2083074,69,31,1944,12,male,1691,144,47,86,136,9,43,77,93
1666176,26,25,1987,7,male,293,143,46,86,69,86,31,0,38
1411728,49,2,1964,10,male,599,141,74,89,33,0,11,89,22
1676235,58,20,1955,3,female,1588,141,22,90,40,0,13,90,27
1086901,31,3,1982,1,female,315,144,104,88,14,41,3,47,11
1620770,21,11,1992,4,female,599,141,57,90,21,83,20,7,1
1544957,21,15,1992,7,male,206,144,133,89,37,89,30,0,7
2090667,29,29,1984,9,female,441,141,56,88,45,88,32,0,13
1216906,108,13,1905,9,male,590,141,21,88,34,88,27,0,7
1462548,58,30,1955,6,male,1441,141,95,90,64,90,56,0,8
1052792,61,22,1952,1,male,22,143,89,90,177,90,145,0,32
1698553,55,24,1958,2,female,1753,140,51,94,47,20,27,74,20
1448715,39,23,1974,5,female,466,143,77,92,51,85,20,7,31
1569032,48,18,1965,8,female,1065,143,61,95,10,95,6,0,4
1128656,32,5,1981,3,female,560,142,66,95,91,95,87,0,4
1201049,51,9,1962,8,female,580,142,112,96,3,0,0,96,3
1719264,22,6,1991,2,male,182,142,87,97,39,78,35,19,4
1256794,67,11,1946,10,female,2214,142,70,98,39,73,18,25,21
2054860,21,15,1992,5,male,1080,142,91,101,33,19,16,82,17
2142525,18,17,1995,2,female,594,141,93,100,40,88,25,12,15
1271458,21,19,1992,10,female,365,142,38,104,153,85,145,19,8
1053279,26,17,1987,11,female,362,140,76,102,221,102,92,0,129
2117415,76,15,1937,8,female,1348,144,52,105,81,0,30,105,51
1100947,47,31,1966,5,female,723,141,88,105,18,53,9,52,9
1583586,32,24,1981,5,female,735,143,80,107,354,67,266,40,88
2130088,24,3,1989,9,female,674,143,80,108,54,108,35,0,19
2008416,36,5,1977,7,male,231,141,62,109,20,109,5,0,15
2138933,19,17,1994,1,male,192,141,123,112,60,47,41,65,19
1407777,23,4,1990,3,male,571,141,79,113,47,101,7,12,40
1646123,27,2,1986,3,female,544,144,99,110,50,81,40,29,10
1536327,28,31,1985,5,female,296,144,81,112,1,112,0,0,1
1835347,35,15,1978,3,male,275,143,109,110,61,110,56,0,5
1922662,43,11,1970,2,female,670,140,82,113,262,113,192,0,70
1286230,61,7,1952,3,male,176,143,122,118,48,0,11,118,37
1673339,53,25,1960,3,male,162,144,37,118,20,33,1,85,19
2192886,13,10,2000,3,female,230,140,94,116,55,110,36,6,19
1147837,35,12,1978,2,female,1864,142,99,119,276,119,127,0,149
1188214,24,3,1989,9,male,488,141,37,120,78,116,48,4,30
1157584,26,17,1987,7,female,641,142,85,120,177,107,127,13,50
2130539,27,14,1986,2,male,128,143,114,124,89,122,61,2,28
1527051,61,10,1952,12,male,5,143,140,123,107,109,76,14,31
1011508,43,24,1970,9,female,720,144,100,121,289,115,193,6,96
2116696,22,10,1991,3,female,555,141,87,124,27,124,14,0,13
2129605,63,7,1950,5,male,1368,140,54,123,34,123,33,0,1
1532883,22,28,1991,10,female,321,144,79,128,170,54,24,74,146
1011743,27,24,1986,3,female,555,144,86,127,26,124,17,3,9
1874199,33,14,1980,10,male,400,140,117,128,56,127,32,1,24
1796897,53,17,1960,1,female,1079,140,110,126,421,126,248,0,173
1995615,108,25,1905,6,male,1244,140,85,135,197,11,65,124,132
1029565,57,5,1956,3,female,54,142,129,134,20,31,10,103,10
1477519,23,30,1990,9,male,440,143,65,134,266,94,144,40,122
1386283,16,20,1997,7,male,381,140,112,139,186,57,101,82,85
1898117,50,11,1963,3,female,1114,143,108,141,102,131,76,10,26
2187674,90,3,1923,2,male,873,143,78,138,168,124,61,14,107
2157708,72,22,1941,6,female,73,140,133,141,284,116,236,25,48
2027151,35,24,1978,4,male,284,144,121,143,172,142,125,1,47
1826527,36,30,1977,11,male,873,144,129,138,9,138,9,0,0
1602642,37,31,1976,10,female,575,141,71,139,197,139,108,0,89
1480687,97,10,1916,5,male,263,141,134,140,109,140,73,0,36
1793844,33,11,1980,6,female,1572,140,100,143,497,143,308,0,189
1867202,48,19,1965,10,female,291,143,61,137,374,137,212,0,162
1892655,36,7,1977,6,female,542,140,124,149,21,0,6,149,15
1809854,29,9,1984,10,male,43,143,77,146,52,29,14,117,38
1466741,23,27,1990,10,male,535,142,118,150,37,80,19,70,18
1091848,48,24,1965,10,female,1498,143,66,150,133,150,71,0,62
1181247,54,18,1959,12,female,795,142,40,157,53,0,44,157,9
2054618,60,9,1953,7,female,1525,143,87,151,63,141,23,10,40
1868514,25,31,1988,12,female,123,144,97,153,225,153,183,0,42
2076912,26,2,1987,3,female,559,143,96,157,99,157,70,0,29
1660304,64,6,1949,10,female,501,141,80,161,255,0,56,161,199
1374191,65,29,1948,5,female,698,142,67,158,272,0,45,158,227
1784733,26,15,1987,7,female,429,141,65,163,88,33,22,130,66
1147028,55,14,1958,4,female,747,144,111,160,59,113,14,47,45
1594704,20,10,1993,10,female,69,142,119,159,122,58,52,101,70
1224714,27,11,1986,10,female,591,142,98,163,145,153,72,10,73
1363281,29,3,1984,3,female,408,142,75,172,111,45,53,127,58
2169902,34,14,1979,11,female,204,143,125,169,185,112,96,57,89
1101133,27,31,1986,5,male,183,144,121,168,0,168,0,0,0
2122484,47,26,1966,5,female,1054,143,57,179,109,31,31,148,78
1054975,62,5,1951,11,female,852,143,48,176,209,0,52,176,157
1309037,46,9,1967,5,female,1762,144,58,174,64,125,50,49,14
1476695,52,15,1961,12,male,884,143,53,180,202,114,134,66,68
1056368,101,12,1912,12,male,1661,143,69,176,180,161,100,15,80
1991529,31,12,1982,9,female,37,143,19,180,751,177,742,3,9
1202060,27,14,1986,12,female,225,143,38,173,445,173,249,0,196
1406153,16,1,1997,1,male,465,142,57,183,249,1,15,182,234
1165713,19,6,1994,12,female,1222,142,119,189,208,105,157,84,51
1698003,19,22,1994,1,male,254,142,108,183,86,181,62,2,24
1290471,51,18,1962,10,male,1832,144,85,184,55,175,14,9,41
1037323,58,30,1955,8,female,799,140,87,182,69,169,38,13,31
1324454,40,8,1973,10,female,900,142,63,185,175,177,131,8,44
1225440,66,19,1947,6,male,1459,144,126,183,243,182,81,1,162
1045198,21,22,1992,8,male,229,143,97,190,21,190,13,0,8
2100825,30,25,1983,10,female,77,143,19,187,265,187,200,0,65
1623548,67,30,1946,11,female,1739,143,62,191,172,17,85,174,87
1919780,62,8,1951,3,male,961,140,95,195,39,73,19,122,20
1564615,23,23,1990,12,male,1031,142,72,195,203,158,102,37,101
1214240,43,21,1970,1,female,874,143,96,200,28,200,10,0,18
1293947,34,28,1979,6,male,1020,144,111,195,52,195,44,0,8
1042179,93,23,1920,11,male,611,142,79,199,51,199,33,0,18
1319561,28,19,1985,4,female,653,143,46,200,181,200,181,0,0
1078279,29,2,1984,10,female,386,142,64,197,354,197,272,0,82
1045884,49,17,1964,5,male,350,140,86,207,94,101,41,106,53
1605307,20,28,1993,5,male,33,141,121,206,114,175,82,31,32
2086652,50,14,1963,7,male,109,144,72,204,146,203,61,1,85
2178844,22,14,1991,5,male,198,141,40,206,86,206,80,0,6
1400888,36,18,1977,2,male,915,144,118,209,81,209,63,0,18
2083777,20,20,1993,8,female,388,140,66,214,82,27,13,187,69
1235196,38,1,1975,1,female,345,144,127,216,96,93,65,123,31
1413536,27,24,1986,2,female,267,140,102,212,37,195,31,17,6
1147169,25,1,1988,7,female,300,141,84,218,87,218,67,0,20
1712919,30,22,1983,12,female,577,144,109,216,350,216,313,0,37
1617807,82,16,1931,10,female,1691,142,104,226,468,52,341,174,127
1331214,22,1,1991,2,male,472,142,66,232,68,174,57,58,11
1524111,22,7,1991,10,male,561,142,81,232,73,179,28,53,45
1443791,48,8,1965,8,female,2003,142,77,230,128,178,36,52,92
1174495,16,8,1997,9,female,43,141,117,232,514,224,331,8,183
1471357,30,15,1983,2,female,605,141,56,227,1299,216,1100,11,199
1161474,23,18,1990,4,male,493,142,70,233,24,233,24,0,0
1397071,31,2,1982,1,male,250,143,58,232,144,232,99,0,45
1861387,23,13,1990,9,female,339,144,117,245,301,238,134,7,167
1191770,24,10,1989,1,male,576,142,34,246,144,246,116,0,28
1804745,32,19,1981,3,female,285,140,79,245,41,245,29,0,12
1341107,103,21,1910,12,female,830,143,86,243,52,243,46,0,6
1904960,18,4,1995,1,male,395,140,94,245,200,245,125,0,75
1735748,93,9,1920,8,female,1467,140,78,235,222,235,182,0,40
1190920,58,17,1955,2,female,1584,141,84,251,15,3,10,248,5
1641062,25,23,1988,8,male,329,142,64,252,150,136,81,116,69
1585195,20,17,1993,7,female,316,141,43,258,156,187,75,71,81
1460442,69,13,1944,8,female,382,143,61,256,43,255,39,1,4
1355452,24,21,1989,10,male,267,142,64,247,84,247,45,0,39
1811383,32,29,1981,10,female,293,140,101,259,437,259,165,0,272
1224809,57,4,1956,5,female,537,144,109,269,31,0,19,269,12
1703142,55,26,1958,8,female,280,140,43,267,266,0,163,267,103
1573930,33,15,1980,3,male,108,140,121,273,187,273,171,0,16
1854653,25,18,1988,9,male,251,140,106,267,568,267,432,0,136
1904205,24,1,1989,8,female,717,142,120,282,284,180,82,102,202
1068302,34,6,1979,10,female,1102,144,51,283,298,175,163,108,135
1086417,35,1,1978,4,female,1315,144,115,289,233,194,99,95,134
2181293,31,23,1982,12,female,1514,140,73,280,521,200,316,80,205
1500981,31,30,1982,3,female,800,142,105,289,75,285,51,4,24
1980628,19,10,1994,5,male,310,142,108,281,22,281,22,0,0
1586294,38,19,1975,12,female,182,140,124,288,167,288,140,0,27
1079847,26,17,1987,10,male,598,142,65,277,275,277,204,0,71
2039191,23,1,1990,8,male,403,144,95,307,16,2,3,305,13
1645537,58,2,1955,11,male,716,142,88,298,51,0,20,298,31
1712372,20,1,1993,5,female,212,141,88,305,356,250,224,55,132
1905582,16,17,1997,7,male,138,143,125,303,52,303,51,0,1
1015237,108,12,1905,6,female,1270,142,37,311,102,3,77,308,25
1054409,17,7,1996,10,female,256,140,79,309,481,124,273,185,208
1357669,49,6,1964,7,female,503,144,107,321,71,307,48,14,23
1916758,34,25,1979,5,female,429,144,131,321,196,287,100,34,96
2163682,43,15,1970,3,male,1842,143,71,319,244,252,167,67,77
1564749,20,11,1993,4,female,334,140,38,309,239,309,158,0,81
1376161,49,21,1964,12,female,339,141,109,310,505,310,472,0,33
1831576,50,13,1963,6,female,1367,142,70,332,83,0,12,332,71
1068465,48,24,1965,1,female,549,143,113,331,226,0,48,331,178
2002317,24,3,1989,9,female,694,143,80,335,31,281,20,54,11
1876943,23,23,1990,7,female,436,142,89,343,209,343,117,0,92
2152783,60,4,1953,9,female,1727,142,90,351,130,173,91,178,39
2046622,37,6,1976,6,female,1618,144,88,347,327,113,243,234,84
1910469,19,8,1994,10,female,244,140,92,353,233,353,175,0,58
1352641,103,14,1910,1,male,1140,140,94,381,222,245,72,136,150
2127949,31,7,1982,12,male,100,143,117,387,139,381,103,6,36
1950167,17,28,1996,7,male,210,143,78,393,895,359,357,34,538
2126898,60,6,1953,12,female,331,140,97,384,51,383,14,1,37
1630442,49,18,1964,8,female,931,140,85,370,120,367,88,3,32
1092308,35,14,1978,3,female,112,142,124,381,421,381,398,0,23
2139318,40,30,1973,9,female,334,142,119,392,497,392,455,0,42
1136676,62,17,1951,1,male,419,143,91,403,6,0,2,403,4
1930901,67,4,1946,11,female,520,142,104,403,98,249,33,154,65
1590670,33,30,1980,5,female,1962,143,56,401,598,288,434,113,164
1524521,15,4,1998,4,female,212,143,57,418,33,361,31,57,2
1937441,23,20,1990,3,female,262,141,99,409,190,409,174,0,16
1506319,33,5,1980,10,female,123,142,32,398,179,398,109,0,70
1482883,53,17,1960,10,male,206,140,78,450,109,0,66,450,43
1601831,65,26,1948,5,female,1534,142,52,445,329,0,26,445,303
1788261,53,24,1960,10,female,2072,144,86,438,241,331,115,107,126
1333420,17,15,1996,4,male,325,142,51,451,2,451,2,0,0
1471728,16,13,1997,10,female,333,143,67,467,323,309,210,158,113
1608950,19,29,1994,8,male,545,140,52,471,408,242,149,229,259
2019534,41,9,1972,5,female,1696,144,93,456,375,357,277,99,98
2029517,21,26,1992,7,female,250,142,133,462,263,462,166,0,97
1135465,35,23,1978,3,male,411,144,89,468,115,468,89,0,26
1181584,42,20,1971,11,female,475,144,84,474,362,474,227,0,135
1133281,67,5,1946,4,female,497,143,129,508,240,0,40,508,200
1440006,74,13,1939,6,female,1347,143,78,493,314,0,62,493,252
1434885,20,14,1993,4,female,562,140,103,506,734,128,450,378,284
1489351,33,28,1980,1,female,389,143,46,519,211,498,123,21,88
1278097,25,15,1988,9,male,150,142,123,493,140,493,117,0,23
1926221,30,19,1983,11,female,430,140,80,510,678,510,401,0,277
1586351,67,30,1946,8,female,1083,143,70,556,252,1,54,555,198
1939040,59,30,1954,9,female,603,143,57,527,411,0,7,527,404
1463132,14,18,1999,4,female,19,140,99,549,209,175,63,374,146
1798192,19,22,1994,4,female,210,140,116,540,167,488,100,52,67
2181579,20,26,1993,8,female,594,140,108,524,187,493,146,31,41
1305645,23,15,1990,8,female,307,140,50,529,148,494,132,35,16
1262576,33,4,1980,12,female,599,144,127,527,398,438,258,89,140
1060321,56,27,1957,11,female,726,143,69,584,135,92,28,492,107
2060774,108,10,1905,8,female,1933,143,92,591,265,62,101,529,164
1016474,15,16,1998,11,female,359,143,118,589,101,526,87,63,14
1309604,100,27,1913,11,male,663,144,86,596,114,583,69,13,45
1033539,20,9,1993,3,male,226,142,105,581,709,549,521,32,188
1053550,65,7,1948,7,male,784,141,88,567,355,553,253,14,102
1701914,100,3,1913,5,male,402,144,90,576,251,574,158,2,93
1672189,103,21,1910,3,female,1791,143,71,653,22,0,9,653,13
1167067,38,28,1975,5,male,453,140,83,627,521,6,73,621,448
1793602,55,24,1958,7,female,325,142,124,610,168,154,77,456,91
1714993,33,1,1980,9,female,789,142,76,618,1082,337,936,281,146
1535267,59,28,1954,4,male,1163,143,76,630,183,529,119,101,64
1499921,36,15,1977,2,female,422,141,66,654,239,654,156,0,83
1902880,60,18,1953,11,female,1508,142,91,654,391,654,346,0,45
2018730,19,20,1994,7,female,307,140,100,647,525,647,418,0,107
1202961,21,10,1992,3,female,176,143,125,645,405,645,306,0,99
1115690,113,28,1900,12,male,1257,143,103,647,811,647,708,0,103
1264113,50,15,1963,11,male,726,142,45,698,227,493,69,205,158
1599680,38,31,1975,12,female,502,140,64,701,343,684,262,17,81
1225243,62,3,1951,6,female,1150,141,102,743,939,0,126,743,813
1247567,13,16,2000,7,female,53,140,83,748,561,283,404,465,157
1958143,66,11,1947,10,male,1430,141,52,740,492,674,218,66,274
1167337,63,25,1950,1,female,1713,140,85,744,264,744,137,0,127
1979676,63,23,1950,9,female,382,141,88,823,241,0,45,823,196
1787388,53,13,1960,3,female,1725,144,81,838,691,108,95,730,596
2183946,60,19,1953,8,female,404,144,42,863,590,0,228,863,362
2111224,66,8,1947,3,female,1757,143,124,815,1512,61,657,754,855
1017489,59,28,1954,9,female,906,143,97,800,119,745,78,55,41
2043055,19,12,1994,1,male,201,140,115,815,8,809,7,6,1
1590086,20,27,1993,4,male,300,144,95,804,44,804,43,0,1
1994083,48,11,1965,5,female,410,144,121,869,416,869,320,0,96
1797380,25,27,1988,7,female,332,140,52,852,967,852,914,0,53
1868901,106,12,1907,4,female,1750,143,97,969,70,61,19,908,51
1004327,15,1,1998,11,female,140,144,98,970,586,884,535,86,51
2030317,43,12,1970,12,female,217,143,128,973,0,973,0,0,0
1807989,21,17,1992,11,female,375,143,100,898,441,898,428,0,13
1212095,48,14,1965,10,female,399,142,45,891,296,891,168,0,128
1473911,59,5,1954,5,female,769,144,74,1043,327,0,73,1043,254
1392111,14,7,1999,4,female,484,140,86,1027,557,630,229,397,328
1280505,24,3,1989,11,male,181,144,74,1120,189,1108,139,12,50
1735424,62,31,1951,8,female,1724,142,101,1005,602,1004,294,1,308
2176889,25,14,1988,2,female,1167,143,54,996,5,996,3,0,2
1051869,47,11,1966,4,female,283,141,123,1037,86,1037,76,0,10
1736765,58,9,1955,3,female,557,143,90,1207,415,0,187,1207,228
1883366,58,18,1955,7,female,677,143,88,1283,240,1283,120,0,120
1347654,43,29,1970,5,male,45,141,96,1474,394,371,251,1103,143
1707429,63,5,1950,6,female,566,144,33,1393,266,778,59,615,207
1541111,22,15,1991,1,female,107,144,119,1451,1667,828,595,623,1072
1767398,31,22,1982,8,male,392,140,73,1657,239,1158,90,499,149
1750998,46,24,1967,8,female,1420,142,74,1560,795,521,131,1039,664
2109898,45,24,1968,5,male,180,142,114,1529,955,721,264,808,691
2115431,17,13,1996,6,female,996,141,70,1749,1056,1645,329,104,727
1472032,18,21,1995,3,male,426,140,55,1950,1014,7,128,1943,886
1195304,59,24,1954,8,female,546,142,115,2133,564,0,275,2133,289
2047413,55,1,1958,4,male,177,142,87,1914,289,1914,182,0,107
1606373,71,21,1942,7,female,1463,144,65,2116,515,2116,264,0,251
1405199,22,12,1991,10,female,46,142,130,3027,1052,1291,729,1736,323
1978117,53,24,1960,4,female,328,140,98,3287,510,3287,224,0,286
1747312,18,23,1995,10,male,262,145,102,4,45,4,35,0,10
1059172,21,13,1992,11,male,207,146,18,4,14,4,12,0,2
1259924,20,17,1993,3,male,308,145,121,4,19,4,17,0,2
1858756,20,11,1993,7,male,319,145,103,4,8,4,4,0,4
1484544,22,7,1991,10,male,40,149,125,4,27,4,15,0,12
1669579,33,22,1980,10,male,183,146,53,4,39,4,37,0,2
1520500,26,4,1987,4,male,472,149,71,5,0,0,0,5,0
1752158,27,22,1986,4,male,612,147,73,5,0,0,0,5,0
1268173,15,17,1998,4,female,377,148,62,5,2,0,0,5,2
1668257,63,21,1950,4,male,1627,145,77,5,36,0,14,5,22
1229297,73,30,1940,6,male,154,145,98,5,17,0,6,5,11
1387691,108,21,1905,10,male,2116,150,127,5,36,0,9,5,27
1727875,22,1,1991,1,male,258,147,43,5,21,3,9,2,12
2185711,44,3,1969,2,female,339,148,83,5,138,1,60,4,78
1039460,23,7,1990,7,female,539,147,46,5,28,4,20,1,8
1408933,65,25,1948,8,male,1129,147,40,5,13,4,9,1,4
1859017,21,19,1992,2,male,786,150,113,5,0,5,0,0,0
1959228,17,19,1996,9,male,315,150,102,5,3,5,0,0,3
1531908,30,27,1983,5,male,445,149,77,5,2,5,2,0,0
2159176,43,30,1970,9,male,239,148,32,5,2,5,2,0,0
1925261,103,12,1910,6,male,691,145,104,5,1,5,1,0,0
1215906,19,1,1994,8,male,177,145,102,5,7,5,6,0,1
1887670,20,21,1993,4,male,230,149,81,5,4,5,2,0,2
1866306,20,18,1993,8,male,447,147,114,5,6,5,6,0,0
1787491,26,19,1987,10,male,485,149,43,5,4,5,2,0,2
1068837,108,12,1905,4,male,1152,147,76,5,4,5,4,0,0
1119104,21,20,1992,11,female,478,148,13,5,81,5,75,0,6
2065389,22,5,1991,3,female,43,147,120,5,20,5,14,0,6
1328121,28,14,1985,12,male,205,147,111,5,14,5,14,0,0
1540014,29,6,1984,2,male,227,148,31,5,16,5,15,0,1
1541140,32,31,1981,3,male,904,150,50,5,8,5,8,0,0
1074838,35,16,1978,2,male,194,145,79,5,47,5,30,0,17
1086673,26,26,1987,9,male,371,145,134,6,2,0,2,6,0
1203220,58,11,1955,4,male,202,146,130,6,1,0,0,6,1
1479047,108,19,1905,9,male,125,146,135,6,5,0,0,6,5
1999329,16,26,1997,5,male,486,148,114,6,70,1,46,5,24
1929577,28,27,1985,8,male,163,146,97,6,25,0,2,6,23
1969481,50,22,1963,10,male,1363,149,66,6,25,1,7,5,18
1188011,64,31,1949,1,female,371,148,67,6,77,1,44,5,33
2099530,113,23,1900,2,male,1242,148,44,6,0,2,0,4,0
1069206,25,16,1988,11,male,140,146,92,6,37,5,16,1,21
1572010,16,15,1997,8,male,221,146,56,6,0,6,0,0,0
1840765,22,5,1991,7,male,377,145,109,6,5,6,1,0,4
2176713,30,2,1983,10,male,763,146,50,6,6,6,5,0,1
1186853,13,9,2000,6,female,83,145,137,6,10,6,7,0,3
1741828,18,4,1995,10,male,166,150,65,6,31,6,18,0,13
1865617,25,1,1988,1,female,78,150,34,6,28,6,24,0,4
1858070,26,7,1987,7,male,269,146,134,6,13,6,9,0,4
2169906,27,5,1986,9,female,724,149,35,6,18,6,16,0,2
1011515,34,17,1979,9,male,350,148,47,6,11,6,6,0,5
1303174,108,5,1905,6,male,1478,147,74,6,25,6,16,0,9
1179700,21,6,1992,6,male,317,148,86,7,20,0,5,7,15
1158695,102,4,1911,10,NA,2043,145,117,7,13,0,11,7,2
1123763,39,5,1974,5,male,516,146,111,7,3,2,3,5,0
1502360,21,9,1992,10,male,154,146,112,7,2,7,2,0,0
1383913,23,8,1990,4,male,75,148,145,7,4,7,3,0,1
1443331,25,11,1988,8,male,294,150,106,7,2,7,2,0,0
2103293,30,29,1983,9,female,622,150,120,7,4,7,3,0,1
1383155,20,16,1993,10,female,205,145,87,7,5,7,1,0,4
1640529,23,7,1990,12,male,538,146,23,7,6,7,1,0,5
1544868,29,12,1984,11,male,405,146,22,7,8,7,7,0,1
1714708,19,25,1994,3,male,268,147,110,7,66,7,44,0,22
1271986,24,25,1989,8,male,567,148,82,7,12,7,12,0,0
1414720,28,1,1985,5,female,582,150,17,7,20,7,16,0,4
1943651,93,18,1920,2,female,1508,148,59,8,26,5,12,3,14
1607464,30,1,1983,4,female,418,150,104,8,1,8,1,0,0
1830099,33,21,1980,12,female,877,145,53,8,0,8,0,0,0
1089887,24,23,1989,3,male,335,147,99,8,2,8,2,0,0
1813262,19,14,1994,7,male,1291,149,103,8,6,8,5,0,1
1421131,20,21,1993,4,male,629,149,93,8,5,8,4,0,1
1227040,26,16,1987,9,male,603,146,63,8,7,8,7,0,0
1660081,26,8,1987,7,male,81,147,79,8,16,8,16,0,0
1427363,63,20,1950,12,female,915,148,73,8,32,8,10,0,22
1344474,53,1,1960,2,female,285,147,97,9,47,0,13,9,34
2119857,27,12,1986,1,male,488,145,122,9,11,6,5,3,6
1652429,42,5,1971,5,male,1196,148,49,9,1,9,1,0,0
1231576,16,28,1997,11,male,310,148,129,9,2,9,2,0,0
1906214,23,9,1990,11,male,303,147,125,9,3,9,1,0,2
1928095,27,7,1986,4,male,759,148,50,9,2,9,2,0,0
1355621,76,4,1937,12,female,478,149,12,9,12,9,11,0,1
2058866,21,8,1992,11,male,440,145,114,9,22,9,19,0,3
1483870,21,26,1992,3,male,144,148,120,9,48,9,34,0,14
1300523,48,22,1965,10,male,92,146,120,9,16,9,8,0,8
1374054,39,1,1974,1,male,252,150,141,10,1,0,1,10,0
1516181,65,16,1948,2,female,580,146,85,10,26,0,5,10,21
1705602,108,25,1905,10,male,2046,146,81,10,4,5,3,5,1
1290927,18,26,1995,8,male,453,145,116,10,12,6,2,4,10
1602128,32,30,1981,11,male,172,146,131,10,16,7,10,3,6
1782118,48,6,1965,12,male,1304,145,101,10,0,9,0,1,0
1477081,65,5,1948,1,male,596,148,80,10,150,9,24,1,126
1156340,28,9,1985,1,male,689,147,50,10,0,10,0,0,0
1298517,48,26,1965,11,male,1244,150,78,10,1,10,0,0,1
2012074,31,11,1982,12,male,253,145,129,10,5,10,3,0,2
2080522,91,8,1922,8,male,665,149,79,10,13,10,11,0,2
1320795,103,7,1910,12,female,606,145,66,10,8,10,8,0,0
1492273,26,16,1987,3,female,102,148,41,10,19,10,18,0,1
1015693,68,20,1945,4,female,334,147,47,10,290,10,159,0,131
1685437,18,13,1995,3,male,440,146,128,11,1,0,0,11,1
1555495,53,27,1960,1,female,455,149,107,11,1,0,0,11,1
1062057,53,23,1960,2,male,431,149,103,11,11,0,1,11,10
1223323,64,25,1949,2,male,733,147,27,11,13,0,10,11,3
1761259,72,10,1941,2,male,2023,149,30,11,9,0,6,11,3
1323993,49,29,1964,3,female,589,145,62,11,19,0,7,11,12
1858179,64,21,1949,11,female,600,149,97,11,28,0,5,11,23
1912862,19,21,1994,5,male,22,146,143,11,9,7,8,4,1
1247913,56,15,1957,8,female,1596,146,65,11,7,5,2,6,5
2128666,15,31,1998,12,male,620,149,101,11,0,10,0,1,0
1577900,34,10,1979,9,male,722,145,133,11,18,10,15,1,3
1455854,25,1,1988,1,male,64,146,117,11,1,11,1,0,0
1750572,34,19,1979,4,male,634,147,61,11,1,11,0,0,1
1254395,19,3,1994,5,male,394,147,65,11,39,11,35,0,4
1572524,21,29,1992,4,male,480,150,52,11,20,11,17,0,3
2145075,53,16,1960,6,female,344,149,117,11,28,11,18,0,10
1204328,84,24,1929,5,female,1116,146,120,11,38,11,32,0,6
1318745,20,3,1993,4,male,1175,145,51,12,10,0,4,12,6
1635916,26,22,1987,1,male,578,148,109,12,9,0,6,12,3
2157091,26,5,1987,11,female,429,147,105,12,16,5,14,7,2
1350114,108,9,1905,3,male,1328,148,18,12,23,3,15,9,8
2168204,101,26,1912,7,male,1598,147,99,12,2,10,0,2,2
1213900,18,6,1995,7,male,316,150,119,12,12,10,4,2,8
1471976,23,25,1990,2,male,187,145,83,12,11,11,7,1,4
1497953,103,1,1910,1,male,359,145,121,12,1,12,1,0,0
1555325,26,18,1987,10,female,113,148,97,12,6,12,6,0,0
1408547,28,22,1985,11,female,476,149,107,12,2,12,0,0,2
1450920,31,22,1982,1,female,690,147,25,12,5,12,3,0,2
1030622,43,30,1970,9,female,703,150,24,12,7,12,7,0,0
1329925,20,4,1993,6,male,56,150,149,12,15,12,5,0,10
1827590,43,1,1970,7,male,583,148,37,12,8,12,7,0,1
1670299,21,5,1992,6,male,546,145,48,12,32,12,18,0,14
1196961,23,10,1990,10,female,610,146,83,12,31,12,30,0,1
2114403,28,8,1985,9,female,509,150,56,12,51,12,50,0,1
1688160,49,23,1964,9,male,358,145,62,12,21,12,13,0,8
1186053,33,23,1980,5,male,640,148,134,13,0,0,0,13,0
1595236,73,18,1940,8,female,1741,145,61,13,30,6,4,7,26
1234234,20,15,1993,8,male,236,149,37,13,1,13,0,0,1
1955530,14,8,1999,1,female,238,147,16,13,7,13,7,0,0
1496201,14,2,1999,1,male,413,149,32,13,11,13,5,0,6
1991847,14,25,1999,9,male,186,146,80,13,10,13,9,0,1
2028787,47,10,1966,12,male,1349,145,70,13,19,13,16,0,3
1173116,29,13,1984,9,female,354,150,63,13,26,13,25,0,1
2019229,61,14,1952,8,female,1483,145,66,13,64,13,31,0,33
1879978,108,31,1905,8,male,1200,146,76,14,3,1,2,13,1
1355824,22,30,1991,8,female,235,148,85,14,2,8,2,6,0
2047865,32,27,1981,11,male,633,145,93,14,24,10,4,4,20
1390820,26,8,1987,6,male,358,150,98,14,28,13,26,1,2
1787281,23,31,1990,5,male,884,149,65,14,0,14,0,0,0
1336904,49,17,1964,4,male,263,149,27,14,1,14,0,0,1
2185668,17,18,1996,11,male,166,145,97,14,7,14,6,0,1
1696795,63,10,1950,11,female,862,146,91,14,4,14,4,0,0
1468617,16,13,1997,8,female,10,145,142,14,16,14,12,0,4
1608662,26,10,1987,6,male,423,148,30,14,18,14,13,0,5
1948855,25,18,1988,11,female,320,146,113,14,94,14,84,0,10
1365983,23,23,1990,1,female,807,150,81,15,4,0,0,15,4
1097273,18,20,1995,12,male,477,147,105,15,14,0,0,15,14
1665896,23,9,1990,3,male,437,149,58,15,7,4,5,11,2
1512343,30,27,1983,5,female,98,146,92,15,0,15,0,0,0
2010018,31,11,1982,1,male,392,146,76,15,5,15,1,0,4
1401193,31,17,1982,10,female,570,147,84,16,33,0,9,16,24
2081593,20,25,1993,6,female,518,147,94,16,67,5,10,11,57
1741262,18,12,1995,2,male,217,148,130,16,0,16,0,0,0
1070149,27,19,1986,11,male,337,147,45,16,1,16,0,0,1
1216280,31,15,1982,12,male,610,148,83,16,9,16,8,0,1
1432695,103,9,1910,11,male,118,148,143,16,3,16,3,0,0
1809400,18,12,1995,12,male,415,147,64,16,26,16,26,0,0
1708978,19,17,1994,6,female,8,146,56,16,363,16,358,0,5
1253049,24,16,1989,3,male,252,150,100,16,25,16,17,0,8
1794973,23,28,1990,10,male,1243,146,67,17,4,3,2,14,2
1627434,21,8,1992,12,male,207,150,147,17,11,0,10,17,1
1851769,52,4,1961,7,male,164,150,113,17,13,8,5,9,8
1448859,63,24,1950,5,female,1700,147,71,17,25,11,8,6,17
1913132,108,22,1905,6,male,1280,148,104,17,1,16,1,1,0
1586964,54,15,1959,8,male,1422,149,24,17,63,13,19,4,44
1952845,55,11,1958,10,male,1071,145,23,17,28,15,20,2,8
1096636,31,4,1982,6,male,212,148,139,17,2,17,2,0,0
1882681,20,29,1993,11,male,352,147,102,17,11,17,4,0,7
1173949,27,10,1986,4,male,225,146,77,18,4,0,0,18,4
2158992,33,9,1980,9,female,798,148,76,18,35,3,23,15,12
1054456,29,26,1984,11,male,493,146,65,18,39,15,16,3,23
1770172,83,4,1930,9,male,815,146,109,18,0,18,0,0,0
1328721,18,20,1995,6,male,291,148,96,18,15,18,8,0,7
2061704,26,27,1987,5,female,607,149,109,19,49,14,41,5,8
1145092,14,31,1999,1,male,418,147,110,19,0,19,0,0,0
1552922,18,19,1995,8,male,199,148,112,19,0,19,0,0,0
2190751,20,23,1993,3,male,615,147,41,19,0,19,0,0,0
1810490,23,12,1990,1,male,259,146,87,19,7,19,5,0,2
1384192,33,21,1980,1,female,262,145,135,19,6,19,6,0,0
1570811,46,25,1967,4,male,295,147,101,19,9,19,7,0,2
1265980,106,8,1907,3,male,53,145,128,19,5,19,4,0,1
1019474,69,21,1944,7,male,1326,147,44,19,16,19,8,0,8
2183108,17,21,1996,1,female,113,145,29,19,31,19,31,0,0
1602964,24,18,1989,8,female,410,147,124,19,38,19,26,0,12
1646031,22,31,1991,12,male,132,147,109,20,2,1,0,19,2
1603515,23,4,1990,10,male,949,145,109,20,1,6,0,14,1
1647594,28,30,1985,6,male,838,146,94,20,19,18,14,2,5
1008298,49,12,1964,6,female,175,148,112,20,96,15,73,5,23
1043079,50,1,1963,2,female,349,149,106,20,1,20,1,0,0
1264345,15,3,1998,10,male,224,148,106,20,8,20,5,0,3
2179684,49,6,1964,1,female,541,148,84,21,2,4,2,17,0
1213159,40,23,1973,8,male,172,147,74,21,14,0,4,21,10
1186378,73,4,1940,3,female,1895,145,114,21,77,14,35,7,42
1241954,15,29,1998,5,male,255,150,93,21,5,16,5,5,0
1980273,19,10,1994,4,female,342,145,37,21,138,17,53,4,85
1376257,27,29,1986,6,male,647,149,49,21,22,21,10,0,12
1507663,21,24,1992,9,male,441,145,99,21,55,21,15,0,40
2125183,42,8,1971,9,male,913,150,93,21,82,21,31,0,51
1654137,17,25,1996,6,male,262,148,131,22,2,0,1,22,1
1500476,29,13,1984,9,male,158,148,129,22,2,0,0,22,2
1909083,18,25,1995,10,female,767,145,29,22,13,14,6,8,7
1490758,24,14,1989,9,female,1496,148,77,22,34,12,9,10,25
1634463,23,13,1990,1,male,494,149,100,22,9,22,4,0,5
1782168,62,30,1951,9,male,480,148,110,22,113,22,50,0,63
1480336,13,23,2000,4,male,307,146,99,23,17,4,8,19,9
1749209,19,20,1994,4,male,140,145,92,23,32,1,19,22,13
2034477,108,5,1905,9,male,961,147,109,23,52,0,19,23,33
2086813,25,12,1988,9,female,374,148,95,23,13,8,4,15,9
1554733,61,19,1952,12,female,1659,147,69,23,67,11,13,12,54
1069420,19,17,1994,11,female,415,147,65,23,6,23,6,0,0
2178409,40,6,1973,10,male,331,150,82,23,7,23,7,0,0
1200699,15,8,1998,9,male,227,146,129,23,34,23,30,0,4
1481885,22,28,1991,3,male,231,148,120,23,30,23,26,0,4
1194662,21,2,1992,7,male,445,147,122,24,0,0,0,24,0
1927590,60,15,1953,6,female,535,146,91,24,24,0,10,24,14
1281003,51,17,1962,3,female,1159,145,96,24,58,4,24,20,34
1868042,65,11,1948,1,male,1347,145,63,24,70,0,19,24,51
1364102,20,1,1993,1,male,332,148,145,24,0,14,0,10,0
1264665,18,19,1995,2,male,455,146,91,25,10,0,2,25,8
2043501,108,14,1905,3,female,218,146,119,25,18,0,3,25,15
1306910,19,4,1994,6,male,314,150,128,25,0,15,0,10,0
1010312,29,8,1984,10,female,1201,150,20,25,21,23,19,2,2
2064729,35,12,1978,6,male,500,147,75,25,0,25,0,0,0
1970686,67,25,1946,8,male,324,148,125,25,11,25,9,0,2
1880609,108,12,1905,1,male,1137,145,73,25,8,25,8,0,0
1675073,15,17,1998,7,female,275,147,80,25,21,25,15,0,6
1964167,60,28,1953,12,male,1429,148,81,25,20,25,18,0,2
1960324,42,23,1971,11,female,271,145,102,25,48,25,44,0,4
1973551,44,5,1969,10,male,1859,148,79,25,51,25,30,0,21
1971080,98,14,1915,10,male,1736,145,73,26,31,0,8,26,23
1252057,23,2,1990,3,male,524,150,69,26,26,6,13,20,13
2115154,33,29,1980,8,female,406,145,87,26,7,23,3,3,4
1610624,25,22,1988,11,male,895,148,77,26,4,26,2,0,2
1819211,30,11,1983,3,male,309,145,71,26,7,26,7,0,0
1348721,19,9,1994,1,male,291,150,67,26,25,26,25,0,0
1736884,18,10,1995,5,male,481,150,135,26,53,26,38,0,15
1762579,48,14,1965,2,female,287,149,111,27,12,0,6,27,6
1900174,68,5,1945,8,male,1816,147,98,27,12,13,7,14,5
1729557,31,2,1982,7,female,1780,145,57,27,80,18,58,9,22
1426668,21,12,1992,4,female,76,148,66,27,51,26,34,1,17
1209417,48,29,1965,11,male,829,150,127,27,8,27,6,0,2
1875714,18,24,1995,11,female,197,145,115,28,39,24,20,4,19
1138957,17,11,1996,7,male,789,148,64,28,1,28,1,0,0
1913087,18,23,1995,1,male,223,150,125,28,5,28,4,0,1
1413400,55,17,1958,9,male,913,146,76,28,11,28,11,0,0
1908515,68,9,1945,3,male,1755,149,31,28,14,28,6,0,8
1724415,18,8,1995,7,male,356,148,84,28,29,28,29,0,0
1832799,25,6,1988,6,male,351,149,135,28,35,28,9,0,26
1779476,26,1,1987,1,male,509,150,90,29,23,15,15,14,8
1977922,45,21,1968,6,male,1598,148,105,29,8,27,8,2,0
2102431,16,11,1997,7,male,487,150,78,29,2,29,2,0,0
1466942,47,2,1966,9,male,107,146,127,29,5,29,1,0,4
2026822,108,14,1905,7,male,479,147,108,29,17,29,14,0,3
1663422,24,22,1989,2,female,910,145,57,29,32,29,29,0,3
1187413,108,15,1905,9,female,291,150,96,31,100,4,44,27,56
1901142,108,3,1905,7,female,1169,147,94,30,12,29,9,1,3
1006641,100,2,1913,10,female,1815,145,83,30,30,26,21,4,9
1386052,19,26,1994,6,male,336,146,88,31,15,31,9,0,6
1119172,33,2,1980,9,female,144,148,96,30,8,30,1,0,7
1917652,26,10,1987,8,male,72,149,139,30,29,30,29,0,0
1888833,30,4,1983,11,male,495,149,121,31,50,31,49,0,1
2005668,50,30,1963,9,male,644,150,87,32,31,0,13,32,18
1444186,28,28,1985,10,male,313,150,75,32,25,21,18,11,7
1802968,20,8,1993,9,female,240,145,91,32,41,28,25,4,16
1988043,42,21,1971,10,male,131,146,15,32,69,32,24,0,45
1402119,45,16,1968,7,female,265,150,124,32,93,32,41,0,52
1185064,22,21,1991,10,male,186,145,133,33,17,9,3,24,14
1877014,32,28,1981,2,male,548,150,59,33,1,33,1,0,0
1272455,20,17,1993,8,female,317,145,79,34,125,33,106,1,19
1280717,25,12,1988,5,male,328,149,48,34,57,25,44,9,13
1666559,22,1,1991,1,male,532,149,113,34,12,34,12,0,0
1523251,52,27,1961,4,male,1027,149,64,34,20,34,7,0,13
2059187,14,2,1999,8,female,335,147,51,34,21,34,6,0,15
1855200,24,13,1989,12,female,417,149,121,36,5,0,2,36,3
2119131,48,21,1965,2,female,105,148,106,36,23,0,0,36,23
1239129,63,22,1950,3,female,299,147,103,35,94,0,34,35,60
1027546,33,17,1980,7,male,1814,149,60,35,2,22,2,13,0
1225402,49,6,1964,6,female,576,146,108,36,6,14,2,22,4
1886741,43,25,1970,11,female,104,147,62,36,43,20,21,16,22
1748528,49,11,1964,7,male,839,147,118,36,68,18,22,18,46
1669304,103,19,1910,3,male,999,148,82,36,107,17,60,19,47
1167257,43,16,1970,10,male,155,150,43,36,33,27,15,9,18
1922226,60,5,1953,11,male,1078,146,28,35,37,27,14,8,23
1175961,19,1,1994,3,female,661,147,65,35,4,35,4,0,0
1049787,69,19,1944,2,female,1213,150,118,36,0,36,0,0,0
1094081,23,24,1990,5,male,520,148,57,36,50,36,40,0,10
2184563,20,23,1993,8,male,87,150,64,35,134,35,89,0,45
2105552,56,11,1957,12,male,311,148,68,37,45,0,25,37,20
1213120,21,5,1992,11,male,100,148,142,37,10,34,7,3,3
1720700,23,18,1990,5,female,716,146,94,37,39,27,21,10,18
2080292,21,8,1992,3,female,339,148,29,37,75,33,73,4,2
2149070,17,18,1996,6,male,436,145,86,39,18,5,14,34,4
1934654,68,3,1945,3,female,1802,148,94,39,15,1,2,38,13
2031249,35,1,1978,6,male,595,149,106,39,24,27,7,12,17
1808943,14,16,1999,12,male,245,146,49,38,38,29,22,9,16
1669144,36,9,1977,1,female,264,146,135,38,32,32,9,6,23
1440086,46,28,1967,10,male,273,145,25,38,38,38,28,0,10
2190401,24,5,1989,12,female,505,147,38,38,66,38,66,0,0
2162603,17,4,1996,8,male,272,145,128,40,2,20,2,20,0
1011613,27,10,1986,4,male,699,146,107,40,21,40,3,0,18
1568926,31,18,1982,8,male,284,146,45,40,39,40,12,0,27
2081469,16,22,1997,12,male,137,149,125,41,13,3,7,38,6
1758559,18,14,1995,5,female,574,146,83,42,8,23,3,19,5
1891056,54,17,1959,1,female,998,146,119,41,72,33,46,8,26
1701015,15,11,1998,10,male,83,146,75,42,12,42,8,0,4
1236748,19,24,1994,4,male,665,145,65,41,24,41,23,0,1
1168178,22,1,1991,12,male,393,145,106,41,20,41,18,0,2
1991915,19,25,1994,9,female,19,146,129,41,45,41,22,0,23
2177849,27,25,1986,3,male,108,145,112,41,439,41,309,0,130
1480618,30,26,1983,2,male,583,148,99,42,91,42,79,0,12
1896155,44,10,1969,4,male,438,146,74,42,118,42,106,0,12
1554082,15,22,1998,8,male,184,150,142,43,0,0,0,43,0
2065163,63,2,1950,4,male,552,146,113,44,28,0,4,44,24
1639811,20,3,1993,4,male,614,145,71,43,3,24,2,19,1
1506686,27,24,1986,6,female,546,150,84,44,110,43,30,1,80
1177820,19,22,1994,4,male,277,148,46,44,21,44,18,0,3
1546965,41,23,1972,6,male,225,147,69,43,25,43,21,0,4
1247904,108,1,1905,7,male,1180,147,91,43,19,43,7,0,12
1232267,19,6,1994,8,female,373,147,86,44,36,44,19,0,17
1225711,28,9,1985,1,female,310,148,113,43,79,43,56,0,23
2153945,47,10,1966,5,female,2222,147,57,43,257,43,173,0,84
2159073,21,12,1992,3,male,376,150,70,45,78,28,35,17,43
1117810,15,2,1998,2,female,127,147,123,45,18,45,13,0,5
1671983,23,9,1990,3,male,438,146,74,45,25,45,17,0,8
1405107,16,19,1997,12,female,157,145,109,45,64,45,22,0,42
2107411,23,24,1990,10,male,507,149,77,45,751,45,380,0,371
1527878,59,20,1954,5,male,485,145,58,46,145,0,54,46,91
1883022,13,14,2000,2,male,233,147,81,47,53,47,41,0,12
1394608,22,11,1991,11,female,532,150,100,46,50,46,48,0,2
1663599,25,9,1988,3,female,483,146,19,46,61,46,20,0,41
1400815,26,16,1987,3,male,286,145,78,47,37,47,32,0,5
1953431,29,1,1984,1,male,321,150,54,46,37,46,36,0,1
1495590,41,10,1972,5,male,258,145,70,46,61,46,31,0,30
1461850,17,11,1996,2,female,5,146,123,49,43,12,12,37,31
1208183,21,2,1992,9,male,333,147,97,48,22,40,17,8,5
1731987,16,10,1997,5,female,462,148,107,48,74,47,51,1,23
1077423,17,15,1996,5,male,187,146,51,48,218,35,100,13,118
1913292,25,8,1988,8,female,177,145,76,48,151,47,70,1,81
1789081,22,15,1991,5,male,273,146,77,48,16,48,16,0,0
1813993,75,24,1938,12,male,648,145,123,48,9,48,4,0,5
1398493,79,1,1934,1,female,1840,147,57,48,10,48,10,0,0
1103372,25,23,1988,12,male,168,149,131,49,729,49,674,0,55
1589681,37,14,1976,9,male,768,149,118,51,4,41,4,10,0
1960810,108,25,1905,5,male,882,145,86,51,6,48,6,3,0
1210877,16,24,1997,6,male,532,148,50,50,8,50,5,0,3
1982868,100,31,1913,12,male,858,148,24,50,6,50,6,0,0
1889745,27,1,1986,1,male,712,145,109,51,21,51,21,0,0
1916272,103,27,1910,12,male,1319,145,87,51,31,51,12,0,19
1420952,29,13,1984,6,male,988,148,84,50,35,50,25,0,10
1338111,15,2,1998,2,female,47,150,139,51,90,51,47,0,43
1070976,48,5,1965,1,male,1242,148,44,51,231,51,177,0,54
2059035,54,11,1959,12,female,966,150,94,50,191,50,157,0,34
1148541,43,23,1970,11,female,221,147,75,53,40,0,5,53,35
1021248,17,1,1996,8,male,470,145,96,52,7,25,4,27,3
1817503,36,30,1977,9,male,539,150,99,53,105,37,58,16,47
2120606,96,26,1917,10,male,2203,148,95,52,49,48,46,4,3
1548716,17,23,1996,4,male,380,149,72,53,31,53,18,0,13
1540404,24,3,1989,7,male,530,147,119,53,9,53,9,0,0
1535894,26,1,1987,3,female,407,147,33,53,77,53,68,0,9
1633888,31,1,1982,6,female,314,147,100,52,86,52,63,0,23
1086114,102,1,1911,1,female,1252,149,82,55,11,0,6,55,5
1074508,46,25,1967,8,female,141,150,54,54,291,23,103,31,188
1560578,17,10,1996,4,male,513,145,49,54,3,51,3,3,0
2002653,21,31,1992,12,male,876,148,59,54,24,54,19,0,5
1530289,44,22,1969,10,male,235,150,99,54,23,54,21,0,2
1753151,24,13,1989,11,male,648,145,83,54,34,54,23,0,11
1675546,30,20,1983,8,male,256,150,109,55,93,55,86,0,7
1162002,17,1,1996,8,male,561,147,34,57,5,3,2,54,3
1679556,28,16,1985,4,male,466,148,119,58,5,2,0,56,5
2151095,61,2,1952,7,female,1176,150,129,57,13,6,3,51,10
1417763,61,6,1952,10,female,1071,149,50,58,56,0,37,58,19
2132089,15,4,1998,3,male,732,148,95,58,1,57,1,1,0
1413768,17,6,1996,10,male,155,150,146,58,8,58,7,0,1
1837843,25,17,1988,4,male,295,149,117,56,7,56,6,0,1
1513083,28,11,1985,3,male,221,148,106,56,28,56,19,0,9
1676039,20,26,1993,1,male,272,150,57,60,11,22,7,38,4
1476409,21,22,1992,4,male,277,148,69,60,51,15,40,45,11
1175993,89,10,1924,3,male,1723,145,91,60,30,59,21,1,9
1624954,34,8,1979,11,female,1485,148,57,60,70,59,33,1,37
1827295,13,15,2000,1,female,232,148,57,62,40,51,21,11,19
1318672,27,8,1986,10,male,470,145,103,62,56,62,33,0,23
1314452,33,7,1980,4,male,515,145,80,63,51,63,37,0,14
1560317,54,15,1959,4,male,735,149,78,63,73,63,54,0,19
1388632,15,10,1998,10,female,477,147,120,62,108,62,88,0,20
1764596,26,8,1987,7,male,275,145,113,64,53,64,27,0,26
1371511,24,12,1989,5,male,860,150,85,68,43,24,20,44,23
2003161,28,7,1985,5,female,592,149,122,66,73,65,55,1,18
1054157,26,10,1987,8,female,370,146,95,66,29,66,29,0,0
1494064,20,11,1993,6,female,262,146,97,67,71,67,32,0,39
1201344,16,20,1997,7,male,261,149,88,70,36,47,25,23,11
1901036,56,12,1957,9,female,2191,147,34,69,106,27,59,42,47
1363633,49,11,1964,3,female,286,150,20,69,328,67,45,2,283
2182017,22,31,1991,7,male,443,149,130,70,0,70,0,0,0
1857527,23,1,1990,1,male,131,150,118,71,17,71,17,0,0
1073638,22,7,1991,9,female,302,146,99,71,69,71,59,0,10
2113010,30,21,1983,4,male,899,145,37,71,95,71,91,0,4
1192741,28,29,1985,9,male,144,150,135,71,122,71,91,0,31
1519661,28,23,1985,12,male,380,146,97,73,34,37,19,36,15
1907401,25,16,1988,1,female,158,148,90,74,48,29,29,45,19
1014214,40,18,1973,12,female,932,150,85,73,103,46,57,27,46
1633097,52,8,1961,12,female,610,150,106,73,3,61,0,12,3
1148729,21,16,1992,12,female,313,149,106,73,9,73,8,0,1
1595685,18,20,1995,11,male,510,145,63,73,42,73,23,0,19
1353440,41,24,1972,5,male,239,149,84,72,42,72,40,0,2
1205799,24,12,1989,12,female,151,149,123,73,87,73,76,0,11
1667631,31,18,1982,8,male,752,149,103,74,145,74,108,0,37
1821402,67,13,1946,8,male,938,148,75,76,46,0,14,76,32
2024354,21,2,1992,8,male,410,150,94,76,221,9,159,67,62
2070761,55,28,1958,8,male,1690,148,72,76,1315,17,502,59,813
2031733,106,21,1907,1,male,1805,145,55,76,90,74,32,2,58
1873167,49,21,1964,5,female,532,148,73,76,124,75,31,1,93
1837875,25,9,1988,9,female,355,149,91,77,52,77,30,0,22
1810297,28,10,1985,10,female,1584,150,115,75,69,75,56,0,13
1154404,59,1,1954,9,female,1714,150,71,76,47,76,46,0,1
1154567,17,18,1996,10,female,87,145,101,78,50,6,19,72,31
1451016,17,11,1996,9,male,456,146,134,79,2,50,1,29,1
1216737,15,13,1998,5,female,214,149,50,80,4,80,3,0,1
1416187,26,1,1987,12,male,312,149,105,78,82,78,55,0,27
1465984,18,5,1995,3,male,437,145,121,83,4,6,4,77,0
1696608,108,5,1905,5,female,1339,145,89,81,22,0,8,81,14
1784840,57,17,1956,4,male,640,150,98,84,58,0,10,84,48
1121123,17,1,1996,11,female,68,145,138,84,50,36,17,48,33
1161348,36,7,1977,11,female,808,145,76,83,14,56,11,27,3
1511137,94,18,1919,2,male,1805,147,99,82,9,81,6,1,3
2141929,27,1,1986,5,male,668,147,84,83,52,66,29,17,23
2037678,43,14,1970,12,female,1061,145,46,82,74,62,41,20,33
1076978,46,28,1967,10,female,1889,146,87,82,212,68,162,14,50
1094381,52,10,1961,11,male,1074,146,65,84,334,74,111,10,223
1688412,15,23,1998,9,female,325,145,91,82,24,82,15,0,9
1437608,16,10,1997,2,male,156,146,79,81,34,81,34,0,0
1303141,16,18,1997,3,female,300,150,95,82,30,82,17,0,13
1749577,24,8,1989,5,female,252,146,118,83,16,83,11,0,5
1892835,19,1,1994,7,male,347,149,98,81,127,81,89,0,38
1341514,23,20,1990,1,female,329,146,81,86,56,55,43,31,13
1323935,23,19,1990,10,male,120,150,115,87,4,87,4,0,0
1005485,21,30,1992,7,female,438,149,93,86,23,86,15,0,8
1511438,28,22,1985,4,female,407,145,137,87,71,87,58,0,13
2020313,19,27,1994,2,male,478,149,33,89,4,1,2,88,2
1597662,66,27,1947,7,female,234,145,41,89,1,0,0,89,1
1630893,23,21,1990,10,female,218,149,62,91,38,91,34,0,4
1765327,34,22,1979,5,female,329,147,43,88,69,88,56,0,13
2011352,63,16,1950,8,female,1697,146,91,93,91,0,48,93,43
1962907,100,7,1913,2,male,1046,145,78,94,260,0,90,94,170
1688494,48,25,1965,12,female,1694,148,94,93,138,46,106,47,32
2193243,111,1,1902,1,NA,2269,148,53,93,90,30,41,63,49
1336718,16,2,1997,1,female,585,150,104,95,31,70,16,25,15
1761751,18,5,1995,10,male,227,150,52,94,102,78,55,16,47
1156365,52,23,1961,11,female,565,145,77,94,67,89,34,5,33
1336121,14,25,1999,2,female,295,150,115,94,38,94,28,0,10
1641612,47,7,1966,11,female,1707,148,77,94,84,94,59,0,25
1877658,19,26,1994,11,female,223,147,74,99,89,97,37,2,52
1196283,22,7,1991,8,female,706,146,79,99,141,99,79,0,62
1873170,113,19,1900,2,female,1195,150,82,101,21,0,20,101,1
1164097,14,7,1999,12,male,310,145,85,100,26,68,15,32,11
1634422,14,15,1999,12,female,51,150,105,103,33,98,30,5,3
1997138,58,10,1955,1,female,352,150,91,101,79,95,35,6,44
1713604,20,4,1993,11,female,661,148,111,101,295,82,189,19,106
1251792,32,8,1981,9,male,945,150,30,104,0,104,0,0,0
1541623,15,20,1998,10,female,312,146,72,104,42,104,42,0,0
2131219,16,21,1997,10,female,154,148,80,104,291,104,277,0,14
1294246,35,8,1978,8,female,323,145,85,100,161,100,136,0,25
1334382,43,5,1970,11,male,379,150,95,104,196,104,178,0,18
1505906,17,6,1996,6,male,129,147,85,108,28,0,15,108,13
1565677,47,1,1966,11,female,414,147,80,105,70,0,18,105,52
2056350,99,26,1914,10,male,638,145,100,109,12,29,7,80,5
1602188,108,28,1905,5,male,1074,150,110,107,9,95,7,12,2
1028241,21,20,1992,12,female,245,146,94,108,9,108,3,0,6
1545457,39,8,1974,8,male,464,150,44,107,64,107,59,0,5
1664680,35,1,1978,9,female,176,149,134,106,87,106,61,0,26
1295042,19,29,1994,9,male,384,145,77,112,24,21,6,91,18
1174959,30,4,1983,11,female,448,148,116,111,9,105,8,6,1
1784974,103,29,1910,4,female,1564,145,75,111,47,111,29,0,18
1380057,19,16,1994,10,male,581,150,107,112,76,112,51,0,25
1086478,32,9,1981,7,female,127,147,97,110,310,110,278,0,32
2033726,60,4,1953,4,female,1793,146,47,113,219,113,132,0,87
1996006,18,20,1995,5,male,524,146,120,114,5,5,3,109,2
1410326,108,2,1905,6,female,1184,149,106,119,17,0,5,119,12
1539104,54,8,1959,2,male,298,150,87,118,30,0,7,118,23
2095752,43,12,1970,12,male,268,146,88,115,14,29,1,86,13
2013240,61,6,1952,2,female,1755,149,103,114,63,42,41,72,22
1783294,29,17,1984,2,female,1404,145,81,119,109,118,80,1,29
1736244,35,21,1978,3,female,511,147,73,115,62,115,18,0,44
2028622,24,5,1989,5,male,302,149,105,119,154,119,117,0,37
1705039,54,11,1959,11,female,1683,145,61,115,86,115,62,0,24
1394299,78,26,1935,8,female,1196,145,87,124,155,0,78,124,77
1424027,18,17,1995,4,male,26,148,133,121,64,26,46,95,18
2179237,16,10,1997,8,male,13,148,46,121,125,111,70,10,55
1906582,41,17,1972,8,female,190,148,63,121,77,119,62,2,15
1964743,96,17,1917,9,female,1489,145,53,121,103,121,86,0,17
1472564,15,17,1998,3,male,129,148,128,126,8,6,2,120,6
1548689,56,10,1957,4,female,1338,147,96,127,92,9,55,118,37
1323849,38,26,1975,10,female,355,145,130,125,75,79,46,46,29
1447503,68,12,1945,8,female,2324,145,43,130,39,92,25,38,14
1747339,44,5,1969,7,male,103,146,143,129,523,84,378,45,145
1073097,48,9,1965,9,female,985,148,94,125,240,122,218,3,22
1604142,32,7,1981,5,male,1386,146,64,128,163,127,93,1,70
1494036,33,7,1980,10,male,669,148,111,125,19,125,17,0,2
1076991,17,3,1996,1,female,421,149,102,127,107,127,71,0,36
1148999,19,18,1994,8,male,19,147,145,126,160,126,85,0,75
2056755,20,20,1993,10,female,204,150,128,133,79,24,23,109,56
2013410,19,1,1994,2,male,637,150,79,136,66,90,39,46,27
1145279,52,15,1961,10,male,752,147,36,132,74,38,43,94,31
1109478,42,31,1971,7,female,1306,148,54,132,17,131,6,1,11
1033518,18,12,1995,10,female,319,147,103,133,17,133,16,0,1
2130046,21,16,1992,7,female,592,146,66,134,94,134,27,0,67
1411998,38,2,1975,7,male,616,146,87,134,104,134,50,0,54
1917723,46,13,1967,6,female,743,150,113,131,92,131,69,0,23
1827911,37,17,1976,3,female,755,146,117,138,46,64,15,74,31
1935412,19,20,1994,7,male,163,150,131,140,112,59,59,81,53
1077005,100,6,1913,11,male,867,146,54,139,56,130,45,9,11
1569326,18,28,1995,6,male,325,147,76,143,108,122,45,21,63
1191101,19,26,1994,7,female,23,147,138,137,25,137,24,0,1
1787699,21,26,1992,4,female,497,148,78,138,157,138,54,0,103
1910322,29,20,1984,6,male,325,145,133,142,234,142,233,0,1
2095762,27,7,1986,5,male,212,146,115,144,16,129,13,15,3
1529203,28,3,1985,9,male,1108,150,110,148,37,119,30,29,7
1333725,17,9,1996,6,female,93,148,98,147,257,139,39,8,218
1946552,37,30,1976,10,male,711,148,58,144,70,144,35,0,35
1953936,49,15,1964,4,female,1193,145,90,146,54,146,53,0,1
1478834,49,15,1964,7,female,359,146,69,150,116,150,82,0,34
1155548,38,8,1975,6,female,627,148,97,157,21,11,3,146,18
1623496,49,26,1964,1,male,2204,147,64,151,81,61,38,90,43
1985089,66,30,1947,6,female,1500,150,82,156,120,155,64,1,56
1858370,52,30,1961,6,female,956,148,53,162,309,31,211,131,98
1786001,20,1,1993,3,female,444,149,56,163,40,134,20,29,20
1532857,18,30,1995,12,male,241,149,29,163,361,158,334,5,27
1709885,41,11,1972,6,female,240,147,114,162,74,162,39,0,35
1545387,15,6,1998,7,male,185,147,89,159,162,159,125,0,37
2163586,28,9,1985,9,male,631,145,127,162,144,162,51,0,93
1909005,100,9,1913,11,female,1660,146,41,171,94,2,19,169,75
1303145,28,2,1985,12,female,489,148,61,165,265,15,118,150,147
1328244,14,26,1999,10,female,188,146,94,171,26,171,18,0,8
1835281,20,20,1993,4,female,627,145,33,168,40,168,40,0,0
1470098,24,8,1989,12,male,310,149,110,173,80,25,36,148,44
2026765,103,25,1910,11,female,1252,147,38,174,42,0,23,174,19
1667903,44,27,1969,6,female,243,148,79,176,114,1,22,175,92
2182040,56,24,1957,10,female,512,146,64,176,305,23,50,153,255
2147945,30,19,1983,8,male,315,147,92,181,445,98,225,83,220
2111730,32,4,1981,8,female,188,145,53,180,62,148,14,32,48
1123719,21,24,1992,4,male,308,149,108,179,72,179,69,0,3
1096160,57,10,1956,7,female,307,150,131,175,70,175,30,0,40
2051417,23,27,1990,9,female,19,146,131,176,209,176,183,0,26
1333551,54,22,1959,1,female,422,145,96,190,90,0,23,190,67
1243711,68,7,1945,10,female,68,146,133,182,88,0,6,182,82
1578219,13,5,2000,5,female,169,147,77,185,83,108,37,77,46
1611150,25,28,1988,12,male,398,147,83,188,226,67,61,121,165
1786738,19,19,1994,4,male,86,150,106,187,3,187,1,0,2
2055461,21,7,1992,1,male,49,150,79,185,12,185,9,0,3
1694043,17,24,1996,1,female,11,146,138,188,37,188,29,0,8
1347122,20,8,1993,7,female,263,149,64,182,76,182,53,0,23
2049084,13,9,2000,6,female,548,148,81,187,185,187,101,0,84
1716846,45,8,1968,11,female,1307,150,79,190,265,190,156,0,109
1165246,72,27,1941,5,female,1731,145,66,185,440,185,237,0,203
1141804,60,17,1953,12,female,1626,147,66,191,33,119,18,72,15
1681208,44,31,1969,10,female,777,145,122,198,301,178,216,20,85
2103486,20,11,1993,11,male,34,148,147,194,162,194,145,0,17
2041061,61,19,1952,4,female,1421,145,71,210,408,0,204,210,204
1195412,95,8,1918,8,male,1555,150,65,202,184,99,91,103,93
1374062,69,4,1944,7,female,898,150,64,209,445,99,107,110,338
1282045,23,24,1990,11,female,292,145,88,208,126,208,46,0,80
1539959,23,23,1990,11,female,165,145,133,206,68,206,46,0,22
1973071,52,17,1961,8,female,2312,145,68,202,61,202,41,0,20
1693720,25,14,1988,11,female,553,145,44,206,153,206,152,0,1
1836559,56,2,1957,6,female,1306,148,71,201,140,201,86,0,54
1804755,104,1,1909,11,male,754,146,89,216,72,0,12,216,60
1174103,21,24,1992,5,male,432,150,89,219,224,36,79,183,145
1218583,63,29,1950,5,female,847,148,55,215,92,206,80,9,12
1584397,29,10,1984,5,male,416,147,117,217,158,184,77,33,81
1162814,22,29,1991,7,female,406,148,87,220,60,219,52,1,8
2111455,45,29,1968,6,male,90,149,115,215,129,215,121,0,8
1173637,81,5,1932,11,male,1068,146,35,217,144,217,98,0,46
1088008,29,26,1984,12,female,356,149,88,213,360,213,253,0,107
1069747,62,5,1951,6,female,1087,149,45,227,22,0,16,227,6
1721032,67,9,1946,7,female,792,146,79,230,388,0,112,230,276
1153300,45,27,1968,10,male,560,149,94,225,45,57,17,168,28
1049986,92,19,1921,9,male,941,149,85,231,69,47,38,184,31
1224851,31,13,1982,10,male,809,146,68,233,305,130,220,103,85
1853347,28,7,1985,10,male,462,147,92,230,451,98,231,132,220
1853363,53,20,1960,6,female,1097,145,49,223,95,210,78,13,17
1438224,17,14,1996,10,female,294,148,60,226,170,221,164,5,6
1308915,32,7,1981,3,male,1588,147,66,227,369,201,259,26,110
1237856,16,6,1997,7,male,329,145,109,241,85,219,63,22,22
1290073,40,13,1973,5,female,1176,150,103,244,605,212,447,32,158
2156943,16,12,1997,2,male,331,148,110,244,16,244,8,0,8
1701252,17,9,1996,4,male,232,146,90,234,124,234,111,0,13
1703089,26,15,1987,3,female,96,147,116,238,214,238,209,0,5
1055165,28,7,1985,1,female,135,146,48,243,361,243,293,0,68
1385436,55,4,1958,5,male,548,148,74,260,108,0,58,260,50
1594292,35,26,1978,8,female,1714,148,44,251,393,166,151,85,242
1189104,20,26,1993,7,male,90,148,132,247,25,243,15,4,10
1291132,44,18,1969,3,male,206,147,13,254,13,250,10,4,3
1676010,61,28,1952,9,male,537,145,67,252,104,245,41,7,63
1889347,61,28,1952,9,female,2127,147,56,260,372,223,141,37,231
1247306,62,7,1951,10,male,647,149,130,249,35,249,34,0,1
1947378,55,21,1958,9,male,1423,147,83,251,256,251,203,0,53
1956901,19,17,1994,6,male,393,149,59,248,578,248,529,0,49
1199793,20,10,1993,1,male,545,146,95,272,33,2,12,270,21
1328702,62,30,1951,8,female,1214,150,90,270,64,32,27,238,37
2135466,71,10,1942,6,female,1240,150,64,267,161,0,17,267,144
1222459,83,25,1930,1,female,1866,145,57,264,159,0,20,264,139
2145073,20,25,1993,11,male,297,147,88,263,79,132,52,131,27
1573167,28,22,1985,3,female,435,147,114,276,129,271,75,5,54
2072351,27,15,1986,11,female,1158,146,93,268,369,264,211,4,158
1743732,54,13,1959,9,female,1784,146,111,266,255,245,229,21,26
1920006,27,29,1986,10,male,444,150,92,264,29,263,24,1,5
1387010,19,4,1994,4,male,198,147,93,273,57,273,50,0,7
1328388,24,13,1989,1,male,628,147,123,265,96,265,86,0,10
1778302,53,10,1960,8,male,329,145,40,270,103,270,36,0,67
1400181,37,9,1976,10,female,934,145,67,261,384,261,265,0,119
1019271,37,20,1976,5,female,491,146,17,267,520,267,418,0,102
1981236,17,28,1996,5,male,126,149,79,277,151,0,40,277,111
1000301,60,20,1953,10,female,408,148,31,289,125,25,101,264,24
1398917,59,11,1954,3,female,843,146,77,284,173,0,50,284,123
1708990,100,13,1913,12,female,1795,145,18,283,99,164,61,119,38
1779669,20,3,1993,1,female,508,150,110,290,204,235,89,55,115
1524833,22,22,1991,7,female,290,149,89,279,218,213,123,66,95
1885843,23,13,1990,10,female,47,149,92,278,291,277,189,1,102
1224301,67,19,1946,7,female,1738,148,85,298,51,39,31,259,20
1171423,44,3,1969,12,male,246,147,95,304,11,131,5,173,6
2020663,23,5,1990,6,male,202,147,87,306,60,188,6,118,54
1994783,22,20,1991,1,female,233,146,77,304,300,299,282,5,18
1503899,17,16,1996,12,male,476,149,108,303,129,301,26,2,103
2059051,36,11,1977,9,male,1052,147,118,307,2,307,2,0,0
1936650,57,11,1956,10,female,1558,147,67,305,20,305,12,0,8
1570497,39,1,1974,5,male,375,148,77,302,66,302,55,0,11
1888200,31,20,1982,9,female,291,148,92,306,205,306,124,0,81
1332018,68,17,1945,8,male,567,149,105,295,316,295,299,0,17
1198185,52,1,1961,8,female,607,148,34,323,38,0,18,323,20
2126376,21,1,1992,10,female,254,149,62,312,371,209,223,103,148
1795622,52,24,1961,9,male,343,145,97,312,53,267,22,45,31
2175582,29,26,1984,10,male,678,150,45,311,328,266,118,45,210
1767718,53,7,1960,2,female,1739,145,103,317,366,268,165,49,201
1941391,53,12,1960,12,female,1278,150,69,314,94,311,74,3,20
1579093,17,5,1996,3,female,307,147,50,321,81,321,56,0,25
1852948,20,28,1993,10,male,247,145,64,310,102,310,73,0,29
1039955,14,31,1999,8,female,390,150,57,309,196,309,177,0,19
1406058,46,21,1967,8,male,606,148,111,322,309,322,216,0,93
2167213,55,28,1958,11,female,462,147,144,328,21,209,9,119,12
1534882,15,2,1998,6,female,283,150,104,341,319,300,199,41,120
2093606,48,17,1965,2,female,457,146,23,342,381,291,153,51,228
2141512,61,31,1952,3,female,946,146,72,346,515,318,235,28,280
2153311,44,15,1969,8,female,1699,145,126,346,16,344,16,2,0
1257346,24,14,1989,10,female,156,149,110,340,378,340,96,0,282
2189024,29,22,1984,7,male,601,150,99,345,246,345,109,0,137
1953751,62,29,1951,9,male,1554,147,97,330,262,330,237,0,25
1651961,26,30,1987,7,male,270,147,93,332,655,332,554,0,101
2082026,14,18,1999,10,female,365,146,90,349,268,22,106,327,162
1950687,45,21,1968,3,female,1417,145,108,360,235,252,160,108,75
1027999,55,3,1958,2,male,810,149,23,360,343,329,248,31,95
1500940,25,16,1988,10,male,433,149,85,363,94,363,64,0,30
2049790,40,10,1973,3,female,485,149,74,358,142,358,108,0,34
2038967,29,3,1984,1,male,728,150,84,349,294,349,278,0,16
1240537,16,1,1997,4,male,77,150,144,374,105,0,21,374,84
1136372,52,15,1961,5,female,922,145,67,394,239,0,134,394,105
1510867,61,8,1952,6,female,309,145,97,376,118,14,52,362,66
1705773,27,8,1986,4,male,423,146,81,382,292,107,159,275,133
1608412,77,29,1936,3,female,2195,147,49,373,274,330,192,43,82
2090885,18,3,1995,9,female,660,145,78,377,48,377,38,0,10
1454938,39,1,1974,8,female,494,147,61,373,72,373,47,0,25
1565510,50,8,1963,6,male,607,146,72,383,227,383,113,0,114
1540695,54,16,1959,9,female,1565,150,78,393,251,393,163,0,88
1185378,20,30,1993,7,male,343,148,92,408,408,309,326,99,82
1865950,30,15,1983,4,female,464,148,66,408,527,408,471,0,56
1760930,54,21,1959,3,NA,197,148,64,411,277,411,187,0,90
2059759,14,11,1999,10,female,478,146,74,433,259,357,127,76,132
1966014,27,13,1986,4,female,353,147,113,451,229,425,136,26,93
1913103,18,2,1995,3,male,101,150,137,433,64,433,63,0,1
1553996,29,5,1984,6,female,813,150,57,461,357,149,187,312,170
2005747,52,14,1961,1,female,652,150,103,477,699,177,561,300,138
1257957,19,15,1994,2,male,685,147,117,477,26,467,22,10,4
2071119,21,16,1992,7,female,455,145,70,469,225,455,166,14,59
1370562,94,6,1919,9,male,322,145,113,469,163,464,148,5,15
1941612,46,27,1967,1,female,371,145,94,481,199,481,154,0,45
1314532,53,9,1960,4,female,357,149,27,482,253,482,116,0,137
1874963,16,16,1997,5,male,159,146,131,455,358,455,238,0,120
1081401,74,10,1939,8,female,1749,147,96,465,334,465,258,0,76
1016398,68,17,1945,8,female,1510,148,86,512,52,42,27,470,25
1497889,69,5,1944,11,female,684,145,64,505,365,0,90,505,275
2018164,57,1,1956,1,female,1780,145,110,515,202,298,52,217,150
1945074,44,19,1969,10,female,1418,148,114,494,685,414,552,80,133
1883764,15,1,1998,1,male,43,148,130,497,35,497,31,0,4
1850035,24,19,1989,11,female,167,145,87,510,420,510,305,0,115
1347832,31,18,1982,5,female,423,147,109,492,327,492,234,0,93
1471238,62,28,1951,6,male,790,146,65,501,1126,501,554,0,572
2100374,25,1,1988,9,male,432,150,54,536,473,250,168,286,305
2110369,20,30,1993,7,female,417,146,101,529,132,470,108,59,24
1606700,17,1,1996,11,male,164,145,111,520,488,409,246,111,242
1179125,19,7,1994,9,male,102,149,124,521,514,497,261,24,253
1470126,33,8,1980,8,male,158,150,132,540,8,540,6,0,2
1358596,67,31,1946,7,female,1411,147,39,568,116,0,55,568,61
1218314,52,19,1961,11,female,2277,147,90,588,260,294,163,294,97
1163892,21,7,1992,4,female,271,147,106,608,272,602,179,6,93
1232884,28,12,1985,12,female,2252,150,88,639,627,419,446,220,181
1975398,14,25,1999,5,female,15,148,137,622,220,576,132,46,88
1013020,31,3,1982,11,female,576,150,98,662,243,628,166,34,77
1691368,36,29,1977,1,female,294,146,48,610,152,597,136,13,16
1202262,31,18,1982,3,female,158,148,39,674,390,1,101,673,289
2124497,19,7,1994,10,male,399,147,109,720,573,265,231,455,342
1274135,18,14,1995,5,female,43,148,50,694,381,682,298,12,83
1384233,20,29,1993,11,male,445,146,111,666,30,666,9,0,21
1041263,57,20,1956,11,male,496,146,114,670,98,670,45,0,53
1324403,52,19,1961,6,male,646,150,79,685,326,685,261,0,65
1072924,65,11,1948,3,male,420,148,93,771,247,110,85,661,162
1960643,48,11,1965,10,female,602,145,119,731,499,11,234,720,265
1916585,35,10,1978,4,male,55,145,125,789,438,789,261,0,177
1308471,48,25,1965,8,female,1675,148,67,854,180,307,129,547,51
1101464,14,17,1999,6,female,182,150,101,828,38,777,19,51,19
1182139,19,14,1994,7,male,553,145,45,863,79,815,46,48,33
1763164,20,19,1993,12,female,1837,146,95,831,427,794,343,37,84
2183201,25,3,1988,5,female,38,147,133,826,764,604,535,222,229
1643400,59,4,1954,1,female,1586,145,88,799,101,797,70,2,31
1569152,28,23,1985,5,male,776,149,81,859,225,859,198,0,27
1220419,69,9,1944,1,female,1852,148,43,948,601,0,224,948,377
1666257,45,29,1968,2,female,1679,147,83,900,493,764,210,136,283
1826909,44,25,1969,11,female,1126,149,90,896,350,896,274,0,76
1968257,57,30,1956,10,female,1881,149,49,916,369,916,134,0,235
1917807,56,17,1957,12,female,977,147,82,889,931,889,203,0,728
1447074,22,1,1991,11,female,385,145,119,1069,548,176,204,893,344
1866199,47,26,1966,2,female,344,148,101,1076,42,831,25,245,17
1271693,15,20,1998,9,female,462,146,117,1037,75,1037,50,0,25
1192469,47,10,1966,3,female,510,149,95,1260,943,18,342,1242,601
1513402,37,25,1976,2,female,407,148,119,1273,665,1273,492,0,173
1741075,30,21,1983,12,female,585,149,118,1285,1084,1285,837,0,247
1149746,60,10,1953,4,female,508,146,93,1315,206,0,38,1315,168
2136919,64,19,1949,3,female,1400,147,87,1399,738,69,528,1330,210
2156834,26,19,1987,6,female,293,145,104,1444,573,1213,448,231,125
1761720,55,3,1958,1,female,1107,147,52,1318,809,1316,501,2,308
1308629,21,12,1992,11,male,88,150,145,1439,200,1439,147,0,53
1905140,38,21,1975,4,female,591,150,95,1439,533,1439,452,0,81
1355974,59,4,1954,4,female,2114,145,71,1684,940,212,731,1472,209
1692590,64,20,1949,12,female,348,147,123,1624,837,0,149,1624,688
1264401,37,15,1976,11,male,550,148,94,1777,4291,890,2684,887,1607
1780545,42,17,1971,6,female,76,148,126,1862,303,1728,141,134,162
1258864,64,18,1949,1,female,1614,148,74,1762,454,1762,199,0,255
1573900,58,15,1955,1,male,178,147,116,2365,1274,0,319,2365,955
1673803,18,27,1995,10,female,798,147,104,2065,769,1882,428,183,341
1874908,30,24,1983,3,female,388,150,83,2164,590,2081,501,83,89
1286943,47,9,1966,5,female,1549,148,51,2084,1123,1771,591,313,532
1523193,16,6,1997,1,male,11,150,70,2121,425,2121,391,0,34
1524979,18,29,1995,1,male,345,146,100,1999,345,1999,327,0,18
1425205,22,8,1991,12,female,454,150,99,2066,358,2066,244,0,114
1362030,25,12,1988,10,female,155,150,90,1878,703,1878,492,0,211
2084943,33,1,1980,11,female,262,145,56,1993,681,1993,243,0,438
1405599,65,18,1948,3,male,819,145,72,3407,1289,0,124,3407,1165
1050744,65,8,1948,8,male,457,148,104,2735,645,1430,483,1305,162
1047459,24,15,1989,2,female,760,146,65,3257,1222,3154,442,103,780
1068267,30,28,1983,3,male,567,147,78,3229,280,3229,244,0,36
1512366,38,12,1975,4,female,27,148,93,3268,2110,3268,504,0,1606
1827130,44,30,1969,7,male,185,147,51,3434,3539,3434,3004,0,535
1284087,54,23,1959,4,male,172,146,78,7745,193,7745,107,0,86
1802437,17,6,1996,4,male,693,153,54,5,3,0,1,5,2
1668124,25,26,1988,3,male,253,151,103,5,81,0,13,5,68
1059856,41,21,1972,1,female,177,156,86,5,14,0,5,5,9
1439226,66,2,1947,9,female,493,155,82,5,25,0,4,5,21
1102172,54,19,1959,7,male,235,156,79,5,24,1,18,4,6
2000688,29,10,1984,12,female,446,155,130,5,1,5,1,0,0
1005581,28,5,1985,5,male,279,151,119,5,2,5,1,0,1
1723334,38,25,1975,9,male,1799,156,62,5,2,5,0,0,2
1247862,29,9,1984,10,male,78,153,141,5,5,5,2,0,3
1735673,33,11,1980,11,male,188,151,78,5,6,5,3,0,3
1621180,33,1,1980,1,male,138,152,107,5,6,5,5,0,1
1954106,47,12,1966,12,female,1259,154,84,5,4,5,2,0,2
1697079,24,12,1989,8,male,893,156,109,5,16,5,14,0,2
1082355,24,1,1989,8,male,608,156,51,5,16,5,14,0,2
2060743,91,6,1922,8,male,405,151,70,5,9,5,3,0,6
1297361,23,5,1990,10,male,290,153,107,6,0,0,0,6,0
1127779,15,1,1998,1,male,434,152,101,6,1,0,0,6,1
2026677,15,18,1998,6,male,327,151,147,6,2,0,0,6,2
1954599,18,2,1995,3,male,460,153,111,6,1,0,0,6,1
2159125,23,3,1990,5,female,205,151,49,6,3,1,0,5,3
1949517,18,31,1995,12,female,190,156,101,6,7,1,3,5,4
1833102,25,23,1988,7,male,716,154,95,6,4,0,2,6,2
1476845,29,31,1984,12,male,310,156,114,6,17,0,10,6,7
1611264,20,14,1993,10,male,367,154,147,6,2,2,2,4,0
1288980,24,18,1989,1,male,211,154,152,6,4,2,3,4,1
2134338,17,17,1996,5,male,279,153,118,6,9,2,1,4,8
1844123,19,27,1994,12,male,1287,155,102,6,1,5,0,1,1
1365889,18,23,1995,2,male,1091,152,114,6,1,6,1,0,0
1134034,34,19,1979,3,male,342,151,13,6,2,6,1,0,1
1186359,71,25,1942,3,male,1980,156,78,6,2,6,1,0,1
2183562,107,6,1906,7,male,847,154,53,6,8,6,2,0,6
1052791,14,4,1999,1,male,102,156,83,6,76,6,68,0,8
1896894,17,19,1996,5,female,560,154,93,6,48,6,36,0,12
1746215,23,12,1990,11,female,311,152,82,6,13,6,8,0,5
1984646,19,16,1994,2,male,397,155,101,7,3,0,1,7,2
1488203,27,6,1986,6,male,322,156,107,7,3,0,2,7,1
1065083,51,14,1962,6,male,267,154,93,7,4,0,3,7,1
2162055,57,30,1956,11,male,20,155,46,7,55,0,17,7,38
1321336,79,17,1934,10,male,257,156,105,7,13,0,3,7,10
1305173,102,1,1911,1,male,1845,155,36,7,12,0,0,7,12
1159519,17,28,1996,11,male,586,155,127,7,1,7,1,0,0
1891522,19,14,1994,2,female,101,151,48,7,0,7,0,0,0
2180091,24,25,1989,5,female,719,153,56,7,0,7,0,0,0
1001464,103,16,1910,4,female,2111,152,90,7,0,7,0,0,0
1144938,31,2,1982,2,male,727,153,83,7,4,7,3,0,1
1679945,19,30,1994,9,male,264,151,91,7,10,7,7,0,3
1179934,23,7,1990,1,female,604,154,120,7,6,7,3,0,3
1631472,60,30,1953,5,male,512,151,85,7,5,7,4,0,1
1674220,15,4,1998,3,female,387,155,72,7,28,7,26,0,2
1766810,21,12,1992,5,male,386,153,111,7,45,7,39,0,6
2113112,23,30,1990,10,male,853,153,54,7,14,7,13,0,1
1127070,26,31,1987,1,female,547,154,90,7,11,7,8,0,3
1554827,103,7,1910,9,female,559,154,36,7,17,7,13,0,4
2012560,108,14,1905,10,male,745,151,64,7,26,7,25,0,1
1455110,17,1,1996,1,male,366,156,102,8,1,1,0,7,1
1729711,17,14,1996,2,male,317,152,89,8,2,0,0,8,2
1184324,22,23,1991,2,male,639,152,141,8,4,0,1,8,3
1934496,22,13,1991,3,male,309,151,84,8,4,0,0,8,4
2097468,18,2,1995,3,male,768,153,109,8,17,0,9,8,8
1676747,14,1,1999,3,male,289,154,103,8,1,5,0,3,1
1155766,21,12,1992,10,male,374,154,110,8,10,7,6,1,4
1297078,16,24,1997,2,male,263,151,93,8,1,8,1,0,0
2065425,18,20,1995,7,male,94,154,125,8,1,8,0,0,1
2018065,28,25,1985,11,male,262,156,61,8,0,8,0,0,0
2047217,68,22,1945,10,male,869,155,118,8,4,8,2,0,2
1374118,16,19,1997,7,male,463,156,101,8,9,8,9,0,0
1340990,20,18,1993,5,female,607,155,63,8,10,8,10,0,0
1078842,63,18,1950,11,female,667,152,65,8,6,8,5,0,1
1391663,103,26,1910,4,female,698,155,117,8,5,8,3,0,2
1438011,14,13,1999,5,male,185,152,61,8,40,8,37,0,3
1025667,20,18,1993,4,male,323,156,92,8,31,8,14,0,17
1355027,30,1,1983,6,male,591,155,132,8,19,8,19,0,0
1487769,33,24,1980,9,male,108,156,92,8,58,8,29,0,29
2160083,14,16,1999,2,male,357,155,59,9,12,0,1,9,11
1875736,52,5,1961,2,female,237,153,130,9,29,0,2,9,27
1289606,24,28,1989,4,female,1077,152,75,9,2,4,2,5,0
1668972,103,2,1910,2,male,792,152,105,9,9,2,7,7,2
2060330,38,14,1975,6,female,395,152,67,9,3,7,2,2,1
1496555,19,15,1994,10,female,557,155,90,9,26,7,12,2,14
1829631,26,23,1987,12,female,566,154,42,9,5,9,5,0,0
2147882,49,27,1964,7,male,351,151,106,9,3,9,2,0,1
1032121,19,26,1994,3,male,347,153,139,10,0,0,0,10,0
2095701,15,19,1998,5,male,365,152,114,10,4,0,1,10,3
1569853,62,22,1951,7,male,1357,152,54,10,32,0,18,10,14
1285599,24,27,1989,12,male,241,151,137,10,0,4,0,6,0
1585489,23,19,1990,3,female,759,154,67,10,94,2,22,8,72
1088603,35,18,1978,9,male,1239,156,89,10,19,7,16,3,3
1793709,20,5,1993,1,female,438,154,63,10,32,9,12,1,20
1485925,28,20,1985,12,female,719,153,74,10,37,9,19,1,18
1703131,15,10,1998,7,male,324,155,85,10,0,10,0,0,0
1831296,25,2,1988,7,male,453,153,143,10,3,10,3,0,0
1919174,63,20,1950,1,female,1621,152,44,10,3,10,2,0,1
1133805,17,20,1996,5,male,169,154,134,10,12,10,8,0,4
1894299,19,30,1994,3,male,370,153,121,10,15,10,12,0,3
1012575,21,2,1992,2,male,430,151,74,10,25,10,22,0,3
1066242,22,4,1991,2,female,273,156,99,10,26,10,22,0,4
2073392,61,4,1952,4,male,1659,152,114,11,1,2,1,9,0
1392643,98,19,1915,2,male,773,154,114,11,0,0,0,11,0
1275309,18,10,1995,9,male,534,156,31,11,10,1,6,10,4
1304051,56,18,1957,9,female,305,153,110,11,44,0,6,11,38
1259194,42,2,1971,9,female,285,151,91,11,0,6,0,5,0
1055360,14,18,1999,5,female,156,156,98,11,15,4,5,7,10
1756339,24,29,1989,8,male,649,156,96,11,7,4,5,7,2
1770992,16,7,1997,11,male,201,151,105,11,34,6,14,5,20
1312973,19,21,1994,6,male,228,156,131,11,4,11,4,0,0
2034615,20,28,1993,7,male,396,152,70,11,3,11,3,0,0
1402733,18,31,1995,7,male,97,151,130,11,9,11,9,0,0
1056724,28,10,1985,3,male,21,151,146,11,13,11,10,0,3
1720051,23,25,1990,2,male,155,154,108,11,67,11,47,0,20
1331924,26,3,1987,1,male,403,152,104,11,36,11,21,0,15
2073322,36,17,1977,12,female,813,152,101,11,17,11,16,0,1
1092935,56,11,1957,10,male,1298,155,63,11,19,11,17,0,2
2102560,21,9,1992,6,male,340,151,64,12,4,0,3,12,1
1812792,23,3,1990,3,male,691,152,59,12,7,0,2,12,5
1268265,48,25,1965,11,male,411,154,120,12,17,0,8,12,9
1251947,53,15,1960,9,male,957,154,136,12,268,0,6,12,262
1842898,15,19,1998,5,male,133,152,80,12,11,7,6,5,5
1469952,26,25,1987,2,male,237,155,131,12,5,12,5,0,0
1780755,18,6,1995,1,female,328,156,73,12,11,12,11,0,0
1446627,19,8,1994,8,female,787,155,108,12,15,12,14,0,1
1296305,23,8,1990,4,male,410,153,82,12,105,12,61,0,44
1651451,18,26,1995,2,male,205,153,80,13,2,5,2,8,0
1281202,43,29,1970,11,male,695,154,121,13,1,4,1,9,0
1900084,16,15,1997,4,male,304,154,118,13,68,7,24,6,44
1385199,107,2,1906,3,male,1378,151,107,13,4,12,1,1,3
1076243,16,17,1997,12,male,746,152,90,13,0,13,0,0,0
1984364,21,1,1992,11,male,552,154,107,13,0,13,0,0,0
1439305,37,10,1976,12,female,234,154,122,13,10,13,3,0,7
1358726,46,13,1967,7,male,537,152,123,13,10,13,7,0,3
1243644,24,10,1989,10,male,112,156,102,14,2,0,0,14,2
1020418,52,27,1961,6,male,509,152,93,14,5,0,3,14,2
1193162,23,9,1990,9,male,891,154,111,14,17,0,1,14,16
1957855,52,7,1961,10,male,333,155,70,14,15,0,0,14,15
1214068,38,24,1975,7,male,1014,154,44,14,3,7,0,7,3
2137766,16,29,1997,5,male,247,154,101,14,3,13,1,1,2
1944123,25,10,1988,8,female,533,156,66,14,17,13,10,1,7
1077322,17,13,1996,6,female,193,153,113,14,55,13,49,1,6
1753264,44,18,1969,6,male,247,154,116,14,4,14,0,0,4
1999290,19,14,1994,11,female,460,152,40,14,10,14,10,0,0
1930124,18,20,1995,2,male,1166,156,53,14,16,14,13,0,3
1087844,21,6,1992,6,male,367,154,123,14,26,14,12,0,14
1449998,27,17,1986,3,male,498,156,94,14,33,14,32,0,1
1250149,69,24,1944,12,male,185,152,45,14,24,14,21,0,3
1572639,103,30,1910,12,female,98,154,117,15,6,0,4,15,2
1149995,60,23,1953,2,male,1011,152,66,15,31,1,18,14,13
2044803,14,26,1999,3,male,219,154,103,15,1,8,1,7,0
1867964,14,22,1999,11,male,64,153,58,15,10,12,5,3,5
1383950,23,13,1990,1,male,397,154,63,15,24,14,17,1,7
1544944,21,11,1992,2,female,720,153,36,15,17,15,17,0,0
1957659,22,10,1991,3,female,1115,155,34,15,44,15,34,0,10
1076359,24,18,1989,7,female,469,152,107,15,30,15,16,0,14
1408531,108,5,1905,2,male,1840,152,61,15,92,15,54,0,38
1110822,33,24,1980,9,female,282,153,84,16,30,0,5,16,25
1836544,27,27,1986,3,female,528,152,103,16,8,6,0,10,8
1669725,22,30,1991,6,male,924,154,86,16,0,13,0,3,0
1946012,44,25,1969,6,male,402,154,113,16,8,13,6,3,2
1603209,17,10,1996,2,male,200,152,123,16,0,16,0,0,0
1709068,20,22,1993,7,male,414,155,117,16,7,16,5,0,2
1312596,59,30,1954,6,female,1666,154,43,16,3,16,1,0,2
1454236,20,24,1993,12,female,355,152,93,16,15,16,15,0,0
1557882,19,1,1994,6,male,156,154,140,16,34,16,34,0,0
1038976,17,5,1996,6,male,205,153,123,17,5,1,2,16,3
1701147,57,24,1956,5,male,1655,155,118,17,4,0,1,17,3
1277139,16,27,1997,11,female,519,154,101,17,33,9,22,8,11
1979223,17,20,1996,8,female,448,154,90,17,35,8,13,9,22
1946349,14,26,1999,6,male,579,152,64,17,0,13,0,4,0
1322641,16,22,1997,11,male,632,155,138,17,4,17,4,0,0
1423193,38,1,1975,11,female,108,154,38,17,25,17,23,0,2
1859366,37,28,1976,2,female,452,153,69,17,68,17,43,0,25
1313111,23,15,1990,4,male,194,155,79,18,40,7,20,11,20
2085311,45,3,1968,10,male,664,156,107,18,6,17,6,1,0
1840647,95,26,1918,4,male,1134,152,31,18,1,18,1,0,0
1212983,46,15,1967,6,male,1914,155,84,18,19,18,16,0,3
2108064,29,2,1984,5,female,635,152,63,18,33,18,7,0,26
1099249,47,29,1966,12,male,610,155,69,18,48,18,42,0,6
1658139,20,17,1993,8,female,331,156,57,19,2,3,0,16,2
1066724,48,21,1965,3,female,421,155,117,19,26,0,6,19,20
2019851,14,16,1999,4,male,118,151,109,19,241,5,86,14,155
1987150,17,20,1996,8,male,453,152,72,19,19,18,11,1,8
1737869,70,21,1943,4,female,897,151,53,19,122,15,50,4,72
1385567,36,9,1977,4,male,271,154,112,19,0,19,0,0,0
1192976,103,3,1910,2,male,1090,154,85,19,10,19,10,0,0
1219388,22,1,1991,1,male,482,156,82,19,15,19,15,0,0
1558433,24,26,1989,6,female,225,152,63,19,24,19,19,0,5
1744427,23,6,1990,11,female,211,153,108,19,52,19,43,0,9
1325842,32,24,1981,7,female,202,156,105,19,34,19,19,0,15
1779856,17,14,1996,4,male,593,154,93,20,5,0,2,20,3
1606188,54,10,1959,1,male,313,156,125,20,22,0,2,20,20
1605033,71,5,1942,11,female,28,151,140,20,58,0,2,20,56
1539480,17,5,1996,1,male,687,156,48,20,0,6,0,14,0
2059865,29,20,1984,1,male,645,151,105,20,7,4,5,16,2
1286206,23,25,1990,7,male,545,151,61,20,0,16,0,4,0
1264734,31,13,1982,5,male,200,152,123,20,18,17,9,3,9
1621122,27,9,1986,4,female,456,154,118,20,26,20,24,0,2
1626322,51,22,1962,3,female,805,155,94,20,57,20,56,0,1
1425534,53,7,1960,9,male,375,156,113,21,16,0,2,21,14
1288305,21,10,1992,3,male,386,156,70,21,35,4,7,17,28
2013270,18,20,1995,4,male,216,152,93,21,64,20,25,1,39
1629780,25,5,1988,2,male,108,151,141,21,3,21,3,0,0
1989286,41,24,1972,9,male,658,152,78,21,3,21,2,0,1
1625484,25,11,1988,11,female,529,155,84,21,5,21,1,0,4
2084551,14,3,1999,5,male,126,153,87,22,7,11,5,11,2
1880527,31,18,1982,9,male,665,155,64,22,29,22,18,0,11
2044243,25,1,1988,1,female,139,153,64,23,26,8,24,15,2
1374035,14,11,1999,3,female,100,156,113,23,0,22,0,1,0
1310007,45,15,1968,12,male,662,154,17,23,183,23,139,0,44
1390286,68,29,1945,1,male,36,151,150,24,0,24,0,0,0
1079305,18,24,1995,8,female,572,156,40,24,11,24,9,0,2
1774496,23,1,1990,1,male,527,153,80,24,14,24,11,0,3
1561322,88,25,1925,9,female,689,151,82,24,5,24,2,0,3
1836562,32,28,1981,10,male,522,155,46,24,85,24,66,0,19
1745973,21,5,1992,8,male,485,154,131,25,2,4,0,21,2
1871322,49,12,1964,10,male,802,156,67,25,12,0,3,25,9
1799888,30,14,1983,4,male,394,156,69,25,13,25,12,0,1
1742020,18,31,1995,5,female,412,156,82,25,31,25,19,0,12
2066405,25,1,1988,9,male,141,151,74,25,21,25,19,0,2
1414432,21,5,1992,9,male,1186,151,86,25,42,25,33,0,9
1916441,26,1,1987,12,male,687,151,76,26,1,7,1,19,0
1725863,19,23,1994,4,male,404,155,29,26,28,25,20,1,8
1259582,26,17,1987,2,female,671,155,65,26,43,25,34,1,9
2156941,40,7,1973,12,male,630,155,66,26,8,26,8,0,0
1655035,37,17,1976,2,female,143,154,134,26,33,26,31,0,2
2156347,18,8,1995,8,female,387,154,109,27,1,0,0,27,1
1063071,17,26,1996,11,male,1016,153,44,27,4,27,3,0,1
1085741,18,30,1995,7,female,438,154,78,27,0,27,0,0,0
2124063,60,18,1953,7,female,1549,153,82,27,0,27,0,0,0
1909593,21,19,1992,9,male,222,154,115,27,29,27,26,0,3
1839125,22,21,1991,4,female,365,152,88,27,32,27,30,0,2
1202856,24,12,1989,6,male,337,155,72,27,27,27,3,0,24
2015575,33,20,1980,4,male,609,153,62,27,23,27,17,0,6
2035186,72,9,1941,11,female,286,155,71,28,29,1,11,27,18
1133353,113,11,1900,8,female,1241,154,55,28,84,8,43,20,41
1089384,16,8,1997,1,female,39,153,67,28,67,26,25,2,42
1194117,67,29,1946,1,female,1005,152,108,29,10,0,6,29,4
1888855,18,9,1995,2,female,55,151,129,29,53,29,45,0,8
1333340,16,6,1997,1,male,616,152,101,31,7,7,1,24,6
2076926,18,2,1995,11,female,334,155,26,30,70,16,32,14,38
1343207,33,31,1980,1,female,244,151,65,30,76,22,30,8,46
1702317,100,11,1913,8,male,1311,154,96,31,1,31,1,0,0
1866915,29,21,1984,4,male,515,152,80,31,34,31,34,0,0
2032645,20,12,1993,12,female,81,152,79,32,94,9,64,23,30
1954991,15,24,1998,12,female,85,156,137,32,32,25,2,7,30
1846132,16,13,1997,2,female,268,153,48,32,127,27,66,5,61
1838796,19,5,1994,7,male,554,151,115,32,33,32,24,0,9
2137867,31,16,1982,10,female,707,153,82,32,47,32,16,0,31
1121722,18,1,1995,12,female,340,153,115,33,18,0,2,33,16
1832632,35,20,1978,4,male,294,154,117,33,11,0,2,33,9
1969924,18,19,1995,2,male,773,153,86,33,13,20,7,13,6
1931258,30,22,1983,8,male,303,154,89,33,9,31,6,2,3
1299348,39,17,1974,4,male,288,155,114,33,168,33,62,0,106
1643675,17,4,1996,1,male,130,155,137,34,8,29,5,5,3
1694883,17,15,1996,3,female,439,156,114,34,6,34,5,0,1
2165114,29,30,1984,6,female,722,156,107,36,1,0,1,36,0
2191516,53,4,1960,3,female,324,154,112,35,37,0,6,35,31
2101027,27,14,1986,12,male,540,153,147,36,3,28,0,8,3
2180520,27,6,1986,6,male,645,154,69,35,5,35,5,0,0
2064201,28,6,1985,7,male,777,153,94,36,0,36,0,0,0
1742675,31,18,1982,12,male,410,153,140,36,32,36,9,0,23
2092470,17,10,1996,7,female,365,152,81,36,54,36,32,0,22
1869386,32,29,1981,3,female,268,154,107,35,60,35,52,0,8
1285650,48,16,1965,8,male,126,153,98,35,124,35,69,0,55
1987559,14,17,1999,1,female,298,153,105,37,8,0,4,37,4
1233901,17,1,1996,1,male,44,151,141,37,45,36,35,1,10
2100132,45,19,1968,11,female,1391,153,87,37,106,37,73,0,33
1382979,16,6,1997,2,male,77,154,105,39,238,9,111,30,127
1074592,14,13,1999,3,male,445,152,130,38,22,33,12,5,10
2089735,21,29,1992,2,male,547,156,79,38,24,33,9,5,15
1071833,20,29,1993,9,female,469,153,72,38,0,38,0,0,0
1170381,21,26,1992,6,male,330,156,111,38,2,38,1,0,1
1891311,16,16,1997,3,male,78,151,136,38,24,38,16,0,8
1078319,23,3,1990,1,female,196,151,50,38,28,38,17,0,11
1581435,41,24,1972,5,female,534,152,106,39,255,39,196,0,59
2163381,13,19,2000,3,male,154,152,129,40,21,0,0,40,21
1630185,22,28,1991,4,female,389,152,107,40,91,16,44,24,47
1438277,105,29,1908,2,female,1034,151,79,40,70,16,39,24,31
1994800,18,1,1995,10,male,546,151,99,40,21,40,11,0,10
1370289,19,8,1994,12,male,216,155,76,42,6,42,5,0,1
1219184,33,1,1980,12,male,70,156,132,42,69,42,53,0,16
1033991,15,9,1998,5,male,603,152,60,44,13,4,0,40,13
2019538,59,6,1954,5,female,1222,151,79,44,29,2,17,42,12
1726127,74,10,1939,1,male,546,155,140,44,2,23,2,21,0
1311697,21,15,1992,2,female,393,151,118,43,14,21,5,22,9
1844785,18,4,1995,6,female,163,152,125,43,71,24,49,19,22
2066900,14,21,1999,6,female,311,156,92,43,1,34,1,9,0
1756577,14,21,1999,11,male,134,153,106,44,34,35,18,9,16
1619808,28,28,1985,7,male,505,151,109,43,79,34,62,9,17
1986090,18,12,1995,9,male,326,156,85,43,6,43,5,0,1
1092475,19,26,1994,5,male,404,156,87,44,0,44,0,0,0
1488167,28,13,1985,12,female,731,152,68,43,6,43,5,0,1
1781061,31,24,1982,3,female,78,155,143,43,22,43,11,0,11
1529707,21,21,1992,6,male,195,153,141,44,61,44,46,0,15
1404095,108,10,1905,10,male,60,153,91,44,43,44,35,0,8
1409611,23,25,1990,1,female,509,151,75,43,107,43,99,0,8
1589130,30,12,1983,8,male,111,151,120,45,63,26,40,19,23
2172130,19,25,1994,8,male,357,155,82,45,38,45,28,0,10
1193260,18,21,1995,1,female,525,154,103,46,17,1,6,45,11
1244953,20,24,1993,12,female,419,151,104,46,25,0,4,46,21
1977444,21,13,1992,11,female,221,153,110,46,112,35,37,11,75
2000308,25,25,1988,7,male,269,156,108,47,6,47,5,0,1
1118341,103,30,1910,10,female,1019,154,75,46,45,46,42,0,3
1648608,38,28,1975,6,male,135,152,50,47,204,47,114,0,90
1264434,22,29,1991,3,male,314,155,91,48,88,5,10,43,78
1879154,20,4,1993,11,male,619,156,131,49,81,15,26,34,55
1112568,15,27,1998,8,female,292,155,75,48,0,48,0,0,0
1563945,27,4,1986,11,male,645,152,24,48,0,48,0,0,0
1469082,30,21,1983,7,female,42,153,37,48,25,48,21,0,4
1917106,44,11,1969,2,female,203,153,88,48,90,48,30,0,60
1901027,15,17,1998,5,female,243,154,95,50,0,4,0,46,0
1347371,17,17,1996,2,male,386,154,108,50,7,0,3,50,4
1720711,55,1,1958,4,female,1056,156,41,51,20,0,8,51,12
1846021,54,30,1959,9,male,656,152,82,50,39,0,23,50,16
1895134,63,26,1950,10,female,2089,153,102,50,55,1,47,49,8
1078275,63,27,1950,1,female,901,154,96,50,37,42,20,8,17
1691750,20,3,1993,12,male,519,151,91,50,4,50,4,0,0
1525191,17,31,1996,5,male,385,153,100,50,32,50,24,0,8
1219428,36,21,1977,3,male,14,154,145,51,69,51,64,0,5
1169952,18,4,1995,6,male,353,153,51,50,104,50,70,0,34
2016854,29,25,1984,3,female,836,152,84,53,6,0,0,53,6
1493331,50,2,1963,5,male,173,155,96,53,43,0,10,53,33
1143727,18,21,1995,4,male,155,154,99,52,83,9,22,43,61
1570897,108,30,1905,9,female,1439,155,5,52,21,44,5,8,16
1961224,19,28,1994,9,female,138,155,137,53,27,53,25,0,2
1144673,24,30,1989,3,female,642,152,70,52,26,52,19,0,7
1447636,26,12,1987,9,male,653,153,68,54,2,5,1,49,1
2044584,49,16,1964,11,male,394,152,52,55,25,0,17,55,8
1352024,20,27,1993,2,male,305,153,95,55,8,12,4,43,4
1696074,53,2,1960,11,male,1348,156,100,55,79,34,64,21,15
2063185,63,20,1950,1,male,1426,152,57,54,11,54,7,0,4
1914608,24,26,1989,4,male,319,156,137,55,68,55,30,0,38
1748965,52,12,1961,3,male,672,155,102,55,35,55,30,0,5
1686423,62,31,1951,3,female,1619,154,22,55,69,55,53,0,16
1709436,52,7,1961,1,male,657,154,143,56,17,0,1,56,16
1946286,22,4,1991,9,male,941,151,76,56,64,9,25,47,39
1539986,14,5,1999,5,male,18,155,113,57,109,31,74,26,35
1299180,16,12,1997,2,male,236,154,119,57,9,53,2,4,7
1194781,36,27,1977,7,male,557,155,97,58,4,58,4,0,0
1761055,65,17,1948,2,female,1145,152,112,57,15,57,12,0,3
1740962,108,21,1905,12,female,923,152,120,59,32,11,15,48,17
1962695,18,20,1995,4,male,271,155,108,59,1,12,1,47,0
1102632,32,27,1981,7,male,763,153,52,60,2,33,2,27,0
1313385,16,27,1997,1,female,1364,152,85,60,102,41,81,19,21
1731776,26,12,1987,5,male,724,153,88,60,4,49,3,11,1
2075137,44,16,1969,7,female,598,155,70,60,119,44,75,16,44
1283196,14,15,1999,4,female,432,151,91,60,0,60,0,0,0
1771240,16,22,1997,3,female,618,156,61,60,34,60,33,0,1
1427102,18,19,1995,7,male,191,154,119,62,36,62,26,0,10
1470186,18,4,1995,6,female,127,153,90,61,42,61,24,0,18
1128875,39,7,1974,4,male,327,154,103,62,47,62,41,0,6
1813111,59,28,1954,4,female,310,152,111,61,134,61,40,0,94
1278749,15,3,1998,10,male,590,152,130,64,4,0,0,64,4
1801577,16,24,1997,8,female,385,153,73,64,11,15,2,49,9
2189296,20,13,1993,6,male,478,152,136,64,38,39,20,25,18
1476584,19,6,1994,11,male,190,156,118,64,39,31,22,33,17
2069903,14,10,1999,7,female,292,156,114,65,19,65,17,0,2
2112970,27,26,1986,2,male,413,151,125,65,11,65,7,0,4
2043769,30,20,1983,4,female,709,151,90,65,107,65,97,0,10
2029587,108,30,1905,3,female,1506,154,83,68,44,0,10,68,34
2020797,23,19,1990,9,male,814,153,58,68,89,62,31,6,58
1702502,38,18,1975,8,female,569,153,116,66,153,50,74,16,79
1447443,32,2,1981,3,male,248,153,134,67,24,67,17,0,7
1515755,46,24,1967,7,male,490,153,128,67,13,67,12,0,1
2145261,35,26,1978,11,female,280,152,105,66,165,66,93,0,72
2065580,67,12,1946,1,female,1486,152,110,70,39,8,15,62,24
1716174,22,5,1991,5,male,306,152,87,70,56,50,30,20,26
1871546,23,31,1990,7,female,148,153,85,69,218,23,75,46,143
2072664,23,3,1990,9,male,579,151,45,71,41,71,40,0,1
1650472,43,3,1970,3,male,215,155,133,69,27,69,22,0,5
1725049,22,14,1991,10,male,488,155,88,69,68,69,66,0,2
1085135,56,21,1957,10,female,330,151,105,74,77,0,17,74,60
1808392,71,10,1942,4,female,1195,151,112,73,82,0,34,73,48
1731195,19,3,1994,11,male,406,156,67,72,68,41,24,31,44
1730760,27,18,1986,11,male,387,154,47,74,55,23,41,51,14
1675198,35,1,1978,6,female,1434,155,60,74,162,53,72,21,90
1073276,101,11,1912,5,female,719,152,78,72,30,71,23,1,7
2171167,108,15,1905,3,female,2958,151,66,73,26,60,20,13,6
1941926,60,23,1953,7,male,615,155,89,74,94,68,37,6,57
2164673,94,4,1919,12,female,2313,154,62,72,110,63,76,9,34
1233079,30,10,1983,7,male,860,153,119,73,5,73,1,0,4
1167523,16,7,1997,2,female,574,155,67,73,24,73,16,0,8
1707963,15,9,1998,6,female,82,154,67,72,67,72,13,0,54
1322183,17,5,1996,4,male,83,156,94,74,56,74,37,0,19
1959829,22,8,1991,7,male,51,155,135,74,94,74,47,0,47
1210269,41,22,1972,1,female,915,154,95,72,57,72,50,0,7
1955608,41,1,1972,1,male,629,153,87,72,58,72,50,0,8
1159078,58,12,1955,8,female,953,154,46,72,181,72,58,0,123
2038901,17,24,1996,2,male,181,151,139,75,41,45,23,30,18
1900013,26,8,1987,5,female,380,156,123,76,61,21,40,55,21
1545203,16,19,1997,5,female,489,153,7,75,3,73,3,2,0
2116967,20,26,1993,8,male,260,154,143,75,5,70,4,5,1
2105210,52,26,1961,11,female,565,153,96,75,42,72,9,3,33
2071415,29,3,1984,12,female,284,151,142,76,38,76,35,0,3
1545973,17,2,1996,7,female,618,154,61,76,86,76,81,0,5
1225832,26,1,1987,1,male,385,152,108,76,80,76,44,0,36
1521643,29,26,1984,4,male,688,153,69,76,57,76,47,0,10
1710859,37,18,1976,5,female,657,153,78,76,89,76,62,0,27
1347649,42,14,1971,1,male,1037,154,102,75,47,75,46,0,1
1474249,25,17,1988,1,female,147,151,47,75,173,75,94,0,79
1499792,19,11,1994,12,male,589,156,124,80,17,42,10,38,7
1818173,22,15,1991,10,female,649,153,80,80,65,80,42,0,23
1694269,18,25,1995,5,male,298,156,81,80,167,80,71,0,96
1157318,47,30,1966,11,male,509,152,109,80,215,80,116,0,99
1408950,43,14,1970,11,male,368,156,119,83,10,0,2,83,8
1993700,22,2,1991,2,female,494,151,53,83,177,5,73,78,104
1228811,23,1,1990,3,female,422,153,80,82,222,77,137,5,85
1222051,32,9,1981,10,male,402,152,98,81,1581,66,706,15,875
1359489,108,22,1905,1,female,1093,152,68,81,264,66,54,15,210
2020120,51,4,1962,1,male,182,151,93,83,19,83,10,0,9
1245614,113,29,1900,3,female,1564,153,47,84,157,84,131,0,26
1792367,21,2,1992,9,male,497,155,96,85,24,37,17,48,7
2014741,24,11,1989,6,male,469,151,98,86,357,70,164,16,193
1684107,51,7,1962,11,female,955,152,92,86,47,86,38,0,9
2019784,16,18,1997,2,male,653,154,48,87,105,87,103,0,2
1070693,24,10,1989,5,male,189,154,92,85,89,85,39,0,50
2020480,24,15,1989,9,female,185,153,110,86,69,86,63,0,6
1378292,80,27,1933,8,female,1793,156,80,90,12,0,7,90,5
1771678,54,18,1959,1,male,1683,154,105,90,90,38,52,52,38
1258095,28,4,1985,10,male,512,152,102,89,44,88,43,1,1
1583224,21,8,1992,7,female,340,154,97,89,123,84,91,5,32
2039699,51,21,1962,5,male,1735,154,73,88,8,88,3,0,5
1351228,31,20,1982,7,female,213,154,61,89,62,89,52,0,10
1028590,24,11,1989,12,male,273,154,73,88,192,88,116,0,76
1134639,21,28,1992,12,male,470,155,81,95,89,11,7,84,82
1185673,49,20,1964,2,female,672,154,91,93,221,0,110,93,111
1331159,19,26,1994,6,male,107,154,150,92,13,31,9,61,4
1930519,59,3,1954,6,female,2025,155,95,93,12,86,4,7,8
1620503,105,26,1908,3,male,360,153,89,94,36,94,33,0,3
1676642,31,19,1982,2,female,440,151,60,94,120,94,77,0,43
1790585,45,25,1968,9,male,586,153,70,95,116,95,67,0,49
1757463,65,29,1948,4,female,1250,154,56,93,276,93,184,0,92
1484388,20,10,1993,5,female,387,153,111,98,55,57,21,41,34
1547230,26,6,1987,5,male,634,152,105,99,30,82,5,17,25
1132817,18,10,1995,7,female,221,151,69,96,38,96,28,0,10
1415836,48,26,1965,7,female,834,154,57,98,53,98,43,0,10
1490906,23,15,1990,9,female,237,151,88,103,18,3,13,100,5
1937077,21,7,1992,4,female,502,153,72,102,223,12,107,90,116
1063652,55,15,1958,3,male,2217,154,104,101,48,51,15,50,33
1185745,52,7,1961,1,female,1511,151,59,102,133,66,74,36,59
1459973,19,16,1994,8,male,501,152,97,103,61,99,52,4,9
1345391,66,10,1947,11,male,860,151,85,100,25,99,16,1,9
1478361,18,27,1995,7,male,208,155,111,104,2,104,2,0,0
1800784,21,3,1992,3,male,120,152,145,100,4,100,4,0,0
1761298,57,15,1956,4,female,530,152,16,103,10,103,7,0,3
1983301,81,5,1932,9,male,817,156,49,100,14,100,10,0,4
1372179,29,20,1984,4,male,628,152,100,103,51,103,48,0,3
1655780,40,1,1973,2,female,1507,151,85,103,52,103,47,0,5
2167928,18,6,1995,7,male,496,153,105,102,102,102,90,0,12
1361199,27,13,1986,1,female,334,154,93,109,77,0,6,109,71
1749854,38,8,1975,10,male,438,152,118,107,61,31,9,76,52
1302765,25,1,1988,1,male,184,151,66,106,49,95,35,11,14
1202503,31,2,1982,5,female,547,155,63,109,233,109,116,0,117
1496210,37,20,1976,12,female,389,152,108,110,107,9,38,101,69
2079668,62,21,1951,4,female,1435,155,104,111,250,1,174,110,76
1162120,60,14,1953,1,male,821,151,109,110,135,87,87,23,48
1293458,55,2,1958,2,female,63,154,61,112,26,112,24,0,2
1862939,21,12,1992,12,female,315,152,85,115,44,41,23,74,21
1219236,16,13,1997,10,female,999,155,113,116,241,34,36,82,205
2072937,23,4,1990,7,female,535,154,54,114,7,99,6,15,1
1884912,29,28,1984,5,male,583,155,89,115,285,92,182,23,103
1539716,19,29,1994,7,male,147,154,86,115,43,115,32,0,11
1384327,33,17,1980,5,male,754,156,129,119,28,119,23,0,5
1567528,103,1,1910,3,male,735,152,77,115,81,115,58,0,23
1071447,68,4,1945,2,male,887,154,75,122,7,0,2,122,5
1033915,50,19,1963,7,male,1809,151,100,124,91,104,48,20,43
1516200,15,10,1998,2,female,463,151,114,121,358,101,203,20,155
1000484,75,18,1938,9,female,2479,152,76,122,352,120,151,2,201
1452543,14,26,1999,9,female,21,155,43,120,36,120,15,0,21
1002666,19,22,1994,2,female,125,154,128,122,52,122,48,0,4
2016281,22,2,1991,1,male,483,156,86,124,166,124,141,0,25
1770767,26,25,1987,1,male,207,155,113,122,192,122,156,0,36
1095644,39,3,1974,10,female,752,156,61,127,30,7,12,120,18
1865951,16,26,1997,12,male,558,156,139,126,35,36,12,90,23
2033786,35,18,1978,9,male,438,153,147,129,11,127,8,2,3
1576479,17,16,1996,6,female,169,153,144,126,34,103,16,23,18
1765684,17,1,1996,1,female,201,152,100,130,132,129,71,1,61
1189203,37,17,1976,9,female,593,153,95,128,450,127,143,1,307
1740501,17,22,1996,4,female,307,156,69,129,70,129,49,0,21
1661137,22,17,1991,3,female,154,156,13,127,36,127,34,0,2
1291280,24,20,1989,10,female,634,154,126,128,129,128,87,0,42
1157443,23,9,1990,9,male,471,152,106,129,522,129,518,0,4
1523781,18,13,1995,9,male,139,153,138,136,0,87,0,49,0
1553422,23,3,1990,1,male,254,152,115,134,192,37,133,97,59
1816829,37,15,1976,5,male,221,153,57,134,257,35,87,99,170
1718337,20,12,1993,1,male,26,155,60,134,192,130,122,4,70
1867713,95,3,1918,5,female,1854,152,70,132,92,131,70,1,22
2128042,24,27,1989,4,male,586,151,98,134,19,134,19,0,0
1580653,31,9,1982,5,female,402,156,45,134,99,134,78,0,21
1087412,19,17,1994,2,female,617,151,95,137,161,6,69,131,92
1359064,34,21,1979,5,female,349,152,89,137,100,1,15,136,85
1127829,78,25,1935,10,female,406,153,116,138,135,96,107,42,28
1273429,15,23,1998,1,female,808,153,64,138,25,103,22,35,3
1028918,15,8,1998,5,male,384,151,110,137,45,124,33,13,12
1065425,28,5,1985,5,male,407,156,67,137,25,137,21,0,4
1433954,25,1,1988,1,male,209,151,53,141,179,141,126,0,53
1652209,35,1,1978,6,female,284,151,63,148,162,5,40,143,122
2033710,19,2,1994,11,female,104,155,103,150,256,8,149,142,107
2118436,113,14,1900,6,female,1520,156,75,150,225,29,130,121,95
1827421,17,3,1996,1,male,293,156,66,145,59,68,45,77,14
2179503,17,29,1996,2,female,313,152,90,145,92,134,86,11,6
1687494,26,28,1987,10,male,736,154,57,146,111,130,67,16,44
1019589,48,25,1965,10,male,647,155,96,145,291,105,151,40,140
1604171,29,14,1984,12,female,442,154,130,144,86,144,85,0,1
1799103,46,12,1967,5,female,467,153,120,150,34,150,29,0,5
1462167,26,3,1987,6,male,170,154,128,149,179,149,77,0,102
1799013,19,23,1994,8,male,237,156,109,154,85,14,21,140,64
1998287,20,18,1993,2,male,672,151,36,151,60,16,32,135,28
1121515,31,7,1982,12,female,1595,153,30,154,19,36,15,118,4
2013124,74,30,1939,9,female,1642,153,92,151,18,85,11,66,7
1042453,65,24,1948,8,male,1546,152,67,155,88,111,45,44,43
2077886,33,28,1980,8,male,259,156,125,152,100,33,58,119,42
1839275,21,15,1992,8,female,223,151,137,156,414,73,242,83,172
2050676,28,30,1985,4,female,2521,155,100,152,291,117,215,35,76
1969710,36,29,1977,12,female,122,153,130,155,79,155,68,0,11
2044252,35,25,1978,3,female,219,151,103,153,79,153,67,0,12
1786756,43,11,1970,4,female,195,155,92,153,130,153,110,0,20
2146597,43,21,1970,3,female,340,156,95,158,34,140,21,18,13
1056775,38,16,1975,1,female,462,156,87,159,265,138,118,21,147
1919159,16,9,1997,8,female,146,152,83,160,13,160,8,0,5
2039525,52,9,1961,10,male,1465,152,88,160,23,160,23,0,0
1694431,27,7,1986,7,female,609,151,93,158,89,158,87,0,2
1220336,29,17,1984,8,male,354,154,51,162,231,162,110,0,121
1354417,33,12,1980,11,female,313,152,75,163,226,163,159,0,67
1387907,32,10,1981,9,female,271,151,86,160,123,160,74,0,49
1001545,23,15,1990,5,male,96,151,106,172,78,4,21,168,57
1676278,23,30,1990,11,male,197,152,130,168,18,77,12,91,6
2075403,67,1,1946,9,female,274,152,51,166,23,53,13,113,10
1829383,36,25,1977,7,male,410,151,86,167,49,112,11,55,38
2106673,25,22,1988,1,female,375,152,109,170,237,168,96,2,141
1678067,20,12,1993,2,male,266,156,114,167,2,167,2,0,0
2088414,46,31,1967,12,male,574,155,103,171,12,171,2,0,10
1059303,41,22,1972,10,female,1606,151,23,169,67,169,58,0,9
1363643,23,4,1990,9,female,322,155,58,167,148,167,69,0,79
1837340,20,18,1993,2,male,167,153,128,168,258,168,236,0,22
1718631,68,22,1945,1,male,1406,153,57,180,222,0,37,180,185
1638191,22,4,1991,2,female,216,155,133,178,9,157,6,21,3
1748382,15,6,1998,3,female,640,155,106,178,65,165,46,13,19
1969279,69,20,1944,7,male,1797,152,17,177,103,135,43,42,60
2012754,26,10,1987,12,male,314,151,111,177,2,177,1,0,1
1838921,17,2,1996,3,female,1024,155,62,180,43,180,29,0,14
1881466,18,19,1995,2,female,248,153,77,174,93,174,93,0,0
1450093,18,16,1995,7,male,174,151,97,175,37,175,25,0,12
1009430,76,24,1937,8,female,1613,154,78,183,60,136,40,47,20
1073003,19,10,1994,8,female,621,151,101,189,173,184,159,5,14
1423514,19,14,1994,9,male,741,154,85,183,197,180,95,3,102
1578161,43,6,1970,12,female,246,151,70,184,87,184,53,0,34
1299650,42,26,1971,8,male,557,156,68,186,220,186,181,0,39
1710060,29,21,1984,2,male,622,151,56,196,6,0,0,196,6
1379049,30,21,1983,4,female,900,152,109,193,83,0,5,193,78
1704397,31,7,1982,6,female,406,153,114,193,124,116,56,77,68
1060501,101,27,1912,10,male,2340,151,30,196,153,101,80,95,73
1496366,54,3,1959,3,female,1344,151,67,195,153,194,94,1,59
2070478,46,20,1967,5,female,440,154,120,195,163,195,128,0,35
1278712,58,25,1955,2,female,1449,151,101,192,153,192,75,0,78
1938808,29,6,1984,2,male,343,152,71,193,381,193,358,0,23
1488259,26,13,1987,10,female,106,155,128,208,71,29,5,179,66
2112113,75,10,1938,10,female,1048,151,95,205,235,0,142,205,93
1585717,32,25,1981,3,male,235,151,68,203,74,84,59,119,15
1916681,42,11,1971,8,male,307,154,89,203,158,165,25,38,133
1361841,23,8,1990,4,male,672,154,65,201,3,201,3,0,0
1330662,18,2,1995,4,male,466,154,38,208,94,208,55,0,39
1047751,37,26,1976,9,female,1369,151,90,201,41,201,41,0,0
1408876,31,17,1982,7,female,304,155,63,207,348,207,259,0,89
1842467,47,20,1966,4,female,846,153,114,215,317,150,193,65,124
1641628,17,6,1996,10,male,416,152,100,218,100,217,87,1,13
1064907,25,2,1988,1,female,558,156,28,215,139,214,63,1,76
1711488,72,8,1941,10,male,1192,152,129,221,58,221,31,0,27
1562425,25,6,1988,1,female,160,155,69,218,349,218,327,0,22
2132061,26,23,1987,10,female,13,153,148,226,59,100,27,126,32
1960027,16,28,1997,10,female,281,151,47,226,232,111,189,115,43
1047543,23,25,1990,2,female,474,156,113,222,257,84,139,138,118
1997285,15,17,1998,2,male,569,151,121,226,0,218,0,8,0
1415264,19,12,1994,2,female,215,154,75,223,47,223,39,0,8
1932115,32,1,1981,2,female,328,152,100,224,79,224,69,0,10
1141755,23,12,1990,5,female,477,153,58,246,24,231,16,15,8
1763989,53,12,1960,9,male,408,153,97,235,238,223,116,12,122
2147343,18,10,1995,10,male,367,155,119,246,16,246,15,0,1
2193538,18,7,1995,11,female,8,154,119,248,330,113,168,135,162
2010273,31,13,1982,9,male,559,154,128,249,163,151,152,98,11
1547587,47,14,1966,9,male,1243,151,88,247,37,213,10,34,27
2055571,22,29,1991,3,male,653,154,79,247,178,221,138,26,40
1206319,113,18,1900,7,male,1137,156,26,257,9,257,3,0,6
1184418,25,1,1988,1,female,137,151,96,252,43,252,33,0,10
1594000,20,21,1993,3,female,149,155,139,248,165,248,64,0,101
1216056,100,14,1913,7,male,1057,155,94,251,303,251,227,0,76
2071364,44,13,1969,7,female,401,156,87,266,106,43,50,223,56
1183297,61,5,1952,7,female,990,151,92,268,170,2,93,266,77
1727482,55,29,1958,9,male,860,151,71,273,393,137,233,136,160
1432860,41,17,1972,3,female,619,154,135,262,151,247,69,15,82
1472275,20,1,1993,1,male,32,156,149,269,71,268,71,1,0
1969211,18,15,1995,9,female,313,155,73,272,112,272,101,0,11
1866843,23,23,1990,8,male,744,151,75,270,70,270,48,0,22
1978299,25,1,1988,4,male,955,153,26,264,73,264,73,0,0
1753680,33,28,1980,12,male,224,153,104,267,392,267,386,0,6
1728258,64,15,1949,12,female,967,152,74,279,139,24,82,255,57
1443906,22,8,1991,5,female,1334,154,70,285,142,269,97,16,45
1878511,29,21,1984,2,female,1786,155,50,290,336,222,231,68,105
1000094,17,23,1996,4,male,109,156,131,277,109,277,92,0,17
1533471,21,28,1992,1,female,455,155,115,286,177,286,142,0,35
1720043,34,14,1979,10,female,407,154,100,303,57,1,29,302,28
1009194,59,12,1954,11,female,1243,156,104,305,296,25,101,280,195
1284508,49,5,1964,8,female,1515,153,33,301,1047,0,129,301,918
1418007,49,14,1964,12,female,980,154,90,304,175,163,48,141,127
1818861,33,29,1980,4,male,365,154,115,301,637,155,449,146,188
1336130,51,27,1962,2,female,680,151,120,305,161,253,47,52,114
1649851,14,10,1999,7,male,95,154,128,300,326,300,182,0,144
1430636,33,1,1980,8,female,1613,154,82,297,465,297,393,0,72
1547366,24,22,1989,7,male,635,154,112,327,32,31,27,296,5
2101965,54,10,1959,11,male,733,151,81,310,115,0,77,310,38
1934746,35,31,1978,10,female,791,151,109,309,271,103,110,206,161
1504095,20,23,1993,1,female,1010,151,97,324,62,313,32,11,30
1425225,29,6,1984,5,female,369,156,115,341,190,216,11,125,179
1631696,50,31,1963,3,male,677,154,130,334,111,132,83,202,28
2081742,41,27,1972,11,female,511,152,133,335,374,189,146,146,228
1261315,52,12,1961,2,female,767,153,77,331,207,197,93,134,114
2177226,17,5,1996,11,female,170,152,105,330,51,286,14,44,37
1794251,25,10,1988,2,female,381,153,37,340,251,269,109,71,142
1912604,32,23,1981,4,female,1757,153,96,332,407,327,254,5,153
1065608,66,15,1947,7,female,851,152,100,339,24,339,8,0,16
2022116,53,18,1960,9,female,988,151,126,361,275,24,143,337,132
1548460,39,18,1974,1,female,626,155,74,350,165,118,39,232,126
1599725,39,21,1974,5,male,1023,156,56,352,609,119,263,233,346
1007202,22,21,1991,9,female,205,151,140,358,140,307,50,51,90
1714742,26,3,1987,3,female,242,152,49,350,326,347,187,3,139
1472792,48,20,1965,4,female,284,156,105,360,107,360,97,0,10
1746404,13,4,2000,3,female,57,152,100,373,37,0,4,373,33
2144101,108,1,1905,1,male,1236,155,60,394,40,0,9,394,31
1620781,19,8,1994,8,male,267,156,92,381,270,47,73,334,197
1014158,18,8,1995,4,female,504,154,70,390,172,153,122,237,50
1805075,21,4,1992,6,female,249,154,67,389,176,234,137,155,39
1534361,14,16,1999,6,male,23,151,145,389,41,369,13,20,28
1038888,31,20,1982,3,female,662,152,62,385,156,385,149,0,7
2147169,37,12,1976,9,female,465,154,82,410,243,19,67,391,176
1163889,58,1,1955,2,female,1490,152,70,418,744,9,504,409,240
1186266,28,21,1985,7,male,206,151,143,395,28,113,7,282,21
1105960,15,27,1998,6,female,640,156,94,414,158,312,42,102,116
1081100,46,25,1967,2,female,670,151,94,399,229,295,71,104,158
1959147,17,31,1996,8,male,229,156,79,401,689,318,233,83,456
1496601,33,22,1980,4,female,406,152,117,418,385,416,358,2,27
1616179,31,27,1982,2,male,363,152,120,400,144,400,77,0,67
1557601,56,2,1957,9,female,174,156,140,451,77,1,47,450,30
1256245,79,5,1934,8,female,784,152,105,423,101,0,11,423,90
1749866,18,13,1995,2,female,91,154,125,440,270,311,171,129,99
1706472,23,24,1990,8,female,624,156,115,435,388,423,326,12,62
1669635,16,13,1997,4,female,552,153,34,441,186,441,177,0,9
1660165,18,31,1995,5,female,297,154,114,442,76,442,75,0,1
2094977,51,3,1962,8,male,466,154,111,464,56,0,2,464,54
1037236,27,3,1986,10,female,416,153,89,455,203,0,34,455,169
1058746,58,6,1955,8,female,1034,154,123,470,89,164,24,306,65
2015192,21,1,1992,1,male,87,156,96,472,293,318,161,154,132
1156637,26,7,1987,7,male,697,151,83,467,394,466,210,1,184
2093504,24,2,1989,8,female,618,154,79,454,313,454,290,0,23
1744104,16,15,1997,3,male,56,155,62,499,534,132,41,367,493
1570251,46,10,1967,8,female,718,152,66,491,561,311,419,180,142
1385811,18,21,1995,5,male,852,153,82,510,203,402,132,108,71
1203153,28,4,1985,10,female,548,154,109,486,184,485,124,1,60
1415531,21,15,1992,7,female,186,156,74,489,69,489,45,0,24
1984125,56,19,1957,11,female,447,154,35,531,121,0,14,531,107
1045253,58,9,1955,5,female,375,152,115,524,494,0,216,524,278
1130463,39,9,1974,8,female,448,153,100,536,64,395,26,141,38
1855970,34,28,1979,3,female,1978,154,80,537,330,473,273,64,57
1847402,23,17,1990,6,female,256,154,85,525,301,520,134,5,167
1492405,102,1,1911,1,male,941,151,135,550,470,549,286,1,184
1784735,25,13,1988,1,female,640,151,93,544,74,544,72,0,2
1526427,57,2,1956,9,male,61,151,79,569,27,0,8,569,19
1994397,108,1,1905,1,male,1124,152,96,579,485,0,133,579,352
2021394,15,6,1998,6,male,312,151,115,565,89,565,80,0,9
1295900,19,12,1994,6,female,128,151,88,567,74,567,64,0,10
1991944,55,30,1958,9,female,842,154,76,613,195,119,48,494,147
1649244,100,26,1913,10,male,287,151,74,612,1336,0,379,612,957
1329811,59,12,1954,5,female,1027,154,89,627,42,398,26,229,16
1240541,36,24,1977,11,female,626,151,106,620,235,588,145,32,90
1820658,49,17,1964,1,female,1732,153,95,620,190,591,102,29,88
2009951,19,29,1994,8,female,303,156,110,637,603,588,222,49,381
1305415,55,27,1958,1,female,503,152,132,674,247,61,68,613,179
1021178,53,30,1960,1,female,616,156,78,665,268,145,60,520,208
1385464,58,12,1955,4,male,740,156,86,675,187,351,40,324,147
2136692,31,7,1982,9,female,360,153,115,692,386,637,200,55,186
1031100,53,21,1960,1,female,615,154,95,731,671,0,118,731,553
1620136,27,14,1986,5,female,406,154,62,760,1951,150,1053,610,898
1490604,22,6,1991,10,female,148,154,122,745,720,495,560,250,160
1351604,18,5,1995,6,male,353,155,57,742,334,659,225,83,109
1494926,28,6,1985,4,female,320,155,127,772,1187,587,802,185,385
1343556,19,6,1994,1,female,323,155,101,795,729,794,168,1,561
2183384,37,30,1976,3,female,161,152,84,741,652,741,514,0,138
1494822,69,14,1944,4,female,482,153,81,847,41,833,27,14,14
2072162,21,15,1992,5,female,704,156,68,870,477,851,403,19,74
1751373,74,18,1939,7,male,462,152,115,798,139,798,103,0,36
1486486,113,21,1900,10,female,1689,155,34,954,448,912,253,42,195
2128818,14,8,1999,2,female,100,156,91,907,666,891,334,16,332
1184680,19,18,1994,12,male,37,153,135,996,479,996,428,0,51
1335853,25,8,1988,1,female,590,156,76,1035,858,1035,706,0,152
1618471,69,13,1944,7,female,745,152,112,1226,508,0,57,1226,451
1462948,64,6,1949,6,male,1615,155,114,1244,319,344,46,900,273
1153753,33,26,1980,9,female,610,151,100,1255,657,1162,481,93,176
1243236,15,6,1998,1,female,344,151,126,1167,113,1167,80,0,33
1116937,63,15,1950,5,female,955,154,64,1284,783,1284,412,0,371
1147843,75,15,1938,8,female,1911,155,72,1299,470,0,148,1299,322
1639444,37,13,1976,12,female,1798,154,100,1359,1273,533,447,826,826
1229722,24,2,1989,6,female,439,155,83,1289,1810,1046,1355,243,455
1049101,62,27,1951,3,female,1680,155,74,1385,541,1372,240,13,301
1670852,34,21,1979,6,female,794,155,76,1496,547,1496,499,0,48
1653078,29,6,1984,7,female,1041,152,64,1734,410,1712,338,22,72
1549683,65,29,1948,4,female,1050,152,76,2043,829,166,235,1877,594
1527462,50,26,1963,12,female,833,154,73,2710,744,1533,253,1177,491
1310283,24,14,1989,1,male,297,155,117,3279,32,3277,16,2,16
1303373,52,3,1961,12,female,245,151,121,3431,80,3431,43,0,37
1885407,34,11,1979,1,female,208,154,61,2447,1602,2447,402,0,1200
1631028,68,7,1945,8,male,353,152,103,5362,469,188,334,5174,135
1196966,35,6,1978,11,female,205,154,117,4317,7833,267,954,4050,6879
2023903,26,31,1987,5,female,119,156,119,3922,4103,1732,2979,2190,1124
2109892,21,25,1992,9,male,384,153,34,7672,1492,7453,1292,219,200
1262796,30,19,1983,9,male,332,156,102,5234,3941,5220,2458,14,1483
2104693,54,6,1959,8,male,272,160,27,2,6,2,5,0,1
1515009,62,1,1951,4,female,1076,158,49,2,8,2,5,0,3
1220891,68,17,1945,8,male,1034,162,125,2,26,2,22,0,4
2172448,24,28,1989,8,male,362,159,101,3,0,0,0,3,0
1646183,18,18,1995,2,male,506,158,151,3,1,0,0,3,1
1502749,23,7,1990,6,male,719,158,97,3,2,0,2,3,0
1004184,24,18,1989,10,male,552,157,125,3,3,0,1,3,2
1096295,52,28,1961,6,female,1225,159,71,3,3,0,1,3,2
1444408,14,24,1999,3,male,416,157,75,3,1,2,1,1,0
1172964,20,13,1993,6,female,869,161,63,3,3,2,0,1,3
1885941,25,2,1988,9,male,305,159,129,3,2,2,2,1,0
1881033,35,22,1978,6,female,230,162,61,3,5,1,4,2,1
1574363,55,13,1958,7,male,586,160,138,3,7,2,5,1,2
1601962,72,13,1941,5,male,630,159,88,3,12,1,5,2,7
1860922,73,29,1940,6,male,316,159,123,3,19,2,13,1,6
1794082,16,1,1997,6,male,494,158,34,3,0,3,0,0,0
2036831,27,15,1986,6,male,695,159,127,3,0,3,0,0,0
1094078,90,1,1923,5,male,986,158,36,3,0,3,0,0,0
1887821,93,8,1920,12,female,1019,160,98,3,1,3,1,0,0
1158798,24,29,1989,5,female,557,160,46,3,4,3,4,0,0
1894979,24,9,1989,6,male,1210,157,123,3,2,3,2,0,0
1164190,26,19,1987,7,male,592,162,72,3,2,3,1,0,1
1708723,31,17,1982,1,male,240,161,79,3,4,3,4,0,0
1370955,15,19,1998,4,male,657,161,43,3,8,3,7,0,1
1755518,16,16,1997,3,male,123,159,138,3,5,3,5,0,0
1569850,21,10,1992,1,male,453,158,85,3,7,3,5,0,2
1707024,23,12,1990,6,male,31,161,153,3,7,3,7,0,0
1271950,103,28,1910,7,female,207,160,50,3,13,3,13,0,0
1232618,34,9,1979,4,male,785,161,128,4,0,0,0,4,0
1238477,17,26,1996,7,female,416,161,115,4,89,0,65,4,24
2006959,23,8,1990,12,female,405,157,99,4,7,0,3,4,4
1125616,45,11,1968,4,male,325,161,57,4,5,2,3,2,2
1280913,20,10,1993,9,male,466,159,74,4,62,3,21,1,41
1478670,50,22,1963,9,female,1240,160,78,4,27,3,25,1,2
1120246,25,31,1988,8,male,300,161,138,4,0,4,0,0,0
1460462,17,23,1996,2,male,314,158,136,4,4,4,4,0,0
1067801,31,28,1982,10,female,992,158,69,4,3,4,3,0,0
1475900,32,25,1981,9,male,449,158,121,4,4,4,3,0,1
2119976,41,1,1972,5,male,792,158,92,4,4,4,4,0,0
1859530,17,17,1996,5,male,139,160,122,4,6,4,6,0,0
1867864,18,17,1995,8,male,613,158,85,4,8,4,7,0,1
1882005,20,19,1993,12,female,570,157,114,4,10,4,10,0,0
1833991,21,4,1992,4,male,669,158,52,4,11,4,2,0,9
2049033,24,22,1989,10,male,98,160,140,4,30,4,23,0,7
1574121,27,12,1986,5,male,378,158,130,4,14,4,14,0,0
1906763,34,1,1979,1,male,362,162,144,4,56,4,27,0,29
1344929,17,15,1996,9,male,343,162,126,5,16,0,4,5,12
1569794,73,8,1940,2,female,1021,158,110,5,9,0,6,5,3
1705711,95,27,1918,11,male,85,157,95,5,13,0,1,5,12
2144541,104,8,1909,4,female,769,160,28,5,8,2,8,3,0
1194340,16,6,1997,6,female,290,162,132,5,3,4,2,1,1
1097450,25,26,1988,10,male,575,160,67,5,16,4,7,1,9
1837528,18,9,1995,5,male,287,162,148,5,0,5,0,0,0
2024016,22,2,1991,7,male,206,160,146,5,0,5,0,0,0
1946100,25,19,1988,5,male,993,158,119,5,0,5,0,0,0
1328251,26,1,1987,1,male,436,161,141,5,0,5,0,0,0
1271188,40,10,1973,11,male,826,161,16,5,2,5,2,0,0
1463090,76,31,1937,3,male,354,159,68,5,1,5,1,0,0
1173333,25,7,1988,4,male,249,162,149,5,7,5,2,0,5
1551294,18,6,1995,2,male,200,160,40,5,9,5,4,0,5
1480953,18,25,1995,5,male,1007,162,32,5,23,5,21,0,2
1164907,24,2,1989,10,female,520,157,109,5,10,5,3,0,7
1871557,27,10,1986,7,male,361,158,142,5,20,5,11,0,9
1820448,35,11,1978,10,male,973,162,117,5,93,5,58,0,35
1263077,66,7,1947,1,female,940,160,119,5,35,5,18,0,17
2004464,24,19,1989,2,female,254,161,136,6,2,0,1,6,1
1654987,19,1,1994,3,female,371,157,53,6,16,0,16,6,0
1493454,24,11,1989,1,male,272,162,134,6,168,1,29,5,139
1720439,27,22,1986,6,male,674,161,71,6,14,0,2,6,12
2190798,17,21,1996,3,male,360,159,125,6,4,2,1,4,3
2184787,59,23,1954,8,female,285,158,147,6,17,4,7,2,10
1061294,65,28,1948,3,male,1081,157,104,6,36,4,25,2,11
1596205,22,22,1991,6,male,563,161,74,6,15,5,4,1,11
1591554,19,23,1994,8,male,262,161,120,6,0,6,0,0,0
1051386,26,2,1987,5,male,860,157,70,6,1,6,1,0,0
1677447,30,13,1983,6,male,398,162,67,6,3,6,2,0,1
1037822,18,7,1995,7,male,317,162,138,6,7,6,3,0,4
1605983,25,21,1988,12,male,586,160,127,6,6,6,6,0,0
1255147,108,31,1905,8,male,613,158,127,6,4,6,3,0,1
1984555,26,27,1987,10,male,347,160,76,6,115,6,108,0,7
2015985,28,30,1985,9,female,178,158,123,6,11,6,11,0,0
1475569,31,1,1982,1,male,557,159,111,6,12,6,10,0,2
2034026,31,21,1982,6,female,605,161,108,6,18,6,15,0,3
1944269,34,13,1979,3,male,941,162,100,6,132,6,102,0,30
2136415,23,28,1990,3,male,702,159,94,7,0,0,0,7,0
1102794,37,13,1976,5,female,666,157,50,7,4,0,0,7,4
1690405,17,15,1996,9,male,381,158,92,7,8,1,3,6,5
1240225,29,25,1984,1,male,816,159,116,7,101,0,42,7,59
1688912,43,23,1970,5,male,594,161,118,7,5,3,4,4,1
1808177,55,22,1958,11,male,1739,159,60,7,20,6,16,1,4
2037897,25,11,1988,6,male,315,158,112,7,1,7,1,0,0
1267562,41,10,1972,1,male,368,159,128,7,0,7,0,0,0
1906677,21,5,1992,2,male,679,159,143,7,3,7,1,0,2
1045051,26,2,1987,4,female,611,159,109,7,24,7,24,0,0
1811314,35,13,1978,1,male,334,158,94,7,26,7,20,0,6
1538290,113,25,1900,2,male,1819,159,90,8,21,0,15,8,6
2190022,27,8,1986,8,male,483,162,126,8,15,3,11,5,4
1570210,15,11,1998,4,male,411,158,127,8,4,6,2,2,2
1830051,23,5,1990,12,male,399,158,143,8,0,8,0,0,0
1545626,58,26,1955,9,male,763,158,46,8,1,8,1,0,0
1580630,23,5,1990,3,female,400,162,122,8,25,8,13,0,12
1355732,25,5,1988,9,male,294,162,67,8,18,8,15,0,3
1045621,32,12,1981,3,male,303,157,93,8,36,8,25,0,11
1356510,37,9,1976,7,male,932,161,80,8,22,8,10,0,12
1203766,18,15,1995,3,male,159,161,135,9,1,0,0,9,1
1586633,17,10,1996,10,male,453,161,92,9,1,3,0,6,1
1066447,20,12,1993,11,male,343,159,99,9,4,3,3,6,1
1989639,19,6,1994,3,male,643,160,89,9,107,4,50,5,57
2094758,73,26,1940,11,male,1798,157,50,9,43,6,20,3,23
1906215,58,2,1955,6,male,1378,160,87,9,2,8,0,1,2
2048290,51,1,1962,10,female,428,160,119,9,23,8,18,1,5
2108697,19,7,1994,11,male,486,158,107,9,0,9,0,0,0
1312063,21,3,1992,1,male,1199,160,126,9,1,9,1,0,0
1816137,108,10,1905,8,male,1604,161,103,9,4,9,4,0,0
1743013,108,30,1905,9,male,974,160,94,9,2,9,1,0,1
1513308,23,12,1990,2,male,424,157,125,9,6,9,4,0,2
1575114,23,26,1990,10,female,300,157,88,9,9,9,6,0,3
2093875,28,8,1985,10,male,792,157,105,9,6,9,6,0,0
1797566,43,31,1970,10,male,70,160,152,9,28,9,27,0,1
1982591,63,10,1950,11,female,1608,160,120,9,20,9,20,0,0
2030903,30,18,1983,8,male,462,160,58,10,29,3,20,7,9
1835008,14,30,1999,12,male,250,159,74,10,7,8,3,2,4
1156243,53,20,1960,10,female,2226,160,76,10,62,9,52,1,10
2050012,54,17,1959,9,male,281,160,59,10,0,10,0,0,0
1450470,75,9,1938,9,female,766,161,88,10,1,10,1,0,0
1469815,23,16,1990,11,male,436,158,73,10,6,10,5,0,1
1260812,18,9,1995,8,male,54,162,156,10,9,10,6,0,3
1386514,23,15,1990,5,male,455,161,40,10,7,10,7,0,0
1781308,26,17,1987,8,male,723,158,34,10,19,10,14,0,5
1576282,38,16,1975,12,male,647,160,69,10,35,10,22,0,13
2019446,108,8,1905,7,male,1021,158,85,11,0,0,0,11,0
1026159,16,27,1997,5,male,99,161,141,11,6,3,4,8,2
1361522,14,4,1999,5,male,164,158,105,11,3,9,3,2,0
1949895,22,1,1991,9,male,354,161,155,11,4,9,4,2,0
1201281,34,17,1979,6,male,155,162,124,11,25,9,15,2,10
1557300,61,19,1952,3,male,1571,161,56,11,17,10,9,1,8
1607263,26,15,1987,1,male,477,162,74,11,0,11,0,0,0
1075702,16,13,1997,12,male,321,157,129,11,4,11,4,0,0
1837356,18,2,1995,3,female,391,162,26,11,9,11,2,0,7
1655947,27,23,1986,3,female,486,161,58,11,7,11,7,0,0
1214687,16,5,1997,1,male,48,162,94,11,39,11,30,0,9
1045893,21,15,1992,3,female,1149,162,89,11,44,11,24,0,20
1311365,15,23,1998,7,male,485,159,112,12,1,1,0,11,1
2140615,20,14,1993,2,female,544,162,107,12,0,0,0,12,0
1275620,28,22,1985,7,female,331,160,93,12,3,0,2,12,1
1505995,46,31,1967,7,female,434,158,66,12,160,1,105,11,55
1755225,108,1,1905,1,male,831,160,105,12,28,2,20,10,8
1374523,27,6,1986,4,male,1022,160,84,12,18,4,17,8,1
1006149,23,19,1990,4,female,537,160,67,12,1,12,1,0,0
1622582,22,14,1991,6,male,1056,161,36,12,19,12,18,0,1
1346244,22,20,1991,8,male,570,157,67,12,52,12,51,0,1
1384163,21,31,1992,5,female,855,157,58,13,1,2,0,11,1
1308001,31,4,1982,4,male,432,159,114,13,0,6,0,7,0
2017976,43,27,1970,9,male,502,162,40,13,17,4,6,9,11
1453496,19,24,1994,2,female,402,158,123,13,21,7,11,6,10
1210225,62,17,1951,8,female,1603,162,35,13,98,10,54,3,44
1196371,30,29,1983,6,male,370,159,115,13,9,13,9,0,0
1676138,24,25,1989,5,male,1088,159,46,13,36,13,36,0,0
1854025,66,21,1947,5,male,423,158,43,14,53,0,6,14,47
1499430,62,20,1951,10,male,1382,161,41,14,5,5,3,9,2
1058009,22,18,1991,10,female,499,158,73,14,19,3,7,11,12
1477614,16,19,1997,5,female,712,158,61,14,2,14,2,0,0
1858888,18,15,1995,5,male,671,160,110,14,0,14,0,0,0
2071063,36,5,1977,4,female,343,160,51,14,20,14,19,0,1
1861209,19,6,1994,10,female,318,158,83,14,36,14,22,0,14
2129926,22,25,1991,9,female,464,157,80,14,34,14,21,0,13
1863894,16,21,1997,8,male,309,160,92,15,0,2,0,13,0
1362895,76,23,1937,11,female,160,160,110,15,12,5,0,10,12
1591518,43,9,1970,1,male,195,161,129,15,1,15,0,0,1
1536955,15,2,1998,6,male,399,158,134,15,4,15,2,0,2
1768468,23,18,1990,7,male,535,158,72,15,5,15,4,0,1
1278106,21,24,1992,12,male,439,157,91,15,26,15,21,0,5
1724452,23,5,1990,5,male,178,161,139,15,24,15,24,0,0
1772722,30,14,1983,9,female,366,159,133,16,1,4,1,12,0
1850607,31,5,1982,4,female,544,162,98,16,5,6,4,10,1
1561507,63,15,1950,10,male,512,159,111,16,57,4,33,12,24
1192358,42,3,1971,12,male,622,157,106,16,22,15,21,1,1
2106454,30,4,1983,7,male,934,160,76,16,79,12,29,4,50
1421135,23,28,1990,3,male,721,160,125,16,0,16,0,0,0
1447137,14,4,1999,6,male,559,159,80,16,3,16,3,0,0
1453243,29,11,1984,6,female,172,157,124,16,36,16,19,0,17
1854660,56,31,1957,7,male,2043,161,64,17,4,1,1,16,3
2014190,27,14,1986,2,male,283,159,24,17,128,0,12,17,116
1593794,64,14,1949,7,male,402,160,132,17,28,0,11,17,17
1714990,103,21,1910,8,male,1498,158,60,17,1,17,1,0,0
1056801,23,4,1990,1,male,287,158,131,17,7,17,5,0,2
1685276,53,18,1960,3,male,699,157,60,17,20,17,14,0,6
1942721,63,16,1950,2,male,1145,160,33,17,15,17,11,0,4
1199279,23,7,1990,10,female,393,158,36,17,30,17,14,0,16
1156531,37,15,1976,4,male,551,159,121,17,31,17,17,0,14
1570882,47,6,1966,9,male,118,162,135,17,38,17,23,0,15
1638500,90,8,1923,12,male,414,162,118,17,66,17,65,0,1
1662694,100,2,1913,11,female,1497,158,24,17,30,17,24,0,6
1334894,49,28,1964,4,male,800,158,81,18,270,15,190,3,80
1106435,66,23,1947,10,female,1759,157,38,18,159,14,109,4,50
1014993,16,9,1997,4,female,173,161,50,18,4,18,4,0,0
1211494,18,10,1995,1,male,212,161,72,18,9,18,4,0,5
1447345,19,24,1994,9,male,315,158,18,18,10,18,10,0,0
1875876,21,15,1992,4,male,354,161,101,18,23,18,23,0,0
1005882,28,25,1985,6,male,393,160,140,18,25,18,18,0,7
1974908,36,8,1977,11,male,1079,162,48,18,14,18,10,0,4
1700168,21,6,1992,6,male,323,158,133,18,28,18,28,0,0
2045913,37,14,1976,2,female,449,159,95,19,7,19,3,0,4
1653754,23,28,1990,11,male,639,162,114,20,52,3,29,17,23
1473127,25,10,1988,1,male,896,159,90,20,65,0,11,20,54
1632304,19,17,1994,4,female,287,157,61,20,11,18,6,2,5
1504177,61,19,1952,11,male,598,157,119,20,12,17,9,3,3
1521972,27,18,1986,5,female,711,162,99,20,119,19,99,1,20
1517871,21,8,1992,1,male,367,159,121,20,0,20,0,0,0
1563260,34,19,1979,8,male,274,159,125,20,0,20,0,0,0
1119276,23,16,1990,6,male,217,161,135,20,6,20,1,0,5
1557617,23,13,1990,2,female,519,162,136,20,117,20,60,0,57
1970387,29,24,1984,4,female,563,161,115,20,60,20,28,0,32
2176476,48,1,1965,3,female,230,157,97,20,39,20,32,0,7
1867871,45,22,1968,1,male,1890,158,88,21,3,4,3,17,0
1133557,80,24,1933,3,male,1985,162,83,21,6,6,1,15,5
1563707,57,22,1956,10,female,1736,161,100,21,45,19,17,2,28
2037526,84,2,1929,10,male,637,159,121,21,14,21,14,0,0
1426618,103,3,1910,6,male,323,157,112,21,28,21,27,0,1
1415868,22,17,1991,1,male,374,160,130,21,32,21,30,0,2
1292370,23,19,1990,3,male,527,158,137,21,39,21,33,0,6
1996314,60,2,1953,12,female,2092,159,73,22,121,2,89,20,32
1248619,41,8,1972,2,male,436,161,135,22,1,22,1,0,0
1977187,29,15,1984,9,male,367,161,147,22,9,22,8,0,1
1450857,108,31,1905,12,male,922,159,70,22,15,22,4,0,11
2187951,26,28,1987,12,female,380,157,107,22,49,22,44,0,5
2075492,61,30,1952,1,female,470,157,65,23,42,0,11,23,31
1551851,19,23,1994,9,male,597,162,62,23,15,5,3,18,12
2138672,45,7,1968,1,male,780,159,34,23,2,23,2,0,0
1124686,16,16,1997,10,female,132,159,34,23,6,23,5,0,1
1940729,18,1,1995,1,male,743,158,100,23,6,23,6,0,0
1820631,34,16,1979,8,male,522,157,124,23,17,23,9,0,8
1730080,26,1,1987,2,male,346,161,119,23,43,23,28,0,15
1976370,24,2,1989,11,male,263,160,70,24,8,0,2,24,6
1523782,36,9,1977,8,male,377,162,76,24,11,24,8,0,3
2111190,18,27,1995,10,male,316,158,77,24,26,24,26,0,0
1563117,27,25,1986,9,female,299,161,130,24,24,24,6,0,18
1840812,20,19,1993,6,female,531,158,84,24,41,24,19,0,22
1799785,16,24,1997,7,male,496,158,88,25,3,25,2,0,1
1667888,16,24,1997,12,male,268,157,58,25,39,25,37,0,2
1939450,31,5,1982,11,male,232,161,97,26,7,2,1,24,6
1640772,23,1,1990,1,male,382,159,85,26,2,26,1,0,1
1627268,24,1,1989,10,male,128,158,92,26,76,26,59,0,17
1589457,37,27,1976,12,male,212,158,102,27,2,0,0,27,2
1779575,18,2,1995,7,female,482,159,115,27,5,0,5,27,0
1231197,54,29,1959,10,male,438,161,92,27,13,0,3,27,10
1892733,81,31,1932,7,female,1515,161,78,27,180,0,134,27,46
1084518,25,16,1988,10,male,432,161,88,27,13,20,8,7,5
1511744,78,1,1935,10,male,1376,159,114,27,7,26,3,1,4
1613453,18,7,1995,8,male,772,159,131,27,24,27,24,0,0
1972627,42,23,1971,1,male,173,158,112,27,138,27,69,0,69
1613033,18,18,1995,3,male,145,158,70,28,13,20,10,8,3
1853512,24,15,1989,1,male,472,157,119,28,1,28,1,0,0
1251040,37,1,1976,1,male,292,162,132,28,32,28,31,0,1
1003085,103,22,1910,4,female,1148,160,50,28,27,28,15,0,12
2026524,18,30,1995,9,male,175,161,114,29,6,0,2,29,4
1023710,17,14,1996,6,female,797,161,80,29,47,0,20,29,27
1335703,17,6,1996,9,male,92,160,135,29,6,16,2,13,4
1362451,30,9,1983,11,female,284,157,93,29,8,29,7,0,1
1097150,108,28,1905,3,male,909,161,115,30,12,0,3,30,9
1572410,20,21,1993,12,female,327,161,122,30,30,9,19,21,11
1149113,19,5,1994,1,male,299,161,91,31,73,13,17,18,56
1716210,36,3,1977,12,male,409,161,150,31,10,28,6,3,4
1294541,21,7,1992,9,male,525,158,134,31,36,27,26,4,10
1901884,19,31,1994,12,male,700,161,66,31,64,25,46,6,18
1294440,15,30,1998,4,female,96,157,123,31,1,31,1,0,0
1245115,23,15,1990,10,male,258,162,89,31,11,31,10,0,1
1071573,26,26,1987,8,male,654,158,80,31,46,31,44,0,2
1854206,27,16,1986,2,male,245,161,111,30,37,30,24,0,13
1627576,106,20,1907,3,male,626,161,137,30,34,30,28,0,6
1529046,49,17,1964,11,male,606,161,87,30,56,30,45,0,11
1290696,34,16,1979,9,male,436,162,95,32,41,4,15,28,26
1866679,26,18,1987,6,male,527,160,118,32,60,8,40,24,20
1169166,40,28,1973,8,male,217,161,118,32,7,32,2,0,5
1441219,19,16,1994,1,female,471,161,51,33,51,9,8,24,43
1536672,57,12,1956,2,female,1274,162,69,33,14,27,5,6,9
1043519,52,12,1961,9,female,829,160,113,33,37,27,19,6,18
1165982,32,7,1981,12,male,166,162,125,33,25,33,17,0,8
1704583,17,22,1996,12,female,80,157,91,33,58,33,17,0,41
1081377,21,5,1992,9,male,347,160,76,33,97,33,93,0,4
1281099,63,9,1950,10,female,755,161,127,34,10,0,6,34,4
1968599,19,3,1994,5,female,791,157,62,34,66,0,12,34,54
1142573,18,13,1995,1,male,607,159,77,34,6,22,1,12,5
1454543,22,21,1991,11,male,355,157,122,34,32,32,21,2,11
1860187,46,21,1967,10,male,665,161,107,34,91,30,75,4,16
2077899,27,18,1986,2,male,412,161,131,34,4,34,3,0,1
1532898,41,13,1972,7,male,424,160,143,34,5,34,5,0,0
1830426,22,22,1991,5,female,469,157,25,34,81,34,43,0,38
1819586,24,9,1989,7,female,665,158,74,34,66,34,47,0,19
1727965,28,9,1985,8,male,435,159,76,34,70,34,69,0,1
1263162,54,26,1959,7,female,381,162,103,35,1,0,0,35,1
1518986,63,1,1950,3,male,1612,157,97,35,55,0,9,35,46
1674213,19,7,1994,9,male,129,161,82,36,22,20,21,16,1
1093706,81,11,1932,10,male,561,162,53,36,168,31,125,5,43
2006860,18,24,1995,10,male,402,159,127,36,47,36,12,0,35
1618498,20,21,1993,9,female,224,159,78,36,22,36,22,0,0
1534227,21,3,1992,9,female,402,157,46,36,22,36,14,0,8
1370549,21,31,1992,12,male,422,159,59,35,54,35,44,0,10
1696135,106,28,1907,2,female,1229,158,91,37,52,0,34,37,18
1424438,16,29,1997,5,male,400,159,102,37,9,37,3,0,6
1359594,100,12,1913,2,male,1014,161,100,37,30,37,17,0,13
2160816,23,18,1990,10,female,417,160,123,38,7,0,0,38,7
2150070,108,9,1905,6,female,902,161,54,39,34,26,20,13,14
2024908,59,20,1954,8,female,948,161,71,38,20,32,3,6,17
1846926,22,5,1991,6,male,424,160,35,39,171,38,109,1,62
1707203,32,13,1981,1,male,424,158,90,39,6,39,3,0,3
1031405,24,24,1989,3,male,73,158,103,39,73,39,23,0,50
1755056,35,31,1978,8,male,111,160,139,39,74,39,61,0,13
1141210,15,24,1998,11,female,162,158,97,40,42,0,20,40,22
1764245,45,11,1968,12,male,936,162,92,42,2,34,1,8,1
2136984,103,10,1910,12,female,401,161,94,41,7,41,6,0,1
1849490,102,27,1911,9,male,574,162,108,42,23,42,23,0,0
1565869,32,22,1981,6,male,510,161,98,41,88,41,66,0,22
1438261,24,27,1989,3,male,405,162,89,43,48,43,26,0,22
1615764,25,26,1988,1,female,587,161,99,44,53,44,50,0,3
1683827,28,24,1985,7,female,1270,158,88,43,80,43,56,0,24
1726577,26,4,1987,1,male,495,157,85,45,25,44,13,1,12
2057864,108,14,1905,10,female,2339,158,53,46,4,1,3,45,1
2114053,50,22,1963,5,female,145,161,95,46,3,17,1,29,2
2095594,19,27,1994,12,male,273,157,49,47,1,47,1,0,0
1964951,19,30,1994,12,female,285,160,78,46,11,46,3,0,8
1281116,23,18,1990,1,male,246,160,93,47,10,47,8,0,2
1675646,25,15,1988,7,male,323,158,141,47,11,47,11,0,0
1725126,15,6,1998,3,female,404,158,51,46,55,46,43,0,12
1347295,18,19,1995,7,male,477,157,118,47,83,47,80,0,3
1946882,38,23,1975,10,male,245,157,95,49,7,0,2,49,5
1958869,42,31,1971,5,female,354,160,104,48,27,0,3,48,24
1940960,21,13,1992,9,female,656,161,80,49,21,13,6,36,15
2141604,29,23,1984,9,male,757,159,95,49,1,43,1,6,0
1164703,19,1,1994,12,male,380,158,116,49,18,48,14,1,4
1919858,19,6,1994,3,male,637,161,51,49,0,49,0,0,0
2076859,21,5,1992,12,male,424,157,119,49,11,49,10,0,1
1195005,63,1,1950,4,female,860,162,56,50,0,7,0,43,0
1634040,33,27,1980,10,male,192,162,127,50,40,4,15,46,25
1478921,28,11,1985,12,male,705,157,47,50,6,16,3,34,3
1755058,17,26,1996,8,male,444,161,134,51,97,12,8,39,89
1678864,18,22,1995,2,female,903,158,94,51,155,31,53,20,102
1563687,24,22,1989,8,male,328,160,119,50,84,30,78,20,6
1135069,59,16,1954,8,female,1550,160,47,51,8,51,6,0,2
1822117,20,11,1993,3,female,142,162,78,51,48,51,42,0,6
1966205,21,31,1992,12,female,101,161,81,50,143,50,83,0,60
1972332,41,16,1972,2,male,528,160,101,53,14,0,6,53,8
1204240,93,25,1920,4,male,249,158,130,53,20,6,9,47,11
1036146,18,5,1995,11,female,93,157,68,52,5,12,1,40,4
1417031,16,26,1997,12,female,335,159,89,52,15,51,6,1,9
2022199,18,22,1995,4,female,283,160,66,52,13,50,5,2,8
1648719,108,1,1905,1,female,865,160,99,53,48,48,39,5,9
1488098,108,5,1905,7,male,34,161,127,52,3,52,3,0,0
1880148,58,29,1955,4,female,1492,160,86,53,11,53,8,0,3
1150950,95,11,1918,12,male,1780,159,88,53,24,53,14,0,10
1853737,54,12,1959,6,male,1608,161,40,53,394,53,256,0,138
1737470,16,22,1997,2,male,579,157,93,54,24,0,6,54,18
1251738,44,25,1969,4,female,463,161,28,54,38,54,30,0,8
2159009,106,24,1907,11,male,1997,160,95,54,37,54,20,0,17
1899742,58,27,1955,7,male,647,160,124,54,112,54,59,0,53
1858093,14,4,1999,2,male,340,162,80,56,19,10,13,46,6
2093154,68,1,1945,1,male,250,158,121,57,79,13,43,44,36
2108945,25,17,1988,8,male,40,157,154,56,8,56,7,0,1
1329099,41,15,1972,2,male,1258,158,47,57,0,57,0,0,0
1528338,28,2,1985,5,male,477,159,83,58,10,58,7,0,3
1732573,15,29,1998,4,female,287,159,95,57,59,57,42,0,17
1033666,16,23,1997,4,female,295,157,89,58,85,58,68,0,17
1120981,61,18,1952,7,female,885,161,77,56,81,56,55,0,26
1042558,15,4,1998,5,male,420,160,110,59,27,59,18,0,9
1849851,38,11,1975,6,male,873,157,128,60,17,60,10,0,7
1148439,21,19,1992,5,female,387,159,67,59,57,59,43,0,14
1033428,35,23,1978,2,male,476,158,107,62,56,1,36,61,20
1625613,35,28,1978,4,male,533,161,132,63,32,26,13,37,19
2052718,18,15,1995,7,male,1364,159,35,63,0,60,0,3,0
1180051,54,21,1959,6,female,353,159,146,62,11,51,7,11,4
1182494,26,14,1987,2,female,368,162,104,61,8,61,3,0,5
1012844,18,29,1995,1,male,96,159,115,61,23,61,20,0,3
1747438,52,11,1961,11,female,514,160,87,62,28,62,22,0,6
2172957,106,16,1907,4,male,399,160,74,63,53,63,46,0,7
1701410,36,27,1977,1,male,738,160,102,63,114,63,44,0,70
1501184,18,10,1995,7,female,607,162,59,64,72,7,15,57,57
1509554,68,30,1945,4,male,1834,159,97,64,78,0,28,64,50
1030279,103,22,1910,5,female,1292,161,100,64,30,64,25,0,5
1982368,103,7,1910,2,NA,1716,159,49,66,2,0,1,66,1
1077464,108,26,1905,12,male,1474,157,89,68,31,0,22,68,9
1731611,27,22,1986,8,male,159,159,139,66,106,4,69,62,37
1589898,16,13,1997,5,male,301,162,107,68,9,66,2,2,7
1880949,21,29,1992,10,male,611,160,69,68,80,68,45,0,35
1825138,28,1,1985,1,male,307,162,116,67,89,67,66,0,23
1052130,66,26,1947,11,female,1483,159,65,71,89,0,21,71,68
2087900,14,21,1999,3,male,223,161,85,69,2,34,1,35,1
2100385,23,8,1990,9,male,294,162,94,70,32,23,5,47,27
1119395,46,30,1967,8,female,1025,160,93,70,267,44,181,26,86
1661925,15,1,1998,7,female,518,161,105,71,41,52,33,19,8
1339413,43,22,1970,6,female,405,158,111,69,98,68,78,1,20
1903050,52,11,1961,7,female,789,157,87,71,64,71,31,0,33
1421303,55,15,1958,5,female,329,157,130,73,26,0,9,73,17
1943120,108,8,1905,10,female,975,158,107,74,72,0,39,74,33
1031709,33,27,1980,8,male,285,158,75,72,9,26,6,46,3
1427707,81,9,1932,8,male,372,158,132,73,80,25,45,48,35
2067482,22,10,1991,12,female,373,159,64,73,418,62,209,11,209
1262501,27,2,1986,4,female,1396,157,72,72,119,71,109,1,10
1542403,18,23,1995,2,female,510,160,109,72,4,72,4,0,0
2181778,24,7,1989,12,female,420,159,82,74,84,74,78,0,6
1055062,33,31,1980,5,female,524,157,40,72,51,72,46,0,5
1819497,46,21,1967,5,female,519,157,82,77,67,39,41,38,26
1201883,34,2,1979,12,male,855,162,89,76,25,61,10,15,15
1288597,16,27,1997,4,female,899,158,53,76,48,63,16,13,32
1601914,65,18,1948,4,female,1386,161,109,78,164,51,81,27,83
1704622,19,2,1994,2,female,567,161,82,79,1,79,1,0,0
1271360,26,24,1987,3,female,263,161,123,79,1,79,1,0,0
1403829,18,17,1995,2,male,616,160,46,78,26,78,26,0,0
2094089,25,9,1988,2,female,276,157,69,80,28,80,25,0,3
1895291,67,11,1946,3,female,752,162,38,80,22,80,20,0,2
1598286,18,7,1995,5,male,74,162,120,79,160,79,144,0,16
2179318,27,28,1986,4,female,628,161,92,80,125,80,99,0,26
2082962,61,21,1952,5,female,1444,160,71,82,174,39,149,43,25
1559953,23,21,1990,3,female,417,157,99,81,87,79,5,2,82
1484293,110,10,1903,7,male,2015,160,66,83,104,81,66,2,38
1301351,44,27,1969,12,female,255,159,130,82,1,82,1,0,0
1430584,34,27,1979,3,female,712,158,89,81,83,81,65,0,18
1091179,77,21,1936,12,male,1401,161,80,83,67,83,44,0,23
1561747,67,23,1946,10,female,1714,162,115,83,151,83,142,0,9
1361728,44,23,1969,3,female,215,160,78,86,111,24,72,62,39
1222333,51,11,1962,11,male,950,162,135,85,47,65,32,20,15
2146934,16,15,1997,7,male,239,158,109,88,32,8,20,80,12
1106539,30,16,1983,1,female,154,157,48,88,10,87,8,1,2
1708386,25,5,1988,4,male,542,162,127,89,28,82,14,7,14
2154198,22,8,1991,7,female,757,157,44,90,159,85,96,5,63
1129597,49,10,1964,9,female,333,161,51,91,19,91,14,0,5
1752490,70,8,1943,12,female,1310,158,71,93,78,0,16,93,62
2141425,62,22,1951,6,female,592,159,57,95,242,29,88,66,154
1278576,16,9,1997,1,male,480,162,69,93,143,76,68,17,75
1962432,49,5,1964,5,male,892,158,88,95,297,72,161,23,136
1518009,17,1,1996,11,male,480,160,148,95,56,95,42,0,14
2069172,27,25,1986,6,female,502,159,124,95,27,95,18,0,9
1891113,50,16,1963,2,female,544,161,20,93,21,93,12,0,9
2171489,18,12,1995,4,female,199,157,90,95,73,95,70,0,3
1525140,27,20,1986,10,male,259,159,77,93,92,93,59,0,33
1994183,48,24,1965,7,female,1319,160,118,99,72,89,64,10,8
1338832,23,21,1990,12,female,671,161,55,98,12,98,11,0,1
1654608,35,9,1978,1,male,327,157,105,99,14,99,3,0,11
1435382,21,24,1992,2,male,16,159,131,97,23,97,15,0,8
1445840,41,1,1972,10,male,423,159,64,99,108,99,75,0,33
1931476,58,10,1955,7,female,1764,157,73,101,11,6,10,95,1
1937426,72,11,1941,2,female,1020,157,62,103,15,3,3,100,12
1318131,17,27,1996,11,female,278,162,129,101,64,18,36,83,28
1131049,57,16,1956,11,male,902,162,108,102,69,0,12,102,57
1428064,15,19,1998,10,male,536,158,114,101,4,92,3,9,1
1296081,20,22,1993,7,male,318,159,112,101,61,79,27,22,34
1378384,49,30,1964,6,female,215,161,133,104,154,96,133,8,21
1725932,39,27,1974,2,female,419,159,110,104,15,104,9,0,6
1008083,19,10,1994,12,male,224,162,122,101,58,101,54,0,4
1436613,35,11,1978,2,female,455,159,54,103,54,103,45,0,9
1929430,68,19,1945,7,female,1742,159,79,106,67,0,26,106,41
2040529,15,8,1998,5,male,247,160,146,107,26,30,11,77,15
1218094,25,17,1988,11,female,253,157,33,107,65,105,33,2,32
1733749,30,12,1983,7,female,536,157,86,105,120,93,34,12,86
1851210,14,1,1999,5,male,134,162,64,112,49,101,25,11,24
1605264,43,12,1970,4,female,216,160,76,110,63,98,48,12,15
1969598,32,6,1981,7,female,285,161,77,110,146,80,55,30,91
1512365,48,12,1965,6,female,458,158,115,110,133,94,59,16,74
1813756,20,6,1993,10,female,244,161,40,112,34,112,23,0,11
1272935,108,1,1905,1,male,244,160,107,112,69,112,67,0,2
1166154,20,15,1993,2,male,332,158,106,111,205,111,100,0,105
1028966,58,26,1955,5,female,2160,160,75,117,39,15,25,102,14
1564113,62,6,1951,1,female,917,161,83,119,205,0,64,119,141
2155768,30,3,1983,4,male,750,159,116,114,69,68,60,46,9
1195325,19,27,1994,1,female,467,162,111,118,204,76,95,42,109
1476297,91,14,1922,2,female,1241,158,74,114,181,111,134,3,47
1812147,15,16,1998,5,male,292,161,142,114,0,114,0,0,0
1589851,18,18,1995,4,male,229,162,132,119,2,119,2,0,0
1922894,40,28,1973,10,female,1956,158,88,115,92,115,59,0,33
1999587,34,17,1979,3,female,785,159,46,120,77,29,19,91,58
1955583,37,10,1976,6,male,1741,160,96,121,26,121,17,0,9
1939905,80,13,1933,2,female,121,161,119,127,73,118,71,9,2
1305132,51,6,1962,10,male,222,159,132,125,95,100,17,25,78
2025476,19,11,1994,12,male,569,160,72,127,43,127,42,0,1
1899961,108,28,1905,4,male,832,160,140,126,67,126,53,0,14
1225276,26,1,1987,1,male,108,160,131,129,87,129,74,0,13
1108093,58,3,1955,4,female,1768,157,52,136,44,33,15,103,29
1644745,105,26,1908,11,male,1449,162,79,133,24,85,14,48,10
1683102,25,10,1988,5,male,433,157,136,132,151,87,59,45,92
2148496,18,13,1995,9,male,273,159,106,134,26,98,9,36,17
1505747,45,13,1968,5,female,982,162,100,133,110,129,79,4,31
1329836,34,14,1979,7,female,505,162,99,133,426,129,168,4,258
1174273,20,22,1993,9,male,490,161,132,131,28,130,22,1,6
1261931,50,11,1963,2,female,624,159,45,134,26,133,17,1,9
1533008,19,23,1994,11,female,574,159,98,133,91,133,73,0,18
1007900,25,27,1988,5,male,436,159,75,133,160,133,109,0,51
1440275,33,19,1980,7,male,276,158,93,133,133,133,114,0,19
1452402,29,17,1984,1,male,594,159,122,140,52,82,16,58,36
1869482,23,27,1990,8,female,388,159,95,141,314,74,106,67,208
1540711,23,19,1990,6,female,196,157,81,139,26,138,19,1,7
1806538,25,21,1988,4,male,283,162,142,143,43,143,35,0,8
1569321,27,8,1986,11,male,202,159,134,140,72,140,72,0,0
2074961,51,17,1962,9,female,1606,161,35,140,47,140,43,0,4
1820610,23,26,1990,6,male,32,162,139,137,96,137,36,0,60
1669412,30,20,1983,10,female,718,161,139,142,230,142,168,0,62
1116332,53,5,1960,3,female,1264,157,108,148,28,0,9,148,19
1342553,53,15,1960,4,female,460,159,87,148,51,14,7,134,44
1747806,27,3,1986,6,male,371,157,83,148,56,98,50,50,6
1218723,25,7,1988,5,female,272,161,128,146,67,137,42,9,25
1094763,24,7,1989,9,female,126,158,61,148,96,134,89,14,7
1088217,20,1,1993,1,male,367,159,142,149,23,149,20,0,3
1735063,57,24,1956,5,male,1047,161,116,154,81,0,13,154,68
2043206,62,19,1951,10,female,1750,157,121,155,92,0,31,155,61
1710898,22,14,1991,8,female,534,161,82,152,39,121,17,31,22
2176942,34,4,1979,7,female,238,157,43,157,103,121,64,36,39
1091330,23,2,1990,5,female,121,159,125,153,353,140,201,13,152
1717022,60,3,1953,1,female,161,157,102,152,60,151,40,1,20
1288382,31,25,1982,2,male,672,158,108,154,4,154,3,0,1
1962655,27,8,1986,1,male,436,158,83,154,92,154,50,0,42
1310693,45,13,1968,4,female,1825,162,75,152,385,152,319,0,66
1927607,68,20,1945,3,female,849,158,112,158,11,0,7,158,4
1109499,16,3,1997,9,male,707,157,32,160,90,116,66,44,24
1939085,19,21,1994,6,female,564,160,36,161,26,161,22,0,4
1226729,16,28,1997,12,male,521,158,93,164,82,164,71,0,11
1752451,19,12,1994,5,male,324,159,139,159,49,159,47,0,2
2108185,27,16,1986,5,male,431,158,110,164,32,164,30,0,2
1282157,51,12,1962,6,male,682,158,103,158,89,158,76,0,13
1350759,65,14,1948,7,NA,1993,159,58,167,48,0,35,167,13
2181087,21,5,1992,5,male,60,160,136,172,120,3,92,169,28
1866378,50,4,1963,1,male,1568,159,58,169,361,34,114,135,247
1282498,56,26,1957,7,male,390,161,105,166,33,164,26,2,7
2115758,108,23,1905,4,male,2124,162,26,168,156,141,78,27,78
1279631,113,3,1900,8,female,1662,162,99,172,110,167,78,5,32
1111378,16,1,1997,1,male,364,162,105,165,46,165,21,0,25
1726043,25,14,1988,9,male,461,160,103,166,244,166,106,0,138
2188957,32,11,1981,1,male,642,157,87,171,218,171,193,0,25
1348031,41,7,1972,11,female,360,159,125,165,140,165,109,0,31
2122038,17,12,1996,3,male,124,159,119,170,376,170,280,0,96
1606230,57,11,1956,12,female,948,157,116,177,71,0,16,177,55
1981208,79,14,1934,10,male,932,159,100,173,73,1,15,172,58
1824005,15,13,1998,5,male,219,158,131,173,49,139,33,34,16
1088999,30,3,1983,8,female,466,158,73,180,49,175,31,5,18
1201235,49,8,1964,7,female,195,158,65,179,35,153,11,26,24
1446119,32,12,1981,8,female,719,157,86,178,130,178,113,0,17
1049129,55,19,1958,10,male,1890,160,79,180,152,180,109,0,43
1695834,55,21,1958,7,female,1109,159,20,184,72,0,35,184,37
1075986,113,17,1900,10,female,2413,158,58,184,137,129,90,55,47
1001709,20,12,1993,10,male,339,157,108,190,115,190,80,0,35
1958943,23,13,1990,10,male,334,158,99,187,36,187,34,0,2
2076306,33,10,1980,9,female,454,158,64,189,105,189,62,0,43
1204766,23,19,1990,9,male,57,160,147,194,62,42,43,152,19
1046853,47,28,1966,4,male,1527,157,72,197,170,72,52,125,118
1816662,34,22,1979,7,female,308,161,103,199,152,174,78,25,74
1825987,30,22,1983,8,male,513,162,107,200,8,200,7,0,1
1845064,21,13,1992,9,female,472,158,31,196,59,196,35,0,24
1209569,61,15,1952,2,female,1959,161,103,208,33,127,30,81,3
1788867,43,16,1970,1,male,58,159,88,204,179,163,140,41,39
1736876,16,1,1997,8,male,248,158,106,213,40,48,20,165,20
1337339,32,15,1981,10,female,660,160,94,216,66,213,41,3,25
1165621,39,21,1974,1,male,1227,161,95,220,41,206,36,14,5
1653289,59,30,1954,1,female,1318,158,71,214,134,177,18,37,116
1861963,22,28,1991,6,female,547,160,138,218,76,217,71,1,5
1447651,26,9,1987,8,male,832,157,94,214,160,212,91,2,69
1081030,27,2,1986,9,female,528,159,47,213,17,213,8,0,9
2191315,28,30,1985,10,male,556,161,80,218,56,218,44,0,12
1955607,103,2,1910,9,male,1200,157,80,221,178,221,135,0,43
1296377,30,22,1983,10,male,764,157,99,224,182,194,100,30,82
1557493,108,7,1905,5,female,218,159,102,223,387,222,326,1,61
1476566,31,3,1982,3,female,192,158,93,231,237,231,181,0,56
1774721,40,21,1973,2,female,172,158,121,231,193,231,147,0,46
1267938,43,1,1970,1,female,235,162,80,233,893,233,422,0,471
2117330,54,14,1959,1,male,737,159,95,242,111,0,9,242,102
1297000,55,18,1958,5,female,857,162,105,246,104,9,17,237,87
1820905,56,25,1957,2,female,494,160,104,241,59,0,35,241,24
1090986,108,25,1905,2,male,1155,159,102,237,43,184,4,53,39
1551471,32,20,1981,4,male,2207,162,156,241,155,230,113,11,42
2124600,50,23,1963,8,female,443,162,119,235,17,235,9,0,8
1919773,20,1,1993,1,female,212,162,123,245,119,245,63,0,56
1403936,19,18,1994,9,male,385,159,129,256,202,171,94,85,108
1260484,18,1,1995,8,male,302,157,123,251,104,224,53,27,51
1979469,37,14,1976,12,male,59,161,31,247,332,240,225,7,107
2075025,51,17,1962,4,female,1941,162,68,248,202,220,174,28,28
1523224,24,18,1989,8,female,517,162,47,250,200,250,100,0,100
1797765,50,25,1963,9,female,1209,161,105,253,276,253,213,0,63
1949667,14,14,1999,3,female,369,162,116,272,18,118,5,154,13
1854144,36,29,1977,1,female,271,162,70,273,904,273,623,0,281
1477295,108,22,1905,11,male,1516,159,117,284,41,1,22,283,19
1680752,59,3,1954,9,female,1271,162,77,283,363,19,164,264,199
1183913,30,27,1983,6,female,128,161,151,288,242,188,157,100,85
1410570,27,17,1986,11,female,215,162,106,278,274,235,154,43,120
1536547,56,11,1957,6,female,1332,159,31,290,453,236,262,54,191
1980822,25,10,1988,3,female,749,162,102,284,3,284,3,0,0
1917838,24,17,1989,11,male,215,160,115,288,164,288,125,0,39
1211235,60,3,1953,2,female,80,159,51,303,206,0,21,303,185
1269809,23,27,1990,4,male,237,159,132,305,23,213,20,92,3
1720012,14,8,1999,5,female,390,160,77,294,148,160,15,134,133
2040943,16,12,1997,6,female,551,160,106,300,61,283,42,17,19
2032044,24,29,1989,6,male,479,157,117,300,106,263,90,37,16
1289656,50,29,1963,5,male,371,158,119,293,14,293,4,0,10
1365746,23,1,1990,5,male,594,160,99,297,96,297,79,0,17
1305301,35,3,1978,5,male,224,157,122,296,146,296,140,0,6
1304976,71,14,1942,9,female,1614,160,81,301,160,301,107,0,53
1045391,54,5,1959,4,female,608,161,117,303,205,303,75,0,130
1566225,51,1,1962,2,female,780,161,58,320,26,0,15,320,11
1617696,61,16,1952,11,female,1853,162,83,326,120,0,29,326,91
1742217,28,7,1985,3,female,631,157,60,319,731,274,287,45,444
1026143,14,28,1999,3,female,289,157,138,310,71,310,55,0,16
1429244,18,1,1995,3,female,248,162,107,313,267,313,253,0,14
1429479,53,7,1960,9,female,760,157,136,328,152,23,98,305,54
1043264,54,6,1959,10,female,1205,162,93,344,83,8,13,336,70
1277856,50,13,1963,12,female,695,161,46,334,501,56,303,278,198
2045792,14,8,1999,6,female,246,162,116,332,313,69,146,263,167
2148902,55,28,1958,11,female,2390,159,60,343,247,209,158,134,89
1810754,19,7,1994,2,male,196,158,137,343,37,279,31,64,6
1261515,19,31,1994,1,male,148,161,113,330,151,263,113,67,38
2180411,21,22,1992,8,female,541,157,119,345,190,312,151,33,39
1040807,51,19,1962,11,female,1533,159,101,337,115,257,66,80,49
1865313,28,2,1985,8,female,297,161,113,335,635,268,500,67,135
2122118,20,5,1993,3,female,443,158,117,338,198,338,180,0,18
1961920,27,2,1986,4,male,143,157,135,329,124,329,114,0,10
1149635,30,27,1983,11,male,518,157,122,346,219,346,214,0,5
1554685,35,10,1978,2,male,224,160,139,332,215,332,195,0,20
2081096,50,22,1963,8,female,1480,160,58,336,214,336,158,0,56
1473151,55,17,1958,3,female,991,160,116,361,169,1,60,360,109
1281507,17,25,1996,8,male,443,159,113,347,6,266,3,81,3
1248424,19,1,1994,7,female,156,161,152,363,69,350,66,13,3
1045038,18,14,1995,8,female,169,161,115,352,634,345,488,7,146
1338037,54,10,1959,2,female,1531,157,90,368,150,368,109,0,41
1926109,55,9,1958,10,female,55,158,131,358,148,358,82,0,66
1722703,18,24,1995,8,male,143,162,148,377,163,239,84,138,79
1683438,23,11,1990,4,female,479,159,123,386,103,342,65,44,38
1894600,36,22,1977,5,female,205,160,140,371,184,367,160,4,24
1996420,52,20,1961,4,female,2175,158,56,385,270,345,152,40,118
1478142,31,22,1982,1,female,261,157,122,372,79,372,68,0,11
1618397,60,24,1953,11,female,1837,159,94,384,174,384,146,0,28
1752990,31,27,1982,10,female,442,162,73,378,308,378,97,0,211
1012252,50,21,1963,7,male,315,162,90,371,333,371,170,0,163
1014583,103,31,1910,10,female,1790,161,83,410,320,7,97,403,223
1860967,59,13,1954,10,female,1785,160,63,406,340,212,185,194,155
1277783,63,5,1950,5,female,984,161,134,403,648,249,334,154,314
1885349,21,25,1992,6,female,605,158,67,399,93,378,30,21,63
1397476,69,13,1944,6,female,1152,161,101,399,242,387,171,12,71
1677213,18,8,1995,8,male,28,158,142,409,294,332,217,77,77
1395482,16,26,1997,1,male,132,162,132,405,0,405,0,0,0
1131008,38,3,1975,8,female,969,162,62,429,222,74,144,355,78
1846286,44,6,1969,11,female,268,158,116,422,197,1,77,421,120
1792648,100,13,1913,12,female,1188,161,36,450,224,429,126,21,98
1419742,46,25,1967,1,female,1960,158,96,437,172,435,105,2,67
2166350,57,30,1956,3,female,1441,161,109,424,153,422,67,2,86
1489540,17,9,1996,8,male,395,162,96,435,12,435,11,0,1
1082720,21,1,1992,1,male,90,157,130,448,198,448,193,0,5
1371179,27,15,1986,12,female,709,158,78,422,318,422,264,0,54
1931687,20,9,1993,9,female,1273,160,117,459,213,265,127,194,86
1940613,57,7,1956,5,female,341,160,101,459,32,459,22,0,10
1261191,54,23,1959,6,male,273,161,151,470,110,470,34,0,76
1923733,30,21,1983,12,female,399,162,90,499,117,331,40,168,77
1264850,33,28,1980,7,female,658,162,29,509,549,278,390,231,159
1898507,79,19,1934,11,female,887,162,68,510,225,500,192,10,33
1721020,31,21,1982,2,female,1616,161,45,511,515,377,295,134,220
2159708,31,22,1982,6,male,402,157,127,497,721,440,362,57,359
1511339,42,20,1971,11,male,244,158,44,502,76,502,53,0,23
1131937,108,11,1905,9,female,1269,160,86,508,40,508,24,0,16
1751983,33,6,1980,12,female,340,158,132,512,235,512,232,0,3
1279858,19,29,1994,9,male,836,159,87,523,444,338,222,185,222
1888286,32,27,1981,10,female,1236,157,34,552,277,534,110,18,167
1297627,56,16,1957,1,male,523,160,34,523,244,503,164,20,80
1370302,13,19,2000,1,male,119,162,77,530,350,466,223,64,127
1058052,21,27,1992,10,male,367,160,108,528,22,528,15,0,7
2129539,59,9,1954,8,male,591,157,32,523,1,523,0,0,1
1769802,54,17,1959,8,female,1459,157,90,522,210,522,135,0,75
1930574,62,28,1951,4,female,614,158,128,587,61,0,11,587,50
1530773,20,29,1993,12,female,306,157,49,580,604,358,512,222,92
1578347,31,12,1982,6,male,1686,157,44,589,368,308,172,281,196
1891929,36,3,1977,5,male,471,158,144,601,540,216,349,385,191
1241852,36,2,1977,6,female,1908,161,61,607,1349,249,825,358,524
1228814,61,3,1952,5,female,478,158,76,568,308,568,140,0,168
1137437,108,9,1905,10,male,271,159,79,569,246,569,225,0,21
1179092,45,28,1968,1,female,77,161,112,564,626,564,511,0,115
1283553,24,11,1989,4,female,650,162,90,634,379,123,128,511,251
2094904,20,30,1993,11,female,169,159,91,637,799,312,568,325,231
1443828,24,4,1989,4,male,285,158,82,649,215,640,192,9,23
1657003,52,22,1961,11,female,413,157,118,622,267,618,90,4,177
1315338,47,23,1966,10,female,1716,160,67,647,974,642,501,5,473
1550298,22,29,1991,1,male,342,161,95,653,40,653,28,0,12
1110013,21,9,1992,9,male,25,159,120,658,371,658,227,0,144
2158610,58,19,1955,8,female,1503,161,47,629,479,629,362,0,117
1260670,61,1,1952,11,female,1155,162,98,686,323,0,127,686,196
1629559,62,31,1951,5,female,763,158,54,701,179,41,51,660,128
1900310,50,4,1963,12,female,57,159,109,678,421,118,137,560,284
1277906,56,11,1957,7,female,1856,160,65,680,519,0,273,680,246
1271533,34,21,1979,5,female,375,160,96,678,343,368,143,310,200
1012596,77,26,1936,6,female,2169,158,75,667,241,420,84,247,157
2106086,21,30,1992,4,female,218,161,119,721,711,393,549,328,162
1975017,66,12,1947,10,female,1745,161,88,679,1008,474,807,205,201
1595791,15,12,1998,5,male,479,162,83,667,12,666,9,1,3
1654032,13,15,2000,5,male,121,160,72,689,23,689,14,0,9
1402839,51,1,1962,12,female,169,157,123,725,104,725,74,0,30
1543124,29,20,1984,3,male,374,158,77,690,337,690,285,0,52
1717398,19,9,1994,1,female,161,160,125,690,578,690,406,0,172
1866867,27,16,1986,10,male,431,157,54,754,566,50,105,704,461
1783902,55,29,1958,6,female,190,157,135,786,665,162,117,624,548
1176315,40,28,1973,5,male,534,159,113,867,423,58,44,809,379
1124737,17,18,1996,12,female,174,160,94,810,835,292,344,518,491
2026179,34,5,1979,7,male,225,162,132,835,340,835,222,0,118
1379478,64,22,1949,1,female,1585,162,62,871,363,871,315,0,48
1052376,32,19,1981,11,female,609,162,54,830,1177,830,649,0,528
1493570,27,18,1986,11,male,493,161,110,940,2578,481,1082,459,1496
2182838,16,7,1997,11,male,85,158,134,911,24,911,10,0,14
1930008,37,20,1976,8,female,210,159,143,919,119,919,76,0,43
1931753,63,30,1950,5,female,308,160,140,948,371,948,182,0,189
2036191,16,7,1997,5,male,917,160,126,998,422,440,266,558,156
1305318,108,16,1905,4,female,142,160,128,996,400,386,71,610,329
1148266,58,31,1955,7,female,1747,162,86,1049,279,1049,134,0,145
1470896,17,12,1996,9,male,569,159,81,1256,59,0,31,1256,28
2097702,18,9,1995,3,male,195,162,144,1499,696,1207,322,292,374
1151184,21,24,1992,1,female,33,160,142,1324,740,1025,473,299,267
1569447,52,10,1961,3,female,1087,161,98,1387,612,1380,324,7,288
1919484,58,7,1955,3,female,1719,162,121,1349,506,1338,133,11,373
2047607,19,16,1994,12,female,269,158,48,1524,195,1524,179,0,16
1901997,69,27,1944,3,female,703,157,96,1574,333,0,112,1574,221
1955115,73,3,1940,7,male,542,160,95,1776,337,100,133,1676,204
2026631,78,27,1935,11,female,1822,158,64,1632,518,0,72,1632,446
2050447,47,20,1966,12,female,914,158,51,1870,482,1092,238,778,244
1319684,23,21,1990,12,female,353,157,53,1636,2252,1049,1319,587,933
1232344,31,22,1982,5,female,1888,158,94,1756,1524,1443,571,313,953
2020537,23,11,1990,2,female,89,159,95,1809,815,1809,647,0,168
1219171,48,3,1965,5,female,964,161,121,1666,375,1666,326,0,49
1865814,27,30,1986,9,female,45,159,120,1627,1052,1627,783,0,269
2028341,16,22,1997,5,female,39,158,35,2328,1176,1678,628,650,548
1790295,17,12,1996,8,female,432,157,56,2041,518,1105,117,936,401
1212902,30,23,1983,10,female,1321,158,62,2129,1553,1467,1238,662,315
1245611,48,6,1965,2,female,1200,158,63,2314,1105,2173,870,141,235
1277994,48,6,1965,7,male,1592,160,110,1885,230,1885,94,0,136
1740171,58,21,1955,3,female,683,161,68,3142,1052,0,280,3142,772
1672528,65,5,1948,4,female,442,162,57,3567,813,0,173,3567,640
1277436,21,23,1992,10,female,47,162,94,3070,2812,95,1519,2975,1293
1833633,35,14,1978,10,female,60,161,127,3351,1796,1396,1201,1955,595
2086598,19,26,1994,7,female,277,162,98,3087,1418,2800,777,287,641
1315260,18,12,1995,6,male,182,157,70,4261,1096,2434,993,1827,103
1994669,65,14,1948,12,female,405,161,134,3928,913,3907,386,21,527
1826269,29,21,1984,11,male,299,160,131,3650,202,3650,165,0,37
1951908,20,10,1993,1,male,139,166,129,3,4,3,4,0,0
1432643,16,21,1997,3,female,163,168,42,3,31,3,25,0,6
1497178,17,28,1996,2,female,106,163,35,3,14,3,4,0,10
1349777,28,25,1985,4,male,637,168,109,3,6,3,1,0,5
1611475,31,1,1982,1,female,257,167,121,3,12,3,8,0,4
1264221,37,30,1976,4,female,726,165,53,3,27,3,7,0,20
2178636,42,27,1971,10,male,309,165,130,3,9,3,9,0,0
1017262,45,3,1968,12,male,2056,167,120,3,5,3,3,0,2
1562481,56,17,1957,8,male,350,167,115,3,40,3,40,0,0
1149415,57,12,1956,2,male,1544,163,47,3,56,3,26,0,30
1227086,65,11,1948,10,male,1299,166,93,3,12,3,8,0,4
2029816,108,22,1905,4,male,1743,165,100,4,11,0,2,4,9
1829306,26,6,1987,10,male,342,169,140,4,6,1,5,3,1
1639870,20,11,1993,6,male,202,167,144,4,0,4,0,0,0
2054478,21,3,1992,10,male,451,164,139,4,0,4,0,0,0
1403669,23,25,1990,6,male,633,166,129,4,0,4,0,0,0
1027828,26,3,1987,3,male,1137,164,92,4,0,4,0,0,0
1541402,19,20,1994,7,male,839,163,65,4,2,4,2,0,0
1845401,25,13,1988,12,male,294,168,118,4,1,4,1,0,0
1332128,27,18,1986,3,male,793,169,95,4,2,4,2,0,0
1504465,33,1,1980,9,male,281,169,159,4,1,4,0,0,1
1072962,19,12,1994,5,male,667,167,94,4,4,4,2,0,2
1979752,20,8,1993,8,female,244,163,133,4,3,4,3,0,0
2152402,21,7,1992,7,female,1157,167,75,4,3,4,3,0,0
1368736,22,7,1991,9,female,507,165,98,4,4,4,3,0,1
1435615,23,9,1990,8,male,371,164,133,4,4,4,4,0,0
1479341,28,6,1985,11,male,640,167,140,4,3,4,3,0,0
1951441,34,19,1979,1,female,543,163,134,4,4,4,3,0,1
1061243,101,29,1912,9,female,509,163,23,4,4,4,3,0,1
1556535,21,26,1992,11,female,475,164,139,4,24,4,18,0,6
1140186,22,7,1991,5,male,352,164,108,4,44,4,41,0,3
1679472,24,24,1989,4,male,361,166,139,4,6,4,2,0,4
1178725,57,3,1956,11,male,1791,163,88,4,27,4,25,0,2
2029888,64,17,1949,10,male,1286,166,69,4,23,4,21,0,2
2120305,25,15,1988,6,male,973,165,130,5,0,0,0,5,0
1226768,17,2,1996,3,female,354,165,109,5,3,0,0,5,3
1703869,90,21,1923,4,male,283,163,142,5,26,0,15,5,11
1949536,31,30,1982,7,male,1058,168,127,5,16,2,15,3,1
1504563,57,17,1956,7,male,1309,168,55,5,32,1,12,4,20
1812934,14,7,1999,11,female,296,167,79,5,1,4,1,1,0
1239318,15,5,1998,5,male,93,167,160,5,6,4,4,1,2
1317342,23,23,1990,3,male,461,168,102,5,11,4,5,1,6
2181794,19,7,1994,2,male,379,169,102,5,0,5,0,0,0
1535330,23,2,1990,2,male,735,167,121,5,0,5,0,0,0
2050804,25,1,1988,1,male,144,167,78,5,0,5,0,0,0
1383997,103,2,1910,8,male,921,164,107,5,0,5,0,0,0
1255909,16,24,1997,3,male,315,164,91,5,1,5,1,0,0
1055156,19,18,1994,6,female,579,164,95,5,1,5,1,0,0
1857259,23,23,1990,12,male,375,164,112,5,1,5,0,0,1
1408560,24,21,1989,12,female,1071,167,131,5,1,5,1,0,0
2145571,44,6,1969,3,male,1118,164,70,5,3,5,2,0,1
1277863,59,11,1954,3,female,1344,163,72,5,3,5,3,0,0
1596338,23,21,1990,11,male,647,163,106,5,5,5,4,0,1
2063224,23,12,1990,6,male,607,165,120,5,5,5,2,0,3
2027915,18,16,1995,8,male,248,166,129,5,10,5,4,0,6
2184362,20,28,1993,12,female,261,167,69,5,8,5,7,0,1
1539741,46,27,1967,10,male,575,163,63,5,53,5,44,0,9
1540410,55,17,1958,11,male,1468,169,43,5,9,5,3,0,6
1196519,43,25,1970,1,male,1235,163,38,6,0,0,0,6,0
1748491,18,1,1995,12,male,298,163,49,6,2,0,1,6,1
1824327,19,20,1994,11,male,781,168,114,6,1,0,0,6,1
1002840,25,12,1988,8,male,874,168,104,6,1,0,0,6,1
1103481,22,2,1991,10,male,223,169,107,6,29,0,3,6,26
1466105,32,1,1981,5,female,536,164,111,6,29,1,17,5,12
1007650,66,17,1947,2,male,2114,163,55,6,33,1,2,5,31
1332803,19,11,1994,2,male,242,165,131,6,2,3,2,3,0
1559592,54,21,1959,8,male,713,163,9,6,5,3,3,3,2
1355760,25,31,1988,10,male,987,168,100,6,0,6,0,0,0
1982223,38,4,1975,11,male,781,169,41,6,0,6,0,0,0
1812356,58,27,1955,6,male,54,163,88,6,0,6,0,0,0
1474946,15,17,1998,2,male,481,169,144,6,1,6,1,0,0
1206573,65,25,1948,4,male,1416,166,98,6,3,6,3,0,0
2050852,19,10,1994,10,male,238,165,79,6,7,6,7,0,0
1357545,21,5,1992,5,male,237,168,109,6,5,6,4,0,1
1482897,14,1,1999,11,male,145,163,69,6,51,6,37,0,14
2186300,18,14,1995,7,female,153,164,89,6,9,6,4,0,5
1018175,19,11,1994,10,male,151,165,74,6,52,6,43,0,9
2157744,21,20,1992,2,male,296,166,124,6,114,6,56,0,58
1653166,28,1,1985,1,male,578,164,127,6,21,6,13,0,8
1923454,31,22,1982,7,male,1459,169,114,6,54,6,32,0,22
2191014,43,2,1970,3,female,1134,168,38,6,11,6,7,0,4
2039758,67,16,1946,5,female,1646,168,36,6,78,6,48,0,30
1899508,113,29,1900,8,female,1781,168,63,6,11,6,3,0,8
1006722,31,19,1982,12,male,189,169,106,7,1,0,0,7,1
1917920,41,24,1972,7,male,87,164,163,7,0,0,0,7,0
1701731,26,30,1987,12,female,552,167,41,7,7,0,4,7,3
1262011,61,1,1952,1,male,591,163,96,7,7,0,7,7,0
2074295,103,3,1910,1,male,1136,165,64,7,50,0,33,7,17
1344997,32,15,1981,6,male,223,163,62,7,0,3,0,4,0
1009372,21,29,1992,5,male,1225,166,33,7,13,5,1,2,12
2130915,32,5,1981,8,male,762,163,100,7,33,4,20,3,13
1645947,50,21,1963,7,male,546,163,109,7,99,4,62,3,37
2083599,54,15,1959,11,male,1270,166,121,7,5,6,5,1,0
1698731,14,9,1999,2,male,626,167,54,7,1,7,1,0,0
1116600,36,17,1977,11,male,1271,169,21,7,1,7,0,0,1
1750597,20,13,1993,4,male,63,166,162,7,2,7,2,0,0
1284671,19,5,1994,4,male,110,165,149,7,10,7,5,0,5
1641531,14,11,1999,8,female,224,165,51,7,54,7,53,0,1
1579806,17,5,1996,8,male,927,165,99,7,13,7,11,0,2
1569976,18,22,1995,1,female,405,164,48,7,12,7,9,0,3
1530399,18,22,1995,6,male,175,167,151,7,27,7,23,0,4
1851417,103,24,1910,9,female,559,166,45,7,25,7,24,0,1
1678798,99,7,1914,10,male,1555,169,144,8,6,0,3,8,3
1508340,45,19,1968,7,male,474,163,90,8,77,0,30,8,47
1018607,17,30,1996,6,male,143,164,91,8,0,6,0,2,0
1252413,33,4,1980,12,male,615,168,122,8,2,6,0,2,2
1919986,21,5,1992,4,male,218,164,98,8,3,8,3,0,0
1921344,34,8,1979,1,male,1506,169,164,8,3,8,3,0,0
1864390,18,19,1995,10,female,348,167,133,8,10,8,9,0,1
1283278,20,26,1993,9,male,111,168,143,8,8,8,7,0,1
1879198,25,30,1988,9,male,1264,168,99,8,10,8,10,0,0
1307674,45,24,1968,8,female,462,166,61,8,6,8,1,0,5
1803432,16,12,1997,11,female,18,164,131,8,55,8,22,0,33
1911168,18,25,1995,9,male,71,167,110,8,33,8,16,0,17
1164236,22,16,1991,6,female,666,168,61,8,38,8,20,0,18
1162978,24,14,1989,1,male,631,167,55,8,20,8,17,0,3
1853306,24,17,1989,6,male,675,167,46,8,22,8,9,0,13
2026206,25,15,1988,10,male,702,168,45,8,50,8,50,0,0
2108673,27,12,1986,12,male,417,165,98,8,22,8,20,0,2
1025357,24,17,1989,12,female,443,164,114,9,5,0,4,9,1
1030549,33,12,1980,12,male,340,166,131,9,12,0,7,9,5
1527866,73,1,1940,11,female,873,163,121,9,8,0,5,9,3
2076681,20,25,1993,6,male,390,164,90,9,20,0,3,9,17
1518077,48,31,1965,3,female,929,163,63,9,34,0,28,9,6
1071178,25,9,1988,3,male,272,164,108,9,0,3,0,6,0
1172447,23,24,1990,3,male,1408,164,24,9,5,6,3,3,2
2015110,24,8,1989,7,female,341,169,51,9,138,6,110,3,28
1824817,98,27,1915,7,female,1943,163,83,9,16,3,4,6,12
1806287,21,28,1992,2,male,1391,165,135,9,34,8,24,1,10
1515031,23,10,1990,4,male,400,167,85,9,1,9,1,0,0
1713981,25,22,1988,12,male,199,168,148,9,0,9,0,0,0
1091146,25,6,1988,5,male,319,165,153,9,0,9,0,0,0
2161269,103,8,1910,1,male,1754,164,81,9,0,9,0,0,0
1782374,19,20,1994,10,male,257,163,65,9,11,9,11,0,0
1127708,53,2,1960,3,male,477,163,112,9,9,9,2,0,7
1380811,24,1,1989,1,male,271,169,96,9,37,9,26,0,11
1317045,103,1,1910,4,female,153,166,128,9,65,9,64,0,1
2132906,34,19,1979,1,male,708,164,107,10,6,0,2,10,4
1487758,38,8,1975,9,male,686,163,94,10,2,1,1,9,1
1248834,53,6,1960,5,female,525,163,97,10,53,0,13,10,40
1539811,31,19,1982,12,male,716,168,87,10,22,9,3,1,19
1031908,24,7,1989,6,male,279,163,131,10,3,10,0,0,3
1686262,113,12,1900,6,male,1700,167,121,10,3,10,3,0,0
2022310,18,16,1995,3,male,198,165,111,10,11,10,4,0,7
1681914,41,31,1972,10,male,312,163,35,10,7,10,1,0,6
1986580,18,17,1995,5,female,194,165,85,10,25,10,8,0,17
2083890,21,2,1992,8,male,650,169,109,10,20,10,15,0,5
1107702,59,20,1954,3,male,1431,168,101,10,58,10,20,0,38
1639615,61,6,1952,8,male,499,169,72,10,26,10,23,0,3
1089828,24,17,1989,9,male,296,169,145,11,0,0,0,11,0
1525968,18,1,1995,1,male,281,167,90,11,4,0,0,11,4
1321521,17,17,1996,2,female,304,165,111,11,0,11,0,0,0
1946992,22,5,1991,5,male,503,164,77,11,0,11,0,0,0
1448680,55,23,1958,4,male,443,164,121,11,1,11,1,0,0
1940230,16,3,1997,9,male,130,163,115,11,5,11,4,0,1
1923518,21,3,1992,9,male,1113,169,128,11,3,11,3,0,0
1033514,25,3,1988,3,male,50,169,155,11,8,11,8,0,0
2122798,25,19,1988,8,male,314,165,125,11,8,11,7,0,1
2175597,27,28,1986,5,male,712,166,125,11,7,11,6,0,1
1957523,15,5,1998,5,female,395,166,63,11,46,11,42,0,4
1271045,18,27,1995,1,female,249,165,92,11,36,11,36,0,0
2036272,20,9,1993,10,female,339,168,143,11,43,11,43,0,0
2004714,16,19,1997,5,male,806,169,61,12,0,1,0,11,0
1289409,62,1,1951,11,male,1230,164,130,12,3,0,3,12,0
1080515,23,16,1990,8,male,892,164,99,12,62,10,47,2,15
1820199,23,5,1990,12,male,155,163,118,12,0,12,0,0,0
1481336,28,23,1985,3,male,655,164,141,12,5,12,5,0,0
2048265,22,19,1991,3,male,629,169,130,12,17,12,15,0,2
1630455,22,20,1991,7,male,181,167,146,12,159,12,89,0,70
1198771,25,17,1988,2,male,172,165,121,12,56,12,42,0,14
1807586,25,25,1988,3,male,864,164,45,12,18,12,7,0,11
1447846,53,20,1960,12,female,1083,169,73,12,34,12,30,0,4
1962747,40,8,1973,5,male,565,164,121,13,5,2,3,11,2
1176069,64,25,1949,2,female,663,164,68,13,23,0,2,13,21
1511021,16,19,1997,12,female,677,169,77,13,31,10,11,3,20
1787708,31,16,1982,8,male,361,167,157,13,0,13,0,0,0
1489178,17,7,1996,6,male,399,165,115,13,12,13,12,0,0
1187067,20,7,1993,4,male,342,168,143,13,11,13,11,0,0
1902721,23,1,1990,11,male,678,164,130,13,12,13,11,0,1
1832431,32,17,1981,1,female,271,169,131,13,10,13,6,0,4
2105076,28,22,1985,12,male,520,168,129,13,26,13,23,0,3
1543041,34,6,1979,3,female,195,165,115,13,66,13,52,0,14
1726907,39,3,1974,4,female,387,169,133,13,169,13,112,0,57
1025001,113,12,1900,7,female,1250,167,50,13,28,13,9,0,19
1718907,14,29,1999,5,male,465,166,124,14,1,0,0,14,1
1722791,18,6,1995,5,female,529,165,77,14,53,12,18,2,35
1101044,19,5,1994,1,male,404,165,125,14,28,13,15,1,13
1858407,18,15,1995,12,male,185,163,105,14,0,14,0,0,0
1789239,46,19,1967,1,male,362,164,130,14,1,14,0,0,1
1442477,53,15,1960,6,male,2276,167,88,14,33,14,26,0,7
1268954,19,10,1994,10,female,678,168,65,15,17,0,0,15,17
1379331,19,8,1994,6,male,543,167,39,15,4,6,0,9,4
1518312,66,14,1947,5,female,1665,165,73,15,7,9,2,6,5
1335631,25,5,1988,1,female,266,167,110,15,38,4,5,11,33
1914806,20,14,1993,3,female,762,165,101,15,2,14,1,1,1
1899398,29,23,1984,8,male,329,169,96,15,0,14,0,1,0
1695167,21,5,1992,5,male,345,167,50,15,14,14,7,1,7
1341156,85,17,1928,12,male,1431,166,81,15,7,15,5,0,2
1821599,93,6,1920,7,male,1416,165,87,15,6,15,3,0,3
1262251,43,7,1970,10,male,725,165,93,15,106,15,59,0,47
1135315,48,2,1965,7,male,485,166,86,15,27,15,18,0,9
1388581,108,21,1905,10,male,1936,168,92,15,89,15,62,0,27
1597216,33,30,1980,7,male,308,164,129,16,0,2,0,14,0
1149676,21,21,1992,1,male,1206,166,103,16,23,0,10,16,13
1362217,65,14,1948,10,female,1188,167,125,16,28,0,9,16,19
1471049,79,3,1934,3,male,1562,167,58,16,70,0,25,16,45
1838648,18,31,1995,5,male,157,168,97,16,3,4,1,12,2
1695810,55,20,1958,9,female,297,165,149,16,52,6,36,10,16
1977266,26,13,1987,11,male,198,168,2,16,8,16,3,0,5
1868613,17,7,1996,12,male,85,165,54,16,11,16,10,0,1
1400816,40,25,1973,4,male,1752,163,68,16,18,16,18,0,0
2164863,25,14,1988,2,female,25,164,64,16,43,16,30,0,13
1330533,30,22,1983,10,male,541,169,58,16,91,16,77,0,14
1188401,20,29,1993,5,male,652,167,90,17,2,10,1,7,1
1340761,16,18,1997,5,female,280,169,55,17,50,6,7,11,43
1652033,26,12,1987,12,male,849,169,64,17,44,8,34,9,10
1770658,15,27,1998,6,male,282,163,81,17,6,15,4,2,2
1540981,16,31,1997,5,male,601,166,150,17,3,17,3,0,0
1073514,17,18,1996,10,male,215,169,46,17,6,17,5,0,1
1691666,93,27,1920,7,male,791,166,115,17,5,17,1,0,4
1267278,19,11,1994,9,male,432,166,54,17,14,17,14,0,0
1098233,25,5,1988,10,female,86,163,145,17,179,17,138,0,41
2126698,44,26,1969,3,female,444,165,77,18,13,13,6,5,7
2114444,25,17,1988,8,male,267,163,124,18,7,14,4,4,3
1814663,47,15,1966,5,female,1007,163,99,18,7,18,4,0,3
1270750,29,18,1984,8,male,280,167,59,18,24,18,13,0,11
1728242,14,4,1999,4,male,404,168,81,18,60,18,50,0,10
1399144,19,2,1994,3,female,484,163,21,18,41,18,38,0,3
1157409,33,14,1980,11,male,757,169,146,18,29,18,15,0,14
1078099,14,6,1999,8,male,349,165,121,19,1,0,0,19,1
1978880,103,21,1910,1,male,1545,168,48,19,36,5,9,14,27
1535558,23,14,1990,3,male,599,168,95,19,0,19,0,0,0
1443781,16,18,1997,12,female,173,163,65,19,37,19,14,0,23
1579893,32,28,1981,4,male,242,166,130,20,2,0,1,20,1
2126824,55,10,1958,10,female,1212,167,101,20,15,0,7,20,8
1891215,102,1,1911,4,male,1655,167,57,20,14,1,10,19,4
1937298,19,11,1994,2,male,397,168,128,20,37,4,3,16,34
1615637,34,27,1979,6,female,270,164,119,20,12,18,7,2,5
1597005,18,17,1995,2,female,293,163,117,20,3,20,3,0,0
1323091,108,1,1905,1,male,925,164,118,20,0,20,0,0,0
1176812,15,13,1998,7,male,224,167,129,20,11,20,9,0,2
1944846,16,7,1997,3,male,642,165,44,20,9,20,9,0,0
1341403,25,1,1988,1,male,280,163,121,20,6,20,6,0,0
1946472,14,21,1999,4,male,561,169,142,21,1,3,0,18,1
1026123,16,10,1997,2,female,16,166,152,21,105,14,19,7,86
2126741,18,19,1995,12,male,249,165,80,21,9,21,8,0,1
1324254,21,18,1992,6,male,160,169,148,21,8,21,8,0,0
2136580,38,5,1975,2,male,355,166,35,21,10,21,5,0,5
2064251,22,11,1991,6,female,355,166,86,21,28,21,21,0,7
1922092,30,29,1983,10,male,455,163,119,21,25,21,25,0,0
1249600,15,4,1998,11,female,167,167,75,22,2,0,1,22,1
2109517,29,27,1984,12,male,281,169,142,22,21,8,11,14,10
1157740,28,17,1985,2,female,172,169,136,22,210,20,139,2,71
1422900,17,27,1996,12,male,301,164,127,22,2,22,2,0,0
1725027,23,29,1990,1,female,272,164,40,22,1,22,1,0,0
1504834,18,19,1995,4,male,524,166,91,22,7,22,7,0,0
1830957,24,3,1989,12,male,286,165,118,22,11,22,10,0,1
1161705,20,8,1993,9,male,526,166,87,22,111,22,78,0,33
1266120,37,19,1976,8,female,407,167,130,22,53,22,38,0,15
1934744,56,13,1957,12,male,388,164,132,23,5,0,0,23,5
1785626,46,21,1967,10,male,824,164,95,23,59,18,23,5,36
1298089,14,20,1999,7,female,23,166,42,23,48,23,35,0,13
1482470,23,2,1990,7,male,445,163,148,23,66,23,55,0,11
1344308,16,18,1997,4,male,307,169,145,24,2,0,1,24,1
1794002,27,26,1986,7,female,190,167,95,24,26,1,10,23,16
1728537,20,3,1993,3,male,1441,167,41,24,42,4,8,20,34
2130234,13,10,2000,3,male,84,164,96,24,14,7,4,17,10
1483715,23,15,1990,12,male,59,168,129,24,24,22,24,2,0
1024095,48,30,1965,11,male,284,166,39,24,1,24,1,0,0
1103689,27,10,1986,12,male,416,169,90,25,4,1,0,24,4
1732991,41,5,1972,5,female,282,166,130,25,5,0,4,25,1
1936970,20,10,1993,3,female,33,169,67,25,21,25,14,0,7
1774900,27,24,1986,6,female,393,165,133,25,36,25,28,0,8
1743074,29,8,1984,2,male,323,165,109,25,99,25,87,0,12
2133823,64,19,1949,3,male,692,164,12,26,4,0,0,26,4
1863654,17,25,1996,8,male,280,166,124,26,0,26,0,0,0
2098926,30,1,1983,1,male,406,166,136,26,3,26,3,0,0
1886516,33,9,1980,3,male,514,165,146,26,3,26,3,0,0
2022148,24,10,1989,12,male,243,165,143,26,6,26,4,0,2
1448829,22,1,1991,1,male,477,168,105,26,18,26,18,0,0
2117230,68,17,1945,10,male,1653,166,89,26,23,26,23,0,0
1954341,108,1,1905,1,male,608,166,82,26,51,26,47,0,4
1625811,94,15,1919,9,male,335,166,149,27,3,0,0,27,3
1672362,13,24,2000,4,female,134,169,66,27,28,4,4,23,24
1832946,15,25,1998,4,male,218,165,117,27,15,16,10,11,5
1820216,19,28,1994,6,male,492,166,80,28,1,1,1,27,0
1978037,113,10,1900,8,female,1535,169,60,28,14,16,10,12,4
1829744,18,10,1995,11,female,142,168,66,28,155,24,49,4,106
1215528,16,12,1997,3,male,627,167,110,29,1,29,0,0,1
1551091,54,13,1959,2,male,655,169,54,29,5,29,4,0,1
1432534,19,14,1994,9,female,454,167,61,29,41,29,37,0,4
1471812,103,28,1910,7,NA,1974,168,75,29,40,29,25,0,15
1284321,18,4,1995,11,male,223,169,112,30,18,14,2,16,16
1703454,26,18,1987,12,female,201,163,74,31,9,25,7,6,2
2144139,16,17,1997,6,male,1127,164,113,30,23,27,8,3,15
1319373,19,19,1994,8,female,260,168,151,30,1,30,1,0,0
1853332,22,17,1991,12,male,572,164,150,30,0,30,0,0,0
2058973,18,1,1995,3,female,455,164,111,30,16,30,8,0,8
1188805,34,19,1979,4,male,152,168,138,30,39,30,32,0,7
1267653,52,27,1961,9,male,256,165,128,30,95,30,87,0,8
1227869,15,23,1998,10,male,573,169,111,32,5,5,0,27,5
1829097,23,18,1990,11,male,222,164,84,32,5,32,2,0,3
1139858,23,22,1990,2,male,300,168,140,32,25,32,21,0,4
1567791,78,28,1935,7,female,1986,168,85,33,40,0,6,33,34
1177336,15,1,1998,3,male,378,169,106,33,35,22,27,11,8
2088187,32,27,1981,12,male,211,169,157,33,95,33,67,0,28
1115183,68,3,1945,2,male,638,163,141,33,51,33,47,0,4
1928263,51,24,1962,6,male,319,165,56,34,14,0,7,34,7
1537122,19,1,1994,4,male,403,165,48,34,22,0,4,34,18
1987965,18,11,1995,8,male,299,167,24,34,65,2,26,32,39
1439969,51,14,1962,9,female,263,166,130,34,16,26,7,8,9
1869854,24,2,1989,9,female,445,167,101,34,8,34,5,0,3
1323441,103,1,1910,6,male,1361,163,81,34,10,34,10,0,0
1583210,41,23,1972,9,male,544,163,134,34,81,34,64,0,17
1183237,46,21,1967,6,male,2101,168,48,34,117,34,59,0,58
1746919,18,1,1995,1,male,443,168,96,35,3,5,3,30,0
1367263,64,26,1949,12,female,464,163,83,36,12,0,3,36,9
1165378,23,14,1990,5,female,600,167,92,35,44,22,14,13,30
1943457,34,29,1979,12,male,136,165,150,35,27,25,15,10,12
1939738,49,6,1964,5,male,1868,165,100,35,52,16,37,19,15
1846584,23,7,1990,11,female,163,166,133,35,12,31,11,4,1
1209742,21,5,1992,11,female,534,164,92,35,25,31,11,4,14
1446697,27,14,1986,4,female,371,165,155,35,236,32,160,3,76
1013306,19,3,1994,7,male,253,167,43,36,20,36,16,0,4
1506027,18,3,1995,11,male,1251,164,93,35,53,35,43,0,10
1258126,50,18,1963,5,male,470,168,125,37,34,0,16,37,18
2099624,19,30,1994,7,male,251,168,121,37,4,30,3,7,1
1864877,20,21,1993,7,female,745,168,73,37,79,36,55,1,24
1728931,63,1,1950,1,NA,2101,164,122,37,6,37,5,0,1
1184794,19,16,1994,1,female,330,163,141,37,15,37,10,0,5
1676062,19,5,1994,4,female,303,167,77,37,64,37,37,0,27
1501738,26,7,1987,9,male,355,169,102,37,59,37,45,0,14
1872484,44,3,1969,3,male,217,164,85,37,69,37,26,0,43
1994811,18,13,1995,9,female,411,168,24,38,128,3,50,35,78
2068445,27,22,1986,4,female,607,163,82,39,86,3,42,36,44
1066895,19,1,1994,1,female,426,165,138,38,13,14,0,24,13
1544072,18,15,1995,7,male,419,166,60,39,63,16,28,23,35
1972013,15,23,1998,3,male,318,164,85,39,1,39,1,0,0
1846199,19,19,1994,7,female,306,169,84,38,15,38,6,0,9
1876592,56,18,1957,3,male,714,163,100,39,49,39,30,0,19
1470613,21,1,1992,1,female,648,163,74,40,1,40,1,0,0
1066009,30,29,1983,4,male,434,167,150,40,2,40,1,0,1
1691791,19,1,1994,1,female,196,166,19,40,20,40,14,0,6
1727905,54,23,1959,4,male,798,163,77,42,18,4,7,38,11
1312078,19,19,1994,9,male,594,169,117,41,2,33,0,8,2
2141174,20,20,1993,9,female,44,166,152,41,176,37,100,4,76
1006129,100,6,1913,11,female,1591,164,92,41,99,40,57,1,42
1899384,24,4,1989,4,male,562,164,102,41,0,41,0,0,0
1101416,34,1,1979,1,male,506,166,140,42,36,42,30,0,6
1725125,102,1,1911,1,male,2198,169,90,44,50,0,22,44,28
1519139,47,24,1966,9,male,1258,167,73,44,57,23,32,21,25
1722822,108,6,1905,6,female,1651,163,24,44,148,20,57,24,91
1840384,26,30,1987,7,male,230,168,75,43,221,32,161,11,60
1929177,20,20,1993,5,female,309,168,142,44,22,44,22,0,0
1729809,19,6,1994,6,male,292,168,142,44,48,44,47,0,1
1907246,54,10,1959,8,male,539,167,109,44,43,44,32,0,11
1882550,17,20,1996,7,male,508,166,115,45,35,28,10,17,25
1323059,26,17,1987,12,female,294,169,39,45,49,44,44,1,5
1184772,20,9,1993,1,male,345,164,105,45,22,45,15,0,7
1870706,108,1,1905,11,male,180,167,125,45,37,45,33,0,4
1880375,49,20,1964,4,male,901,167,138,47,0,0,0,47,0
1493766,18,21,1995,9,male,433,166,117,47,2,45,2,2,0
2057855,25,7,1988,7,male,303,168,135,46,35,36,18,10,17
1108236,37,3,1976,10,female,1065,164,92,46,48,45,37,1,11
1588157,29,1,1984,8,female,289,167,59,46,113,42,43,4,70
2132852,51,16,1962,10,female,1629,164,31,46,30,46,29,0,1
2110539,100,27,1913,2,male,320,169,118,47,31,47,13,0,18
1809899,19,22,1994,11,male,648,164,110,46,89,46,69,0,20
1175744,27,13,1986,3,female,452,168,44,47,168,47,109,0,59
2090839,33,23,1980,2,male,326,164,132,49,113,0,75,49,38
1708109,103,31,1910,12,female,2313,169,92,48,141,7,91,41,50
1416142,46,27,1967,3,male,224,169,151,48,34,46,25,2,9
1118555,21,22,1992,1,male,253,164,131,48,39,48,34,0,5
1701972,59,12,1954,7,male,965,166,44,50,6,0,2,50,4
1662082,31,30,1982,5,female,291,166,138,50,22,35,14,15,8
1861580,17,19,1996,3,female,321,164,83,51,51,50,40,1,11
1762520,18,29,1995,8,male,165,169,92,50,69,45,63,5,6
1019467,22,1,1991,1,male,102,168,109,51,13,51,6,0,7
1227340,32,25,1981,10,male,268,169,55,50,170,50,137,0,33
1794479,107,11,1906,4,female,1778,166,64,50,95,50,65,0,30
1636162,24,20,1989,8,male,573,163,97,52,65,43,32,9,33
2007503,25,14,1988,10,male,81,164,154,53,57,53,50,0,7
1366989,33,23,1980,7,female,668,166,94,53,48,53,29,0,19
1881116,26,6,1987,10,female,525,163,66,53,87,53,80,0,7
1816247,35,10,1978,1,male,461,169,48,52,127,52,113,0,14
1532628,64,23,1949,11,male,881,164,144,55,62,0,50,55,12
1603279,16,14,1997,1,male,580,169,88,54,21,12,4,42,17
1152519,27,2,1986,12,female,483,165,91,54,24,38,8,16,16
1183884,15,24,1998,8,male,407,164,108,55,49,40,25,15,24
1415952,25,30,1988,8,female,104,165,104,54,83,46,48,8,35
2125591,73,24,1940,10,female,1864,163,97,54,150,51,112,3,38
1412977,31,25,1982,12,male,369,165,159,55,0,55,0,0,0
2165470,41,15,1972,10,female,206,168,116,55,66,55,49,0,17
1330915,108,12,1905,11,male,69,169,154,56,18,0,5,56,13
1507719,54,16,1959,12,female,1084,163,76,56,130,14,79,42,51
1261922,66,26,1947,8,female,1479,163,55,57,335,13,163,44,172
1277148,14,18,1999,2,male,338,163,111,58,6,57,5,1,1
1904279,16,11,1997,8,female,93,164,114,57,127,56,99,1,28
2174961,19,20,1994,5,female,240,169,96,58,19,58,11,0,8
2056633,21,28,1992,10,female,216,169,122,58,25,58,25,0,0
1763782,63,5,1950,5,male,180,163,140,59,12,0,10,59,2
1793915,32,13,1981,11,male,778,167,119,59,50,6,20,53,30
1411485,61,23,1952,10,male,1641,165,69,60,106,3,41,57,65
2072651,15,22,1998,8,female,384,166,90,59,139,15,20,44,119
1614360,24,11,1989,8,male,312,167,93,60,103,42,45,18,58
1406150,108,28,1905,2,female,2013,167,106,60,48,48,21,12,27
1714081,56,27,1957,3,male,357,163,116,60,7,60,5,0,2
2107888,22,10,1991,2,male,644,163,82,60,86,60,80,0,6
1387052,19,1,1994,1,male,342,165,85,62,29,1,15,61,14
2128306,59,23,1954,10,female,1330,163,39,61,27,36,13,25,14
2047003,17,16,1996,4,male,95,164,161,63,45,48,44,15,1
1845434,23,21,1990,7,male,372,165,120,61,1,61,0,0,1
1559722,32,22,1981,5,male,928,163,59,62,9,62,7,0,2
1057676,29,12,1984,6,male,106,169,144,62,34,62,25,0,9
1919469,19,28,1994,8,male,417,169,86,63,62,63,34,0,28
1736189,49,20,1964,9,female,1378,163,111,62,39,62,35,0,4
1510435,43,9,1970,2,female,1526,166,107,62,178,62,62,0,116
1524860,28,25,1985,11,female,375,169,151,64,16,46,5,18,11
1879639,28,16,1985,5,male,228,163,86,65,82,36,6,29,76
1291423,48,2,1965,1,female,1707,168,70,65,154,63,87,2,67
1568592,22,5,1991,6,female,83,164,52,64,9,64,9,0,0
2049875,16,11,1997,9,male,243,165,103,64,23,64,8,0,15
1999726,22,21,1991,3,male,232,169,103,64,32,64,23,0,9
1627368,103,10,1910,10,male,442,169,135,64,41,64,28,0,13
1258042,70,5,1943,2,female,799,169,106,68,14,0,6,68,8
1733024,103,9,1910,8,female,571,164,112,68,65,9,50,59,15
1926249,16,13,1997,12,male,202,168,62,66,241,4,118,62,123
1886940,34,1,1979,11,female,698,165,115,66,203,4,71,62,132
1392808,23,8,1990,8,female,464,165,106,67,85,56,48,11,37
1598718,31,6,1982,3,male,861,167,103,66,32,66,17,0,15
1923181,93,1,1920,7,male,1277,163,55,68,100,68,86,0,14
2082115,55,14,1958,2,female,738,165,102,71,8,0,3,71,5
1709824,86,26,1927,9,male,1838,167,79,69,166,0,71,69,95
1103471,108,31,1905,12,male,118,167,124,70,11,18,3,52,8
1780373,30,11,1983,4,female,967,163,95,70,69,40,20,30,49
1924268,18,7,1995,6,male,106,169,117,70,32,55,21,15,11
1984053,23,1,1990,1,male,406,169,135,71,42,57,24,14,18
1563988,30,18,1983,5,female,326,168,75,71,440,70,172,1,268
1698322,37,7,1976,8,male,104,168,168,70,2,70,2,0,0
2016544,21,2,1992,7,female,295,167,151,70,26,70,21,0,5
1998573,41,4,1972,1,male,414,163,92,70,29,70,18,0,11
1168120,48,30,1965,11,female,80,168,146,71,16,71,11,0,5
1399461,30,21,1983,1,male,521,166,102,71,86,71,55,0,31
1171571,51,29,1962,8,female,1497,167,88,72,21,6,15,66,6
2085845,14,3,1999,10,female,94,164,87,73,59,56,32,17,27
1422405,18,9,1995,11,female,88,169,154,74,77,72,56,2,21
1919893,22,18,1991,9,male,1187,163,81,73,119,61,73,12,46
1886252,27,2,1986,9,female,919,168,84,73,114,65,95,8,19
1479908,17,9,1996,1,male,531,169,107,74,21,74,15,0,6
1141511,55,23,1958,10,female,615,164,108,74,83,74,38,0,45
1114947,23,1,1990,9,female,668,166,80,74,125,74,65,0,60
1528801,18,11,1995,1,male,419,166,97,76,85,13,32,63,53
1927003,23,4,1990,4,male,947,166,89,75,0,68,0,7,0
2063954,33,27,1980,3,female,285,166,126,76,82,75,36,1,46
1097606,34,20,1979,3,male,594,163,84,77,44,77,37,0,7
1859263,101,26,1912,3,male,876,164,116,77,32,77,30,0,2
1967115,21,28,1992,11,male,170,165,130,75,106,75,80,0,26
1837210,25,30,1988,4,male,245,169,116,77,67,77,47,0,20
1004637,39,14,1974,2,male,131,163,151,79,1,0,0,79,1
1210992,89,30,1924,12,male,1018,165,67,79,58,0,17,79,41
1792186,15,1,1998,7,male,180,168,149,79,6,28,2,51,4
1817961,15,3,1998,2,female,672,164,68,80,108,76,94,4,14
1979573,43,27,1970,7,male,752,163,110,79,10,79,5,0,5
1600899,48,1,1965,7,male,728,167,96,80,14,80,11,0,3
1204559,35,2,1978,1,female,824,168,91,78,327,78,305,0,22
1150432,51,21,1962,7,male,571,164,71,82,72,44,25,38,47
1190181,53,24,1960,8,female,734,167,132,81,53,43,43,38,10
1613975,23,2,1990,10,male,624,166,72,82,0,67,0,15,0
1957487,72,24,1941,4,female,1661,163,105,83,7,81,5,2,2
1529082,20,4,1993,11,male,230,169,115,84,54,78,38,6,16
1777136,40,15,1973,10,female,86,164,142,83,55,82,27,1,28
1069512,17,5,1996,3,male,531,167,66,86,52,0,23,86,29
1842779,14,20,1999,8,male,375,168,100,85,130,37,19,48,111
1546172,35,1,1978,2,female,189,164,117,85,73,66,39,19,34
1110376,22,31,1991,10,male,184,164,69,87,51,87,38,0,13
1359642,51,5,1962,8,male,704,163,154,91,54,60,49,31,5
1638829,15,11,1998,10,male,291,163,99,90,11,90,9,0,2
1644999,55,23,1958,12,female,1021,167,118,88,53,88,40,0,13
1568914,107,24,1906,12,female,795,169,30,91,75,91,40,0,35
1655025,44,5,1969,2,male,602,168,116,95,139,94,107,1,32
1367798,60,2,1953,4,female,1013,165,101,94,59,93,12,1,47
1872717,103,29,1910,12,male,612,169,110,94,30,94,19,0,11
1774794,23,20,1990,5,female,495,165,81,92,71,92,36,0,35
1096601,15,1,1998,10,female,219,164,105,97,43,3,22,94,21
2079383,54,14,1959,1,female,598,164,73,97,36,6,22,91,14
1087884,89,12,1924,6,female,782,165,66,96,25,12,16,84,9
1387710,26,20,1987,3,female,77,169,116,98,78,12,65,86,13
1034113,35,10,1978,3,female,218,164,156,96,8,31,3,65,5
1938728,22,12,1991,9,male,449,164,91,97,19,97,17,0,2
1812450,108,14,1905,5,female,52,169,95,102,43,2,16,100,27
1423048,23,14,1990,1,female,372,167,96,101,401,90,258,11,143
1997361,41,1,1972,7,female,408,164,138,103,161,93,96,10,65
1656435,13,24,2000,1,female,280,167,131,101,34,101,34,0,0
1671721,24,1,1989,4,female,400,168,86,102,90,102,73,0,17
1020994,32,5,1981,7,female,1917,163,87,104,105,104,90,0,15
1071386,32,20,1981,10,male,198,164,138,103,135,103,87,0,48
1651223,66,27,1947,10,female,1660,166,82,107,38,3,25,104,13
1376429,18,9,1995,12,male,314,168,141,105,35,64,24,41,11
1663275,20,6,1993,11,female,625,166,83,105,8,103,5,2,3
1381057,20,19,1993,3,female,673,165,46,109,3,109,2,0,1
1822047,51,16,1962,4,female,127,168,42,105,17,105,14,0,3
1998824,57,1,1956,12,female,235,169,84,108,61,108,39,0,22
1824009,23,20,1990,11,male,189,169,104,112,132,4,17,108,115
1063544,48,13,1965,4,female,180,168,91,110,189,2,36,108,153
1017018,108,22,1905,6,female,1268,167,61,113,60,67,32,46,28
1857521,69,14,1944,10,female,385,167,97,111,108,90,46,21,62
1001577,59,8,1954,5,female,464,165,52,112,383,101,261,11,122
1127275,28,11,1985,6,male,144,168,138,110,11,110,5,0,6
1264243,18,16,1995,7,female,450,165,20,111,19,111,15,0,4
1278888,54,5,1959,1,female,2041,167,112,111,312,111,178,0,134
1142830,68,29,1945,8,female,129,168,128,110,547,110,78,0,469
1690345,46,17,1967,12,female,1309,165,86,115,66,3,18,112,48
1566528,108,28,1905,3,female,1970,169,98,114,68,0,30,114,38
2160991,28,27,1985,5,male,578,167,121,119,22,30,11,89,11
1347556,57,23,1956,7,female,1643,168,47,117,538,44,302,73,236
1284306,18,9,1995,8,female,243,164,60,116,15,116,10,0,5
1048088,19,3,1994,7,female,216,164,138,115,29,115,29,0,0
1647757,25,19,1988,5,male,346,169,111,124,6,65,1,59,5
1944495,74,8,1939,8,male,646,169,113,121,32,26,2,95,30
1990896,77,21,1936,9,female,1818,165,61,120,22,58,6,62,16
1937169,48,30,1965,1,female,1139,168,70,123,120,71,96,52,24
1375629,26,25,1987,11,male,1612,167,91,123,62,103,33,20,29
1654475,57,13,1956,10,female,1012,163,91,122,29,100,20,22,9
1543227,20,30,1993,5,female,256,164,62,123,39,123,35,0,4
1392517,77,19,1936,6,female,1088,167,47,124,48,124,39,0,9
1636923,38,27,1975,11,female,427,167,62,129,33,3,15,126,18
2075147,46,26,1967,12,female,312,165,122,125,52,8,8,117,44
1034861,56,23,1957,1,female,822,165,111,128,94,0,39,128,55
1831557,19,21,1994,7,female,71,167,123,129,200,42,56,87,144
1174493,29,27,1984,3,female,508,165,109,128,128,128,116,0,12
2170084,43,21,1970,7,female,519,165,132,135,23,0,3,135,20
1733075,24,20,1989,7,male,86,169,149,131,75,129,64,2,11
1124575,58,12,1955,3,female,336,168,147,135,95,135,72,0,23
1392009,21,4,1992,12,male,262,169,87,136,301,136,245,0,56
1182359,19,18,1994,10,female,338,168,111,141,12,0,4,141,8
1439408,56,6,1957,8,female,1254,168,109,137,18,3,6,134,12
2046642,21,10,1992,3,female,665,168,41,138,130,66,72,72,58
1642506,14,30,1999,8,female,116,167,98,139,12,137,2,2,10
1020858,20,5,1993,6,male,480,166,137,142,6,125,5,17,1
1261178,20,30,1993,10,female,720,166,71,140,121,138,75,2,46
1854989,66,2,1947,4,female,1986,164,121,142,90,129,47,13,43
1683324,22,16,1991,9,female,71,166,108,143,244,114,214,29,30
1948437,18,7,1995,6,female,193,167,124,141,142,140,123,1,19
1989914,57,14,1956,4,female,1153,167,46,137,224,136,180,1,44
1750440,94,29,1919,7,male,1585,163,112,137,143,137,109,0,34
1523912,20,12,1993,8,female,316,168,101,145,32,63,26,82,6
1042899,52,27,1961,10,female,1763,167,92,144,253,79,161,65,92
1809211,52,9,1961,10,female,750,169,38,150,415,60,183,90,232
1022940,14,20,1999,10,male,361,165,118,147,82,139,69,8,13
1297107,42,19,1971,12,male,200,165,143,148,122,146,88,2,34
1046065,22,29,1991,5,female,623,167,112,145,238,134,196,11,42
1242886,41,24,1972,10,female,1433,169,120,149,274,126,142,23,132
1454112,23,10,1990,4,male,733,166,78,148,153,148,76,0,77
1944251,42,4,1971,7,male,334,166,85,146,146,146,78,0,68
1731968,20,14,1993,8,female,600,164,119,144,262,144,223,0,39
1230830,65,1,1948,6,male,745,168,87,153,146,57,81,96,65
1743005,58,1,1955,1,male,557,165,113,156,412,112,305,44,107
1725939,70,18,1943,10,female,310,163,103,155,266,78,151,77,115
1330262,57,14,1956,10,female,869,169,103,152,97,142,73,10,24
1015460,17,27,1996,3,male,458,165,18,155,104,154,94,1,10
1570460,19,16,1994,3,female,303,164,40,154,145,154,41,0,104
2062745,17,8,1996,6,female,407,165,43,161,2,20,2,141,0
1742025,45,28,1968,9,male,262,168,110,161,37,3,17,158,20
1489617,23,11,1990,12,male,777,164,56,161,151,150,85,11,66
2181915,14,14,1999,10,male,383,165,155,162,4,162,4,0,0
1436523,37,25,1976,6,male,559,167,52,162,18,162,8,0,10
2127960,33,10,1980,10,male,421,169,103,162,83,162,47,0,36
1371567,22,15,1991,6,male,423,167,142,167,96,73,42,94,54
1139964,48,12,1965,12,female,950,165,134,171,185,44,82,127,103
1524414,18,10,1995,6,male,163,169,107,169,352,94,142,75,210
1683516,50,25,1963,9,female,314,167,153,165,3,165,3,0,0
1486593,24,30,1989,5,female,215,169,105,167,56,167,20,0,36
2128862,58,14,1955,10,female,1450,169,76,165,61,165,44,0,17
1403634,22,3,1991,3,male,341,165,67,166,147,166,39,0,108
1265727,55,24,1958,1,female,262,165,80,171,118,171,75,0,43
1417538,51,14,1962,9,female,430,168,71,181,181,0,23,181,158
2115071,33,13,1980,7,female,664,163,84,174,257,82,155,92,102
1575689,60,21,1953,5,female,1730,164,99,180,137,58,38,122,99
1717946,43,16,1970,7,female,724,163,59,176,80,172,71,4,9
1337793,34,5,1979,7,female,257,166,19,174,461,146,322,28,139
1771996,28,11,1985,1,male,605,164,65,178,11,178,10,0,1
1948194,92,9,1921,3,female,1883,169,61,179,16,179,9,0,7
1021087,28,29,1985,9,female,1338,164,66,175,216,175,161,0,55
1192063,68,17,1945,7,female,2387,168,55,185,65,5,52,180,13
2147299,39,15,1974,11,female,644,169,136,184,140,95,104,89,36
1240318,46,23,1967,11,female,943,165,123,185,481,81,321,104,160
1642606,27,5,1986,3,female,934,168,97,190,16,178,10,12,6
1668566,35,6,1978,8,male,566,169,55,188,89,186,22,2,67
1584607,16,15,1997,8,male,367,169,150,186,26,186,26,0,0
1349588,60,3,1953,10,male,2309,168,113,188,38,188,16,0,22
1661825,36,3,1977,6,female,168,163,146,189,178,189,151,0,27
1239990,45,24,1968,12,female,761,169,101,184,183,184,129,0,54
1729866,22,8,1991,4,female,413,168,83,188,294,188,205,0,89
1343049,18,25,1995,9,female,219,163,90,194,191,124,94,70,97
1318134,23,5,1990,7,female,354,163,107,191,3,186,3,5,0
1261722,62,7,1951,7,female,681,164,113,198,51,198,41,0,10
1831273,20,23,1993,5,male,209,169,107,205,2,0,1,205,1
2013245,64,17,1949,7,female,1559,166,83,205,235,77,112,128,123
1429876,29,5,1984,9,female,453,166,59,202,58,186,19,16,39
1677323,43,6,1970,7,female,748,168,69,203,310,203,277,0,33
1299692,35,24,1978,5,male,641,169,92,214,197,186,62,28,135
1392864,51,9,1962,1,female,355,166,131,220,652,220,517,0,135
1207228,56,20,1957,6,male,139,168,127,230,26,4,15,226,11
1941424,113,19,1900,3,female,1953,163,56,230,105,0,16,230,89
1793164,17,25,1996,7,male,254,166,127,224,240,92,135,132,105
1698001,17,3,1996,4,male,426,169,133,228,113,220,65,8,48
2031186,34,9,1979,8,female,237,167,120,232,321,229,234,3,87
1426037,27,16,1986,4,female,382,169,140,229,384,212,340,17,44
1123611,57,23,1956,8,female,466,163,38,232,439,230,300,2,139
1382714,23,2,1990,7,female,471,163,101,231,8,231,7,0,1
1492308,44,13,1969,5,female,230,163,94,225,49,225,18,0,31
1387895,36,11,1977,2,female,596,163,54,225,316,225,181,0,135
2084404,60,7,1953,1,male,1685,168,91,244,99,40,59,204,40
1413917,26,23,1987,9,female,371,163,142,256,183,12,109,244,74
1799218,68,6,1945,6,male,690,164,98,256,446,0,133,256,313
2177523,40,4,1973,2,female,257,167,114,259,191,156,150,103,41
1788930,77,13,1936,7,female,1495,169,70,251,164,118,86,133,78
1632559,43,8,1970,5,female,628,164,89,250,55,243,15,7,40
1178774,23,29,1990,4,male,712,168,115,258,287,202,155,56,132
1798713,41,15,1972,4,female,1572,167,61,259,290,227,103,32,187
1044217,45,19,1968,8,male,191,164,110,259,130,259,101,0,29
1142036,56,27,1957,2,female,825,169,110,268,153,31,53,237,100
2111410,20,14,1993,12,female,530,163,102,262,194,6,59,256,135
1319505,30,22,1983,6,female,139,167,123,276,127,158,62,118,65
1306047,18,20,1995,1,female,339,165,95,271,326,71,238,200,88
1000786,75,29,1938,1,female,2306,164,100,272,191,258,153,14,38
1711218,21,8,1992,12,female,256,167,133,274,114,274,106,0,8
1956742,25,25,1988,12,male,279,163,100,267,74,267,36,0,38
1794481,28,10,1985,8,male,141,164,145,268,188,268,162,0,26
2185703,101,19,1912,9,male,737,163,102,279,59,0,32,279,27
2112227,16,13,1997,10,female,468,169,122,277,185,13,93,264,92
2135047,44,18,1969,5,female,341,163,141,292,139,167,40,125,99
1525431,32,2,1981,11,female,1598,167,61,291,352,207,244,84,108
1915124,49,2,1964,8,male,163,166,113,282,268,236,113,46,155
1535281,55,3,1958,12,male,538,169,132,279,35,279,3,0,32
1365517,31,2,1982,2,female,281,168,133,283,159,283,92,0,67
1393408,17,13,1996,2,female,143,163,83,279,322,279,274,0,48
1120500,31,12,1982,4,female,212,169,122,280,182,280,124,0,58
2127927,35,17,1978,9,female,475,167,139,298,246,24,80,274,166
1630956,26,19,1987,9,female,379,167,100,303,216,212,140,91,76
1171540,17,3,1996,6,female,202,169,113,299,98,293,66,6,32
1710382,18,27,1995,1,female,247,164,149,294,99,277,37,17,62
1669979,55,30,1958,10,male,686,166,51,295,407,280,326,15,81
1100775,49,27,1964,9,male,834,167,102,315,27,116,0,199,27
1758987,35,21,1978,3,female,1168,168,100,326,68,80,18,246,50
1803845,28,15,1985,10,female,576,164,113,316,417,161,261,155,156
2078146,65,25,1948,5,female,1319,166,30,316,61,259,32,57,29
1672185,60,9,1953,4,female,217,168,118,332,82,0,16,332,66
1072519,69,21,1944,9,female,1729,168,71,340,209,38,101,302,108
2159251,27,17,1986,2,female,242,169,129,330,1893,0,794,330,1099
1043720,17,19,1996,12,female,455,163,75,330,104,298,64,32,40
1089258,57,21,1956,10,female,1463,163,77,331,201,323,145,8,56
2191484,37,28,1976,3,male,481,168,119,344,520,251,209,93,311
1472616,47,1,1966,2,male,546,164,147,346,1,346,1,0,0
1685425,53,6,1960,9,female,653,169,148,329,67,329,46,0,21
1802780,32,15,1981,3,male,393,166,81,329,583,329,408,0,175
1463854,52,27,1961,6,female,1767,165,78,355,181,90,50,265,131
1052726,19,6,1994,4,male,291,163,99,358,301,110,157,248,144
1449560,23,6,1990,10,female,532,165,108,366,543,264,242,102,301
1060534,57,28,1956,8,female,1913,163,89,350,330,123,167,227,163
1772777,34,18,1979,3,female,333,163,69,358,131,358,112,0,19
1405061,38,14,1975,9,male,276,167,144,363,190,363,127,0,63
1157497,55,21,1958,6,female,747,163,83,379,332,0,92,379,240
1768618,25,27,1988,6,female,400,169,72,388,150,137,55,251,95
1261645,13,25,2000,1,male,165,164,146,380,424,365,356,15,68
1445460,56,3,1957,7,male,843,166,127,372,102,372,55,0,47
1704194,40,10,1973,6,female,312,169,101,371,233,371,70,0,163
1269881,20,2,1993,2,male,188,168,81,382,701,382,532,0,169
1141466,70,3,1943,6,female,1181,169,149,405,181,0,1,405,180
1360919,65,4,1948,7,female,1443,166,126,408,1290,0,467,408,823
1907548,21,23,1992,6,male,226,167,99,418,53,170,38,248,15
1030763,17,15,1996,3,female,310,167,135,405,69,358,55,47,14
1540590,24,6,1989,6,female,478,163,91,395,90,300,53,95,37
2016073,30,17,1983,1,female,1717,168,81,408,155,383,121,25,34
1239950,30,26,1983,10,female,572,166,87,416,188,404,80,12,108
1388579,62,12,1951,11,male,256,165,97,395,223,306,167,89,56
1801006,22,1,1991,1,female,140,166,99,417,400,416,365,1,35
1027537,103,20,1910,1,male,778,164,58,406,74,406,39,0,35
1319689,19,20,1994,5,male,211,165,84,408,369,408,318,0,51
1476140,19,11,1994,12,female,388,169,95,426,73,1,16,425,57
1741829,18,28,1995,9,male,427,166,48,423,95,35,37,388,58
1079389,64,20,1949,3,female,1159,164,42,451,324,0,113,451,211
1493964,20,4,1993,3,female,544,165,119,422,121,88,66,334,55
1571575,23,9,1990,1,female,274,167,124,433,474,284,155,149,319
2124855,45,10,1968,8,female,527,169,84,430,578,89,406,341,172
1801635,100,26,1913,9,male,1973,167,89,448,1329,170,412,278,917
1859144,19,30,1994,11,male,691,168,128,440,126,430,71,10,55
1561540,19,7,1994,10,female,699,169,111,427,437,327,251,100,186
1933290,26,27,1987,1,female,540,163,95,443,274,427,198,16,76
1034324,25,26,1988,8,female,349,169,69,449,290,447,173,2,117
1626184,19,10,1994,6,male,560,164,86,447,24,447,24,0,0
1289940,22,16,1991,7,female,179,166,111,429,149,429,62,0,87
1882208,20,11,1993,7,female,216,167,95,435,320,435,209,0,111
2158866,18,11,1995,7,female,234,166,60,463,581,56,379,407,202
1361134,31,22,1982,4,female,119,164,86,474,606,1,151,473,455
2166665,21,6,1992,3,male,420,169,125,464,50,446,16,18,34
1713932,21,31,1992,8,male,433,163,138,476,333,415,71,61,262
1707497,17,10,1996,11,male,36,169,142,461,162,461,76,0,86
1037335,18,26,1995,11,female,172,167,84,480,173,480,108,0,65
1084750,62,13,1951,5,female,1619,165,92,459,227,459,212,0,15
2093187,41,13,1972,10,male,359,166,95,460,313,460,227,0,86
1089092,49,3,1964,9,female,1723,164,83,452,594,452,352,0,242
1311114,35,1,1978,1,male,170,164,132,458,868,458,621,0,247
1788177,41,24,1972,9,female,1195,164,102,469,1392,469,1095,0,297
1571908,47,9,1966,4,female,1843,169,86,510,332,57,154,453,178
1250075,68,17,1945,8,female,1060,169,121,508,21,507,16,1,5
1674104,33,22,1980,8,male,215,165,39,496,66,496,43,0,23
1108918,15,14,1998,4,male,31,166,134,522,215,169,145,353,70
1026660,20,28,1993,9,female,337,163,125,525,153,143,96,382,57
1134717,23,12,1990,5,female,395,163,58,532,257,456,177,76,80
1616562,19,17,1994,7,female,454,166,39,543,332,543,164,0,168
1946673,53,30,1960,11,female,797,166,85,609,57,0,7,609,50
1433082,24,18,1989,4,female,52,169,113,609,2103,93,648,516,1455
1743720,27,1,1986,1,male,264,167,114,570,172,549,139,21,33
1687208,83,28,1930,10,female,1499,167,95,564,388,548,329,16,59
1379424,43,2,1970,3,female,1313,164,73,564,267,563,209,1,58
1441108,59,19,1954,10,female,1368,166,82,590,530,586,412,4,118
1152357,38,17,1975,7,female,259,169,97,601,121,601,95,0,26
1488601,44,15,1969,11,male,267,167,67,580,264,580,70,0,194
1395362,45,1,1968,1,male,302,169,44,597,2228,597,1066,0,1162
1416718,70,4,1943,12,female,1220,163,110,646,232,0,58,646,174
1831622,36,15,1977,10,female,182,164,145,649,1117,1,228,648,889
2019352,14,13,1999,3,male,25,166,152,615,49,602,41,13,8
1785727,43,2,1970,5,female,337,164,80,619,107,590,74,29,33
2184147,26,6,1987,4,female,666,163,80,709,197,13,105,696,92
2143164,23,20,1990,3,male,109,163,123,699,530,626,247,73,283
1293066,39,22,1974,12,male,194,167,132,667,591,588,368,79,223
2136407,24,7,1989,6,female,180,165,118,682,63,682,43,0,20
1977153,23,22,1990,7,female,74,169,146,705,170,705,93,0,77
1501616,26,26,1987,7,male,366,165,149,664,112,664,98,0,14
1058881,31,16,1982,6,female,383,166,128,698,399,698,393,0,6
1762791,54,3,1959,8,female,766,165,72,796,165,0,16,796,149
1146133,61,24,1952,6,female,1093,165,75,767,132,0,35,767,97
2117952,49,14,1964,9,female,778,166,48,796,462,505,313,291,149
1615981,45,9,1968,1,female,435,168,148,759,374,743,151,16,223
1539734,45,23,1968,9,male,619,167,67,784,389,783,276,1,113
1075758,38,5,1975,4,female,436,167,87,745,302,745,241,0,61
1650169,37,10,1976,6,female,178,163,131,763,477,763,283,0,194
1750521,91,1,1922,6,female,1262,163,50,850,8,0,2,850,6
1135570,55,1,1958,1,female,362,167,101,846,301,31,140,815,161
1833514,58,25,1955,9,female,878,164,136,838,282,0,137,838,145
1978441,27,1,1986,3,male,220,166,137,878,71,878,58,0,13
1129417,26,23,1987,6,female,123,163,101,883,268,624,119,259,149
1430316,21,10,1992,3,male,390,164,118,883,35,739,25,144,10
1336885,34,26,1979,10,male,15,167,162,902,230,891,175,11,55
1756528,32,6,1981,9,female,1023,169,102,917,922,813,192,104,730
1671662,49,9,1964,9,female,733,166,141,984,316,983,230,1,86
2182544,56,1,1957,12,female,1342,167,59,986,123,986,42,0,81
1629800,54,13,1959,2,female,296,165,66,1010,100,0,13,1010,87
1457893,16,26,1997,3,female,54,166,125,1076,386,203,301,873,85
1970374,27,8,1986,7,female,1612,168,125,1036,205,159,103,877,102
1304069,61,29,1952,7,female,164,164,87,1049,347,0,41,1049,306
1160651,66,3,1947,5,female,1225,167,107,1051,244,117,132,934,112
1994124,19,10,1994,9,female,143,163,107,1097,591,514,246,583,345
2148299,51,13,1962,9,female,1397,168,93,991,551,712,385,279,166
1789977,17,21,1996,4,male,26,163,147,1011,397,839,342,172,55
1566734,18,11,1995,3,male,568,169,123,1081,579,1004,162,77,417
1661778,53,21,1960,6,female,879,163,74,988,302,956,152,32,150
2079466,31,25,1982,9,female,468,164,95,1091,1260,1089,975,2,285
1825962,17,21,1996,5,female,688,167,51,1027,104,1027,19,0,85
1195206,23,14,1990,1,male,299,166,145,1098,3,1098,2,0,1
1521090,41,17,1972,8,female,552,168,86,990,238,990,213,0,25
1774247,32,9,1981,9,female,74,167,111,1000,639,1000,438,0,201
2069375,65,21,1948,9,female,1420,167,83,1284,160,0,37,1284,123
1439458,49,10,1964,12,female,1795,167,110,1142,985,818,719,324,266
1846122,55,31,1958,3,male,193,164,127,1273,727,1052,531,221,196
1824073,89,16,1924,1,female,1612,167,63,1186,370,1174,253,12,117
1460847,29,18,1984,9,female,388,163,96,1143,1085,1143,786,0,299
1067641,62,7,1951,8,female,216,165,119,1187,1676,1187,1473,0,203
1810173,64,25,1949,7,female,800,168,75,1304,538,0,170,1304,368
1091408,61,11,1952,12,female,935,167,65,1291,1249,4,211,1287,1038
1178345,52,19,1961,10,female,1304,167,108,1387,1927,516,884,871,1043
2118018,90,25,1923,3,female,1688,163,76,1296,826,1051,290,245,536
2190449,16,11,1997,9,female,249,168,92,1376,577,1368,224,8,353
2065747,20,18,1993,12,female,578,164,124,1328,1668,1328,357,0,1311
1887934,22,9,1991,12,female,780,164,113,1607,1210,69,106,1538,1104
2005148,18,23,1995,2,male,587,164,35,1661,14,1661,14,0,0
1069881,19,7,1994,3,female,429,167,111,1757,396,1757,297,0,99
1995195,40,20,1973,6,female,263,169,99,1866,854,1866,471,0,383
1546508,30,10,1983,1,female,384,168,104,1739,1282,1739,1198,0,84
1784479,51,20,1962,6,female,515,163,125,2084,87,0,14,2084,73
1767170,48,6,1965,8,female,1593,167,101,2184,828,2022,501,162,327
1212561,27,3,1986,6,female,26,167,94,3055,2120,30,1006,3025,1114
2120317,47,28,1966,1,female,774,168,68,3045,2324,397,690,2648,1634
1953121,28,5,1985,10,male,493,163,79,2593,558,2526,485,67,73
1775318,18,15,1995,3,male,479,167,97,3403,3511,3267,2314,136,1197
1470573,43,22,1970,4,female,216,169,51,3161,1626,3160,851,1,775
1353467,41,18,1972,8,female,488,168,71,3073,1148,3073,741,0,407
1265817,61,9,1952,6,male,259,166,90,3947,913,0,143,3947,770
2016364,16,10,1997,12,female,391,167,119,5961,5525,918,1618,5043,3907
1734624,39,2,1974,9,female,1641,166,83,4978,4709,4752,1741,226,2968
1911392,80,9,1933,11,female,1369,163,110,3996,168,3969,101,27,67
2190192,90,2,1923,3,female,735,168,125,3928,1852,3913,1654,15,198
1663659,27,2,1986,10,male,37,164,54,11396,8534,11396,6599,0,1935
1825490,30,16,1983,11,male,1222,175,70,3,9,3,9,0,0
1742736,29,17,1984,8,male,1053,171,136,3,9,3,5,0,4
1856687,34,10,1979,5,female,337,174,133,3,7,3,7,0,0
1148194,37,12,1976,12,male,778,174,82,3,14,3,6,0,8
1188896,41,19,1972,1,male,1060,172,48,3,13,3,5,0,8
1771856,60,10,1953,9,male,539,171,33,3,48,3,20,0,28
1259140,19,23,1994,1,male,496,175,130,4,0,0,0,4,0
1558532,27,4,1986,1,male,858,174,75,4,2,0,2,4,0
1802243,51,21,1962,11,male,564,171,95,4,2,0,1,4,1
1887466,23,1,1990,1,male,853,170,108,4,4,0,3,4,1
1977125,42,22,1971,12,male,503,172,87,4,5,0,1,4,4
1814540,14,16,1999,10,male,363,172,113,4,20,0,4,4,16
1087896,61,5,1952,7,male,1164,172,65,4,5,2,3,2,2
2040165,14,6,1999,8,male,234,172,156,4,0,4,0,0,0
2065691,16,17,1997,7,male,307,172,95,4,0,4,0,0,0
2121023,23,15,1990,6,male,288,171,128,4,0,4,0,0,0
1106601,108,20,1905,4,male,202,170,133,4,0,4,0,0,0
1662232,14,7,1999,6,male,112,175,144,4,2,4,2,0,0
1855965,57,11,1956,9,male,377,174,75,4,1,4,0,0,1
1212485,18,13,1995,4,male,920,173,66,4,5,4,3,0,2
1745221,21,20,1992,6,male,208,173,135,4,3,4,1,0,2
1232992,23,2,1990,3,male,429,170,120,4,4,4,2,0,2
1391999,16,23,1997,5,female,15,170,126,4,13,4,2,0,11
2084611,16,3,1997,10,male,456,171,37,4,11,4,6,0,5
2167103,21,14,1992,8,male,169,170,143,4,11,4,9,0,2
2120570,23,14,1990,9,male,790,173,107,4,54,4,20,0,34
1593833,31,13,1982,2,male,584,171,135,4,18,4,11,0,7
1708119,38,5,1975,5,male,428,173,63,4,12,4,6,0,6
1385555,16,8,1997,11,male,433,171,148,5,0,0,0,5,0
1480972,23,7,1990,4,male,230,174,123,5,2,0,2,5,0
1762645,18,20,1995,1,male,288,175,113,5,7,0,0,5,7
1114150,49,25,1964,4,female,331,172,128,5,4,1,0,4,4
1485713,18,1,1995,12,male,286,171,80,5,18,2,4,3,14
1214469,26,20,1987,6,male,591,172,136,5,33,1,19,4,14
1082531,21,6,1992,10,male,369,172,108,5,0,5,0,0,0
2097398,103,23,1910,3,male,772,172,34,5,1,5,1,0,0
1802278,21,1,1992,4,male,66,174,157,5,7,5,7,0,0
1013713,29,10,1984,10,female,291,175,135,5,5,5,5,0,0
1400787,16,19,1997,10,male,175,170,151,5,28,5,24,0,4
1069141,21,28,1992,7,male,468,170,150,5,25,5,12,0,13
1691741,22,5,1991,10,male,460,172,67,5,58,5,23,0,35
1280176,24,22,1989,5,female,124,174,116,5,10,5,6,0,4
1710881,25,17,1988,7,male,530,171,82,5,16,5,16,0,0
1443758,31,13,1982,10,male,280,172,155,5,12,5,12,0,0
1798049,52,4,1961,5,male,1415,175,67,5,37,5,15,0,22
1705546,53,24,1960,11,male,685,171,72,6,0,0,0,6,0
1064242,23,17,1990,7,male,435,171,97,6,7,0,6,6,1
1496622,52,12,1961,5,male,200,174,133,6,5,1,1,5,4
1417528,27,28,1986,1,female,660,174,107,6,20,0,9,6,11
2132027,29,1,1984,6,male,670,171,127,6,10,0,2,6,8
1026239,35,20,1978,12,male,930,173,101,6,0,5,0,1,0
1278982,32,14,1981,7,male,1043,174,132,6,59,5,44,1,15
1311992,66,26,1947,3,male,1532,173,98,6,74,5,43,1,31
1250831,21,4,1992,3,female,512,170,89,6,0,6,0,0,0
1944663,23,10,1990,11,male,668,170,86,6,0,6,0,0,0
1002554,22,21,1991,4,female,523,170,91,6,0,6,0,0,0
2146108,17,2,1996,10,female,160,174,89,6,1,6,0,0,1
1858248,23,2,1990,12,male,286,171,124,6,2,6,2,0,0
2134765,46,20,1967,3,male,378,175,130,6,1,6,0,0,1
1530355,26,12,1987,10,female,1306,170,77,6,7,6,6,0,1
1674929,26,24,1987,10,male,400,171,167,6,5,6,5,0,0
1553223,22,24,1991,11,male,401,171,92,6,16,6,10,0,6
2047827,25,25,1988,12,male,204,170,156,6,91,6,77,0,14
1799898,26,1,1987,5,male,470,170,123,6,27,6,21,0,6
1088445,27,18,1986,6,male,545,174,110,6,20,6,13,0,7
2085535,32,14,1981,3,male,438,170,103,6,83,6,79,0,4
1210550,34,21,1979,4,male,798,173,123,6,16,6,14,0,2
1432944,41,13,1972,3,female,338,173,40,6,11,6,10,0,1
1128858,48,6,1965,3,female,520,172,139,6,34,6,8,0,26
1503212,53,19,1960,9,male,1461,174,123,6,11,6,10,0,1
1748715,31,21,1982,11,male,925,175,104,7,1,0,0,7,1
2011461,17,18,1996,2,male,349,170,79,7,3,0,1,7,2
1170445,59,10,1954,10,male,516,174,150,7,159,0,92,7,67
1012763,69,25,1944,9,female,1345,171,12,7,210,5,145,2,65
1811049,18,28,1995,4,male,430,174,37,7,2,6,1,1,1
1436288,18,27,1995,7,male,344,173,72,7,0,7,0,0,0
2121706,22,3,1991,12,male,482,171,158,7,0,7,0,0,0
1125195,30,21,1983,4,male,786,172,123,7,1,7,1,0,0
1394647,20,18,1993,8,male,211,171,127,7,3,7,2,0,1
1536780,48,12,1965,11,female,1648,174,133,7,10,7,10,0,0
1251934,100,6,1913,3,male,843,172,84,7,6,7,6,0,0
1152806,21,23,1992,11,male,148,171,122,7,111,7,73,0,38
1640083,21,6,1992,2,female,498,175,135,7,34,7,22,0,12
1394942,28,3,1985,9,female,713,172,127,7,20,7,15,0,5
1026392,36,12,1977,1,male,772,170,91,7,74,7,29,0,45
1812933,40,25,1973,12,male,297,172,82,7,16,7,13,0,3
1057922,23,4,1990,8,female,476,175,105,8,2,0,0,8,2
1211935,28,22,1985,9,male,591,170,120,8,0,4,0,4,0
2059144,23,28,1990,11,female,824,175,118,8,4,4,2,4,2
1677574,55,4,1958,6,female,584,173,73,8,24,2,0,6,24
1737056,37,28,1976,7,male,772,175,49,8,3,6,2,2,1
1949601,16,1,1997,3,female,434,173,54,8,0,8,0,0,0
1516751,16,27,1997,10,male,783,171,82,8,0,8,0,0,0
2008991,17,19,1996,7,female,243,171,140,8,0,8,0,0,0
1562620,23,13,1990,3,male,269,172,154,8,1,8,1,0,0
1872934,32,2,1981,3,male,389,172,140,8,0,8,0,0,0
1872225,23,26,1990,10,male,406,171,75,8,5,8,5,0,0
1642245,33,17,1980,7,female,567,173,107,8,9,8,9,0,0
1887980,36,16,1977,5,male,603,174,123,8,9,8,5,0,4
1375552,62,16,1951,8,male,660,173,139,8,142,8,84,0,58
1982322,16,23,1997,7,male,392,173,127,9,3,0,1,9,2
1076189,89,29,1924,12,male,2530,174,47,9,4,0,0,9,4
1000733,19,30,1994,11,male,156,173,128,9,5,6,1,3,4
1841361,17,17,1996,9,male,905,173,50,9,0,9,0,0,0
1871764,24,20,1989,6,male,1006,172,98,9,0,9,0,0,0
1594266,31,4,1982,4,male,826,170,123,9,7,9,2,0,5
1015706,34,2,1979,1,male,430,173,97,9,9,9,6,0,3
2075828,30,2,1983,10,male,349,173,122,9,27,9,18,0,9
1797950,15,3,1998,12,female,660,175,94,10,0,0,0,10,0
1771324,42,14,1971,12,male,657,175,127,10,15,2,6,8,9
1677956,61,18,1952,9,female,788,172,129,10,51,6,35,4,16
1958443,107,13,1906,11,male,2185,170,73,10,18,4,8,6,10
1154204,25,1,1988,10,female,497,175,91,10,1,8,0,2,1
1822881,16,14,1997,6,male,723,172,123,10,7,8,5,2,2
1932833,18,14,1995,6,male,431,175,130,10,17,9,13,1,4
2139360,25,10,1988,6,male,619,170,107,10,0,10,0,0,0
1527476,29,4,1984,4,male,764,172,102,10,1,10,1,0,0
1485152,25,11,1988,11,male,754,171,155,10,14,10,3,0,11
2044420,49,3,1964,4,male,227,174,127,10,9,10,8,0,1
1286566,38,30,1975,5,male,160,173,164,10,30,10,21,0,9
1267470,93,1,1920,1,male,612,175,110,10,26,10,26,0,0
1694975,58,11,1955,2,female,335,174,107,11,10,0,3,11,7
1532152,42,10,1971,9,female,425,172,81,11,18,0,3,11,15
2049012,15,30,1998,10,male,462,173,129,11,0,7,0,4,0
1959979,18,18,1995,1,female,285,175,134,11,0,3,0,8,0
1371036,29,8,1984,8,male,288,174,131,11,0,11,0,0,0
1239217,108,31,1905,12,female,419,170,142,11,3,11,2,0,1
1478856,34,24,1979,11,male,535,170,82,11,87,11,37,0,50
1680883,24,14,1989,9,male,402,170,53,12,50,1,30,11,20
1838013,57,23,1956,3,male,168,171,117,12,57,5,45,7,12
1825240,105,14,1908,7,female,948,175,97,12,6,9,3,3,3
1853325,17,20,1996,6,male,303,171,124,12,1,12,0,0,1
1475692,21,10,1992,2,male,492,175,114,12,1,12,1,0,0
1580333,21,6,1992,5,female,708,175,76,12,6,12,6,0,0
1579439,21,1,1992,3,male,192,170,51,12,16,12,16,0,0
1497473,24,19,1989,12,male,724,173,90,12,9,12,5,0,4
1231633,23,11,1990,3,male,521,170,132,12,10,12,5,0,5
1642357,30,14,1983,2,male,243,175,147,12,157,12,95,0,62
2014569,57,23,1956,9,male,221,174,68,13,0,0,0,13,0
1568313,18,15,1995,5,male,388,174,104,13,5,1,1,12,4
1495862,18,14,1995,1,male,413,173,57,13,3,8,2,5,1
1147472,20,1,1993,1,female,154,172,159,13,4,3,4,10,0
1734192,65,30,1948,8,female,1243,171,84,13,113,5,76,8,37
1287905,34,1,1979,1,male,362,174,144,13,4,13,4,0,0
1976796,23,31,1990,7,male,177,172,127,13,8,13,5,0,3
1382340,25,13,1988,12,male,151,175,111,13,36,13,26,0,10
2149394,24,21,1989,6,female,264,170,42,13,28,13,22,0,6
1422499,28,25,1985,3,male,530,171,76,14,6,1,6,13,0
1086589,40,15,1973,9,male,277,173,162,14,34,1,17,13,17
1934851,16,12,1997,5,male,785,170,54,14,2,11,0,3,2
1165980,20,11,1993,8,male,376,174,110,14,0,14,0,0,0
1710803,26,25,1987,11,male,648,173,146,14,0,14,0,0,0
1638376,31,16,1982,2,male,496,171,80,14,5,14,3,0,2
1359185,47,5,1966,6,male,581,173,63,14,8,14,3,0,5
1806056,100,12,1913,12,NA,2420,171,63,14,7,14,3,0,4
1694180,21,3,1992,5,male,683,172,69,14,9,14,9,0,0
1981684,25,12,1988,2,male,701,170,146,14,13,14,11,0,2
1236232,14,2,1999,6,male,287,175,70,14,56,14,25,0,31
2077084,19,27,1994,7,male,296,174,152,15,0,1,0,14,0
1669984,22,1,1991,12,female,174,175,146,15,18,1,6,14,12
1136575,14,8,1999,7,male,306,174,102,15,9,14,4,1,5
1625098,19,5,1994,8,male,481,171,125,15,6,12,3,3,3
1306824,15,23,1998,11,male,467,171,84,15,0,15,0,0,0
2018187,14,1,1999,1,male,131,173,161,15,3,15,3,0,0
1786329,17,1,1996,8,male,115,171,125,15,12,15,11,0,1
1104346,23,1,1990,1,male,573,175,104,15,18,15,14,0,4
1097099,33,1,1980,5,male,313,171,135,15,10,15,10,0,0
1694527,108,15,1905,1,male,1358,175,87,15,11,15,9,0,2
1088579,15,1,1998,1,male,426,171,123,16,10,0,1,16,9
1073015,62,25,1951,2,female,1560,171,95,16,77,1,38,15,39
1299850,70,21,1943,5,male,1537,175,80,16,4,9,2,7,2
1800033,20,4,1993,6,female,381,173,94,16,5,16,2,0,3
1848744,22,7,1991,12,male,1314,174,119,17,1,0,0,17,1
1625087,16,1,1997,12,female,136,172,44,17,14,3,4,14,10
2014564,43,10,1970,9,female,1647,173,107,17,55,9,48,8,7
1651710,19,22,1994,4,female,82,171,152,17,29,17,27,0,2
1747929,21,22,1992,7,male,457,170,163,18,2,0,0,18,2
1789190,82,31,1931,8,female,845,171,85,18,0,0,0,18,0
1872652,25,13,1988,5,male,411,172,100,18,16,0,6,18,10
1944970,30,14,1983,12,male,285,174,129,18,24,0,7,18,17
1499342,56,11,1957,9,male,446,175,96,18,53,0,5,18,48
2120749,36,19,1977,11,male,1417,171,89,18,25,17,8,1,17
1475596,44,18,1969,10,female,362,170,120,18,16,18,5,0,11
1960929,18,24,1995,9,female,560,173,38,18,28,18,26,0,2
1172147,13,31,2000,7,male,86,172,117,19,3,3,2,16,1
1847640,108,20,1905,4,male,1380,173,113,19,2,0,1,19,1
1153471,78,2,1935,9,female,711,173,110,19,10,2,3,17,7
1825908,27,20,1986,12,female,358,171,67,19,36,2,24,17,12
1354115,16,25,1997,2,female,815,173,63,19,63,7,25,12,38
1500168,100,1,1913,1,male,1466,174,58,19,22,18,14,1,8
1320464,43,2,1970,1,female,484,170,134,19,76,18,41,1,35
1688003,30,19,1983,6,male,709,170,140,19,0,19,0,0,0
1990594,22,19,1991,1,male,372,175,131,19,6,19,6,0,0
1262974,22,4,1991,1,male,502,174,133,19,17,19,11,0,6
1081146,20,2,1993,3,male,220,175,97,20,5,14,5,6,0
1717846,83,29,1930,9,male,2484,170,94,20,12,11,4,9,8
1919200,41,18,1972,4,male,754,172,120,20,0,20,0,0,0
1468019,45,4,1968,3,male,889,173,86,20,1,20,0,0,1
1498265,17,10,1996,4,female,328,174,138,20,8,20,7,0,1
2063417,18,4,1995,7,female,514,175,135,20,38,20,37,0,1
1724461,49,2,1964,2,female,496,175,99,20,175,20,170,0,5
1374761,20,5,1993,1,male,385,175,86,21,1,4,0,17,1
1633791,30,18,1983,1,female,512,174,127,21,50,0,10,21,40
1811037,100,8,1913,1,male,961,170,50,21,285,4,93,17,192
1090787,25,3,1988,1,female,603,173,120,21,27,14,7,7,20
1054135,94,30,1919,5,male,547,171,124,21,36,10,30,11,6
1879601,17,8,1996,3,male,450,170,72,21,18,21,15,0,3
2086253,25,14,1988,8,male,520,171,83,21,18,21,11,0,7
1389610,16,9,1997,9,male,253,174,94,22,8,3,8,19,0
1576037,42,9,1971,6,male,470,171,83,22,6,0,0,22,6
1510320,88,1,1925,1,female,1822,172,99,22,5,5,3,17,2
1156815,19,25,1994,8,male,136,170,166,22,4,20,3,2,1
1840316,22,27,1991,6,female,409,170,106,22,23,18,14,4,9
1893779,23,2,1990,8,male,273,171,119,22,0,22,0,0,0
2054214,29,13,1984,12,male,582,173,161,22,2,22,0,0,2
1009701,26,15,1987,1,male,522,170,107,22,21,22,3,0,18
1680654,66,19,1947,9,female,1719,174,85,23,7,0,6,23,1
1895453,16,25,1997,12,female,131,173,107,23,92,2,20,21,72
1483289,21,14,1992,5,male,173,172,141,23,1,15,0,8,1
2102060,23,3,1990,12,male,126,173,148,23,20,16,2,7,18
1405493,22,11,1991,7,female,472,175,76,23,108,6,59,17,49
1380217,31,28,1982,9,male,456,175,150,23,0,23,0,0,0
1213018,107,2,1906,4,male,1037,175,111,23,0,23,0,0,0
1900961,16,26,1997,1,female,287,175,139,23,12,23,11,0,1
1274593,18,22,1995,3,male,537,175,75,23,27,23,24,0,3
1937642,51,19,1962,5,female,385,174,130,23,329,23,121,0,208
1089143,34,3,1979,6,male,1153,170,84,24,1,13,1,11,0
2131814,66,25,1947,2,female,1161,173,61,24,12,11,5,13,7
1375377,86,13,1927,9,female,2389,173,76,24,45,7,25,17,20
1073229,20,8,1993,8,female,434,175,73,24,25,23,19,1,6
1758443,99,4,1914,12,male,1047,171,85,24,4,24,4,0,0
1880058,22,11,1991,9,male,321,173,110,24,47,24,46,0,1
1134507,63,23,1950,7,male,102,171,124,25,5,25,5,0,0
1462661,88,11,1925,11,female,434,171,99,25,8,25,5,0,3
1764785,20,9,1993,6,male,402,175,88,25,26,25,16,0,10
1102724,23,18,1990,10,male,73,172,110,25,128,25,121,0,7
2182031,23,21,1990,5,female,354,171,80,26,1,0,1,26,0
1415049,19,1,1994,7,male,424,170,128,26,8,0,3,26,5
1945788,24,4,1989,12,male,799,174,163,26,26,4,15,22,11
1205427,25,4,1988,4,male,720,172,108,26,58,8,47,18,11
1738901,51,17,1962,9,female,1072,170,80,26,181,10,39,16,142
1638963,55,18,1958,3,female,79,174,121,26,62,26,54,0,8
1639264,53,15,1960,12,female,332,170,73,27,43,5,10,22,33
1845959,20,28,1993,1,male,755,174,90,27,2,8,0,19,2
2112586,61,17,1952,9,male,1019,174,89,27,1,27,1,0,0
1982522,26,14,1987,8,male,402,174,160,27,7,27,7,0,0
1875562,25,10,1988,10,male,635,174,114,27,17,27,17,0,0
1716953,29,31,1984,10,male,998,174,86,27,26,27,16,0,10
1520666,14,14,1999,9,male,348,172,107,28,1,0,0,28,1
1930095,57,17,1956,1,female,1622,171,61,28,35,3,27,25,8
1616579,108,28,1905,11,male,11,172,138,28,64,0,17,28,47
1057708,21,29,1992,9,male,391,173,82,28,16,27,11,1,5
2159756,22,12,1991,12,female,1600,175,94,28,270,28,170,0,100
1090157,43,9,1970,10,male,353,172,120,28,60,28,37,0,23
1048223,26,1,1987,1,male,456,170,153,29,116,28,102,1,14
1516436,63,4,1950,7,female,683,172,131,29,2,29,0,0,2
1731250,18,9,1995,8,female,22,172,30,29,34,29,23,0,11
1841806,31,25,1982,3,male,417,175,79,29,78,29,49,0,29
1616696,31,3,1982,1,female,699,173,134,30,19,0,2,30,17
1209405,57,10,1956,9,male,138,174,84,30,50,0,41,30,9
1166061,26,3,1987,7,male,1407,174,64,31,10,22,5,9,5
1039412,26,5,1987,12,male,131,170,151,30,168,16,86,14,82
1179234,23,1,1990,8,male,404,170,39,30,4,29,3,1,1
1623943,14,24,1999,6,female,41,174,14,30,18,29,11,1,7
2176069,27,16,1986,1,female,663,175,50,30,65,28,20,2,45
1458722,17,6,1996,9,male,673,173,125,31,5,31,5,0,0
1118110,15,8,1998,8,male,190,173,130,31,16,31,11,0,5
1172607,18,24,1995,9,male,1339,171,109,30,11,30,8,0,3
1654686,30,15,1983,9,male,615,175,42,30,13,30,10,0,3
1563316,29,20,1984,10,female,167,170,118,32,21,6,4,26,17
1619687,25,1,1988,5,male,758,170,95,32,42,10,32,22,10
1221823,38,26,1975,11,female,592,170,57,32,10,28,8,4,2
2176280,25,11,1988,8,male,651,174,84,32,89,29,71,3,18
1537560,19,30,1994,4,male,1067,174,45,32,1,32,1,0,0
1098988,29,12,1984,4,male,710,174,114,32,11,32,11,0,0
1654703,31,22,1982,10,male,283,175,119,32,12,32,10,0,2
1767300,30,23,1983,1,female,273,173,114,33,3,33,1,0,2
1016675,31,20,1982,4,male,185,171,118,33,113,33,79,0,34
1712594,15,26,1998,12,male,287,175,78,34,2,0,2,34,0
1462541,18,2,1995,3,male,169,175,156,34,68,34,35,0,33
1758691,40,1,1973,7,male,1228,175,100,34,55,34,35,0,20
1728637,22,1,1991,5,male,399,172,141,36,60,1,9,35,51
1678455,40,23,1973,12,male,402,174,146,35,2,15,0,20,2
1331526,56,28,1957,7,female,652,171,145,36,1,22,1,14,0
1576530,29,8,1984,8,male,413,173,73,35,53,10,21,25,32
2039281,17,22,1996,1,female,423,174,98,35,127,29,32,6,95
1836149,21,8,1992,2,male,879,171,132,35,12,35,8,0,4
1535501,20,13,1993,12,female,752,171,58,36,73,36,60,0,13
1668453,26,17,1987,1,male,602,173,113,37,23,33,13,4,10
1194572,26,3,1987,12,female,489,170,50,37,0,37,0,0,0
1106810,17,1,1996,5,female,152,170,139,37,20,37,15,0,5
2029009,23,5,1990,11,male,435,172,71,37,159,37,124,0,35
1325155,25,15,1988,12,female,35,173,94,37,85,37,85,0,0
1758890,43,18,1970,4,male,868,174,111,39,114,0,71,39,43
1245789,49,31,1964,3,male,264,170,84,39,44,8,24,31,20
1545588,38,17,1975,10,male,314,173,74,38,74,23,24,15,50
1068389,21,5,1992,5,female,312,171,118,38,1,38,0,0,1
2084324,25,17,1988,9,male,201,170,142,39,34,39,26,0,8
1429098,26,3,1987,1,female,334,175,69,39,556,39,546,0,10
1354476,27,12,1986,4,male,756,172,81,39,97,39,59,0,38
1309075,40,1,1973,8,female,1223,173,85,40,34,28,13,12,21
1331880,35,3,1978,8,male,457,175,142,40,15,32,11,8,4
1681799,22,28,1991,12,male,318,170,124,40,22,40,21,0,1
1156012,30,23,1983,8,male,344,171,59,40,52,40,37,0,15
1577272,27,26,1986,1,female,866,173,83,42,11,8,1,34,10
1206197,19,5,1994,8,male,57,170,137,42,54,3,7,39,47
1593660,62,2,1951,7,female,1493,170,119,41,38,6,22,35,16
1033725,55,14,1958,10,male,1427,171,40,41,89,0,21,41,68
2114910,25,19,1988,7,male,678,170,105,41,26,11,14,30,12
1376249,16,5,1997,11,male,546,171,147,42,9,41,9,1,0
1373071,33,13,1980,4,female,2247,172,118,41,248,39,123,2,125
2134857,21,30,1992,5,male,220,174,139,41,5,41,5,0,0
1059684,24,11,1989,6,male,376,170,105,42,0,42,0,0,0
1429459,18,5,1995,2,male,46,174,165,41,31,41,11,0,20
1961900,30,31,1983,8,female,556,173,61,42,53,42,21,0,32
1666255,33,16,1980,5,male,396,170,106,43,25,0,10,43,15
1720080,37,23,1976,9,female,257,172,114,44,65,4,28,40,37
1789259,66,6,1947,11,male,1335,175,124,43,23,21,12,22,11
1186431,18,28,1995,11,female,580,174,44,44,1,44,1,0,0
1904701,23,19,1990,11,male,160,175,134,44,2,44,0,0,2
1448460,36,4,1977,4,female,831,175,35,44,24,44,14,0,10
2156922,19,2,1994,4,male,662,170,68,43,151,43,92,0,59
2172022,45,5,1968,12,male,378,175,125,43,176,43,122,0,54
1457514,51,14,1962,2,male,570,174,46,44,76,44,68,0,8
2101829,64,29,1949,6,male,1381,170,73,45,15,0,8,45,7
1158357,74,3,1939,6,male,2257,172,84,45,48,26,28,19,20
1438525,25,20,1988,4,male,167,171,27,45,88,45,23,0,65
1376921,52,27,1961,10,male,902,175,143,47,23,0,4,47,19
1163346,18,16,1995,12,female,230,174,116,47,47,15,11,32,36
1784688,20,7,1993,3,female,298,175,31,46,29,12,16,34,13
1969314,23,19,1990,9,female,453,171,98,46,93,39,56,7,37
1109898,14,21,1999,1,male,536,171,118,46,5,46,3,0,2
1772730,31,27,1982,11,male,97,170,74,46,204,46,184,0,20
1552963,20,6,1993,10,male,62,173,161,48,0,2,0,46,0
1735772,108,9,1905,4,female,2007,172,56,48,69,19,34,29,35
1501203,19,28,1994,6,male,255,172,63,48,18,48,17,0,1
1698826,19,26,1994,7,female,315,174,45,49,38,49,30,0,8
1330044,77,26,1936,4,female,1064,173,143,50,21,46,13,4,8
2050265,30,15,1983,2,male,549,171,109,50,4,50,3,0,1
1462827,18,11,1995,9,female,182,175,40,51,89,51,81,0,8
1204483,49,15,1964,7,female,2154,172,114,51,85,51,62,0,23
1395047,53,23,1960,5,female,265,173,44,50,79,50,47,0,32
1931644,18,14,1995,11,female,130,171,149,52,15,0,9,52,6
1751712,18,22,1995,11,female,403,174,88,52,10,37,8,15,2
1403179,23,20,1990,1,male,136,170,156,53,37,38,35,15,2
1993832,19,2,1994,2,male,286,173,117,52,1,51,1,1,0
2063404,24,25,1989,4,male,542,171,97,52,42,50,24,2,18
1329387,54,28,1959,2,male,410,174,96,52,17,52,10,0,7
1699625,73,1,1940,3,female,891,173,73,55,45,0,27,55,18
1613085,28,12,1985,9,male,857,175,155,55,36,22,19,33,17
1132770,38,1,1975,1,female,2105,172,95,55,43,54,38,1,5
1523342,44,1,1969,2,male,1591,171,84,54,35,47,23,7,12
1471839,19,31,1994,1,female,464,172,61,54,27,54,24,0,3
1011092,108,27,1905,9,female,848,174,70,58,4,0,4,58,0
1749834,71,2,1942,9,female,1568,174,43,56,44,39,26,17,18
1771178,19,7,1994,5,male,209,175,80,56,395,35,171,21,224
1498293,24,13,1989,2,female,59,173,97,57,97,16,44,41,53
1981212,23,15,1990,5,female,1018,175,61,58,13,45,9,13,4
1763110,43,15,1970,8,male,568,173,139,57,12,48,8,9,4
1052350,29,1,1984,4,female,765,170,155,57,75,56,47,1,28
1692486,21,10,1992,1,male,226,170,121,56,103,52,100,4,3
2173274,28,16,1985,1,female,338,173,150,56,70,56,42,0,28
1334371,55,11,1958,1,female,555,174,49,58,46,58,15,0,31
1839135,18,1,1995,5,female,446,175,69,59,13,8,0,51,13
2030989,53,18,1960,10,female,222,174,133,59,43,0,6,59,37
1140908,60,7,1953,11,female,843,170,112,59,180,0,37,59,143
2187836,17,2,1996,11,female,572,172,130,59,126,26,42,33,84
1618218,43,20,1970,1,male,780,174,89,60,158,34,111,26,47
1244243,29,27,1984,12,female,393,173,155,59,79,45,67,14,12
1010458,21,23,1992,7,male,330,174,136,60,220,55,93,5,127
1477675,23,8,1990,5,male,253,174,158,60,48,60,45,0,3
1928659,43,31,1970,12,male,271,170,134,59,36,59,34,0,2
2108607,30,17,1983,12,male,414,175,61,61,10,1,4,60,6
1782697,19,11,1994,7,female,198,174,97,61,63,33,28,28,35
1616226,43,14,1970,8,male,818,173,154,63,76,13,24,50,52
1609501,18,10,1995,1,male,315,170,139,61,32,45,26,16,6
1490593,21,13,1992,12,female,494,173,93,61,144,51,36,10,108
1671345,46,1,1967,2,male,920,173,82,62,25,62,17,0,8
1157610,19,25,1994,5,male,17,171,133,62,125,62,92,0,33
1174636,30,25,1983,4,male,557,172,94,63,170,63,170,0,0
1206860,53,27,1960,7,female,607,173,139,65,3,0,1,65,2
1640383,14,30,1999,4,female,235,172,119,65,13,0,4,65,9
1491987,18,2,1995,7,male,576,171,135,65,46,5,13,60,33
1332638,33,2,1980,1,female,897,175,136,64,68,42,44,22,24
1510463,44,2,1969,12,male,578,173,73,64,49,17,30,47,19
2047562,44,3,1969,9,female,330,171,113,64,82,39,47,25,35
1344744,17,1,1996,8,male,195,173,132,64,70,47,28,17,42
2159661,18,19,1995,12,male,455,171,146,65,1,65,1,0,0
2140041,56,18,1957,3,female,1829,172,77,71,132,6,64,65,68
1062743,58,20,1955,5,female,223,172,134,70,161,3,107,67,54
1558509,16,10,1997,10,male,564,172,149,71,10,16,0,55,10
2130103,26,8,1987,1,male,622,174,121,69,83,18,43,51,40
1450306,26,11,1987,2,female,406,174,55,71,120,47,101,24,19
1296646,48,23,1965,3,female,1201,175,72,69,126,68,63,1,63
1549653,21,6,1992,6,male,259,174,114,71,55,71,38,0,17
2084777,81,18,1932,1,female,1364,171,107,74,8,3,7,71,1
1449783,14,31,1999,3,female,133,175,137,74,69,57,49,17,20
2026646,23,14,1990,9,male,283,170,136,72,15,72,6,0,9
1265760,47,20,1966,10,female,21,170,152,72,97,72,46,0,51
1332728,100,3,1913,1,female,1710,170,45,72,74,72,34,0,40
1302253,56,5,1957,6,female,688,174,67,73,1119,73,881,0,238
2075413,18,6,1995,2,male,39,172,163,77,4,77,4,0,0
1933481,29,4,1984,4,male,962,172,120,77,6,77,5,0,1
1790317,19,2,1994,5,male,150,175,146,76,35,76,34,0,1
1089013,14,9,1999,2,male,196,171,114,80,99,25,26,55,73
2017014,33,9,1980,8,female,622,171,131,80,71,41,31,39,40
1438309,14,30,1999,4,male,135,171,109,80,14,79,10,1,4
2049743,34,25,1979,4,male,316,175,148,79,166,79,82,0,84
1577646,108,8,1905,12,male,850,173,50,82,26,51,14,31,12
2167629,21,9,1992,6,male,327,174,80,83,8,80,5,3,3
2176578,43,14,1970,1,female,244,171,144,81,99,64,84,17,15
1938244,43,19,1970,7,male,88,174,131,81,68,73,68,8,0
1168563,24,8,1989,7,male,387,171,147,83,1,83,1,0,0
1396971,17,20,1996,7,male,97,170,160,82,18,82,18,0,0
2052577,67,4,1946,8,female,713,172,145,86,28,0,10,86,18
1402953,18,19,1995,12,female,945,175,101,85,107,67,69,18,38
2112487,21,15,1992,6,male,438,170,113,87,69,63,31,24,38
1255123,36,13,1977,5,male,303,171,115,85,49,85,36,0,13
2134295,20,21,1993,10,female,509,172,83,88,8,81,3,7,5
1370352,46,17,1967,9,female,434,173,117,88,6,80,3,8,3
1943966,17,9,1996,1,male,235,170,107,91,128,85,82,6,46
2003077,62,5,1951,2,female,505,171,53,88,106,86,76,2,30
1018797,25,20,1988,8,male,521,172,71,89,16,89,8,0,8
1999851,29,23,1984,11,male,1016,172,111,91,26,91,25,0,1
1652373,26,17,1987,1,male,524,175,129,89,94,89,45,0,49
1709670,61,7,1952,9,female,1652,171,42,89,70,89,51,0,19
1596416,105,23,1908,1,female,1939,175,32,93,4,0,2,93,2
1334100,19,12,1994,10,male,492,171,90,93,49,0,10,93,39
1066886,66,11,1947,12,male,474,171,75,95,86,0,24,95,62
1942099,67,19,1946,7,male,1789,174,69,93,93,28,42,65,51
1915533,47,10,1966,10,female,909,170,88,93,36,85,22,8,14
1809489,49,25,1964,6,female,1686,173,68,92,18,91,16,1,2
1395915,108,8,1905,8,female,475,175,93,94,59,93,44,1,15
1214618,19,1,1994,3,male,1814,171,89,93,58,93,29,0,29
1974617,20,22,1993,7,male,388,170,72,94,96,94,65,0,31
1015061,32,14,1981,6,male,1284,171,88,97,161,43,73,54,88
1324279,64,22,1949,4,male,218,172,81,101,6,88,4,13,2
2006631,20,29,1993,8,male,595,173,143,102,57,102,57,0,0
1377837,20,3,1993,8,male,810,172,91,100,86,100,74,0,12
1831729,23,31,1990,1,male,842,175,146,104,106,104,81,0,25
1371476,38,1,1975,7,female,1683,174,114,103,126,103,120,0,6
2064515,25,27,1988,5,female,840,172,90,103,224,103,177,0,47
1681706,28,8,1985,8,male,151,171,81,102,220,102,156,0,64
1945119,59,5,1954,7,female,378,173,125,106,10,0,3,106,7
2115120,32,13,1981,1,male,211,170,100,107,78,60,34,47,44
1383923,23,1,1990,1,male,121,171,153,108,65,85,51,23,14
1972180,21,26,1992,2,female,607,170,132,106,108,104,63,2,45
1293452,41,3,1972,4,male,574,173,147,109,8,108,8,1,0
1959173,14,18,1999,3,female,208,173,108,112,65,27,37,85,28
1173539,20,13,1993,9,female,170,170,75,111,108,105,52,6,56
1093377,52,29,1961,5,female,314,171,83,111,218,105,191,6,27
1465417,20,19,1993,5,female,431,172,116,113,2,113,2,0,0
1504799,53,9,1960,1,female,1753,175,102,112,2623,112,1935,0,688
1025887,41,4,1972,2,female,685,172,65,117,247,48,55,69,192
1659016,21,16,1992,10,female,341,172,44,116,51,87,37,29,14
2050402,108,10,1905,6,female,1685,174,69,114,53,93,23,21,30
1260258,19,11,1994,10,female,445,171,68,114,139,109,81,5,58
1760849,22,10,1991,7,male,769,170,88,119,18,119,18,0,0
1317775,25,1,1988,3,male,723,171,145,115,22,115,21,0,1
1684508,108,5,1905,5,male,380,172,82,114,56,114,40,0,16
1985667,20,10,1993,10,male,457,172,73,119,110,119,89,0,21
2076180,18,24,1995,2,female,66,174,24,118,194,118,151,0,43
1103135,18,10,1995,12,male,210,173,86,124,35,124,23,0,12
1144921,30,5,1983,12,female,550,171,141,123,27,123,23,0,4
1633633,39,11,1974,4,male,577,174,94,127,411,82,150,45,261
1779995,24,29,1989,1,female,285,171,120,126,44,126,25,0,19
1751396,54,27,1959,6,male,599,170,142,129,98,129,58,0,40
1731740,24,19,1989,11,male,627,171,51,126,244,126,231,0,13
1224488,17,5,1996,9,male,210,170,139,135,19,0,3,135,16
1656998,58,12,1955,7,male,397,170,118,131,58,0,8,131,50
1239401,104,12,1909,1,male,1009,172,110,131,140,1,14,130,126
1649816,23,14,1990,11,male,464,172,133,136,195,125,171,11,24
1720587,37,3,1976,3,female,371,170,151,132,261,119,237,13,24
1719083,50,19,1963,5,male,431,173,111,135,45,135,32,0,13
1617666,27,14,1986,1,male,501,174,90,134,204,134,137,0,67
2039713,18,7,1995,12,male,271,173,100,143,53,3,21,140,32
1554326,37,25,1976,1,female,777,171,115,137,294,75,253,62,41
1414816,79,24,1934,12,male,884,173,45,141,42,117,10,24,32
1501260,18,23,1995,1,female,401,172,122,137,48,137,26,0,22
1068587,25,2,1988,6,female,36,175,84,137,92,137,85,0,7
1944894,29,3,1984,5,female,215,174,156,138,146,138,107,0,39
1838817,59,8,1954,9,female,365,172,129,146,40,2,5,144,35
2061435,19,6,1994,6,female,364,172,107,148,227,114,135,34,92
1473759,20,6,1993,8,male,431,170,138,144,9,144,6,0,3
1920689,24,25,1989,12,male,200,170,62,147,173,147,172,0,1
1556458,28,30,1985,5,male,277,170,137,148,98,148,95,0,3
1609927,102,1,1911,1,female,1597,170,104,155,81,2,19,153,62
1597668,62,17,1951,2,male,746,170,163,153,90,142,71,11,19
2055516,62,22,1951,11,male,1529,174,64,153,140,117,79,36,61
1686578,53,30,1960,3,male,291,175,97,153,43,153,16,0,27
1121808,50,29,1963,5,female,1299,173,71,160,74,0,26,160,48
1349052,15,21,1998,5,female,809,170,86,160,55,159,55,1,0
1657373,68,17,1945,8,male,717,173,130,158,3,158,0,0,3
1262925,108,27,1905,3,male,1313,171,39,158,24,158,12,0,12
1166654,47,26,1966,8,female,457,171,75,163,76,163,56,0,20
1545466,108,18,1905,6,male,348,174,99,159,108,159,66,0,42
1690790,15,11,1998,12,male,247,174,127,169,21,33,8,136,13
1497914,50,17,1963,1,female,1177,174,90,170,34,158,9,12,25
2120703,52,14,1961,3,male,979,174,125,172,157,155,135,17,22
1372108,15,30,1998,9,female,160,170,71,166,6,166,6,0,0
1117710,43,19,1970,8,male,437,174,73,167,119,167,67,0,52
1105905,56,7,1957,10,female,256,171,134,175,76,12,20,163,56
1518157,49,28,1964,7,female,425,171,53,177,254,6,38,171,216
1967503,26,13,1987,6,female,532,171,39,180,124,168,64,12,60
1795484,26,11,1987,7,female,291,171,129,178,132,145,130,33,2
1446525,14,9,1999,8,female,412,170,141,173,21,173,17,0,4
1926681,28,20,1985,1,female,771,172,125,177,93,177,38,0,55
1548089,59,12,1954,8,female,1589,170,99,177,95,177,74,0,21
1716333,49,21,1964,4,female,1490,170,91,180,289,180,248,0,41
1700199,18,25,1995,1,male,416,171,110,190,1,0,1,190,0
1771340,22,15,1991,2,male,480,171,104,190,11,186,1,4,10
1840100,38,25,1975,6,male,72,171,151,189,119,183,109,6,10
2165497,24,9,1989,10,male,285,170,155,187,86,187,63,0,23
2060571,31,4,1982,12,male,738,174,121,188,39,188,39,0,0
1288283,24,12,1989,9,female,668,174,133,182,112,182,105,0,7
2093671,16,27,1997,1,male,501,171,75,196,44,17,27,179,17
1613711,71,4,1942,12,female,348,171,49,196,170,0,19,196,151
1230909,24,12,1989,9,female,1263,174,123,195,140,102,51,93,89
1997561,71,11,1942,4,male,124,173,38,191,198,178,165,13,33
1241430,18,26,1995,4,male,1020,173,35,191,15,191,14,0,1
1130269,26,27,1987,10,male,173,170,104,199,95,199,52,0,43
2007810,44,23,1969,11,female,627,175,109,204,72,0,15,204,57
1875137,51,1,1962,9,female,204,171,104,205,77,11,42,194,35
1972188,20,18,1993,3,male,793,172,67,201,154,33,71,168,83
2132828,25,15,1988,2,male,263,175,149,202,85,191,81,11,4
2054294,73,11,1940,6,male,1230,171,94,207,39,157,19,50,20
1607665,15,17,1998,7,male,127,172,148,205,125,180,118,25,7
1220080,26,2,1987,6,male,338,172,138,216,53,8,26,208,27
1161714,103,28,1910,1,male,1730,170,78,214,103,2,47,212,56
1725211,50,9,1963,5,male,533,175,102,215,43,70,11,145,32
1954251,13,22,2000,2,female,219,174,71,220,87,203,46,17,41
2083737,55,10,1958,8,male,1363,173,122,219,102,210,63,9,39
2136040,43,12,1970,12,female,1603,170,62,217,140,217,89,0,51
1653908,57,26,1956,9,female,651,174,84,212,260,212,201,0,59
1782807,51,26,1962,6,female,533,173,131,225,17,0,4,225,13
1511346,14,6,1999,4,male,434,172,83,228,78,140,17,88,61
1538856,18,1,1995,1,female,376,170,55,228,148,79,87,149,61
2087488,108,5,1905,6,male,1736,174,44,229,182,146,107,83,75
1420142,41,15,1972,1,female,1875,171,102,224,499,76,371,148,128
1082380,18,28,1995,9,female,317,170,138,228,5,205,5,23,0
1456837,27,13,1986,9,male,563,170,155,229,226,229,115,0,111
1081868,46,2,1967,4,female,667,175,100,239,74,0,15,239,59
1294962,20,22,1993,11,male,264,175,77,237,350,7,18,230,332
1655444,50,3,1963,7,female,1410,172,46,234,223,8,13,226,210
1063217,13,1,2000,1,female,57,171,156,242,139,143,73,99,66
1752763,26,17,1987,4,female,434,174,58,238,40,222,17,16,23
2185030,29,2,1984,2,male,124,170,44,235,328,175,214,60,114
1121708,55,22,1958,3,female,1377,170,52,241,281,196,104,45,177
1541689,21,13,1992,5,male,163,173,148,240,119,240,46,0,73
1480217,24,24,1989,12,male,374,173,123,256,45,5,11,251,34
1061882,23,13,1990,10,female,672,175,134,257,190,55,81,202,109
1222949,36,3,1977,8,male,589,172,109,248,66,244,54,4,12
1508376,54,8,1959,1,female,1846,170,86,252,66,249,63,3,3
2163855,25,5,1988,7,female,423,174,151,254,179,235,156,19,23
2173014,28,22,1985,7,female,1801,172,78,256,161,249,144,7,17
1477515,56,18,1957,6,female,1888,174,55,250,415,224,352,26,63
1267680,34,1,1979,2,male,618,174,101,250,141,250,93,0,48
2066141,17,16,1996,7,male,156,174,149,250,263,250,196,0,67
1858971,25,5,1988,6,female,178,175,83,253,315,253,190,0,125
1724091,52,23,1961,8,male,1068,170,72,250,224,250,205,0,19
1473243,36,18,1977,3,female,285,173,142,251,444,251,330,0,114
1853696,49,23,1964,1,female,220,170,124,269,250,0,60,269,190
1033085,61,15,1952,7,female,919,170,79,266,314,154,189,112,125
1483600,63,10,1950,7,female,1430,174,40,265,215,146,64,119,151
1149110,15,13,1998,7,female,320,173,90,267,83,241,67,26,16
1415869,15,30,1998,1,female,220,174,73,272,58,271,44,1,14
1468655,51,20,1962,6,male,295,173,125,269,39,269,31,0,8
1042577,38,10,1975,3,female,369,170,132,268,220,268,161,0,59
1777921,47,7,1966,11,male,473,172,118,266,392,266,299,0,93
1810320,14,25,1999,1,female,152,173,98,283,565,1,107,282,458
2065366,22,13,1991,7,female,143,174,117,289,597,12,44,277,553
2156175,33,11,1980,9,female,608,173,112,280,209,151,40,129,169
1830706,36,3,1977,6,female,2257,172,106,278,201,265,171,13,30
2107774,19,4,1994,3,male,432,172,137,277,81,277,72,0,9
1035046,24,22,1989,9,female,621,175,75,282,188,282,179,0,9
1266161,14,25,1999,12,female,316,173,118,305,360,12,21,293,339
1223012,27,5,1986,12,female,249,174,147,303,45,219,19,84,26
1109723,33,17,1980,3,male,356,174,143,299,73,299,42,0,31
2030865,21,19,1992,5,male,332,170,142,308,343,308,230,0,113
1035478,80,20,1933,11,female,1355,174,73,310,292,0,136,310,156
2049766,52,5,1961,2,female,1690,171,79,315,368,111,263,204,105
2035543,25,23,1988,2,male,1043,172,103,310,523,207,283,103,240
1821042,23,27,1990,3,female,569,172,57,324,576,322,431,2,145
1803033,37,31,1976,3,male,140,171,109,311,130,311,63,0,67
1019927,58,9,1955,10,male,764,172,139,330,12,4,5,326,7
1813885,30,2,1983,9,female,536,174,114,328,69,60,39,268,30
2154837,47,5,1966,12,female,249,174,99,343,358,12,90,331,268
1398689,62,24,1951,9,male,868,172,104,338,531,14,167,324,364
1383065,23,19,1990,7,female,93,173,117,341,293,161,77,180,216
2096452,57,14,1956,10,female,919,173,100,356,74,13,48,343,26
1978840,20,20,1993,4,female,564,172,88,350,272,67,218,283,54
1291201,48,9,1965,3,female,919,171,115,360,728,209,206,151,522
1885125,52,4,1961,5,female,2371,175,101,361,161,266,94,95,67
1092718,37,14,1976,12,male,659,173,125,362,301,356,241,6,60
1000720,58,24,1955,7,female,1846,171,139,353,332,344,241,9,91
1739744,100,3,1913,9,female,390,173,123,366,333,358,235,8,98
1609896,47,18,1966,2,female,903,173,94,361,71,361,51,0,20
1139649,17,20,1996,3,female,50,170,38,355,226,355,119,0,107
1271683,47,20,1966,12,female,1292,173,117,359,316,359,280,0,36
2027929,85,13,1928,11,male,1709,170,97,355,273,355,219,0,54
1594992,24,6,1989,1,female,548,171,83,386,364,107,159,279,205
1891294,54,2,1959,3,female,1243,173,127,377,72,354,29,23,43
1036241,75,13,1938,8,male,481,170,130,379,137,329,97,50,40
1464252,53,18,1960,3,male,742,172,80,377,631,328,486,49,145
2018142,36,15,1977,11,female,914,175,125,377,98,374,63,3,35
1169950,50,11,1963,1,female,237,173,108,392,279,389,200,3,79
1947921,22,11,1991,6,male,105,175,131,375,9,375,9,0,0
1361807,30,11,1983,4,female,520,170,84,386,65,386,52,0,13
1097219,31,1,1982,3,male,392,171,70,376,280,376,200,0,80
1867938,32,3,1981,9,female,364,172,155,414,232,136,146,278,86
1927805,30,28,1983,2,male,473,170,97,417,343,288,206,129,137
1535430,30,8,1983,8,female,1363,172,110,411,280,282,135,129,145
1900411,24,13,1989,7,female,307,173,130,396,169,370,113,26,56
1155950,51,23,1962,4,female,1267,173,93,396,185,373,59,23,126
1967639,27,4,1986,1,male,161,172,124,438,368,10,45,428,323
1120443,23,3,1990,9,male,944,172,70,448,25,378,14,70,11
2090858,36,15,1977,7,female,366,172,140,427,184,416,110,11,74
1288984,22,26,1991,10,female,1396,173,102,432,307,416,267,16,40
1460608,15,23,1998,6,female,318,173,70,429,0,428,0,1,0
1123686,103,3,1910,12,female,901,172,111,449,280,449,184,0,96
1113032,24,9,1989,6,female,329,173,76,428,1222,428,958,0,264
1453255,22,16,1991,12,male,745,174,76,457,120,59,22,398,98
1201417,61,24,1952,1,male,180,170,151,454,783,0,87,454,696
1078173,27,22,1986,6,male,1424,171,111,469,246,279,131,190,115
2119728,51,30,1962,9,female,990,172,50,470,284,335,126,135,158
1198786,33,12,1980,1,female,528,173,92,481,217,475,134,6,83
2075161,66,11,1947,2,male,119,173,85,461,372,461,339,0,33
1155275,61,28,1952,9,male,673,175,28,486,93,19,65,467,28
1006255,24,30,1989,3,female,764,174,129,487,581,92,249,395,332
2020586,28,18,1985,7,female,217,170,121,494,176,469,75,25,101
1093447,23,13,1990,12,female,122,173,147,519,148,519,64,0,84
2115453,23,22,1990,8,female,1482,175,90,510,89,510,71,0,18
1933801,45,13,1968,11,male,477,170,129,502,224,502,167,0,57
1258450,54,6,1959,6,female,310,172,137,490,92,490,78,0,14
1731018,56,15,1957,5,male,293,175,49,532,143,0,10,532,133
1475995,51,11,1962,2,female,1576,173,93,558,491,323,249,235,242
2118571,48,9,1965,4,female,822,173,89,549,94,399,49,150,45
1098741,21,5,1992,2,male,130,175,118,545,1102,470,975,75,127
1609290,44,5,1969,9,male,759,170,95,544,243,543,216,1,27
1751111,22,2,1991,3,male,241,172,146,558,40,558,40,0,0
1997599,59,25,1954,3,female,898,175,71,530,139,530,112,0,27
1497599,25,7,1988,6,female,246,174,135,556,870,556,601,0,269
1909322,21,2,1992,8,female,29,170,154,568,291,0,103,568,188
1610859,21,18,1992,9,female,341,174,80,588,175,47,26,541,149
1747406,46,1,1967,5,female,1338,172,84,601,299,9,195,592,104
1660715,102,12,1911,4,female,815,171,136,574,254,14,63,560,191
1799801,15,13,1998,9,male,261,171,62,603,356,125,175,478,181
1335888,61,27,1952,4,female,2039,173,110,600,241,206,94,394,147
1257258,41,1,1972,2,female,1515,174,80,576,618,226,416,350,202
1515518,108,8,1905,10,female,949,170,83,562,369,122,229,440,140
1976890,30,27,1983,9,male,961,175,101,564,118,495,50,69,68
1655219,44,6,1969,10,female,1678,172,52,600,180,589,138,11,42
1625801,41,29,1972,3,male,470,175,161,587,121,587,75,0,46
1780962,25,4,1988,4,female,166,174,23,566,709,566,547,0,162
1168494,54,10,1959,12,female,1649,175,99,644,566,74,371,570,195
1944081,47,17,1966,6,male,543,170,74,611,1488,91,521,520,967
1654724,19,1,1994,9,female,320,171,112,617,816,386,493,231,323
1313897,23,20,1990,10,female,1139,172,118,645,905,397,644,248,261
1110615,22,1,1991,5,male,390,172,121,619,188,503,80,116,108
1914661,16,24,1997,7,male,828,174,104,613,20,612,18,1,2
1231833,49,29,1964,10,female,578,173,31,656,664,656,502,0,162
1286742,19,5,1994,9,female,306,171,122,694,386,91,101,603,285
1544367,38,28,1975,7,female,907,171,106,714,383,539,200,175,183
2013008,48,17,1965,4,female,446,175,144,719,202,718,85,1,117
1263334,26,27,1987,10,female,249,172,149,702,242,702,113,0,129
2050078,65,31,1948,3,female,1361,174,111,769,112,0,33,769,79
1074272,80,10,1933,7,female,1673,171,110,789,430,209,209,580,221
1198181,20,30,1993,11,female,723,173,88,737,510,643,290,94,220
1935702,51,27,1962,9,male,1416,170,145,775,302,775,253,0,49
1889133,68,29,1945,10,female,1095,171,90,732,192,732,144,0,48
1773320,108,17,1905,10,male,532,172,81,870,491,0,64,870,427
1265765,21,10,1992,3,male,247,173,132,814,343,708,107,106,236
1209304,48,3,1965,7,female,897,174,99,873,1157,838,510,35,647
1540913,57,31,1956,7,female,1708,175,91,896,277,0,58,896,219
1044873,22,18,1991,5,female,206,170,72,956,543,673,304,283,239
1452337,51,3,1962,12,female,809,172,41,894,445,523,255,371,190
1926406,98,20,1915,12,female,1379,172,116,907,395,449,99,458,296
1032439,108,29,1905,3,female,1766,170,108,948,273,387,87,561,186
1903017,16,22,1997,2,male,538,175,120,917,772,896,489,21,283
1295366,59,16,1954,2,female,2049,170,96,889,545,794,367,95,178
1351759,18,1,1995,1,male,180,172,139,952,190,952,185,0,5
2017237,18,8,1995,8,female,150,170,130,944,561,944,532,0,29
2028954,55,8,1958,9,female,851,175,65,882,301,882,279,0,22
1976477,68,6,1945,11,male,446,175,121,1039,597,694,181,345,416
1541667,48,12,1965,12,female,1452,171,126,1032,633,857,400,175,233
1257430,104,11,1909,9,male,448,170,99,1021,370,1021,251,0,119
1500549,20,15,1993,12,female,117,170,108,999,782,999,536,0,246
1925284,51,13,1962,5,female,2109,172,48,1352,814,1329,349,23,465
1067208,63,1,1950,1,female,163,170,110,1409,565,1365,134,44,431
1313930,90,23,1923,3,male,1490,172,128,1469,284,1385,203,84,81
1710502,19,4,1994,6,male,361,174,139,1403,643,1403,598,0,45
1835470,81,20,1932,2,male,73,171,158,1361,278,1361,215,0,63
1435663,29,5,1984,2,female,1048,174,61,1345,882,1345,745,0,137
1582511,34,17,1979,12,female,525,175,109,1853,1732,131,475,1722,1257
1733889,103,5,1910,12,female,1692,170,130,1611,2226,699,1134,912,1092
2013471,78,1,1935,8,female,63,173,128,1727,379,1727,280,0,99
1590496,54,24,1959,9,female,903,171,89,2055,141,0,18,2055,123
1959860,59,25,1954,2,female,399,171,117,2333,747,0,16,2333,731
1897780,19,5,1994,1,female,99,172,88,2312,311,1118,129,1194,182
1941597,18,15,1995,2,male,235,171,133,1881,412,705,265,1176,147
2040312,63,2,1950,6,female,1388,171,89,1894,611,691,345,1203,266
1723438,28,29,1985,11,female,668,170,85,2153,356,2122,259,31,97
1182366,25,5,1988,3,female,782,173,70,2174,485,2174,275,0,210
1254489,51,14,1962,10,female,344,173,49,2231,2233,2231,1939,0,294
1476723,42,27,1971,9,female,1524,173,113,3082,1527,1775,947,1307,580
1075870,63,25,1950,2,female,1722,172,86,2394,700,911,220,1483,480
1967013,43,24,1970,6,female,760,174,78,2566,3252,1787,2739,779,513
2041002,25,20,1988,11,female,19,170,119,2741,407,2718,73,23,334
2060854,30,22,1983,12,female,223,171,104,3517,813,3517,649,0,164
1335748,57,13,1956,11,female,790,170,145,3944,410,87,75,3857,335
1568412,23,26,1990,3,male,257,173,81,6652,310,4000,231,2652,79
1449243,48,26,1965,6,female,1395,175,108,4748,41,2510,27,2238,14
1961997,53,30,1960,5,female,436,175,145,3937,1043,3937,953,0,90
1350938,25,21,1988,8,male,199,177,143,2,14,2,13,0,1
1378068,28,14,1985,8,male,486,178,70,2,9,2,6,0,3
1714849,35,10,1978,8,male,223,176,39,2,9,2,5,0,4
1110954,45,2,1968,10,male,589,177,108,2,5,2,0,0,5
1118954,60,21,1953,4,male,1185,182,34,2,3,2,1,0,2
1203207,103,4,1910,3,male,692,179,71,2,11,2,9,0,2
1515309,66,24,1947,10,male,427,176,141,3,0,0,0,3,0
1515499,20,30,1993,8,male,594,180,134,3,4,0,0,3,4
1133167,47,20,1966,6,male,807,179,74,3,4,0,4,3,0
2184906,89,12,1924,7,male,1741,179,74,3,2,0,2,3,0
1147531,24,18,1989,7,male,427,180,84,3,8,0,2,3,6
1097600,16,17,1997,9,male,71,182,124,3,1,2,1,1,0
1355178,19,20,1994,7,female,420,180,62,3,3,2,2,1,1
1956435,27,25,1986,7,male,308,177,40,3,11,2,7,1,4
1574605,20,25,1993,9,male,344,179,128,3,0,3,0,0,0
1225763,23,3,1990,3,male,209,177,159,3,0,3,0,0,0
1598382,23,21,1990,6,male,363,179,81,3,0,3,0,0,0
1995788,108,31,1905,10,female,372,176,130,3,0,3,0,0,0
1783569,22,23,1991,6,male,668,176,42,3,1,3,1,0,0
1098409,18,2,1995,6,male,155,180,173,3,2,3,1,0,1
1569250,20,15,1993,11,male,172,178,120,3,2,3,1,0,1
1037020,45,12,1968,6,male,641,179,139,3,2,3,1,0,1
1764213,47,30,1966,4,female,1497,179,73,3,4,3,4,0,0
2105050,64,1,1949,3,female,229,180,49,3,2,3,0,0,2
1660467,17,13,1996,9,male,289,178,105,3,24,3,23,0,1
1146153,22,1,1991,1,male,340,177,64,3,14,3,14,0,0
2031417,22,2,1991,2,male,956,182,93,3,8,3,4,0,4
1935693,24,26,1989,12,male,372,181,95,3,32,3,28,0,4
2162099,23,26,1990,9,male,318,178,127,3,41,3,31,0,10
2084139,24,10,1989,3,male,552,177,124,3,12,3,10,0,2
1998221,26,12,1987,11,male,1404,176,156,3,7,3,2,0,5
1386638,27,8,1986,10,female,284,177,140,3,7,3,5,0,2
1821459,39,24,1974,3,female,1037,178,93,3,11,3,10,0,1
1538729,19,1,1994,1,male,196,182,172,4,0,0,0,4,0
2049114,56,25,1957,7,male,1080,177,112,4,0,0,0,4,0
1702918,72,4,1941,8,male,924,181,125,4,22,0,12,4,10
1478554,28,1,1985,2,male,433,178,90,4,4,2,2,2,2
2145955,24,16,1989,8,male,338,181,159,4,3,3,3,1,0
1582398,26,14,1987,8,male,297,179,146,4,12,3,8,1,4
2175820,16,12,1997,2,male,293,177,102,4,0,4,0,0,0
1165163,19,28,1994,12,male,483,179,121,4,0,4,0,0,0
2092422,29,25,1984,9,female,500,180,57,4,2,4,0,0,2
1785176,103,6,1910,7,female,449,181,98,4,2,4,2,0,0
1572571,16,22,1997,4,male,268,177,126,4,4,4,2,0,2
1243455,20,18,1993,10,male,200,180,44,4,3,4,3,0,0
1023734,22,26,1991,10,female,687,178,62,4,4,4,1,0,3
1543997,31,9,1982,11,male,664,178,151,4,4,4,4,0,0
1109492,19,26,1994,4,female,469,177,67,4,31,4,21,0,10
1421532,21,17,1992,8,male,442,179,154,4,15,4,15,0,0
1944459,23,24,1990,5,male,282,176,43,4,32,4,8,0,24
1516623,26,28,1987,1,male,456,177,112,4,14,4,11,0,3
1852997,36,18,1977,8,female,533,177,105,4,7,4,7,0,0
2026720,68,10,1945,9,male,343,181,91,4,49,4,14,0,35
1391856,95,17,1918,8,male,103,177,152,4,20,4,10,0,10
2085563,100,17,1913,6,male,1838,178,16,4,10,4,4,0,6
1063799,19,30,1994,3,male,306,176,170,5,0,0,0,5,0
1670580,36,12,1977,3,male,202,176,136,5,2,0,1,5,1
1328316,18,27,1995,11,male,575,182,100,5,8,0,6,5,2
1278624,24,17,1989,1,female,988,182,49,5,39,0,21,5,18
1022022,32,6,1981,7,female,294,182,95,5,13,0,1,5,12
1975397,28,27,1985,5,male,378,178,149,5,31,3,20,2,11
1268310,54,16,1959,7,female,1223,176,86,5,16,4,8,1,8
1142477,14,17,1999,8,male,230,182,11,5,0,5,0,0,0
1434311,51,31,1962,12,male,154,177,122,5,0,5,0,0,0
1871075,22,22,1991,2,male,456,180,105,5,1,5,0,0,1
1938572,20,28,1993,12,male,255,176,85,5,5,5,4,0,1
2052145,21,11,1992,10,male,699,182,43,5,10,5,10,0,0
1235980,26,30,1987,3,female,679,182,44,5,105,5,86,0,19
1632974,32,21,1981,11,female,782,181,108,5,44,5,23,0,21
1213202,33,29,1980,9,male,579,181,134,5,119,5,69,0,50
1638448,36,14,1977,12,male,383,177,168,5,18,5,14,0,4
2088425,53,7,1960,8,male,1638,179,70,5,10,5,2,0,8
2156622,32,9,1981,9,male,661,176,135,6,2,0,2,6,0
1107620,103,30,1910,6,male,500,179,118,6,3,0,3,6,0
1969192,32,24,1981,11,male,443,182,147,6,20,0,6,6,14
1351110,81,9,1932,1,male,1447,180,85,6,113,0,60,6,53
2107135,89,12,1924,6,female,1587,179,69,6,33,0,2,6,31
1333111,17,28,1996,2,female,91,178,172,6,3,3,2,3,1
1372993,18,16,1995,4,male,454,178,113,6,1,4,1,2,0
1882776,34,4,1979,3,male,1658,181,105,6,2,3,1,3,1
1840232,29,4,1984,9,male,569,177,113,6,4,3,1,3,3
1602067,28,17,1985,4,male,635,179,86,6,9,4,5,2,4
1055450,53,3,1960,9,female,1603,177,39,6,19,2,13,4,6
1454980,31,16,1982,7,male,626,179,63,6,0,6,0,0,0
1656993,16,11,1997,2,female,245,178,76,6,3,6,2,0,1
1348697,24,17,1989,12,male,548,176,97,6,2,6,1,0,1
1602262,108,9,1905,6,male,1571,179,47,6,2,6,2,0,0
1775158,21,27,1992,8,male,812,180,123,6,6,6,6,0,0
1441963,89,7,1924,3,male,1345,179,71,6,6,6,4,0,2
1710231,108,15,1905,3,male,942,177,130,6,4,6,3,0,1
1258224,19,19,1994,3,male,234,178,111,6,158,6,115,0,43
1044742,20,7,1993,4,male,377,181,152,6,11,6,7,0,4
1240746,21,18,1992,4,male,242,179,117,6,29,6,11,0,18
1459313,22,9,1991,9,female,564,182,39,6,92,6,73,0,19
1409149,24,8,1989,7,male,266,182,63,6,11,6,11,0,0
1352821,27,28,1986,8,female,267,178,57,6,14,6,9,0,5
1779533,48,28,1965,11,female,1993,179,63,6,21,6,1,0,20
1989231,15,25,1998,7,male,258,176,111,7,0,0,0,7,0
1911960,24,26,1989,8,male,319,180,125,7,0,0,0,7,0
1818169,27,21,1986,8,female,272,182,151,7,2,0,1,7,1
2008978,30,17,1983,3,male,258,176,70,7,13,1,13,6,0
1114335,31,1,1982,7,male,294,181,87,7,14,0,3,7,11
1949681,21,7,1992,12,male,130,182,128,7,1,5,0,2,1
1161498,20,28,1993,3,male,574,179,68,7,9,2,8,5,1
1406307,40,8,1973,11,female,719,182,81,7,60,5,29,2,31
1413855,18,1,1995,1,male,278,178,115,7,0,7,0,0,0
2002249,21,13,1992,10,male,1111,176,91,7,1,7,1,0,0
1486726,83,10,1930,7,male,744,179,159,7,2,7,2,0,0
1812094,18,11,1995,3,male,141,177,142,7,7,7,7,0,0
1960749,18,6,1995,4,male,602,176,83,7,6,7,6,0,0
1322106,18,12,1995,9,male,71,177,176,7,5,7,5,0,0
1667684,23,5,1990,9,male,290,176,158,7,5,7,3,0,2
1234653,19,1,1994,1,male,602,178,92,7,18,7,15,0,3
1129208,25,20,1988,8,male,243,181,147,7,52,7,26,0,26
1208226,36,23,1977,11,male,266,179,168,7,17,7,17,0,0
1806211,38,25,1975,9,female,160,181,103,7,192,7,156,0,36
1955587,51,1,1962,4,female,384,182,92,7,42,7,12,0,30
1793665,53,24,1960,5,male,1513,181,137,7,19,7,13,0,6
1023012,59,21,1954,8,female,1398,180,51,7,20,7,9,0,11
1223065,62,18,1951,9,male,820,176,99,7,109,7,53,0,56
2140935,108,23,1905,4,female,354,181,98,7,15,7,4,0,11
1007291,16,15,1997,7,male,164,178,153,8,3,1,2,7,1
1354711,32,23,1981,5,male,402,178,100,8,6,1,2,7,4
1115239,54,8,1959,1,male,391,181,167,8,12,0,1,8,11
1336139,19,15,1994,12,male,725,181,163,8,0,2,0,6,0
1999102,21,14,1992,3,male,721,178,113,8,0,8,0,0,0
1652935,19,25,1994,11,female,538,177,130,8,3,8,2,0,1
1539166,35,29,1978,8,male,1519,179,19,8,4,8,3,0,1
1595314,59,11,1954,5,male,476,176,161,8,2,8,2,0,0
1715745,83,20,1930,5,male,438,177,172,8,2,8,0,0,2
1236374,20,2,1993,1,male,1361,176,35,8,9,8,8,0,1
2177360,28,29,1985,1,female,483,179,162,8,6,8,1,0,5
1125532,20,19,1993,3,female,425,182,61,8,74,8,33,0,41
1156245,44,25,1969,3,male,1901,180,55,8,22,8,20,0,2
2082776,49,5,1964,5,female,1950,178,31,8,636,8,347,0,289
1166557,46,22,1967,5,female,151,177,60,9,5,0,2,9,3
1100989,16,1,1997,9,male,385,180,142,9,19,0,1,9,18
1620642,63,9,1950,12,female,1742,177,105,9,18,3,16,6,2
2008780,14,8,1999,9,male,315,179,142,9,8,8,7,1,1
1694511,17,14,1996,10,female,188,181,159,9,77,7,50,2,27
1341513,14,5,1999,10,male,230,177,137,9,0,9,0,0,0
2175694,21,8,1992,6,male,979,179,64,9,2,9,2,0,0
1049031,25,10,1988,12,female,447,181,105,9,7,9,7,0,0
1124518,23,15,1990,9,male,523,176,110,10,6,0,3,10,3
1438897,30,6,1983,4,male,587,181,112,10,10,1,4,9,6
1533866,16,27,1997,8,male,129,181,99,10,32,1,22,9,10
1498609,38,1,1975,3,male,393,179,81,10,11,7,1,3,10
2119475,34,9,1979,10,female,838,176,110,10,20,9,16,1,4
1315477,22,25,1991,9,female,272,179,174,10,0,10,0,0,0
1323668,21,30,1992,7,female,741,180,88,10,2,10,1,0,1
1552982,28,25,1985,2,female,259,178,62,10,3,10,3,0,0
1538032,63,19,1950,11,female,360,177,118,10,2,10,1,0,1
1414825,106,11,1907,6,male,1351,178,117,10,3,10,3,0,0
2074410,103,16,1910,10,female,1239,177,83,10,7,10,7,0,0
1961304,18,23,1995,4,female,387,179,153,10,25,10,20,0,5
2173216,21,15,1992,2,male,246,177,98,10,92,10,54,0,38
1159435,36,10,1977,1,male,101,182,106,10,31,10,19,0,12
1903905,17,19,1996,12,male,398,180,153,11,8,3,6,8,2
1435762,29,3,1984,8,male,825,179,140,11,10,5,7,6,3
2107954,19,27,1994,1,male,521,180,134,11,27,10,24,1,3
1141261,16,3,1997,3,male,476,180,87,11,0,11,0,0,0
1648094,19,14,1994,12,male,232,176,119,11,3,11,3,0,0
1100270,18,1,1995,8,male,388,182,79,11,2,11,2,0,0
1188414,28,1,1985,5,male,607,179,89,11,6,11,6,0,0
1335161,75,7,1938,6,male,308,181,149,11,5,11,4,0,1
1968051,20,17,1993,5,male,272,179,114,11,9,11,9,0,0
1644331,21,2,1992,2,male,252,181,173,11,11,11,8,0,3
1485160,24,16,1989,6,female,515,179,134,11,8,11,5,0,3
1821535,24,7,1989,4,female,437,176,70,11,51,11,47,0,4
1443040,28,10,1985,2,male,819,182,101,11,76,11,21,0,55
1071142,30,7,1983,10,female,419,178,115,11,51,11,46,0,5
1564065,28,29,1985,11,male,752,181,92,12,6,0,1,12,5
1176459,18,1,1995,4,male,304,177,116,12,16,8,4,4,12
1112189,41,4,1972,3,female,269,178,148,12,12,4,3,8,9
1769995,26,1,1987,10,male,610,177,57,12,27,6,8,6,19
2191433,19,28,1994,3,female,488,177,80,12,26,10,13,2,13
1331390,16,1,1997,1,female,602,181,96,12,0,12,0,0,0
1387411,30,15,1983,12,male,852,178,114,12,0,12,0,0,0
1607588,23,25,1990,5,male,378,182,166,12,6,12,6,0,0
1395569,26,29,1987,8,male,316,181,147,12,5,12,5,0,0
2029802,20,12,1993,11,male,435,177,114,12,11,12,11,0,0
1551950,26,20,1987,10,male,727,177,139,12,12,12,5,0,7
1304193,18,14,1995,3,male,201,179,113,12,32,12,24,0,8
1030960,23,2,1990,12,male,648,180,134,12,39,12,19,0,20
1850836,26,7,1987,9,male,749,182,146,12,47,12,40,0,7
1320192,108,12,1905,12,male,618,181,59,12,18,12,15,0,3
1281745,23,20,1990,10,male,495,182,156,13,1,0,1,13,0
1811568,20,21,1993,4,female,563,176,109,13,7,0,2,13,5
1957426,105,10,1908,5,male,557,179,161,13,5,2,3,11,2
1510343,57,26,1956,5,female,436,177,51,13,9,0,2,13,7
1902225,33,4,1980,2,female,496,178,18,13,114,2,30,11,84
1419411,14,17,1999,2,male,115,177,165,13,12,5,6,8,6
2081266,14,4,1999,11,female,187,182,94,13,59,10,29,3,30
2061683,45,1,1968,1,male,956,181,150,13,2,13,2,0,0
1641409,17,13,1996,9,male,476,180,110,13,6,13,6,0,0
1551758,26,3,1987,1,male,655,182,106,13,78,13,46,0,32
1013343,19,12,1994,11,male,1064,178,114,14,4,0,2,14,2
2098921,16,26,1997,12,male,209,178,155,14,1,5,0,9,1
1959586,26,29,1987,8,female,146,180,159,14,6,11,4,3,2
1003315,24,15,1989,7,male,245,177,103,14,45,12,26,2,19
1221718,28,23,1985,12,female,742,180,54,14,85,11,20,3,65
2125768,53,15,1960,10,female,2087,179,28,14,90,12,75,2,15
1262213,21,17,1992,8,female,513,182,143,14,2,14,2,0,0
1770263,21,25,1992,5,male,449,182,143,14,4,14,4,0,0
1924442,23,28,1990,1,female,145,178,146,14,7,14,2,0,5
1039006,14,25,1999,8,male,395,177,145,14,20,14,18,0,2
1870655,16,27,1997,4,female,369,181,75,14,16,14,16,0,0
1883157,20,5,1993,2,female,386,181,71,14,11,14,9,0,2
1250214,21,20,1992,2,female,153,182,86,14,10,14,8,0,2
1724224,27,28,1986,9,male,604,176,108,14,38,14,30,0,8
1408836,29,13,1984,3,male,558,180,125,14,68,14,39,0,29
1827562,34,4,1979,4,male,1044,176,113,15,7,10,2,5,5
1113982,15,25,1998,8,female,310,181,92,15,6,15,4,0,2
1521539,18,10,1995,6,male,30,177,135,15,3,15,2,0,1
1704113,20,14,1993,4,male,494,177,129,15,19,15,19,0,0
1333528,22,6,1991,11,male,701,177,39,15,26,15,24,0,2
1442829,37,28,1976,9,female,445,180,79,16,0,3,0,13,0
2020579,62,18,1951,2,female,751,181,137,16,29,0,5,16,24
1054365,85,16,1928,1,male,1161,177,83,16,184,0,60,16,124
1829404,73,18,1940,2,female,657,177,83,16,15,8,8,8,7
1239641,27,17,1986,8,male,353,180,155,16,52,10,16,6,36
1524417,47,14,1966,6,female,612,178,109,16,6,13,4,3,2
1428665,19,3,1994,7,male,387,180,119,16,0,16,0,0,0
1939779,21,11,1992,3,female,532,180,92,16,16,16,14,0,2
1948812,23,23,1990,5,male,424,178,93,16,21,16,2,0,19
1065885,24,10,1989,4,male,849,178,61,17,22,5,6,12,16
1611133,15,18,1998,12,male,128,181,169,17,0,13,0,4,0
1032174,27,6,1986,3,male,176,180,102,17,17,16,12,1,5
1527188,23,3,1990,7,female,435,177,85,17,22,17,11,0,11
2141932,28,19,1985,3,female,831,178,57,17,20,17,18,0,2
1995275,33,20,1980,9,female,975,177,137,17,19,17,4,0,15
1899882,21,7,1992,5,female,498,181,123,17,66,17,62,0,4
1801802,14,24,1999,10,male,259,180,121,18,22,1,3,17,19
2089754,19,1,1994,7,female,295,180,49,18,3,18,3,0,0
1819086,68,17,1945,8,male,1425,180,49,18,7,18,7,0,0
1884235,108,21,1905,8,male,1158,180,85,18,8,18,5,0,3
1150785,24,2,1989,5,female,597,176,37,18,22,18,14,0,8
2002783,23,1,1990,1,male,322,178,149,18,30,18,26,0,4
1497174,21,2,1992,9,male,595,178,113,19,1,0,1,19,0
1369080,15,22,1998,8,male,234,182,128,19,9,0,6,19,3
1887790,34,14,1979,11,female,264,179,157,19,5,11,1,8,4
1949370,21,4,1992,7,female,609,177,86,19,326,16,200,3,126
1151434,22,8,1991,10,male,484,176,117,19,3,19,3,0,0
1702661,24,1,1989,7,male,1175,179,119,19,1,19,1,0,0
1825388,43,10,1970,7,female,285,180,143,19,5,19,5,0,0
2083239,24,4,1989,2,female,503,178,91,19,12,19,10,0,2
1143783,27,17,1986,1,female,338,182,86,19,16,19,16,0,0
2189905,28,29,1985,10,male,338,179,153,19,14,19,13,0,1
1306485,19,24,1994,10,male,43,178,88,19,46,19,21,0,25
2031673,23,25,1990,11,male,639,180,105,19,57,19,56,0,1
1965301,30,12,1983,10,male,286,178,80,20,14,0,4,20,10
2042867,41,25,1972,7,female,590,179,146,20,74,15,9,5,65
1299188,34,26,1979,3,male,116,180,146,20,3,20,3,0,0
1124853,38,21,1975,9,male,863,180,102,20,3,20,3,0,0
1178434,18,20,1995,3,male,210,177,145,20,5,20,3,0,2
1550310,27,5,1986,9,male,122,182,172,20,15,20,12,0,3
1895191,59,15,1954,2,female,1390,181,64,20,21,20,19,0,2
1114860,15,11,1998,4,male,213,178,94,21,14,0,2,21,12
2060909,60,24,1953,7,male,1983,182,103,21,31,20,19,1,12
1599179,17,13,1996,8,male,645,179,94,21,38,18,13,3,25
1909049,16,22,1997,12,male,221,178,92,21,0,21,0,0,0
1948366,17,20,1996,8,male,232,180,76,21,0,21,0,0,0
1151244,24,7,1989,3,male,495,182,124,21,13,21,7,0,6
1661865,108,26,1905,7,female,1763,178,60,22,5,4,3,18,2
1652666,29,4,1984,4,male,274,179,92,22,22,7,4,15,18
1180015,18,16,1995,5,female,351,181,57,22,52,14,29,8,23
1748677,16,20,1997,11,male,424,182,91,22,2,22,2,0,0
1012308,17,28,1996,9,male,564,180,95,22,6,22,3,0,3
2139556,19,23,1994,5,male,116,176,149,22,35,22,26,0,9
1911602,93,28,1920,2,male,566,179,140,23,15,0,2,23,13
1013391,27,3,1986,4,male,418,178,124,23,5,23,4,0,1
1680171,21,26,1992,7,male,420,182,67,23,49,23,30,0,19
2140362,25,1,1988,1,female,401,176,47,23,35,23,33,0,2
1898627,17,15,1996,1,male,1420,176,34,24,9,2,3,22,6
1280448,22,30,1991,4,male,642,178,132,24,8,3,1,21,7
1294282,23,4,1990,9,male,725,180,141,24,34,19,22,5,12
1217133,32,19,1981,7,male,883,181,129,24,0,24,0,0,0
1707445,22,4,1991,1,male,301,182,166,24,9,24,4,0,5
1473778,20,1,1993,12,male,420,178,112,24,19,24,14,0,5
1364760,21,10,1992,6,male,460,179,98,24,20,24,7,0,13
2155840,19,21,1994,5,male,250,180,95,24,49,24,39,0,10
1559910,69,29,1944,5,male,2377,181,50,25,13,15,9,10,4
1423961,30,13,1983,12,female,412,178,93,25,71,12,38,13,33
2000451,18,21,1995,7,female,301,181,83,25,25,24,15,1,10
1428973,36,29,1977,6,female,1335,178,51,25,22,22,16,3,6
1575411,18,26,1995,11,female,197,180,86,25,18,25,18,0,0
1471588,51,19,1962,7,female,218,182,108,26,15,15,11,11,4
1136619,13,1,2000,3,female,65,178,131,26,36,26,33,0,3
1336819,76,29,1937,9,male,1071,178,136,27,4,0,2,27,2
1350413,15,4,1998,10,male,308,176,52,27,12,0,0,27,12
1923792,24,11,1989,8,male,108,177,125,27,17,0,1,27,16
1688023,14,20,1999,3,female,265,178,149,27,3,24,1,3,2
1905534,29,22,1984,11,female,343,176,96,27,68,27,41,0,27
1105568,43,20,1970,4,female,505,182,123,28,33,22,15,6,18
1919719,14,25,1999,11,male,382,181,37,28,13,28,12,0,1
1875108,33,10,1980,8,male,313,176,160,28,7,28,7,0,0
1178196,23,7,1990,5,female,300,178,86,28,22,28,13,0,9
2120900,49,21,1964,5,female,425,181,81,28,40,28,38,0,2
2116380,31,16,1982,4,female,469,178,140,29,80,15,68,14,12
1341604,27,7,1986,2,male,327,178,105,29,9,29,7,0,2
1526937,32,3,1981,3,female,893,176,129,29,5,29,3,0,2
1238660,14,10,1999,7,female,378,182,56,31,8,6,1,25,7
1378525,16,19,1997,9,female,590,180,64,30,9,2,5,28,4
1164667,35,12,1978,12,male,411,180,134,31,7,0,5,31,2
1014405,23,27,1990,2,female,938,182,77,31,5,22,3,9,2
1356115,24,15,1989,3,male,968,178,109,30,5,18,0,12,5
1065015,19,10,1994,10,male,1830,182,127,31,13,27,12,4,1
1157393,29,12,1984,12,male,156,182,121,30,20,29,5,1,15
1922666,28,4,1985,7,male,523,177,105,31,4,31,4,0,0
1036837,34,24,1979,8,female,485,176,98,31,23,31,22,0,1
2043539,35,21,1978,10,male,624,178,118,32,50,2,12,30,38
1197675,16,3,1997,7,female,119,179,125,32,17,8,15,24,2
1291836,39,4,1974,5,male,515,178,95,32,6,18,4,14,2
1547115,54,24,1959,10,male,999,180,46,32,41,17,16,15,25
1250459,63,2,1950,9,male,1186,181,110,32,16,28,11,4,5
1381821,108,4,1905,7,male,1127,180,133,32,90,30,80,2,10
1706949,108,28,1905,4,female,1192,176,118,32,27,32,20,0,7
1787675,30,27,1983,6,male,546,179,125,32,53,32,48,0,5
1050101,60,18,1953,11,female,281,178,101,33,64,0,24,33,40
1567986,21,3,1992,11,male,296,177,86,33,3,13,2,20,1
2115037,108,1,1905,1,NA,2131,179,145,33,29,26,15,7,14
1636898,19,24,1994,8,male,311,179,166,33,40,33,32,0,8
1683737,65,29,1948,11,female,484,179,60,33,36,33,24,0,12
1704039,30,16,1983,5,female,372,180,130,33,71,33,62,0,9
1820778,60,12,1953,8,female,594,181,141,34,7,0,2,34,5
1644728,53,21,1960,8,female,1336,182,103,34,159,3,76,31,83
1503234,104,16,1909,12,female,1674,177,75,34,64,0,17,34,47
1585540,44,3,1969,7,male,369,181,103,34,74,11,46,23,28
2154894,34,16,1979,1,male,216,182,139,34,10,34,3,0,7
1779255,25,16,1988,2,female,800,179,56,34,32,34,25,0,7
2061737,28,4,1985,12,female,421,176,110,34,48,34,38,0,10
1108977,18,1,1995,2,male,1108,178,62,35,3,15,2,20,1
1969548,23,18,1990,11,male,142,182,135,36,13,36,6,0,7
1114025,22,14,1991,4,male,524,177,89,35,10,35,4,0,6
1267662,29,1,1984,8,male,191,179,141,35,14,35,9,0,5
2018485,33,2,1980,2,male,397,182,172,36,9,36,9,0,0
2186770,36,18,1977,8,male,526,181,63,35,14,35,12,0,2
1794829,40,27,1973,1,male,1105,176,93,35,6,35,0,0,6
1637462,25,17,1988,5,male,259,178,141,36,39,36,30,0,9
1034836,39,8,1974,7,male,1390,176,39,37,0,1,0,36,0
1994167,61,9,1952,10,female,567,178,139,37,16,0,4,37,12
1427343,36,2,1977,2,male,894,181,81,37,115,12,81,25,34
1295790,53,17,1960,4,male,2069,177,143,37,66,21,42,16,24
1683434,35,3,1978,9,female,893,180,121,37,2,34,1,3,1
1730981,108,5,1905,1,female,1034,176,100,37,1,36,1,1,0
1445977,23,27,1990,11,female,797,177,98,37,9,37,7,0,2
1882630,25,2,1988,8,male,340,178,129,37,79,37,72,0,7
1069241,13,20,2000,1,male,260,178,140,39,10,0,0,39,10
1497362,16,13,1997,10,female,132,177,33,39,8,5,7,34,1
1376508,20,10,1993,1,male,123,180,152,38,6,21,4,17,2
1944486,108,1,1905,12,male,1641,178,47,38,44,11,24,27,20
2071676,42,9,1971,9,male,857,181,107,38,12,30,11,8,1
1537889,15,4,1998,1,male,824,178,85,39,37,35,19,4,18
1395876,24,20,1989,9,male,372,176,152,38,6,38,4,0,2
1096783,28,31,1985,8,female,1410,179,111,39,15,39,14,0,1
1753520,22,28,1991,12,male,284,179,113,39,40,39,26,0,14
1791777,23,18,1990,5,male,675,181,142,39,32,39,10,0,22
1736209,53,15,1960,10,female,950,182,125,38,73,38,67,0,6
1769635,20,18,1993,2,male,256,180,125,40,3,0,0,40,3
1232102,27,11,1986,7,female,559,180,41,40,402,28,139,12,263
1148967,24,15,1989,4,male,690,178,70,40,4,40,4,0,0
1888635,30,30,1983,3,female,804,182,119,40,108,40,40,0,68
2021709,18,16,1995,7,female,213,182,142,41,108,30,21,11,87
2138129,25,11,1988,6,female,239,181,118,41,73,41,20,0,53
1551936,16,31,1997,12,male,461,177,117,43,0,27,0,16,0
1201728,108,25,1905,11,female,2150,176,96,43,46,13,36,30,10
1654717,15,18,1998,8,female,543,182,20,44,0,44,0,0,0
1928514,18,13,1995,12,male,31,179,147,45,308,21,85,24,223
1494935,19,9,1994,12,male,149,180,71,45,69,12,28,33,41
1349995,30,25,1983,2,female,475,178,89,45,0,45,0,0,0
1712484,17,26,1996,3,female,234,179,115,45,25,45,23,0,2
1013308,22,24,1991,10,male,137,181,169,45,11,45,11,0,0
1146781,86,1,1927,11,male,124,178,137,46,21,2,5,44,16
1131152,48,13,1965,5,female,735,180,49,47,23,11,4,36,19
1216450,21,10,1992,7,male,189,177,108,46,85,24,52,22,33
1039729,33,23,1980,12,male,583,177,165,46,10,45,9,1,1
2192112,31,19,1982,7,male,126,178,146,47,54,42,21,5,33
1974188,47,11,1966,9,female,237,181,159,46,111,44,57,2,54
1146317,91,22,1922,2,male,817,181,158,47,67,47,56,0,11
1063084,26,13,1987,7,female,449,177,79,49,8,2,1,47,7
1225778,101,26,1912,3,female,762,176,125,48,39,0,29,48,10
1031832,19,25,1994,7,male,687,179,81,48,1,40,1,8,0
2180705,29,24,1984,9,female,395,182,115,49,21,49,11,0,10
1802496,37,20,1976,4,female,459,180,133,49,103,49,64,0,39
2114732,45,3,1968,1,male,815,180,107,51,19,0,1,51,18
1995067,23,10,1990,5,male,334,179,151,50,44,0,9,50,35
1000341,17,18,1996,8,female,364,177,93,51,50,50,48,1,2
1052747,24,12,1989,4,female,558,180,102,51,41,51,36,0,5
1430792,24,21,1989,8,male,677,179,162,51,34,51,32,0,2
2176401,100,7,1913,9,male,2208,178,109,52,17,2,4,50,13
1494793,14,23,1999,8,female,274,180,159,53,35,7,6,46,29
1964451,66,25,1947,10,male,1386,177,73,55,22,6,1,49,21
1795213,17,13,1996,12,female,38,178,168,55,50,46,15,9,35
1911483,20,4,1993,2,male,295,182,93,54,46,53,34,1,12
2180559,24,12,1989,8,male,428,179,133,55,33,55,22,0,11
1078013,29,18,1984,11,male,405,180,106,55,30,55,24,0,6
1199722,23,25,1990,9,male,448,180,54,55,34,55,33,0,1
1186602,32,11,1981,6,female,246,182,71,55,88,55,86,0,2
1242179,39,10,1974,1,male,510,182,134,55,405,55,327,0,78
1334200,37,11,1976,3,female,267,180,100,56,32,18,1,38,31
2100009,59,3,1954,12,female,1394,178,78,58,377,24,303,34,74
1342524,18,6,1995,3,male,192,178,160,58,35,57,28,1,7
2183442,32,5,1981,12,female,613,180,116,58,33,56,27,2,6
1548529,55,21,1958,5,female,1468,181,65,57,72,46,36,11,36
2023214,19,1,1994,1,male,592,182,86,57,0,57,0,0,0
1454065,53,13,1960,10,female,354,176,132,58,43,58,36,0,7
1058228,69,8,1944,5,female,1733,182,87,60,73,32,34,28,39
1355781,20,15,1993,6,female,567,177,71,59,11,59,11,0,0
1949670,40,1,1973,7,female,316,182,162,60,29,60,26,0,3
1264961,17,19,1996,11,female,97,182,139,59,44,59,35,0,9
2145377,61,14,1952,1,male,857,181,44,59,117,59,81,0,36
1635481,19,7,1994,3,female,162,180,157,62,35,15,20,47,15
1554235,38,28,1975,12,female,518,179,96,61,37,39,24,22,13
1566426,22,22,1991,2,male,243,180,143,61,120,38,44,23,76
1282457,46,27,1967,6,female,743,178,107,62,233,24,105,38,128
1702316,63,24,1950,12,female,1039,178,94,61,83,56,49,5,34
1319506,35,11,1978,2,male,440,178,113,63,7,63,7,0,0
1040448,24,31,1989,8,female,337,181,40,63,56,63,54,0,2
2120205,99,2,1914,3,male,2316,182,132,65,58,31,40,34,18
1434780,17,7,1996,8,female,494,178,99,65,116,56,63,9,53
1347901,18,1,1995,1,female,19,182,162,65,345,65,293,0,52
1537636,64,1,1949,7,male,1029,178,111,67,8,0,6,67,2
1539829,47,30,1966,8,female,550,176,94,66,51,62,41,4,10
2095519,28,26,1985,8,male,368,182,92,68,27,68,13,0,14
2086405,31,21,1982,6,female,691,181,103,66,54,66,37,0,17
1595489,22,4,1991,5,female,494,179,93,67,114,67,110,0,4
1820894,60,6,1953,9,male,1405,176,125,69,18,44,10,25,8
1103587,35,5,1978,10,female,1098,180,87,70,254,68,138,2,116
1455204,22,25,1991,1,male,247,181,87,69,73,69,62,0,11
1271322,25,2,1988,9,male,486,177,95,70,48,70,37,0,11
1939275,103,10,1910,10,female,734,180,72,71,51,71,49,0,2
1812830,103,9,1910,6,female,1046,177,76,74,47,72,39,2,8
1195466,19,3,1994,7,male,559,179,65,73,4,73,0,0,4
1547475,25,8,1988,8,male,418,176,161,73,4,73,4,0,0
1704949,75,27,1938,4,male,849,177,104,73,32,73,17,0,15
1853976,16,29,1997,1,male,311,180,94,76,5,35,2,41,3
1742724,25,2,1988,7,male,382,177,94,77,78,77,51,0,27
2044582,30,5,1983,10,female,572,176,76,76,65,76,38,0,27
1411585,70,23,1943,12,female,1797,178,91,77,104,77,29,0,75
1738801,25,16,1988,3,female,716,179,48,75,121,75,59,0,62
1834960,39,21,1974,10,male,149,180,127,75,210,75,177,0,33
1963894,20,1,1993,9,male,134,177,91,80,0,80,0,0,0
1196199,51,18,1962,5,female,841,178,37,79,86,79,46,0,40
1789656,53,20,1960,10,female,335,178,63,79,109,79,100,0,9
1307583,18,11,1995,12,female,427,176,97,84,116,8,28,76,88
1485284,22,30,1991,8,female,683,177,37,82,174,0,33,82,141
1136384,28,2,1985,9,male,556,179,150,83,52,60,22,23,30
1858896,18,9,1995,9,male,132,181,172,82,13,82,11,0,2
1986319,31,15,1982,11,male,473,177,135,83,8,83,7,0,1
1325187,108,12,1905,7,male,242,182,136,87,3,69,3,18,0
1023481,16,6,1997,4,male,262,179,88,86,0,86,0,0,0
1464749,32,28,1981,9,male,524,179,26,85,2,85,1,0,1
1502891,56,29,1957,11,male,141,180,58,86,19,86,11,0,8
1016383,77,7,1936,12,female,1397,176,124,87,37,87,30,0,7
1645675,30,25,1983,10,female,1247,178,42,85,65,85,61,0,4
1164995,56,14,1957,4,female,415,181,80,90,26,0,6,90,20
1275683,32,16,1981,4,male,641,180,153,91,9,46,6,45,3
1983322,34,24,1979,4,male,445,178,74,88,155,85,68,3,87
1410929,22,18,1991,12,male,382,180,108,90,100,90,67,0,33
1987949,48,19,1965,1,male,327,182,148,93,13,4,0,89,13
1005580,68,25,1945,12,male,644,179,93,92,44,0,21,92,23
1190692,53,1,1960,7,male,543,178,115,94,100,0,43,94,57
1742571,58,29,1955,4,female,472,182,87,92,139,0,40,92,99
1286431,61,28,1952,11,male,2132,181,100,92,384,47,221,45,163
1446051,20,23,1993,12,female,502,176,116,93,126,69,88,24,38
1624141,21,16,1992,4,female,628,177,106,95,62,91,59,4,3
1646456,29,11,1984,9,female,719,182,79,94,108,83,39,11,69
1627702,38,21,1975,12,male,1578,180,92,94,201,70,92,24,109
2182389,16,21,1997,8,male,375,179,131,92,51,92,10,0,41
1705272,57,14,1956,12,female,2489,179,66,96,24,2,10,94,14
2064395,40,13,1973,2,female,1165,180,81,98,91,21,47,77,44
1161409,44,3,1969,2,female,1744,181,92,99,104,62,90,37,14
1599515,47,19,1966,5,female,1531,181,97,96,124,86,87,10,37
1900122,46,27,1967,8,female,44,177,108,97,248,89,121,8,127
2155975,17,17,1996,3,male,326,177,133,97,33,97,28,0,5
1215666,20,28,1993,11,female,559,176,48,97,19,97,17,0,2
1333438,19,25,1994,7,female,323,180,128,96,42,96,40,0,2
1808609,23,21,1990,10,male,573,176,94,97,127,97,38,0,89
1704432,55,21,1958,9,male,797,177,80,96,88,96,81,0,7
1889029,41,24,1972,11,male,476,179,68,96,157,96,119,0,38
1698458,61,21,1952,7,female,1545,178,75,101,47,47,28,54,19
1293542,17,8,1996,12,female,279,180,105,103,58,83,42,20,16
1168916,26,1,1987,1,male,425,177,158,103,0,103,0,0,0
1642676,62,28,1951,4,female,705,178,82,104,50,104,36,0,14
1953343,30,22,1983,4,female,744,178,126,104,135,104,36,0,99
1692752,20,21,1993,5,female,418,178,124,107,18,70,13,37,5
1999608,108,15,1905,6,male,873,181,80,109,29,107,20,2,9
1902381,19,21,1994,5,female,630,180,108,108,85,87,52,21,33
1308136,55,9,1958,11,female,868,180,59,107,175,103,77,4,98
1663890,31,2,1982,4,female,278,181,131,108,68,107,55,1,13
1631000,18,14,1995,10,male,215,176,129,108,79,108,78,0,1
1141753,24,18,1989,1,female,269,177,93,111,61,8,26,103,35
1213904,18,20,1995,2,male,496,178,66,113,50,113,42,0,8
1697287,39,1,1974,12,male,442,181,122,110,152,110,99,0,53
1969359,58,27,1955,4,female,957,180,114,113,153,113,32,0,121
1195858,25,8,1988,6,male,430,180,169,115,112,0,47,115,65
1181031,113,1,1900,1,female,1279,181,42,117,72,21,23,96,49
2108203,48,25,1965,7,female,1693,179,80,118,371,8,225,110,146
2097989,13,6,2000,6,female,79,179,146,117,43,46,21,71,22
1575318,38,14,1975,3,female,791,180,110,118,21,73,4,45,17
1784290,78,30,1935,8,female,1134,182,108,119,158,97,104,22,54
1502361,58,27,1955,4,male,948,182,29,114,80,113,58,1,22
1670099,26,17,1987,7,female,744,179,78,118,25,118,24,0,1
1479965,26,21,1987,2,female,171,177,60,120,99,115,91,5,8
1430221,15,18,1998,6,female,83,179,94,120,14,120,14,0,0
2030121,35,16,1978,2,female,1278,177,89,120,119,120,89,0,30
1990639,80,13,1933,12,female,1387,180,108,128,64,22,15,106,49
1166139,108,4,1905,1,male,1032,177,102,128,272,9,81,119,191
1586694,102,21,1911,9,male,1402,181,98,130,23,125,19,5,4
1901701,23,25,1990,8,male,304,180,155,127,97,124,73,3,24
1779230,26,20,1987,3,female,274,180,162,126,88,120,78,6,10
1599445,103,16,1910,10,male,277,176,161,130,5,130,5,0,0
1809273,21,5,1992,2,male,204,181,142,128,23,128,22,0,1
1594125,27,25,1986,11,male,312,178,137,125,31,125,15,0,16
1168237,50,18,1963,9,male,1029,176,82,126,34,126,29,0,5
2101587,25,8,1988,10,male,393,176,91,128,82,128,54,0,28
1302922,27,5,1986,4,female,306,178,50,125,164,125,98,0,66
1873034,22,11,1991,9,male,122,182,122,131,24,1,16,130,8
1243536,23,21,1990,10,female,397,176,142,134,21,134,10,0,11
1578733,34,22,1979,9,female,619,177,138,135,155,135,116,0,39
1581231,58,23,1955,2,female,565,177,146,135,120,135,58,0,62
2003176,57,17,1956,2,female,657,178,131,142,25,0,11,142,14
1958227,44,28,1969,12,male,313,179,153,141,132,75,43,66,89
1213324,17,2,1996,8,male,380,178,162,143,190,128,63,15,127
1508606,108,21,1905,3,female,844,182,105,140,217,107,115,33,102
1640841,50,13,1963,10,male,202,177,155,140,80,139,53,1,27
1505212,30,11,1983,4,male,262,179,140,141,4,141,2,0,2
2068281,48,4,1965,2,female,267,182,154,140,292,140,178,0,114
1624687,29,1,1984,10,female,532,177,54,144,16,0,1,144,15
1110516,61,22,1952,6,female,379,180,69,146,158,0,45,146,113
1340608,65,12,1948,2,female,1217,180,27,149,70,43,43,106,27
2125221,57,12,1956,1,male,1724,181,129,144,360,33,164,111,196
2086224,35,12,1978,1,female,509,178,162,148,22,147,15,1,7
1872726,27,16,1986,11,male,528,177,159,149,25,149,16,0,9
1637207,28,17,1985,7,female,456,176,58,150,100,150,86,0,14
1037502,42,20,1971,3,male,454,179,65,145,362,145,311,0,51
1147491,24,3,1989,7,female,685,178,100,153,86,4,23,149,63
1268130,51,30,1962,9,female,1541,178,80,155,138,154,94,1,44
1170342,59,9,1954,10,male,812,182,141,153,117,153,73,0,44
1339123,64,2,1949,4,male,1295,176,97,159,221,2,104,157,117
1191502,57,8,1956,4,female,1042,181,134,160,53,132,21,28,32
1625658,26,14,1987,9,male,537,176,133,159,87,159,59,0,28
2011976,55,3,1958,10,female,156,176,140,160,60,160,41,0,19
1468302,18,6,1995,12,female,345,182,81,158,247,158,185,0,62
1251668,21,19,1992,12,female,726,180,132,170,131,82,86,88,45
2022492,106,27,1907,1,male,849,176,113,171,133,46,65,125,68
1189200,17,21,1996,5,male,204,182,141,167,100,131,70,36,30
1213552,75,6,1938,10,female,1788,179,110,165,89,155,41,10,48
1168641,25,12,1988,11,male,1068,179,54,171,216,133,99,38,117
1506342,53,19,1960,4,NA,2191,176,56,172,148,168,125,4,23
1987341,23,1,1990,6,female,252,182,30,165,261,141,63,24,198
1398987,27,21,1986,4,female,1478,178,130,169,384,166,201,3,183
1631480,46,6,1967,1,male,288,182,130,170,16,170,13,0,3
1518344,18,7,1995,12,female,119,176,161,171,89,171,61,0,28
1647378,17,8,1996,2,female,382,182,88,168,60,168,25,0,35
1426482,44,19,1969,10,male,975,179,110,168,53,168,40,0,13
2152646,94,5,1919,2,female,2144,178,76,171,81,171,79,0,2
1597390,31,11,1982,6,female,468,178,134,169,365,169,333,0,32
1778954,52,31,1961,7,female,395,182,157,176,79,0,19,176,60
1695533,55,27,1958,5,female,682,176,104,175,41,0,1,175,40
1725430,42,18,1971,7,female,1681,176,122,175,175,146,128,29,47
1415444,20,1,1993,10,male,149,176,123,173,21,173,15,0,6
1741035,108,12,1905,1,male,418,178,120,178,52,178,11,0,41
1011846,108,30,1905,12,male,1980,181,141,185,6,0,2,185,4
1329055,37,14,1976,1,male,224,180,100,188,392,11,311,177,81
1108894,46,7,1967,4,female,1862,181,93,189,596,0,154,189,442
1371126,71,3,1942,9,male,1720,176,71,182,16,68,8,114,8
1875346,49,13,1964,2,female,1695,179,111,188,123,38,24,150,99
2067645,41,30,1972,3,female,420,179,71,190,345,62,161,128,184
2165512,23,5,1990,6,male,1680,177,86,185,231,148,185,37,46
1260239,33,19,1980,9,male,590,180,113,185,267,151,18,34,249
1692614,29,25,1984,1,female,615,180,106,183,0,182,0,1,0
2157710,26,17,1987,2,male,369,177,156,183,100,183,93,0,7
1445215,32,24,1981,11,female,194,180,48,188,99,188,99,0,0
1087513,37,20,1976,10,female,2391,181,158,185,119,185,90,0,29
1594543,64,25,1949,4,female,2027,182,106,193,57,0,1,193,56
1314387,94,10,1919,1,male,1063,181,121,192,112,0,64,192,48
1375002,34,21,1979,4,female,932,179,122,192,252,33,127,159,125
2097198,18,5,1995,8,male,290,181,118,197,98,57,48,140,50
1826374,20,15,1993,9,male,82,181,167,197,298,78,267,119,31
1390456,14,28,1999,7,male,358,178,67,194,7,192,5,2,2
1888691,27,1,1986,7,male,810,180,165,193,25,193,24,0,1
1995248,33,19,1980,1,male,338,179,147,194,36,194,27,0,9
1048010,21,14,1992,1,male,324,181,146,191,140,191,119,0,21
1176980,54,5,1959,6,female,702,176,84,191,190,191,95,0,95
1836873,28,31,1985,10,female,468,176,56,191,496,191,401,0,95
1991556,18,18,1995,12,female,418,177,132,208,63,38,32,170,31
1959290,20,3,1993,11,female,125,176,125,204,212,129,57,75,155
1272425,59,21,1954,8,female,2313,180,130,204,229,137,177,67,52
1563815,43,13,1970,7,male,507,177,101,210,87,210,59,0,28
1020484,53,18,1960,4,male,502,176,121,210,172,210,102,0,70
1587463,63,6,1950,9,male,1001,181,82,202,153,202,143,0,10
1148074,26,17,1987,8,male,481,180,148,208,346,208,308,0,38
1351707,19,6,1994,11,male,244,181,77,215,29,18,8,197,21
2002140,51,7,1962,8,female,300,178,132,213,147,22,125,191,22
1104091,18,1,1995,1,male,181,181,121,217,107,217,95,0,12
1833467,33,6,1980,7,male,478,176,85,217,43,217,31,0,12
1357705,76,2,1937,5,male,1402,179,105,219,81,219,52,0,29
1287425,28,9,1985,4,female,474,181,130,214,200,214,193,0,7
2180971,56,18,1957,2,female,1406,177,50,214,625,214,255,0,370
1000454,102,2,1911,9,female,1167,182,141,233,276,0,41,233,235
1694999,84,18,1929,5,female,790,176,68,233,87,219,80,14,7
1427696,20,16,1993,5,female,117,179,148,224,185,208,103,16,82
1063794,18,21,1995,4,female,136,182,93,223,460,171,234,52,226
1759530,19,15,1994,11,female,650,177,58,233,56,233,52,0,4
1151393,18,4,1995,2,male,776,182,123,222,48,222,47,0,1
1475777,45,4,1968,4,male,902,182,66,228,261,228,209,0,52
1410194,51,5,1962,2,male,644,181,127,231,152,231,108,0,44
1952499,53,10,1960,6,female,1484,176,95,226,224,226,105,0,119
1205332,30,21,1983,11,male,902,182,86,243,327,49,59,194,268
1707849,19,13,1994,11,male,115,178,155,243,35,240,32,3,3
1444429,52,18,1961,2,female,1898,182,117,234,41,176,23,58,18
1400614,18,7,1995,7,male,216,177,122,248,90,16,65,232,25
1832887,21,9,1992,6,female,431,178,80,252,80,11,14,241,66
1598167,33,14,1980,3,male,340,178,107,255,294,179,172,76,122
1642162,37,11,1976,9,female,429,179,151,252,199,208,135,44,64
1109301,57,1,1956,10,male,1600,182,58,255,173,250,127,5,46
1709236,23,14,1990,5,male,351,177,142,252,61,252,61,0,0
1401195,108,19,1905,10,male,175,178,151,260,105,260,87,0,18
1334316,57,24,1956,5,female,638,181,111,258,177,258,97,0,80
1386694,63,18,1950,2,female,1327,182,109,252,263,252,135,0,128
1962103,62,6,1951,10,female,1933,180,89,271,164,181,66,90,98
1544370,107,8,1906,2,male,5,180,175,269,549,152,272,117,277
1865167,16,9,1997,2,male,154,180,123,266,178,233,71,33,107
1915169,14,18,1999,3,male,194,177,52,270,8,270,8,0,0
1094817,96,16,1917,9,male,1196,176,97,266,93,266,61,0,32
1089986,16,11,1997,8,male,437,178,131,286,461,199,121,87,340
1768456,35,9,1978,9,female,660,177,114,292,154,231,67,61,87
2091703,53,10,1960,4,male,1394,178,64,291,97,291,34,0,63
1825669,103,5,1910,8,female,819,177,145,287,143,287,116,0,27
1577154,20,13,1993,1,female,434,180,65,278,512,278,189,0,323
1964652,16,23,1997,11,female,518,177,110,301,275,50,88,251,187
2176486,108,29,1905,4,female,1384,177,96,298,176,202,133,96,43
1771316,23,7,1990,12,male,463,178,125,301,31,285,21,16,10
2046635,23,26,1990,3,female,673,182,91,304,226,300,141,4,85
1439929,37,5,1976,1,female,586,177,134,305,277,275,144,30,133
1290104,21,11,1992,3,female,317,182,154,300,23,300,22,0,1
1748450,25,2,1988,12,male,126,180,152,295,101,295,80,0,21
1728744,49,29,1964,10,female,77,178,87,293,719,293,203,0,516
1154751,59,23,1954,4,female,1338,180,133,309,255,60,86,249,169
1394248,97,17,1916,7,male,1340,177,37,322,458,7,57,315,401
1951924,21,24,1992,3,male,193,182,168,327,105,190,76,137,29
1280711,58,8,1955,2,female,1792,177,93,325,128,70,28,255,100
1712679,33,7,1980,12,female,133,177,135,319,191,318,89,1,102
1296396,38,14,1975,4,female,393,182,135,309,50,309,38,0,12
1034237,88,24,1925,9,male,287,179,133,333,96,0,21,333,75
1011476,28,28,1985,4,female,725,176,91,335,273,0,82,335,191
2054711,64,3,1949,12,female,1792,182,100,332,236,106,180,226,56
1203151,21,16,1992,4,female,508,178,51,333,340,301,261,32,79
1837060,19,19,1994,10,male,379,179,125,344,172,344,125,0,47
1402207,61,11,1952,12,male,1163,178,47,340,146,340,79,0,67
1917222,22,26,1991,1,female,710,182,79,334,401,334,292,0,109
1646219,61,12,1952,8,female,1268,179,70,332,539,332,322,0,217
1563812,22,27,1991,11,female,478,177,79,360,179,70,54,290,125
1534040,25,12,1988,1,male,363,179,150,368,96,0,28,368,68
1026967,52,23,1961,6,female,1559,178,88,359,233,355,132,4,101
1220206,15,3,1998,1,male,129,178,125,355,0,355,0,0,0
1557302,34,17,1979,9,female,101,177,166,369,201,369,161,0,40
1986171,16,25,1997,9,female,64,181,140,359,383,359,349,0,34
1981142,33,1,1980,1,female,261,177,32,348,412,348,276,0,136
2080677,55,24,1958,1,male,845,178,133,367,226,367,97,0,129
1457042,14,1,1999,1,male,329,181,137,379,136,2,47,377,89
1251435,61,16,1952,4,female,1779,178,102,379,121,33,0,346,121
1908267,62,17,1951,10,female,1181,178,110,384,165,0,27,384,138
1733918,44,28,1969,7,female,519,177,125,380,205,117,69,263,136
1164613,28,25,1985,5,female,154,176,165,390,288,263,148,127,140
1292713,18,11,1995,9,male,301,182,112,394,255,378,52,16,203
1533019,36,4,1977,5,male,339,178,77,375,310,375,278,0,32
1971294,18,17,1995,6,male,237,179,47,415,130,0,57,415,73
1284839,82,6,1931,9,NA,2016,178,133,399,109,33,75,366,34
1341613,28,24,1985,5,female,175,179,151,414,164,374,119,40,45
1566739,35,29,1978,11,male,231,177,121,415,178,355,127,60,51
1441196,44,22,1969,12,female,1857,182,88,413,78,326,40,87,38
2131063,33,11,1980,4,male,595,180,83,413,568,412,521,1,47
2086050,103,17,1910,10,female,849,179,54,412,268,412,265,0,3
1553063,16,2,1997,12,female,1307,177,120,423,157,35,108,388,49
1622986,30,6,1983,5,female,265,182,150,449,253,335,73,114,180
2040394,24,5,1989,6,male,139,177,123,431,336,396,194,35,142
2072451,30,2,1983,9,male,339,177,89,437,95,437,58,0,37
1303302,22,12,1991,10,female,430,182,150,458,543,255,359,203,184
1022086,54,5,1959,3,female,592,180,139,474,106,471,57,3,49
1959106,33,5,1980,9,male,392,179,122,510,119,504,88,6,31
2100254,59,19,1954,12,female,1458,178,109,521,48,0,35,521,13
1298611,20,18,1993,8,male,597,180,112,552,230,263,19,289,211
1967220,47,23,1966,11,female,719,179,68,531,269,388,118,143,151
1868691,46,27,1967,7,female,1726,181,108,547,325,535,230,12,95
1331380,17,4,1996,4,female,469,180,86,531,444,524,201,7,243
2193070,25,4,1988,8,female,1417,180,75,545,418,541,145,4,273
1311332,38,18,1975,11,male,1427,176,122,538,661,538,626,0,35
1719700,19,18,1994,8,female,222,177,119,608,398,603,312,5,86
1375991,57,20,1956,3,female,1834,181,121,575,245,575,175,0,70
1979686,45,29,1968,7,male,557,177,143,627,1064,86,832,541,232
1010627,23,7,1990,10,female,792,179,143,651,112,353,65,298,47
1025044,67,24,1946,6,female,598,176,138,626,289,626,144,0,145
1689105,52,5,1961,10,female,407,182,113,726,157,24,57,702,100
1739827,22,3,1991,8,female,15,176,166,700,426,81,250,619,176
1423608,19,22,1994,9,female,198,181,118,665,200,438,165,227,35
2109759,52,30,1961,5,female,543,182,130,700,127,446,60,254,67
1657169,25,13,1988,10,female,472,177,136,707,482,410,329,297,153
1783846,18,21,1995,8,female,185,180,162,667,290,653,216,14,74
2039596,26,2,1987,11,female,140,176,154,715,811,701,479,14,332
1427665,37,22,1976,9,female,353,177,89,724,534,621,398,103,136
1851513,24,21,1989,2,female,594,182,93,695,1183,533,690,162,493
1160491,22,4,1991,10,male,352,180,162,689,194,689,184,0,10
1241361,23,5,1990,5,male,113,179,148,783,129,13,102,770,27
1397649,108,7,1905,6,male,1602,177,138,748,73,106,38,642,35
2187765,56,21,1957,7,female,1324,178,68,758,622,263,423,495,199
1807384,71,10,1942,9,male,193,178,134,748,91,655,72,93,19
1157627,58,12,1955,7,female,1404,178,121,791,309,688,223,103,86
1296319,33,8,1980,2,female,393,180,122,765,144,765,110,0,34
1687352,60,29,1953,9,female,1013,181,149,808,600,2,76,806,524
1932350,13,6,2000,3,male,319,179,110,878,153,842,126,36,27
1305876,15,12,1998,7,female,327,178,76,860,260,723,149,137,111
1557544,17,28,1996,1,male,339,178,101,798,180,645,103,153,77
1913579,50,26,1963,4,male,355,177,33,870,217,679,121,191,96
1849219,18,1,1995,8,female,100,176,80,853,94,853,57,0,37
1967483,24,28,1989,6,male,300,182,132,876,573,876,477,0,96
1402140,52,17,1961,5,male,845,180,94,871,795,871,285,0,510
1035559,58,30,1955,3,female,779,176,118,886,145,0,40,886,105
1958716,67,26,1946,12,male,1572,176,33,964,125,427,42,537,83
1210427,100,31,1913,12,female,1362,181,47,975,164,203,42,772,122
1026114,23,1,1990,1,female,478,181,33,896,490,847,308,49,182
1679806,28,6,1985,8,female,412,177,62,919,421,886,339,33,82
1783937,21,2,1992,4,female,20,182,114,923,1235,752,595,171,640
1134999,56,7,1957,12,female,1679,181,62,998,333,99,121,899,212
1371093,37,8,1976,8,female,851,181,109,1102,1054,174,353,928,701
1444400,15,23,1998,2,female,377,179,41,1027,263,429,151,598,112
1922411,28,17,1985,5,female,549,178,104,1013,350,473,209,540,141
1891592,54,28,1959,7,female,908,176,71,1088,678,777,433,311,245
1406791,44,10,1969,4,female,922,176,158,1124,172,1106,155,18,17
1463767,26,20,1987,6,male,417,179,103,1115,168,1115,141,0,27
1315054,108,31,1905,8,male,181,182,113,1179,619,23,508,1156,111
1497628,17,28,1996,8,female,98,176,123,1141,75,247,66,894,9
1907229,18,25,1995,2,male,279,180,93,1236,192,306,75,930,117
1579046,17,22,1996,4,female,137,181,83,1247,818,829,606,418,212
1234225,44,18,1969,10,female,1681,176,26,1254,989,628,475,626,514
1268652,100,28,1913,8,male,165,179,99,1134,104,1009,97,125,7
1747494,32,28,1981,7,female,790,177,131,1225,534,1118,311,107,223
2144788,60,30,1953,1,female,1564,180,119,1142,221,1142,177,0,44
1019438,60,5,1953,9,female,242,176,139,1234,338,1234,225,0,113
1329199,37,11,1976,4,female,1669,181,89,1497,919,455,682,1042,237
1469538,83,31,1930,8,female,895,181,124,1539,20,0,1,1539,19
1992425,19,2,1994,10,male,81,181,119,1802,186,1751,119,51,67
1125136,56,22,1957,1,female,740,181,105,1835,788,1451,510,384,278
1459616,33,31,1980,5,female,228,178,138,1594,2202,1572,1932,22,270
1480129,19,19,1994,5,female,98,180,127,1565,623,1553,373,12,250
1862759,43,30,1970,5,female,402,180,155,1571,161,1571,127,0,34
2167402,64,23,1949,6,female,2163,181,93,1580,721,1580,692,0,29
2189642,39,20,1974,6,female,355,176,92,1598,1169,1598,894,0,275
1763565,64,13,1949,10,female,607,176,109,2204,797,0,27,2204,770
1942033,15,28,1998,9,female,220,181,66,2241,398,1547,125,694,273
1452082,21,14,1992,6,female,482,179,87,2005,566,1273,254,732,312
1331008,15,14,1998,1,female,201,181,67,2084,364,2084,252,0,112
1470637,38,5,1975,4,female,1645,181,95,2488,1373,336,196,2152,1177
1620352,67,23,1946,10,female,980,178,138,3223,1065,265,256,2958,809
1127127,54,22,1959,7,female,295,176,90,2511,315,869,84,1642,231
1311584,14,1,1999,1,female,307,182,125,3440,1630,2252,1013,1188,617
2005903,18,15,1995,8,female,340,176,98,3288,1802,960,623,2328,1179
2058196,20,13,1993,11,male,283,178,132,2756,655,1095,360,1661,295
1723919,18,19,1995,4,male,67,177,134,2636,2433,1840,1430,796,1003
1037943,49,6,1964,2,male,548,176,122,3231,1165,3205,675,26,490
1588233,43,16,1970,9,female,765,180,78,2461,15,2461,14,0,1
1092045,72,8,1941,11,female,2018,177,86,4492,467,4492,251,0,216
1782250,40,1,1973,2,female,224,188,97,92,29,92,28,0,1
2017023,41,27,1972,10,male,368,183,110,93,76,93,69,0,7
1343301,28,27,1985,10,female,427,188,70,95,175,95,125,0,50
1715402,35,30,1978,9,female,121,184,174,92,229,92,204,0,25
1884059,55,17,1958,4,male,796,183,132,95,299,95,229,0,70
1960473,108,9,1905,6,female,1264,186,24,97,119,13,42,84,77
1423519,15,6,1998,9,female,375,183,66,97,49,27,30,70,19
1728597,19,17,1994,8,male,4,190,138,97,77,78,55,19,22
2175698,25,8,1988,8,male,560,184,135,98,63,86,43,12,20
2107011,55,2,1958,6,female,941,187,122,99,1,98,0,1,1
1196201,25,8,1988,2,male,651,188,99,97,13,97,8,0,5
1697886,43,17,1970,4,female,418,188,90,96,7,96,5,0,2
1845074,18,1,1995,11,female,580,187,149,99,82,99,50,0,32
2139023,63,15,1950,4,female,2049,187,65,102,291,0,66,102,225
1300321,47,7,1966,3,female,1296,186,84,103,292,71,193,32,99
1542602,68,25,1945,3,male,1570,190,108,102,3,94,2,8,1
1634791,94,12,1919,6,female,812,189,99,101,160,81,63,20,97
2156480,21,4,1992,12,male,848,187,68,103,15,103,12,0,3
1456603,59,26,1954,4,male,1126,188,114,102,9,102,9,0,0
2131124,64,3,1949,3,female,1315,190,47,103,9,103,6,0,3
1371463,47,15,1966,11,female,1140,183,135,104,103,104,76,0,27
1478380,27,30,1986,10,female,199,189,137,102,182,102,92,0,90
2121708,59,14,1954,5,female,556,188,143,109,32,0,17,109,15
1541374,47,5,1966,2,female,160,186,167,107,99,64,80,43,19
1269612,18,22,1995,10,female,1006,188,97,107,47,97,41,10,6
1351274,16,24,1997,5,male,66,183,176,108,7,108,7,0,0
1383933,25,1,1988,1,male,261,190,169,105,1,105,1,0,0
1412474,14,3,1999,4,male,335,187,128,107,54,107,54,0,0
1089109,15,8,1998,8,female,298,183,106,105,28,105,27,0,1
1073363,94,13,1919,9,male,897,184,88,106,32,106,28,0,4
1568167,22,7,1991,8,female,89,189,84,107,154,107,86,0,68
1685034,35,25,1978,9,male,260,186,51,112,32,0,10,112,22
1770236,103,20,1910,11,male,1503,190,95,110,30,1,5,109,25
1291369,15,26,1998,6,female,647,190,87,111,186,12,69,99,117
1053372,66,5,1947,11,male,388,184,139,112,87,101,57,11,30
1746145,18,28,1995,6,female,515,186,90,111,44,111,31,0,13
1137877,23,14,1990,7,male,598,190,128,110,36,110,7,0,29
1378356,28,3,1985,1,male,374,184,112,111,24,111,19,0,5
1584587,103,20,1910,7,male,616,184,133,111,63,111,29,0,34
1983733,20,1,1993,3,male,265,187,139,110,126,110,51,0,75
1256035,29,11,1984,1,female,463,190,91,112,204,112,81,0,123
1279281,62,17,1951,9,female,256,185,84,119,15,0,9,119,6
2187268,22,17,1991,11,female,430,185,104,115,57,21,19,94,38
1119877,71,16,1942,9,male,607,188,153,118,79,2,16,116,63
1645236,26,1,1987,12,female,333,183,142,116,93,33,30,83,63
1321215,26,4,1987,12,male,486,183,127,118,7,110,4,8,3
1865008,21,6,1992,6,male,50,186,161,119,3,119,2,0,1
1641343,64,24,1949,8,female,1057,183,78,120,23,0,5,120,18
1397637,17,30,1996,10,male,442,183,109,121,95,11,4,110,91
1480617,69,11,1944,11,female,1519,186,118,122,23,68,15,54,8
1098681,39,24,1974,5,male,219,187,137,123,19,104,6,19,13
1872395,59,30,1954,6,female,472,186,75,120,44,112,27,8,17
1041924,27,26,1986,9,male,742,187,87,120,74,113,31,7,43
1684602,32,4,1981,5,female,272,185,98,123,246,111,111,12,135
1887304,20,17,1993,6,female,215,184,155,120,42,120,11,0,31
2083609,21,7,1992,10,male,662,185,127,122,140,122,118,0,22
1532243,54,4,1959,6,female,1335,189,60,128,53,11,33,117,20
1443993,82,10,1931,9,male,898,188,75,125,153,0,48,125,105
1743373,21,21,1992,12,male,93,183,128,128,203,49,71,79,132
2107060,33,22,1980,4,female,449,183,125,127,221,53,130,74,91
1781842,24,19,1989,5,male,111,183,170,130,12,130,11,0,1
1361171,45,15,1968,5,male,1250,183,139,126,35,126,29,0,6
2060719,14,23,1999,1,male,360,190,131,134,24,0,7,134,17
1216070,17,22,1996,8,female,137,184,95,133,404,105,66,28,338
1786833,23,10,1990,11,male,441,184,99,135,43,135,27,0,16
1651374,34,20,1979,8,male,145,189,61,131,133,131,133,0,0
1445469,19,13,1994,5,male,88,184,164,132,298,132,42,0,256
1547627,18,5,1995,2,female,357,186,165,137,154,12,48,125,106
1585283,30,9,1983,5,male,264,189,118,137,33,43,8,94,25
1167610,68,18,1945,12,female,2221,190,134,142,99,139,69,3,30
1666453,57,4,1956,3,female,2045,190,103,137,346,135,194,2,152
1877970,24,28,1989,4,female,290,189,135,137,99,137,83,0,16
2094696,38,28,1975,7,female,472,190,106,143,252,143,169,0,83
1610278,54,28,1959,5,female,524,184,122,147,234,0,82,147,152
1836885,78,1,1935,7,female,1443,189,94,144,42,101,39,43,3
1690485,51,1,1962,6,female,1754,183,133,145,283,73,214,72,69
1295893,24,4,1989,9,male,475,186,98,144,0,120,0,24,0
1399597,19,29,1994,4,female,140,189,60,149,35,116,20,33,15
1921721,15,22,1998,3,female,610,188,117,146,94,143,79,3,15
2188160,22,17,1991,9,female,380,188,131,147,64,146,41,1,23
1308063,59,6,1954,7,female,2293,187,47,150,188,149,131,1,57
2131640,35,3,1978,7,female,1579,186,114,149,94,149,48,0,46
1727597,55,7,1958,2,female,849,188,78,153,202,56,46,97,156
1993457,40,14,1973,7,male,530,190,128,154,258,152,216,2,42
1415839,46,9,1967,3,male,437,190,129,151,14,151,1,0,13
1502291,33,20,1980,5,male,321,189,76,154,39,154,20,0,19
1206234,65,6,1948,2,male,2185,188,86,154,33,154,22,0,11
1833155,53,1,1960,8,female,602,189,127,159,229,0,70,159,159
2038168,25,8,1988,8,female,564,190,133,160,106,149,65,11,41
1176500,63,13,1950,4,female,1243,185,151,166,199,14,76,152,123
2023173,18,4,1995,10,female,571,189,76,169,56,116,24,53,32
1358890,43,1,1970,5,female,1760,184,64,168,52,129,26,39,26
1991641,108,9,1905,10,female,969,183,107,172,100,162,27,10,73
1821144,15,11,1998,3,male,397,188,162,171,5,171,4,0,1
1266618,27,29,1986,8,male,306,189,54,169,118,169,61,0,57
1687563,29,8,1984,11,female,263,184,128,178,158,111,68,67,90
1045974,17,16,1996,11,female,164,189,121,180,281,100,121,80,160
1667915,49,17,1964,8,female,1606,184,132,181,97,173,69,8,28
1667711,16,3,1997,9,male,733,184,78,179,3,179,3,0,0
1157229,22,11,1991,3,male,278,185,95,180,104,180,51,0,53
1729472,30,26,1983,3,male,650,188,137,178,32,178,22,0,10
1806198,63,9,1950,4,male,1018,190,146,173,82,173,57,0,25
1626220,24,12,1989,8,male,370,190,72,180,127,180,97,0,30
2124882,26,24,1987,10,male,633,187,144,190,0,42,0,148,0
1501838,25,11,1988,10,female,673,189,95,187,94,150,89,37,5
2124302,23,24,1990,4,male,747,187,94,187,168,143,87,44,81
1031075,37,8,1976,11,female,335,183,56,190,146,166,128,24,18
1823045,26,22,1987,1,female,153,188,51,187,452,187,382,0,70
2029864,23,30,1990,6,female,341,185,127,195,49,4,26,191,23
1476880,47,23,1966,3,female,1546,184,77,192,257,25,65,167,192
1113623,16,22,1997,9,male,207,184,28,196,85,134,56,62,29
1594516,35,3,1978,2,female,665,184,145,200,210,142,125,58,85
1767940,24,19,1989,10,female,1227,189,96,191,336,81,195,110,141
1466543,18,11,1995,1,female,209,186,135,194,80,141,57,53,23
1631400,40,21,1973,7,female,228,183,87,196,92,193,50,3,42
2167640,26,1,1987,1,female,173,186,162,193,203,141,175,52,28
1987481,36,13,1977,3,female,1741,188,102,198,283,162,201,36,82
1838614,61,8,1952,11,female,1504,188,55,191,66,191,54,0,12
1340419,42,23,1971,7,male,745,184,169,210,3,0,2,210,1
1840695,23,13,1990,7,female,575,185,118,209,108,69,28,140,80
2136985,45,27,1968,1,female,455,189,141,201,82,46,55,155,27
2184482,19,4,1994,12,male,686,190,104,205,277,46,216,159,61
2050957,26,7,1987,1,female,1023,186,127,210,183,86,93,124,90
1100497,29,7,1984,9,female,684,185,80,209,14,205,10,4,4
2004125,19,2,1994,10,male,287,187,125,208,62,205,34,3,28
1617734,29,1,1984,3,female,315,185,151,211,106,211,57,0,49
2044263,29,22,1984,9,female,354,186,68,206,203,206,126,0,77
1334637,18,10,1995,1,male,537,187,102,216,112,19,42,197,70
1165127,33,24,1980,11,female,354,189,118,214,230,1,151,213,79
1708120,23,22,1990,5,female,1165,185,114,219,180,135,122,84,58
2042997,26,2,1987,5,male,409,185,133,221,378,119,214,102,164
1344731,20,1,1993,5,male,184,185,112,214,209,173,82,41,127
1609494,25,15,1988,10,male,268,187,146,216,14,215,9,1,5
1766393,24,24,1989,4,female,788,186,118,220,274,219,182,1,92
1095322,101,16,1912,12,male,464,185,146,214,63,214,56,0,7
1133740,20,21,1993,4,male,530,185,118,216,147,216,134,0,13
1503576,16,19,1997,4,female,103,185,121,226,291,27,146,199,145
1238111,29,4,1984,8,male,453,183,147,229,46,51,37,178,9
1811171,24,13,1989,9,male,392,190,150,226,283,156,147,70,136
1096138,16,4,1997,1,male,401,187,54,234,71,185,52,49,19
1600268,28,3,1985,6,female,716,190,99,243,76,187,36,56,40
2109956,64,8,1949,7,female,1705,185,76,238,88,207,41,31,47
1013504,100,17,1913,10,female,1721,188,87,238,256,232,201,6,55
1008301,26,14,1987,1,male,92,186,126,236,159,236,145,0,14
2086510,31,4,1982,4,male,340,186,130,240,220,240,181,0,39
1246260,40,5,1973,4,male,114,185,153,242,184,242,173,0,11
1245884,50,7,1963,10,male,1147,183,99,258,186,62,87,196,99
1141479,58,2,1955,9,female,1352,183,57,255,199,240,144,15,55
2026536,25,11,1988,8,female,324,187,113,249,377,241,265,8,112
2138942,93,1,1920,7,female,704,185,113,250,17,250,9,0,8
1631428,23,5,1990,7,male,472,190,100,254,133,254,118,0,15
1368749,62,23,1951,9,female,1888,183,134,247,81,247,34,0,47
1849790,22,12,1991,7,female,264,187,139,249,227,249,214,0,13
1648949,17,20,1996,9,female,424,188,84,261,256,70,41,191,215
2000133,29,27,1984,7,male,331,188,140,271,105,238,36,33,69
1396593,34,10,1979,10,female,164,190,152,276,170,210,131,66,39
1949277,19,5,1994,6,female,634,185,60,264,63,264,47,0,16
2106994,43,9,1970,6,female,621,188,101,268,55,268,46,0,9
1607260,108,16,1905,2,male,193,184,52,265,106,265,103,0,3
1492341,18,16,1995,10,male,179,186,133,262,160,262,89,0,71
1919651,26,11,1987,3,female,343,187,55,267,190,267,183,0,7
1067561,60,7,1953,11,female,1776,185,126,267,244,267,202,0,42
2057164,57,12,1956,10,female,769,186,110,292,403,0,144,292,259
1886865,17,22,1996,10,male,331,186,157,288,287,256,138,32,149
1944512,19,4,1994,9,male,539,183,118,282,422,267,162,15,260
1651537,14,27,1999,6,male,145,190,100,288,154,288,142,0,12
1992702,15,22,1998,8,female,264,185,122,288,74,288,58,0,16
2006309,27,1,1986,4,male,558,190,45,281,171,281,164,0,7
1546280,30,15,1983,3,female,306,183,132,284,379,284,234,0,145
1792804,71,17,1942,3,female,1463,183,66,293,187,41,121,252,66
1496579,15,4,1998,2,female,218,184,137,295,196,95,75,200,121
1042783,52,21,1961,11,female,215,186,158,303,22,303,9,0,13
1185321,26,16,1987,4,female,983,187,119,306,201,306,169,0,32
1553868,40,5,1973,8,female,237,184,154,304,205,304,121,0,84
1986163,74,12,1939,1,female,1088,185,103,324,29,0,13,324,16
1764182,50,28,1963,6,male,833,183,116,310,752,23,454,287,298
2049022,14,4,1999,8,male,153,186,152,318,125,182,82,136,43
1519410,27,30,1986,7,female,552,186,97,316,404,205,369,111,35
2056436,28,31,1985,3,male,334,183,130,310,246,309,181,1,65
1110258,25,19,1988,7,male,373,184,117,311,11,311,10,0,1
1947816,42,24,1971,6,male,352,190,113,314,171,314,100,0,71
1162758,34,26,1979,3,female,363,183,130,322,261,322,177,0,84
1120395,63,18,1950,3,male,214,189,87,315,203,315,123,0,80
1300824,36,9,1977,7,female,284,183,137,328,177,16,81,312,96
1113955,38,10,1975,8,male,601,188,129,331,28,68,12,263,16
1060540,25,1,1988,1,male,849,190,123,330,617,222,227,108,390
1858461,19,12,1994,2,male,589,183,79,342,248,290,169,52,79
1901313,47,10,1966,5,female,789,186,129,338,637,266,554,72,83
1120205,63,21,1950,8,female,767,189,48,338,32,338,18,0,14
1574153,46,20,1967,5,male,438,187,137,340,79,340,63,0,16
1502563,103,4,1910,3,female,1510,183,59,339,164,339,62,0,102
1242057,21,10,1992,3,female,143,183,86,333,277,333,188,0,89
1025122,59,6,1954,9,male,714,187,124,348,310,196,180,152,130
2147566,20,29,1993,1,female,206,189,144,356,158,339,76,17,82
1887368,15,22,1998,10,female,348,189,122,361,150,361,127,0,23
1148386,25,14,1988,4,male,610,184,123,350,166,350,162,0,4
1812528,38,6,1975,2,female,597,188,133,351,241,351,72,0,169
1543877,22,17,1991,3,male,576,190,164,375,511,66,150,309,361
1123485,35,21,1978,12,female,399,186,63,385,408,254,142,131,266
1348183,50,29,1963,8,male,1681,183,123,379,339,117,179,262,160
1323771,16,24,1997,2,male,447,187,85,379,223,316,99,63,124
1652704,22,12,1991,9,female,522,189,112,386,121,352,89,34,32
1837057,19,13,1994,10,female,113,190,111,370,1021,313,623,57,398
1556754,44,1,1969,1,male,258,187,82,391,206,391,152,0,54
1803030,52,21,1961,11,male,412,188,104,389,151,389,99,0,52
1666650,36,24,1977,7,female,340,183,128,386,315,386,258,0,57
1576685,50,29,1963,3,female,627,184,76,372,694,372,598,0,96
1499286,95,28,1918,2,male,1557,189,73,414,238,254,101,160,137
1749541,18,14,1995,5,female,306,186,100,406,251,142,104,264,147
1164666,29,22,1984,5,male,559,184,126,395,100,395,63,0,37
2010323,21,17,1992,2,female,480,184,71,439,549,158,256,281,293
1622422,67,8,1946,2,female,1756,183,122,482,324,348,169,134,155
1942480,18,28,1995,10,male,23,184,172,456,87,456,82,0,5
2137507,20,18,1993,5,female,461,188,131,478,265,478,161,0,104
1377928,32,23,1981,12,female,406,188,41,469,474,469,306,0,168
1675034,105,17,1908,4,male,2051,185,103,513,322,0,125,513,197
1212861,46,11,1967,8,female,1265,186,147,487,206,486,116,1,90
1318503,25,1,1988,1,male,331,188,150,491,68,491,58,0,10
1215404,26,2,1987,11,female,266,185,60,485,384,485,305,0,79
1216277,56,2,1957,4,female,369,188,93,518,361,518,228,0,133
2120333,59,1,1954,4,male,462,184,87,532,69,1,17,531,52
1887490,18,19,1995,2,female,198,184,65,559,647,4,248,555,399
1062440,47,13,1966,11,female,790,189,127,539,809,1,385,538,424
1332086,37,1,1976,1,male,578,186,120,553,34,504,25,49,9
1111771,53,8,1960,1,female,1141,186,74,525,52,515,23,10,29
1929269,21,30,1992,12,female,441,183,53,553,165,499,156,54,9
1337873,34,15,1979,4,male,543,189,122,539,312,513,214,26,98
1172129,21,28,1992,12,female,399,183,92,556,361,535,206,21,155
1725075,28,12,1985,8,female,335,183,69,522,406,500,307,22,99
1027264,34,20,1979,8,female,275,186,106,551,864,550,430,1,434
1082429,54,2,1959,4,female,115,189,69,543,68,543,42,0,26
1071458,113,4,1900,5,male,1280,189,109,521,103,521,84,0,19
1457308,53,17,1960,5,female,1644,187,72,584,830,1,395,583,435
1259033,25,1,1988,1,male,196,190,182,606,237,464,108,142,129
1714718,53,4,1960,4,male,376,184,99,602,264,474,122,128,142
1979429,49,6,1964,7,female,1835,184,83,602,601,436,377,166,224
1416848,59,10,1954,10,female,243,183,93,602,168,600,145,2,23
1835112,15,20,1998,11,female,297,189,110,596,305,596,275,0,30
1983559,26,31,1987,5,male,521,185,154,582,231,582,121,0,110
1924468,29,8,1984,12,female,486,183,131,583,294,583,174,0,120
1783555,36,13,1977,5,female,241,185,96,591,270,591,239,0,31
1086836,55,29,1958,1,female,1544,186,159,586,345,586,237,0,108
1794610,58,15,1955,7,female,159,185,88,595,286,595,115,0,171
1666200,50,16,1963,1,female,356,185,126,641,602,9,219,632,383
2106529,58,5,1955,2,female,2120,190,122,638,291,368,154,270,137
1772209,18,18,1995,9,female,736,187,112,631,820,440,390,191,430
1049443,33,7,1980,12,male,147,184,136,623,1370,599,1251,24,119
1179002,48,28,1965,4,female,460,184,100,638,46,638,42,0,4
1465605,68,17,1945,8,male,553,184,163,653,288,653,273,0,15
1317102,27,28,1986,9,female,340,186,86,646,685,646,562,0,123
1493218,40,15,1973,11,female,431,184,121,683,367,41,114,642,253
1551643,43,16,1970,6,male,363,189,150,723,191,220,130,503,61
1892536,46,7,1967,7,female,941,189,116,665,399,387,110,278,289
1403889,14,13,1999,6,female,165,183,160,687,141,622,74,65,67
2024690,47,23,1966,11,female,2401,183,102,678,228,649,100,29,128
1499026,70,28,1943,7,male,242,185,108,768,599,0,71,768,528
1593682,55,27,1958,3,male,860,190,134,735,1506,86,1101,649,405
1590627,18,4,1995,11,male,369,183,159,777,42,236,23,541,19
1939156,21,16,1992,5,female,64,186,169,766,371,417,174,349,197
1108157,46,6,1967,9,female,93,187,143,791,361,528,178,263,183
1146245,21,5,1992,11,female,469,185,59,778,736,529,361,249,375
2030759,40,27,1973,10,female,1420,186,47,754,488,248,197,506,291
2087363,52,20,1961,8,female,1519,185,138,749,471,500,205,249,266
1698075,108,16,1905,5,male,913,186,121,741,30,708,25,33,5
1666625,23,9,1990,9,female,113,183,154,785,400,595,270,190,130
1928807,49,29,1964,6,female,1584,187,100,750,352,667,185,83,167
1469582,19,9,1994,4,female,232,190,142,751,460,728,360,23,100
1827857,33,10,1980,5,male,723,189,155,747,680,693,443,54,237
2108389,46,6,1967,9,female,546,190,168,793,448,791,340,2,108
1155843,55,15,1958,10,female,308,184,101,765,155,765,120,0,35
1541009,31,24,1982,7,female,658,184,121,749,521,749,471,0,50
1892499,34,2,1979,10,female,1034,188,96,863,722,404,344,459,378
2167526,22,25,1991,11,female,259,183,134,863,122,799,94,64,28
1855309,28,29,1985,11,female,224,190,142,838,233,628,101,210,132
1051771,50,2,1963,9,male,1692,190,57,868,150,806,67,62,83
1623264,15,9,1998,9,female,240,190,75,847,1022,826,445,21,577
1834729,16,5,1997,2,female,181,187,85,858,601,853,537,5,64
1063547,53,7,1960,1,male,405,188,155,874,648,874,101,0,547
1708325,65,15,1948,12,female,1947,185,118,985,726,1,202,984,524
2181846,19,1,1994,11,female,303,186,85,952,363,305,175,647,188
1835505,54,10,1959,12,female,2138,185,78,980,556,506,263,474,293
1616009,20,9,1993,4,female,150,187,108,903,355,819,265,84,90
1485936,23,16,1990,1,female,138,185,153,915,866,766,518,149,348
1771283,16,8,1997,5,male,310,183,128,881,17,881,17,0,0
1809414,37,5,1976,2,female,452,188,118,900,0,900,0,0,0
1179569,101,29,1912,1,female,695,189,177,911,93,911,72,0,21
1427599,43,12,1970,10,female,570,186,109,950,427,950,122,0,305
1483391,54,16,1959,2,female,1084,188,139,944,635,944,552,0,83
2193145,17,14,1996,8,female,623,190,66,1041,117,175,64,866,53
1055389,57,10,1956,9,female,432,186,131,1025,253,0,49,1025,204
1532299,59,16,1954,6,female,448,186,143,1048,457,0,178,1048,279
1074397,19,13,1994,6,female,950,183,109,1004,888,11,336,993,552
2086977,47,12,1966,3,female,413,184,117,1077,1075,0,93,1077,982
2120422,18,9,1995,3,female,109,185,85,1037,471,554,230,483,241
2063811,49,22,1964,3,female,620,185,127,989,125,863,70,126,55
1390714,17,26,1996,7,female,580,190,51,1018,662,808,240,210,422
1354038,23,14,1990,8,female,641,185,59,1038,46,1038,41,0,5
1799625,32,4,1981,12,male,193,184,156,1026,61,1026,56,0,5
2147790,51,1,1962,7,male,256,186,169,1045,33,1045,19,0,14
1073224,18,4,1995,4,female,475,186,133,992,166,992,162,0,4
2036757,20,18,1993,11,female,409,190,103,1130,420,1130,379,0,41
1824076,59,3,1954,11,female,1613,183,108,1081,233,1081,171,0,62
1676413,54,8,1959,5,female,1243,189,84,1254,800,7,243,1247,557
2189351,47,2,1966,5,female,242,187,41,1243,1399,1100,744,143,655
1147387,24,3,1989,5,male,298,189,159,1206,163,1206,155,0,8
1423187,72,2,1941,6,male,1247,188,124,1477,16,0,2,1477,14
1316431,78,25,1935,5,female,1596,184,167,1519,265,0,62,1519,203
1377083,22,15,1991,6,female,1233,187,113,1335,436,1156,292,179,144
2100431,49,10,1964,11,female,1587,188,109,1519,440,1464,246,55,194
2167334,14,20,1999,7,female,387,184,147,1331,729,1318,628,13,101
1175884,49,20,1964,2,female,565,185,124,1678,26,185,11,1493,15
1930967,108,12,1905,4,female,1015,189,145,1727,1038,0,283,1727,755
1167489,78,8,1935,9,female,1578,187,63,1679,1719,0,465,1679,1254
1665221,31,12,1982,3,female,416,183,95,1536,3512,592,2153,944,1359
1166488,17,13,1996,3,female,256,183,72,1865,199,1615,118,250,81
1455954,34,25,1979,6,female,401,190,148,1844,916,1710,631,134,285
1845666,49,24,1964,1,female,1628,185,153,1616,498,1449,139,167,359
1282037,14,14,1999,1,female,522,187,103,1806,158,1806,116,0,42
1735417,41,9,1972,8,female,498,185,100,1633,763,1633,714,0,49
1899534,24,10,1989,8,male,205,187,146,1525,1127,1525,799,0,328
1433436,20,23,1993,1,female,1170,183,120,2109,1942,1500,748,609,1194
1155212,44,20,1969,4,female,430,183,113,2235,1253,2143,895,92,358
1967809,15,9,1998,4,male,383,188,131,2592,2656,23,435,2569,2221
1200370,19,23,1994,8,female,343,186,113,2952,2062,444,650,2508,1412
2001681,60,24,1953,12,female,2022,186,120,2481,1576,230,334,2251,1242
1291171,56,28,1957,4,female,754,185,87,2670,1519,544,919,2126,600
2061137,62,18,1951,7,female,1622,185,134,2408,249,2370,125,38,124
1675652,50,6,1963,11,female,675,185,118,2554,466,1931,233,623,233
1665033,24,26,1989,10,female,105,190,119,2472,2606,2004,1817,468,789
1034804,27,3,1986,5,female,426,184,107,3499,2543,3499,1698,0,845
1311023,22,25,1991,4,female,254,185,69,3690,3741,744,1914,2946,1827
1691805,55,8,1958,3,male,1231,187,127,6453,4167,6402,1982,51,2185
1945467,54,28,1959,12,female,678,185,146,4234,504,4234,431,0,73
1339345,25,25,1988,10,male,266,193,134,8,296,8,194,0,102
1123824,24,30,1989,8,male,1136,194,112,9,87,1,81,8,6
1430699,28,10,1985,3,male,593,193,130,9,5,5,2,4,3
1995138,21,3,1992,2,male,1136,197,131,9,0,9,0,0,0
1638698,23,25,1990,12,male,277,191,174,9,6,9,2,0,4
1766843,36,9,1977,8,male,833,196,135,9,6,9,3,0,3
1624691,49,10,1964,12,female,866,195,109,9,46,9,34,0,12
2012662,23,29,1990,12,male,212,197,122,10,11,4,10,6,1
1835575,23,19,1990,12,female,459,195,142,10,61,8,58,2,3
1180708,18,3,1995,1,male,625,191,107,10,3,10,3,0,0
1610775,23,20,1990,4,female,329,196,90,10,4,10,2,0,2
1224411,103,16,1910,10,female,476,195,93,10,6,10,6,0,0
2135113,108,17,1905,6,male,1185,197,127,10,6,10,4,0,2
2067694,20,10,1993,7,male,690,191,86,10,10,10,5,0,5
1926636,15,21,1998,10,male,388,191,55,10,87,10,41,0,46
1276892,20,14,1993,11,female,420,196,138,10,17,10,7,0,10
1274414,21,12,1992,2,male,38,191,73,10,40,10,38,0,2
1212150,68,11,1945,11,male,1442,193,73,11,1,0,1,11,0
1206380,15,22,1998,4,male,545,193,145,11,9,7,6,4,3
1925571,18,10,1995,9,male,618,194,54,11,0,11,0,0,0
1525516,14,4,1999,10,male,271,195,184,11,4,11,4,0,0
2069167,36,16,1977,9,male,1824,193,99,11,6,11,4,0,2
1488269,15,28,1998,5,male,156,191,94,11,71,11,48,0,23
2082690,27,26,1986,1,male,556,196,150,11,22,11,16,0,6
1065242,27,20,1986,7,female,1082,191,126,11,49,11,30,0,19
1224221,18,17,1995,2,male,537,191,26,12,12,0,6,12,6
2038051,32,3,1981,10,female,418,191,142,12,43,0,13,12,30
1221595,30,5,1983,6,male,405,191,54,12,3,4,2,8,1
1103953,19,31,1994,12,male,273,197,92,12,1,11,1,1,0
1396325,113,19,1900,10,female,1548,193,136,12,37,9,24,3,13
1424808,20,22,1993,12,male,429,197,155,12,0,12,0,0,0
2053187,22,25,1991,4,male,580,193,102,12,0,12,0,0,0
1709105,18,13,1995,4,female,462,193,62,12,4,12,1,0,3
2191636,22,17,1991,3,male,407,197,99,12,17,12,11,0,6
2135730,52,5,1961,6,male,580,191,132,13,0,2,0,11,0
1170718,18,6,1995,9,female,193,192,135,13,8,1,3,12,5
1243745,44,26,1969,12,female,527,193,102,13,9,0,5,13,4
1062726,100,9,1913,7,female,2119,193,93,13,160,0,88,13,72
2081466,15,26,1998,2,female,150,191,85,13,25,9,18,4,7
1511108,60,26,1953,10,female,1722,195,43,13,112,4,57,9,55
1150387,21,8,1992,3,male,449,194,45,13,0,12,0,1,0
1400934,17,16,1996,12,male,130,193,167,13,0,13,0,0,0
1037407,28,1,1985,1,male,606,196,163,13,2,13,1,0,1
1195366,22,17,1991,8,male,572,195,116,13,4,13,2,0,2
1101164,16,24,1997,5,male,328,194,113,13,18,13,18,0,0
1623922,21,30,1992,3,female,64,192,33,13,9,13,9,0,0
1902509,34,18,1979,10,male,198,196,46,13,9,13,9,0,0
1038423,53,31,1960,8,male,1032,195,119,13,16,13,13,0,3
1160102,31,4,1982,2,male,345,193,104,13,32,13,14,0,18
1125254,35,22,1978,12,female,315,194,131,14,4,2,1,12,3
2185337,50,12,1963,12,male,290,195,84,14,19,2,7,12,12
1243952,83,24,1930,10,male,1762,192,36,14,13,0,5,14,8
2146919,16,3,1997,9,male,293,195,117,14,31,4,2,10,29
2019328,19,5,1994,10,male,671,195,113,14,4,12,2,2,2
1106040,28,22,1985,8,male,448,193,169,14,0,14,0,0,0
1470282,39,31,1974,8,male,443,197,122,14,8,14,3,0,5
1112419,32,9,1981,1,male,728,192,147,15,1,4,0,11,1
1854656,18,10,1995,3,male,200,196,135,15,7,7,0,8,7
1256173,27,15,1986,5,female,410,191,144,15,99,13,38,2,61
1272002,25,1,1988,4,male,264,196,73,15,4,15,3,0,1
1707278,20,21,1993,7,female,586,192,112,15,21,15,20,0,1
1653958,25,28,1988,9,male,248,194,163,15,20,15,20,0,0
1985900,35,23,1978,7,male,491,195,149,15,43,15,28,0,15
1414709,42,3,1971,1,male,383,194,120,15,32,15,30,0,2
1473953,20,4,1993,10,male,568,193,128,16,5,0,1,16,4
1030433,25,11,1988,11,male,604,191,146,16,27,14,21,2,6
1914028,25,21,1988,7,male,228,195,74,16,2,16,1,0,1
1400440,29,28,1984,5,male,932,191,113,16,5,16,5,0,0
1694364,94,21,1919,12,male,1558,191,88,16,89,16,70,0,19
1740977,57,11,1956,3,male,726,192,137,17,6,0,1,17,5
1169369,59,17,1954,3,male,333,194,106,17,8,0,0,17,8
1044545,59,11,1954,3,female,1699,194,93,17,55,1,45,16,10
1154775,27,28,1986,2,male,470,197,197,17,2,12,1,5,1
2186663,94,20,1919,11,male,768,194,129,17,14,10,8,7,6
1817103,48,27,1965,3,male,1657,193,105,17,34,10,25,7,9
2186269,25,1,1988,1,male,211,193,111,17,9,17,8,0,1
1651480,33,26,1980,12,male,463,192,74,17,3,17,1,0,2
1099746,22,6,1991,8,male,473,191,152,18,32,9,26,9,6
1157316,16,9,1997,10,male,119,193,159,18,98,17,63,1,35
1988305,44,2,1969,4,male,298,196,131,18,49,15,31,3,18
1084546,65,5,1948,2,male,1567,191,88,18,39,14,9,4,30
1901703,28,20,1985,4,female,19,195,134,18,470,18,256,0,214
1309811,47,1,1966,9,male,397,194,97,19,0,0,0,19,0
1853486,16,28,1997,7,male,158,194,147,19,1,5,0,14,1
1469021,16,7,1997,11,male,182,192,143,19,5,9,5,10,0
2108539,28,8,1985,9,male,569,194,162,19,11,18,9,1,2
1470286,20,15,1993,6,female,541,197,171,19,67,18,16,1,51
1913923,21,6,1992,2,male,735,196,66,19,31,16,20,3,11
1614695,28,7,1985,12,male,647,192,165,19,3,19,3,0,0
1166516,42,26,1971,5,male,841,197,179,19,0,19,0,0,0
1987277,22,22,1991,5,female,306,193,121,19,28,19,23,0,5
1006486,28,29,1985,4,female,496,191,77,19,28,19,26,0,2
1389682,67,9,1946,9,female,1522,194,112,19,26,19,15,0,11
1693042,21,2,1992,4,female,783,194,30,19,60,19,53,0,7
2066819,97,11,1916,9,female,1582,191,109,19,83,19,64,0,19
1298622,64,14,1949,12,female,1378,194,79,20,8,4,6,16,2
1183412,33,2,1980,1,male,212,192,47,20,294,14,118,6,176
1221290,43,29,1970,9,female,445,195,18,20,16,19,8,1,8
1765129,18,10,1995,7,female,302,192,93,20,31,20,31,0,0
1279381,34,21,1979,4,female,223,194,73,20,32,20,19,0,13
1925742,32,29,1981,3,male,314,196,165,21,43,0,35,21,8
2071592,43,18,1970,5,male,172,193,167,21,64,11,48,10,16
1536832,15,18,1998,3,male,176,195,100,21,0,21,0,0,0
1362934,108,19,1905,2,male,261,191,144,22,20,0,6,22,14
1785041,23,12,1990,5,female,429,194,127,22,66,12,41,10,25
1973668,33,5,1980,12,male,248,193,117,22,121,20,46,2,75
1503320,29,7,1984,9,female,315,195,54,22,23,22,23,0,0
1176533,20,3,1993,6,female,505,196,151,23,45,4,34,19,11
1601559,16,20,1997,11,male,551,194,134,23,43,8,6,15,37
2003173,16,19,1997,2,male,382,192,145,23,3,17,0,6,3
1030824,27,26,1986,12,male,125,195,91,23,12,23,10,0,2
1605824,28,22,1985,6,male,332,191,120,23,62,23,59,0,3
1187118,50,16,1963,3,male,638,195,81,23,60,23,31,0,29
1864950,29,15,1984,2,male,529,197,95,24,10,0,2,24,8
1521921,56,24,1957,1,female,415,196,147,24,26,0,6,24,20
1756302,34,26,1979,5,male,502,193,90,24,9,11,5,13,4
1872331,22,20,1991,8,male,150,196,82,24,79,24,25,0,54
1662240,44,13,1969,4,female,1756,197,125,24,206,24,166,0,40
1649775,64,6,1949,5,male,1425,194,132,25,13,0,7,25,6
1099973,30,26,1983,9,male,536,196,154,25,32,3,16,22,16
1664417,17,5,1996,8,female,558,197,77,25,53,8,33,17,20
1751219,33,25,1980,5,male,802,195,160,25,16,24,3,1,13
1154464,48,17,1965,4,male,471,195,89,25,34,19,14,6,20
1429340,27,29,1986,12,male,298,191,143,25,4,25,4,0,0
1362237,49,31,1964,12,female,340,196,66,25,1,25,1,0,0
2178906,26,12,1987,5,female,550,196,137,25,14,25,10,0,4
1350656,56,8,1957,11,male,144,192,179,25,38,25,16,0,22
1016957,20,15,1993,9,male,194,196,112,26,0,15,0,11,0
1575400,64,22,1949,11,female,1624,193,85,26,12,8,7,18,5
1758163,27,15,1986,1,male,758,195,129,26,3,26,3,0,0
1303978,41,4,1972,10,male,607,191,157,26,8,26,8,0,0
1833575,22,15,1991,8,female,296,195,131,26,47,26,18,0,29
1962594,44,13,1969,2,male,436,193,116,27,28,0,3,27,25
1110881,20,17,1993,5,male,407,191,179,27,27,10,20,17,7
1030217,22,17,1991,3,male,452,195,78,27,36,25,16,2,20
1000883,108,3,1905,7,female,547,196,65,27,16,27,15,0,1
1802472,16,19,1997,5,male,51,197,43,27,28,27,26,0,2
1847995,36,14,1977,12,female,529,191,89,27,73,27,33,0,40
1121878,16,1,1997,1,male,571,197,138,28,3,3,3,25,0
1288341,108,13,1905,9,male,1019,192,160,28,6,0,4,28,2
1467931,108,25,1905,9,female,1092,194,116,28,44,3,18,25,26
1475682,53,18,1960,4,male,1267,196,79,28,15,6,6,22,9
1570428,18,19,1995,9,female,443,197,83,28,44,25,9,3,35
1971301,23,3,1990,11,male,352,196,141,28,7,28,5,0,2
1906684,21,4,1992,9,male,718,196,155,28,62,28,56,0,6
1487198,17,11,1996,8,female,64,192,165,29,79,2,4,27,75
1568501,21,22,1992,8,female,506,191,87,29,49,11,37,18,12
1807697,24,16,1989,6,female,687,192,107,29,47,19,31,10,16
1189838,62,3,1951,3,female,1723,197,21,29,39,29,22,0,17
1792569,94,18,1919,9,male,246,191,114,30,2,4,2,26,0
2187979,87,25,1926,10,male,807,194,92,31,101,2,44,29,57
1720919,20,19,1993,3,female,339,197,56,30,14,10,7,20,7
1061499,30,19,1983,5,female,663,195,71,31,17,19,3,12,14
1136020,17,31,1996,1,male,780,197,119,30,29,17,9,13,20
1658275,35,25,1978,7,female,587,191,157,30,0,28,0,2,0
1802044,66,10,1947,1,female,1579,192,108,31,12,26,6,5,6
1253852,15,6,1998,7,female,53,191,166,30,8,30,4,0,4
1370704,20,11,1993,11,female,370,197,153,30,18,30,17,0,1
1238980,60,5,1953,12,female,1372,193,123,31,9,31,7,0,2
1788511,68,17,1945,8,male,490,191,109,30,7,30,7,0,0
1890164,21,1,1992,12,male,175,195,114,32,79,19,27,13,52
1987025,60,4,1953,7,male,99,192,181,32,25,32,18,0,7
1123152,20,7,1993,11,female,550,193,141,34,27,0,0,34,27
1741355,67,7,1946,10,male,2224,194,115,34,28,2,13,32,15
1425435,98,1,1915,1,male,1656,196,39,34,35,18,17,16,18
1377104,19,17,1994,4,male,405,192,96,36,9,0,3,36,6
1095475,58,11,1955,11,female,486,191,140,35,18,0,3,35,15
1493330,18,15,1995,3,male,635,193,60,36,8,8,2,28,6
1919085,22,21,1991,8,female,905,197,52,36,6,26,3,10,3
1959972,16,30,1997,10,female,286,192,92,35,9,33,4,2,5
1443898,22,4,1991,6,male,318,192,94,35,27,26,9,9,18
1356399,26,18,1987,3,male,712,194,135,36,141,35,89,1,52
1889613,54,22,1959,2,male,684,196,42,35,68,26,27,9,41
1472678,16,24,1997,9,female,452,192,162,36,3,36,3,0,0
1032835,108,18,1905,9,male,1541,193,81,35,1,35,0,0,1
1682701,22,27,1991,9,male,72,194,192,36,21,36,20,0,1
1713807,23,9,1990,9,male,429,192,161,35,52,35,38,0,14
1013046,33,17,1980,9,male,452,192,104,35,87,35,68,0,19
1977961,23,4,1990,8,male,433,197,181,37,40,36,38,1,2
1118589,35,1,1978,9,male,541,193,158,37,0,37,0,0,0
2113988,64,4,1949,2,female,104,195,180,37,38,37,12,0,26
1993687,28,8,1985,5,male,504,195,175,38,12,22,6,16,6
1839906,26,18,1987,7,male,806,196,171,38,382,17,353,21,29
1278899,64,27,1949,2,male,748,191,133,39,4,34,2,5,2
1426009,20,24,1993,9,male,626,196,138,39,111,37,77,2,34
1393176,98,4,1915,6,male,364,195,134,38,32,38,32,0,0
1104686,103,20,1910,2,male,1526,191,91,39,36,39,33,0,3
1997073,34,23,1979,9,female,1188,192,149,38,63,38,49,0,14
1327016,61,28,1952,12,male,2216,192,128,38,63,38,46,0,17
2086698,93,6,1920,9,female,809,197,67,40,39,0,27,40,12
1116742,61,19,1952,5,male,936,196,97,40,103,12,43,28,60
1457657,36,3,1977,9,male,493,191,73,40,117,40,89,0,28
2093159,43,28,1970,11,male,798,196,92,40,99,40,55,0,44
2106197,38,4,1975,10,male,455,196,115,41,20,0,6,41,14
2023963,55,29,1958,9,male,1017,195,167,42,35,0,11,42,24
1849508,21,2,1992,9,male,525,191,142,41,59,12,14,29,45
1641931,22,16,1991,1,male,714,194,112,41,2,39,2,2,0
1630918,16,11,1997,3,female,442,191,81,42,9,36,7,6,2
1074836,103,28,1910,4,female,744,197,103,41,17,41,17,0,0
1669099,14,27,1999,9,male,207,193,66,42,27,42,24,0,3
1120727,57,7,1956,10,female,1016,191,82,44,52,2,27,42,25
1050886,22,5,1991,7,female,1254,195,94,43,8,10,4,33,4
2175870,14,18,1999,1,male,393,193,136,44,3,43,3,1,0
1613234,61,12,1952,8,female,498,197,88,44,10,44,3,0,7
1971520,16,27,1997,7,female,186,195,116,44,160,44,153,0,7
1169382,20,11,1993,9,female,269,197,166,45,135,20,52,25,83
1490427,20,27,1993,6,female,231,197,65,45,41,43,36,2,5
1858406,32,2,1981,3,male,606,194,148,46,16,31,11,15,5
1687306,55,4,1958,3,female,2128,197,123,47,21,28,18,19,3
1289087,32,1,1981,2,male,202,195,135,46,246,11,120,35,126
2072130,20,6,1993,3,male,402,192,37,47,58,47,38,0,20
1536274,48,29,1965,5,female,253,196,36,46,51,46,36,0,15
1552306,33,16,1980,4,female,229,195,132,46,73,46,69,0,4
1052699,40,16,1973,2,male,1489,193,44,49,49,36,30,13,19
1148121,103,3,1910,11,male,751,194,136,49,25,49,25,0,0
2076139,96,6,1917,1,female,905,196,43,48,34,48,33,0,1
1445718,47,16,1966,11,female,838,191,133,50,8,38,7,12,1
1782035,23,11,1990,11,male,572,194,82,50,85,49,78,1,7
1590779,24,18,1989,11,male,402,196,139,50,57,50,47,0,10
1952774,17,31,1996,10,male,426,195,159,53,45,51,22,2,23
1489379,25,7,1988,4,female,239,196,135,52,85,47,49,5,36
2044397,18,25,1995,3,male,270,196,120,52,16,52,12,0,4
1979781,27,25,1986,1,female,1298,195,69,53,14,53,14,0,0
1986074,28,27,1985,4,female,1177,194,127,52,99,52,85,0,14
1059116,16,15,1997,9,female,253,197,103,55,40,17,24,38,16
1514453,49,16,1964,10,male,440,197,176,55,46,18,27,37,19
1794629,101,12,1912,12,male,236,194,111,54,21,54,16,0,5
1721394,14,14,1999,8,female,375,196,134,54,54,54,54,0,0
1125220,17,20,1996,11,female,266,196,107,55,38,55,22,0,16
1228849,20,28,1993,5,female,703,195,35,58,57,8,30,50,27
1955134,56,29,1957,10,female,741,193,119,58,161,0,32,58,129
1778828,59,20,1954,3,female,1260,194,106,56,173,39,114,17,59
1840126,22,5,1991,10,male,179,195,166,56,19,55,17,1,2
2084950,22,25,1991,10,male,679,196,149,58,4,58,3,0,1
1767052,42,2,1971,6,male,592,195,121,56,44,56,15,0,29
1520302,69,29,1944,1,female,793,197,159,58,66,58,47,0,19
1516987,100,7,1913,5,female,1017,194,97,58,36,58,25,0,11
1497565,33,20,1980,1,female,328,191,88,57,151,57,81,0,70
1075766,83,5,1930,6,female,2289,194,62,59,21,0,13,59,8
1298006,46,12,1967,2,female,763,196,104,60,89,13,12,47,77
1126318,13,8,2000,4,male,464,194,72,59,83,52,58,7,25
1297324,18,15,1995,7,male,501,193,95,59,63,54,45,5,18
1897621,52,18,1961,6,male,1001,197,117,60,171,53,80,7,91
1316643,15,30,1998,5,female,448,195,64,59,54,59,47,0,7
1536487,21,24,1992,4,male,228,194,169,60,70,60,58,0,12
1112371,64,5,1949,4,male,105,194,173,60,61,60,40,0,21
1996883,20,24,1993,1,male,64,192,177,62,150,55,83,7,67
1983188,108,20,1905,12,female,902,194,103,62,4,62,4,0,0
1741381,14,1,1999,9,male,367,195,141,63,19,63,6,0,13
1146451,16,31,1997,5,male,655,196,151,61,19,61,3,0,16
1375337,32,17,1981,5,female,555,193,70,61,112,61,102,0,10
1718148,30,9,1983,2,male,384,196,71,65,4,58,2,7,2
1859091,58,19,1955,3,male,165,193,101,68,67,0,15,68,52
1202369,14,3,1999,10,female,316,196,103,66,23,34,14,32,9
1204468,36,12,1977,12,female,375,197,120,67,111,38,91,29,20
1529929,19,30,1994,8,male,540,192,97,68,16,63,6,5,10
1624861,46,30,1967,3,female,583,192,92,67,65,62,37,5,28
1644081,32,26,1981,5,male,524,193,83,66,7,66,4,0,3
1262434,59,16,1954,1,male,380,192,146,67,32,67,9,0,23
2047859,15,20,1998,8,female,207,195,152,66,84,66,58,0,26
1815030,21,11,1992,8,female,650,196,29,66,81,66,48,0,33
1677667,25,8,1988,12,female,376,197,131,68,64,68,64,0,0
1821255,45,30,1968,4,male,556,193,73,67,41,67,24,0,17
1639096,47,14,1966,11,male,299,194,131,66,79,66,70,0,9
1176496,103,8,1910,5,female,755,194,116,66,51,66,24,0,27
1293431,59,24,1954,5,male,740,194,66,70,34,0,23,70,11
1741920,103,16,1910,7,male,1327,194,124,69,4,39,1,30,3
1795625,15,27,1998,5,female,446,193,81,69,61,39,34,30,27
1245652,15,3,1998,1,male,113,196,152,69,45,58,31,11,14
2014042,28,26,1985,6,male,410,191,111,69,5,69,4,0,1
1751335,18,5,1995,5,male,46,193,189,71,22,71,20,0,2
1807135,24,9,1989,10,male,269,194,139,70,38,70,26,0,12
1141792,24,1,1989,1,male,596,193,141,69,125,69,114,0,11
1942843,17,6,1996,11,female,356,196,72,72,20,7,8,65,12
1625860,62,17,1951,1,female,728,196,96,73,456,0,141,73,315
1683494,54,1,1959,2,male,1319,194,135,74,73,74,26,0,47
1463060,58,10,1955,7,male,1444,195,120,77,79,73,48,4,31
1460780,50,9,1963,1,female,296,192,136,75,22,75,12,0,10
1523528,65,21,1948,9,female,1770,195,72,77,67,77,36,0,31
1651005,51,17,1962,4,male,766,196,167,77,120,77,55,0,65
2132484,51,17,1962,12,male,2075,192,147,78,171,48,108,30,63
1874425,29,6,1984,8,male,223,191,171,80,1,80,1,0,0
1924130,26,1,1987,1,female,393,193,115,79,24,79,22,0,2
1204396,100,1,1913,1,female,438,192,177,80,30,80,26,0,4
2083294,28,5,1985,1,female,731,195,102,79,121,79,47,0,74
1865599,58,19,1955,12,female,363,192,101,80,129,80,75,0,54
2177858,49,9,1964,3,female,1478,195,85,82,77,1,28,81,49
1536606,58,18,1955,9,female,1700,192,57,83,224,31,83,52,141
1415870,26,1,1987,9,male,361,193,131,83,35,79,30,4,5
1407998,23,19,1990,5,male,268,194,61,84,76,84,52,0,24
1831942,39,16,1974,7,male,186,197,32,84,77,84,62,0,15
1687263,56,2,1957,4,female,581,191,166,81,116,81,42,0,74
1243352,41,19,1972,12,female,2235,197,90,84,472,84,393,0,79
2108187,54,5,1959,3,female,1519,192,158,86,366,9,92,77,274
1548494,26,1,1987,1,female,1827,193,25,87,159,48,72,39,87
1768840,32,9,1981,7,female,211,191,100,86,172,46,67,40,105
1421024,51,1,1962,7,female,1458,197,108,87,132,57,90,30,42
1482572,61,6,1952,10,female,1372,195,123,85,342,21,201,64,141
2055468,37,15,1976,11,female,1539,197,88,86,111,74,79,12,32
1471800,24,18,1989,12,female,164,192,177,87,51,87,39,0,12
1529208,54,11,1959,11,female,1734,193,108,85,78,85,57,0,21
1893644,36,2,1977,3,female,457,191,169,88,88,16,61,72,27
1648185,101,29,1912,1,male,1400,197,58,91,197,17,117,74,80
1020628,33,28,1980,3,female,235,195,66,91,17,30,6,61,11
2063945,24,10,1989,6,female,512,196,158,88,190,26,108,62,82
2009887,18,19,1995,12,female,541,197,137,91,99,84,56,7,43
1006188,25,7,1988,10,male,422,194,165,89,18,89,9,0,9
1874807,21,16,1992,7,male,850,197,119,95,74,10,27,85,47
1911668,26,16,1987,7,male,333,194,104,93,42,54,21,39,21
1308166,107,4,1906,11,male,356,197,109,95,69,36,53,59,16
2124090,17,1,1996,2,female,37,196,24,93,206,54,126,39,80
2030726,20,14,1993,2,female,387,191,39,94,29,93,22,1,7
1885592,24,13,1989,11,male,299,195,144,94,59,68,28,26,31
2164441,59,28,1954,4,male,1490,194,150,92,8,92,4,0,4
2115911,16,2,1997,10,female,223,192,109,93,29,93,26,0,3
1213866,108,29,1905,7,female,326,196,125,93,103,93,99,0,4
1973199,30,5,1983,9,female,307,197,160,97,0,0,0,97,0
1899678,23,2,1990,5,female,404,195,125,97,53,46,27,51,26
1938870,98,2,1915,1,female,1462,191,59,98,76,95,63,3,13
2162471,16,12,1997,1,female,369,194,118,99,47,99,45,0,2
1078077,68,4,1945,6,male,216,193,125,97,46,97,19,0,27
1599309,27,29,1986,3,male,422,192,148,102,9,12,8,90,1
1811529,26,25,1987,6,female,468,196,154,102,125,1,82,101,43
1331441,17,29,1996,6,male,303,195,88,100,55,24,32,76,23
2041765,21,6,1992,2,male,495,194,138,104,69,102,59,2,10
1176682,27,29,1986,5,female,618,192,112,102,326,101,266,1,60
2165649,46,19,1967,2,male,102,197,110,104,11,104,7,0,4
1076188,68,25,1945,4,male,295,196,176,104,18,104,10,0,8
1064101,37,26,1976,6,female,737,196,87,102,141,102,87,0,54
2024924,28,2,1985,5,male,768,192,123,100,820,100,754,0,66
1956386,45,17,1968,1,male,1361,193,12,100,174,100,166,0,8
1221949,31,31,1982,3,male,944,197,149,106,25,21,17,85,8
1448461,15,3,1998,7,male,504,193,150,105,134,68,33,37,101
1224030,26,19,1987,7,female,831,195,77,109,82,38,35,71,47
1379138,49,12,1964,12,female,1508,193,123,106,132,104,83,2,49
1125650,15,8,1998,12,female,277,196,142,106,39,106,13,0,26
1454235,23,24,1990,4,male,600,193,131,109,22,109,18,0,4
1881352,33,21,1980,8,female,409,193,174,105,38,105,31,0,7
1727025,33,5,1980,2,male,1761,191,101,113,31,11,7,102,24
1359554,54,9,1959,7,female,376,196,114,111,175,0,43,111,132
1399252,26,12,1987,10,male,577,197,97,113,122,43,86,70,36
1261567,28,2,1985,1,female,175,192,11,111,500,81,97,30,403
1893550,18,15,1995,10,male,155,196,92,112,9,112,5,0,4
1978551,65,2,1948,12,female,940,196,146,113,17,113,9,0,8
1216991,21,30,1992,12,male,736,197,63,111,57,111,41,0,16
1845568,27,23,1986,7,male,181,192,107,112,148,112,55,0,93
1971198,28,7,1985,8,male,248,193,49,110,190,110,159,0,31
1547863,58,11,1955,7,female,1815,193,111,114,36,26,18,88,18
1619092,100,1,1913,4,female,2173,195,73,114,442,27,128,87,314
2090990,25,3,1988,9,male,637,193,145,118,112,108,38,10,74
1700452,18,6,1995,6,female,196,197,97,118,203,112,115,6,88
1034481,30,16,1983,12,female,684,197,85,118,442,102,405,16,37
2152207,49,11,1964,11,female,339,197,135,116,19,116,13,0,6
1796619,20,10,1993,5,female,270,196,70,117,115,117,52,0,63
1977583,38,16,1975,10,male,334,197,123,115,88,115,38,0,50
1345904,90,29,1923,10,male,2198,192,70,117,184,117,156,0,28
2167257,23,12,1990,7,male,439,193,85,124,46,2,32,122,14
2125150,106,22,1907,4,male,1315,195,151,121,121,117,69,4,52
1696718,36,4,1977,4,female,281,192,126,120,55,120,53,0,2
2109341,37,17,1976,10,female,356,195,144,122,59,122,36,0,23
1422787,21,31,1992,12,male,862,195,89,124,136,124,40,0,96
1218421,27,11,1986,11,male,680,191,46,123,90,123,74,0,16
2149601,27,3,1986,3,female,314,195,48,124,404,124,143,0,261
1001146,79,2,1934,6,male,303,197,120,125,41,0,6,125,35
1972706,14,10,1999,9,female,134,191,119,129,35,52,17,77,18
1476047,16,15,1997,8,male,953,191,78,127,71,114,55,13,16
1249448,19,20,1994,9,female,347,192,159,130,268,128,228,2,40
2037138,20,3,1993,8,female,147,191,46,125,117,125,74,0,43
1963883,21,30,1992,8,male,127,191,129,125,104,125,33,0,71
1518656,17,26,1996,8,male,549,197,133,134,231,17,141,117,90
1906895,19,25,1994,10,male,356,194,140,136,26,31,3,105,23
1662252,23,26,1990,4,male,344,194,78,133,23,129,21,4,2
1866326,21,22,1992,8,male,415,193,111,134,74,134,67,0,7
2003324,50,14,1963,4,male,333,194,146,131,28,131,9,0,19
2089638,70,1,1943,1,female,965,194,127,136,61,136,52,0,9
1612094,34,14,1979,12,male,583,194,134,138,306,68,98,70,208
1530617,21,9,1992,6,female,200,192,112,138,54,138,21,0,33
1790586,52,26,1961,10,female,294,193,134,143,83,143,72,0,11
1275731,21,30,1992,6,female,57,192,152,140,393,140,373,0,20
1958213,75,17,1938,3,female,2135,191,118,144,138,0,50,144,88
1697343,19,26,1994,9,male,499,197,98,144,78,104,47,40,31
1192569,24,6,1989,8,female,551,192,155,146,68,85,3,61,65
2085025,55,22,1958,11,female,1409,191,113,148,142,33,66,115,76
1276569,64,7,1949,3,male,841,197,137,147,7,131,6,16,1
1153462,23,20,1990,4,male,1097,191,137,146,33,133,30,13,3
1723339,106,1,1907,1,female,2788,191,110,149,97,136,53,13,44
1802163,25,4,1988,3,male,358,195,99,145,51,145,47,0,4
1860176,26,7,1987,5,male,211,191,138,148,34,148,25,0,9
1639410,20,25,1993,12,female,58,195,104,144,178,144,161,0,17
1208011,16,5,1997,9,male,438,194,79,157,22,8,13,149,9
1593803,23,16,1990,9,female,551,194,66,153,93,12,65,141,28
1953928,49,17,1964,6,female,2205,196,53,157,47,27,28,130,19
1916132,59,17,1954,1,female,998,191,44,157,150,4,57,153,93
1651358,34,2,1979,12,female,1928,191,138,153,286,78,102,75,184
2067303,63,6,1950,2,male,862,197,45,151,120,119,73,32,47
2183458,19,23,1994,6,female,214,195,134,152,258,144,177,8,81
1908484,20,15,1993,10,female,695,191,65,155,16,155,14,0,2
2170249,29,17,1984,10,female,453,197,146,156,104,156,72,0,32
1329741,57,31,1956,3,female,650,196,58,163,97,0,46,163,51
1370043,21,5,1992,7,female,968,195,89,158,193,50,113,108,80
1463299,55,24,1958,10,female,36,191,167,164,131,82,57,82,74
1685801,108,18,1905,9,female,1327,197,84,161,236,144,92,17,144
1142505,48,12,1965,1,female,1349,194,54,159,302,121,112,38,190
1236656,22,27,1991,9,male,715,194,151,159,4,159,4,0,0
1672412,17,21,1996,9,female,174,191,102,159,72,159,48,0,24
1594802,18,4,1995,4,male,416,191,148,161,80,161,75,0,5
2105926,54,30,1959,5,female,854,191,54,159,369,159,190,0,179
1199395,29,20,1984,2,female,374,193,171,170,102,159,26,11,76
2057213,36,3,1977,3,male,305,196,143,168,184,165,131,3,53
1786173,16,21,1997,6,male,718,193,155,166,0,165,0,1,0
2103163,15,13,1998,8,male,137,195,167,171,1,171,0,0,1
2120499,41,3,1972,5,male,61,191,170,167,99,167,51,0,48
1374955,16,20,1997,3,female,246,192,50,179,90,30,32,149,58
1357511,61,7,1952,9,female,422,191,183,177,595,0,272,177,323
1095180,20,1,1993,1,female,1741,197,145,181,131,111,102,70,29
1551723,15,6,1998,3,female,349,195,61,181,285,121,194,60,91
1591858,18,12,1995,11,male,180,194,161,175,37,164,20,11,17
1674264,19,29,1994,5,female,604,192,73,178,246,173,92,5,154
1511466,19,8,1994,5,male,348,191,160,173,144,173,133,0,11
1249324,63,4,1950,2,female,1506,195,132,190,24,0,13,190,11
1653510,49,21,1964,1,female,348,197,127,189,60,12,48,177,12
2054502,29,12,1984,11,female,752,196,162,187,36,95,9,92,27
1921102,26,30,1987,8,female,960,193,113,182,171,102,50,80,121
1732307,17,13,1996,6,female,117,197,149,183,115,133,107,50,8
1752552,25,1,1988,1,male,122,195,182,183,75,183,8,0,67
1599540,66,8,1947,6,female,949,193,101,183,104,183,99,0,5
1554331,23,12,1990,10,male,514,196,134,190,148,190,116,0,32
1879896,54,7,1959,9,male,887,193,164,196,32,1,3,195,29
1065346,28,5,1985,10,female,531,192,92,192,256,33,51,159,205
1571011,24,5,1989,5,female,291,191,137,191,56,74,18,117,38
1661498,29,19,1984,3,female,525,196,86,198,337,192,266,6,71
2069957,27,11,1986,10,female,574,196,104,198,115,198,71,0,44
1167674,54,16,1959,3,female,204,196,15,192,256,192,231,0,25
1811493,49,22,1964,3,male,752,197,147,211,60,174,22,37,38
2134115,18,23,1995,12,male,568,196,120,205,618,200,497,5,121
1239327,17,4,1996,11,male,100,192,168,205,128,205,115,0,13
1912951,52,2,1961,7,female,1363,195,90,220,123,220,65,0,58
2153259,64,7,1949,1,male,1564,195,63,231,59,3,29,228,30
1827503,17,22,1996,7,female,362,196,139,229,76,151,38,78,38
1220985,93,11,1920,1,female,127,191,36,232,85,121,26,111,59
1094739,13,11,2000,4,female,260,192,151,232,153,228,87,4,66
1402487,29,29,1984,12,female,469,197,123,225,246,221,93,4,153
1683004,100,1,1913,7,female,1235,197,133,226,104,226,74,0,30
2111089,17,30,1996,12,female,313,194,126,225,293,225,271,0,22
1453550,24,4,1989,6,male,25,193,175,233,205,233,197,0,8
1346347,24,21,1989,10,female,639,193,87,228,185,228,181,0,4
1670983,39,16,1974,6,male,413,197,106,242,10,4,4,238,6
1372186,15,1,1998,5,female,451,193,97,239,52,13,26,226,26
1306713,58,7,1955,7,female,579,192,102,243,267,0,63,243,204
1327078,20,1,1993,1,male,470,196,131,239,46,114,7,125,39
1973221,14,11,1999,1,male,271,196,131,237,347,107,137,130,210
2134146,14,6,1999,9,female,379,194,93,245,285,72,50,173,235
1209938,67,16,1946,3,female,1777,193,104,234,188,141,97,93,91
1495973,32,18,1981,1,female,284,196,102,243,193,187,70,56,123
1707157,26,29,1987,8,female,83,196,91,235,120,235,96,0,24
1722405,19,10,1994,6,female,419,193,113,258,174,55,40,203,134
1142861,35,21,1978,12,female,286,193,121,260,111,260,86,0,25
1150596,57,9,1956,6,female,881,192,111,257,85,257,79,0,6
1852556,101,20,1912,2,female,523,193,75,252,150,252,141,0,9
1915687,103,30,1910,10,female,1083,197,96,249,223,249,134,0,89
1762504,55,21,1958,6,male,864,197,135,259,1992,259,1576,0,416
1072694,48,13,1965,4,male,129,192,185,264,207,0,103,264,104
1229217,57,16,1956,6,female,825,192,84,261,590,2,229,259,361
1658562,40,27,1973,2,male,528,191,96,275,163,110,86,165,77
1155985,103,19,1910,4,male,1447,197,114,276,215,83,81,193,134
1296289,55,23,1958,4,female,1635,196,119,265,9,265,9,0,0
1901437,15,19,1998,2,female,201,194,103,286,44,19,7,267,37
1446776,58,2,1955,10,female,725,194,132,287,165,0,42,287,123
1163112,31,29,1982,8,female,908,196,102,292,595,291,303,1,292
1841680,32,14,1981,11,male,228,195,133,281,119,281,118,0,1
1416275,22,4,1991,2,female,617,193,83,278,212,278,177,0,35
1020393,51,23,1962,10,female,365,196,148,299,165,0,28,299,137
1612800,38,14,1975,5,female,696,191,116,295,279,205,81,90,198
1634185,55,26,1958,9,female,1248,197,67,298,316,258,244,40,72
1652321,25,2,1988,7,female,573,191,82,302,182,302,127,0,55
1219201,27,22,1986,8,male,212,197,186,296,50,296,33,0,17
1715949,108,5,1905,5,male,868,191,87,298,57,298,53,0,4
1745741,56,23,1957,2,female,460,195,149,322,88,3,30,319,58
1619482,38,10,1975,10,female,695,197,135,315,276,177,181,138,95
1367257,50,20,1963,7,male,332,197,96,314,215,86,51,228,164
1087175,20,28,1993,4,female,1744,197,88,324,100,303,78,21,22
1805418,58,25,1955,5,female,456,191,110,322,110,322,90,0,20
1507108,17,31,1996,8,female,494,191,65,322,201,322,160,0,41
1281183,63,23,1950,3,female,1428,193,94,346,168,323,98,23,70
1653288,40,2,1973,8,female,700,196,140,340,436,293,364,47,72
1324199,71,24,1942,4,female,1563,197,83,342,498,271,247,71,251
2080530,18,23,1995,6,male,254,191,146,338,271,338,233,0,38
1037978,17,26,1996,3,male,282,194,99,356,500,184,243,172,257
1536530,36,20,1977,6,female,556,192,110,364,179,359,19,5,160
1269883,58,13,1955,8,female,742,195,105,348,45,348,41,0,4
1485970,32,26,1981,2,female,508,194,58,360,218,360,126,0,92
1398712,37,27,1976,6,male,406,196,37,358,194,358,173,0,21
1218455,106,4,1907,10,male,1496,195,48,387,170,82,81,305,89
1279152,16,24,1997,12,female,512,196,111,381,56,301,11,80,45
1486027,20,1,1993,1,male,483,192,120,389,228,349,73,40,155
1605478,24,21,1989,12,female,499,193,116,379,97,365,38,14,59
2052694,48,22,1965,7,male,193,192,162,385,384,315,161,70,223
1540724,51,10,1962,7,female,1707,192,149,382,306,287,48,95,258
1215265,14,4,1999,3,male,254,196,148,379,69,379,54,0,15
1723685,17,14,1996,11,female,646,194,152,390,95,390,77,0,18
1909989,18,25,1995,3,female,565,193,139,379,258,379,194,0,64
1133582,55,26,1958,8,female,1946,197,96,418,238,42,119,376,119
1072942,29,9,1984,5,female,1060,196,120,420,501,1,301,419,200
1178818,57,4,1956,4,male,1108,196,107,408,327,158,254,250,73
1953154,23,14,1990,12,male,246,192,139,416,60,382,58,34,2
1675807,108,14,1905,8,female,1808,195,84,411,145,341,95,70,50
1371632,43,12,1970,1,male,825,195,94,418,360,356,202,62,158
2020042,55,13,1958,3,female,1030,191,89,406,446,336,297,70,149
1848828,34,11,1979,10,male,851,194,107,401,26,399,8,2,18
1006923,14,6,1999,3,female,456,196,125,409,26,409,11,0,15
1081209,62,3,1951,8,male,1831,192,102,407,15,407,9,0,6
1964619,14,19,1999,9,male,330,195,95,448,150,85,23,363,127
1273157,19,22,1994,7,female,70,195,75,440,311,75,64,365,247
1497281,37,29,1976,12,female,1523,191,80,446,218,101,81,345,137
1552610,39,7,1974,3,female,479,196,125,422,180,92,128,330,52
1000136,56,13,1957,5,female,1767,194,80,422,408,141,143,281,265
1338979,16,24,1997,11,female,293,194,114,447,1355,210,241,237,1114
1416169,38,16,1975,1,female,181,194,157,437,365,363,217,74,148
1523451,26,6,1987,1,female,303,197,151,472,332,255,209,217,123
1344309,14,5,1999,9,female,273,194,56,468,71,431,31,37,40
1506337,17,16,1996,6,male,154,192,145,465,181,454,101,11,80
1191882,65,25,1948,8,female,1946,194,106,483,155,454,106,29,49
1381359,30,25,1983,9,female,175,197,127,471,379,371,141,100,238
1965276,60,1,1953,9,female,977,192,121,483,318,453,216,30,102
1039218,16,8,1997,9,female,585,197,93,481,21,477,18,4,3
1229195,15,9,1998,3,female,13,195,165,452,237,451,221,1,16
1331203,40,12,1973,7,male,532,196,111,459,22,459,20,0,2
1308489,25,1,1988,1,male,192,197,29,473,960,473,596,0,364
1012824,50,8,1963,6,female,1530,192,88,497,67,35,34,462,33
1861356,72,21,1941,11,male,950,195,97,488,171,2,38,486,133
1882894,60,27,1953,2,female,1270,192,120,503,524,146,168,357,356
1946302,25,4,1988,2,male,341,194,158,503,262,424,108,79,154
1481471,23,21,1990,10,female,304,193,134,502,344,502,257,0,87
1449930,68,2,1945,1,female,1721,194,85,545,132,15,105,530,27
1498081,19,28,1994,12,female,481,194,96,556,566,262,60,294,506
1106904,29,22,1984,7,female,100,197,144,560,856,187,326,373,530
1190143,19,9,1994,7,male,586,196,149,559,39,531,4,28,35
1027488,32,18,1981,4,female,386,191,113,520,6,520,5,0,1
2066245,31,6,1982,7,female,451,193,60,543,565,543,336,0,229
1137969,26,8,1987,6,female,188,195,71,531,889,531,565,0,324
2126539,54,16,1959,3,female,1888,196,123,535,1793,535,961,0,832
1460000,61,5,1952,10,male,1558,197,93,601,1579,46,1097,555,482
1067956,20,21,1993,3,female,439,196,134,588,359,385,43,203,316
1646591,22,25,1991,11,female,790,196,161,596,455,446,306,150,149
2127223,53,22,1960,8,female,455,193,120,633,419,0,117,633,302
2136779,108,21,1905,2,female,857,194,88,634,409,57,134,577,275
2051057,17,18,1996,1,male,608,194,79,616,204,162,129,454,75
1133259,63,9,1950,7,female,1226,196,109,612,253,355,121,257,132
1028666,18,4,1995,6,female,80,193,92,640,456,193,96,447,360
2001568,20,21,1993,3,female,1250,196,52,657,960,474,184,183,776
1197833,62,8,1951,10,female,1161,193,102,638,474,356,42,282,432
1330522,65,4,1948,12,female,1569,196,124,655,511,369,269,286,242
2008737,68,3,1945,4,male,2242,193,94,629,487,162,215,467,272
1031184,26,21,1987,6,female,394,191,162,615,925,589,661,26,264
1442796,37,5,1976,10,female,473,191,137,622,419,616,388,6,31
1952963,58,22,1955,1,male,273,193,87,672,207,7,78,665,129
1356084,24,1,1989,1,male,577,197,82,690,433,690,374,0,59
1516715,32,24,1981,7,female,237,196,148,702,472,702,339,0,133
1666406,33,28,1980,8,female,856,191,122,781,703,130,335,651,368
1526099,29,16,1984,4,female,79,195,176,764,510,169,335,595,175
1273775,49,29,1964,10,female,1095,194,53,729,1226,698,802,31,424
1668885,18,30,1995,3,female,295,191,90,833,708,44,246,789,462
1361175,47,22,1966,1,female,880,194,114,837,806,361,487,476,319
1202335,30,3,1983,11,female,325,194,95,838,216,838,186,0,30
2188366,37,28,1976,6,female,299,194,64,827,491,827,411,0,80
1611902,22,11,1991,8,male,291,191,165,829,693,829,667,0,26
2081049,67,30,1946,1,female,1475,195,75,917,688,0,247,917,441
1088242,24,23,1989,11,male,475,197,160,936,26,936,20,0,6
1493467,31,23,1982,11,male,640,192,134,973,460,973,346,0,114
1332821,78,15,1935,10,female,1609,191,78,1119,103,0,62,1119,41
1736092,71,7,1942,6,female,1299,193,95,1049,312,0,157,1049,155
1857256,103,12,1910,10,female,1422,195,60,1129,665,7,81,1122,584
1615778,62,19,1951,3,female,517,193,91,1033,1086,0,89,1033,997
2033788,17,13,1996,2,female,355,197,132,1017,407,1002,315,15,92
1377964,29,25,1984,9,female,686,197,142,1029,827,805,538,224,289
1670167,50,11,1963,5,female,1598,194,86,1128,664,1128,444,0,220
1645589,16,11,1997,3,female,133,195,137,1247,374,1152,301,95,73
1304338,18,20,1995,4,female,452,191,155,1157,448,926,284,231,164
1572283,28,5,1985,10,female,244,197,113,1195,486,1195,416,0,70
1404806,34,13,1979,1,female,499,196,54,1174,332,1174,257,0,75
2098057,51,28,1962,3,female,527,196,145,1138,653,1138,615,0,38
1734817,54,30,1959,7,female,1498,192,78,1268,1281,1268,588,0,693
1224686,63,31,1950,12,male,952,196,78,1512,192,180,99,1332,93
1613685,31,25,1982,8,female,361,191,146,1414,702,763,568,651,134
1905905,14,13,1999,9,female,47,194,157,1463,140,1463,117,0,23
1289468,34,14,1979,4,male,357,193,181,1366,442,1366,427,0,15
1913192,42,30,1971,4,male,443,196,153,1419,1127,1419,805,0,322
1301225,54,26,1959,11,female,1444,197,95,1620,256,391,135,1229,121
1744843,28,9,1985,8,male,931,195,110,1586,1338,514,715,1072,623
1708007,24,17,1989,12,female,297,193,45,1690,502,1690,102,0,400
2033532,57,15,1956,2,female,153,195,164,1905,309,0,103,1905,206
1152063,53,28,1960,2,female,1085,195,130,2086,1098,0,287,2086,811
1687515,60,22,1953,4,female,1606,197,32,1974,465,0,158,1974,307
1535098,108,8,1905,5,female,1558,194,100,1976,984,386,212,1590,772
1366905,72,13,1941,9,female,1287,191,81,2096,942,686,293,1410,649
1284335,35,8,1978,12,female,469,191,110,1956,2143,1846,1705,110,438
1312300,23,22,1990,12,female,628,194,88,3359,2120,0,611,3359,1509
1522332,14,25,1999,2,female,322,193,113,2816,1262,1980,724,836,538
1615908,32,6,1981,9,male,234,194,75,3028,1289,3028,450,0,839
1792753,53,24,1960,3,female,1106,194,118,3302,968,3302,570,0,398
2025446,69,13,1944,6,female,1555,195,129,2583,834,2583,615,0,219
1572852,20,31,1993,3,female,788,193,69,6160,4814,4371,3118,1789,1696
1828366,15,30,1998,7,male,407,191,74,8078,1094,7840,649,238,445
1353187,47,8,1966,6,male,311,196,104,3798,113,3798,102,0,11
1792158,83,8,1930,4,male,1063,204,138,5,4,5,4,0,0
1098868,24,19,1989,3,female,268,204,77,5,9,5,5,0,4
1649086,25,18,1988,8,female,778,200,113,5,9,5,6,0,3
1290236,32,2,1981,2,male,716,202,47,5,8,5,6,0,2
2062044,73,15,1940,4,male,216,200,121,5,44,5,40,0,4
1983037,103,17,1910,4,male,520,202,63,5,8,5,6,0,2
1105422,19,15,1994,3,female,484,202,161,6,0,0,0,6,0
1090706,22,13,1991,9,male,214,199,58,6,0,1,0,5,0
1231305,18,1,1995,1,male,295,202,188,6,1,1,1,5,0
2129513,29,11,1984,7,female,270,199,27,6,27,0,12,6,15
2011285,19,21,1994,8,male,924,204,113,6,3,3,2,3,1
1932681,27,17,1986,8,male,450,202,63,6,69,3,36,3,33
2093477,32,18,1981,4,male,894,203,133,6,9,5,4,1,5
1750629,22,25,1991,7,male,721,201,71,6,0,6,0,0,0
1268039,18,5,1995,7,male,105,201,180,6,2,6,1,0,1
1618586,63,19,1950,6,female,1648,200,69,6,2,6,1,0,1
1074523,21,15,1992,10,male,546,200,43,6,5,6,4,0,1
1941107,29,2,1984,8,male,438,201,160,6,5,6,5,0,0
1142469,14,9,1999,11,female,255,200,65,6,18,6,14,0,4
2153150,18,13,1995,6,female,389,198,120,6,83,6,52,0,31
1281615,23,17,1990,11,male,492,199,142,6,17,6,15,0,2
2129780,26,4,1987,4,female,242,204,58,6,65,6,56,0,9
1882669,57,5,1956,6,male,260,204,135,6,13,6,10,0,3
1034921,68,24,1945,8,female,612,199,111,6,36,6,36,0,0
1180399,25,7,1988,5,male,470,200,146,7,3,0,2,7,1
1539962,38,16,1975,11,female,967,198,96,7,2,0,0,7,2
1787272,45,15,1968,3,female,451,202,99,7,45,0,13,7,32
1292174,59,1,1954,1,male,424,201,25,7,22,0,15,7,7
1577208,29,1,1984,5,male,644,198,123,7,139,4,66,3,73
2108504,29,30,1984,7,female,666,198,80,7,27,2,10,5,17
1018302,94,9,1919,6,male,918,198,149,7,1,7,1,0,0
1409198,19,26,1994,2,male,359,199,183,7,4,7,3,0,1
1774524,19,9,1994,6,male,184,198,93,7,3,7,3,0,0
1662160,18,14,1995,2,female,731,202,45,7,5,7,1,0,4
1226619,22,29,1991,7,male,507,202,152,7,40,7,31,0,9
1630181,24,30,1989,8,male,680,201,128,7,42,7,42,0,0
1700336,26,28,1987,5,male,296,202,122,7,15,7,8,0,7
1590850,43,1,1970,4,male,348,203,103,7,12,7,11,0,1
1643069,23,13,1990,6,male,173,204,112,8,0,0,0,8,0
1341550,30,11,1983,9,male,1172,203,27,8,64,0,15,8,49
2092065,38,7,1975,8,male,355,199,104,8,8,4,4,4,4
1129314,31,9,1982,2,male,1874,198,28,8,13,2,11,6,2
2001006,22,18,1991,2,male,140,198,99,8,2,6,0,2,2
2182238,56,11,1957,7,male,1362,198,116,8,151,6,104,2,47
1807544,18,19,1995,10,male,82,204,183,8,0,8,0,0,0
1941539,52,27,1961,11,female,96,203,17,8,4,8,4,0,0
1377057,13,17,2000,4,female,85,202,34,8,6,8,5,0,1
1742052,24,15,1989,3,male,91,200,196,8,10,8,8,0,2
1913137,41,24,1972,9,male,588,201,112,8,9,8,5,0,4
2155314,103,18,1910,8,male,480,202,183,8,6,8,4,0,2
1103971,22,7,1991,1,male,399,199,46,8,78,8,64,0,14
1269849,24,15,1989,2,male,480,201,77,8,20,8,17,0,3
1756870,47,20,1966,4,male,327,198,147,8,334,8,213,0,121
1965669,67,30,1946,6,male,1038,199,88,8,12,8,8,0,4
2163317,25,5,1988,7,male,464,204,65,9,13,0,3,9,10
1523237,28,19,1985,1,female,408,201,174,9,6,0,2,9,4
1666904,25,7,1988,5,female,255,204,133,9,65,0,8,9,57
1714173,17,1,1996,5,male,585,200,131,9,0,7,0,2,0
1741224,23,21,1990,1,male,310,204,201,9,3,7,1,2,2
1935274,17,6,1996,10,male,391,198,42,9,11,8,9,1,2
1791342,14,24,1999,10,female,234,198,108,9,93,7,46,2,47
1857613,17,21,1996,11,male,314,200,166,9,20,8,10,1,10
1838252,18,7,1995,12,male,582,200,109,9,0,9,0,0,0
1378449,25,29,1988,12,male,782,203,126,9,1,9,1,0,0
1352837,39,10,1974,4,male,759,202,182,9,1,9,1,0,0
2173099,22,18,1991,9,female,536,199,103,9,13,9,9,0,4
1510729,24,1,1989,1,male,705,200,170,9,6,9,6,0,0
1876438,54,19,1959,6,male,1455,201,96,9,7,9,7,0,0
1011340,20,8,1993,6,male,344,198,146,9,208,9,148,0,60
1233392,28,5,1985,5,female,636,198,131,9,16,9,4,0,12
2083115,32,14,1981,2,male,1345,202,70,9,23,9,23,0,0
2041179,21,21,1992,4,male,652,198,170,10,0,0,0,10,0
1183946,23,18,1990,4,male,1175,203,80,10,1,7,1,3,0
1813358,61,6,1952,8,male,2154,201,97,10,2,4,1,6,1
1254246,42,2,1971,9,male,446,204,131,10,106,9,60,1,46
1238641,94,14,1919,2,male,2105,199,44,10,52,8,16,2,36
1805464,22,10,1991,9,male,425,198,111,10,2,10,1,0,1
1684441,23,3,1990,3,male,323,204,128,11,12,6,11,5,1
2084153,52,23,1961,7,female,697,201,167,11,1,9,0,2,1
1688723,13,8,2000,8,male,528,198,88,11,50,9,33,2,17
1747903,41,4,1972,9,male,276,199,103,11,22,9,16,2,6
1864503,55,2,1958,1,female,847,198,67,11,58,9,23,2,35
1684252,111,10,1902,12,male,1309,199,122,11,26,9,10,2,16
1742813,15,8,1998,8,male,400,199,167,11,1,11,1,0,0
1067102,20,26,1993,1,male,710,201,183,11,3,11,1,0,2
2139858,20,24,1993,6,male,264,203,153,11,3,11,3,0,0
1393808,21,30,1992,9,male,1124,201,107,11,6,11,6,0,0
1810958,18,1,1995,7,female,621,202,70,11,11,11,8,0,3
1410203,25,2,1988,6,male,577,203,112,11,8,11,8,0,0
1805859,21,17,1992,10,female,751,199,89,11,65,11,41,0,24
2083125,81,5,1932,10,male,1131,204,121,11,17,11,8,0,9
1356531,94,10,1919,1,female,689,199,73,11,21,11,18,0,3
2036198,108,13,1905,3,male,1500,202,24,12,4,2,2,10,2
1901736,102,4,1911,5,male,775,201,93,12,13,0,2,12,11
1246665,22,17,1991,2,male,506,198,172,12,3,6,2,6,1
1334629,22,12,1991,3,male,1392,204,96,12,4,4,1,8,3
1155010,15,17,1998,10,male,282,198,138,12,16,12,12,0,4
1226834,18,4,1995,11,male,472,203,78,12,13,12,9,0,4
1430990,17,28,1996,5,male,196,204,188,12,8,12,3,0,5
2155852,19,13,1994,6,female,312,200,141,12,26,12,11,0,15
1268969,25,3,1988,8,male,485,203,54,12,32,12,12,0,20
1727753,16,19,1997,11,male,303,200,127,13,2,1,0,12,2
2154746,19,8,1994,7,male,572,203,65,13,4,0,0,13,4
1908708,26,5,1987,6,male,276,201,84,13,8,10,1,3,7
2152943,56,27,1957,7,female,1261,204,83,13,106,12,46,1,60
1017577,22,10,1991,4,male,441,202,169,13,6,13,6,0,0
2064895,18,4,1995,3,male,410,203,139,13,13,13,7,0,6
1236287,32,20,1981,10,male,913,201,91,13,30,13,16,0,14
1320071,36,1,1977,4,male,114,204,119,13,43,13,36,0,7
1832783,20,7,1993,2,female,369,203,152,14,22,0,5,14,17
1262302,20,21,1993,8,male,1509,202,103,14,5,4,0,10,5
1999596,14,4,1999,9,female,248,203,90,14,49,6,26,8,23
1534087,106,11,1907,7,male,2174,202,117,14,47,4,34,10,13
2017718,108,11,1905,2,male,1601,198,119,14,182,7,178,7,4
1852286,19,20,1994,7,male,217,200,152,14,7,14,4,0,3
1353782,48,10,1965,9,male,1632,198,82,14,8,14,7,0,1
1990149,23,30,1990,10,female,44,198,11,14,107,14,41,0,66
1081822,98,10,1915,2,male,1484,204,83,14,32,14,29,0,3
1814587,38,23,1975,5,female,430,200,111,15,1,0,1,15,0
2101641,51,23,1962,4,male,735,201,104,15,59,1,22,14,37
1557048,103,30,1910,3,female,1378,204,75,15,52,0,10,15,42
2114124,36,12,1977,11,female,999,198,114,15,78,13,63,2,15
1881094,45,20,1968,12,male,1850,199,87,15,36,13,8,2,28
2190613,15,20,1998,6,male,646,198,147,15,0,15,0,0,0
1381576,21,24,1992,6,male,252,199,77,15,5,15,4,0,1
1630580,26,28,1987,10,male,568,202,124,15,9,15,2,0,7
1639872,36,28,1977,4,male,387,201,98,15,6,15,6,0,0
1185868,18,12,1995,11,male,228,202,108,15,27,15,23,0,4
1361217,31,2,1982,10,male,474,198,125,15,226,15,214,0,12
1449847,49,4,1964,4,female,1753,199,75,15,27,15,16,0,11
1850352,103,25,1910,8,male,637,204,142,15,75,15,33,0,42
1257484,15,26,1998,9,male,252,203,91,16,26,15,24,1,2
1093060,21,9,1992,6,male,617,203,86,16,28,14,16,2,12
1249380,22,19,1991,9,female,513,202,174,16,1,16,1,0,0
1276256,43,25,1970,3,male,230,198,104,16,9,16,7,0,2
2138749,23,20,1990,10,female,117,202,50,16,23,16,17,0,6
2166383,73,11,1940,11,male,307,204,124,17,0,0,0,17,0
1096999,23,27,1990,12,female,81,204,122,17,23,11,17,6,6
2063664,31,24,1982,4,male,2222,198,66,17,154,15,127,2,27
1366244,20,23,1993,6,male,474,198,140,17,1,17,0,0,1
1295578,16,25,1997,6,female,215,204,87,17,3,17,2,0,1
1656152,17,29,1996,1,male,742,199,157,17,5,17,4,0,1
1985862,19,8,1994,7,male,349,198,115,17,7,17,7,0,0
1126026,21,30,1992,1,female,489,200,23,17,5,17,3,0,2
2014781,33,15,1980,11,female,431,199,122,17,17,17,16,0,1
1310757,17,20,1996,3,female,341,203,100,18,1,0,1,18,0
1415649,17,10,1996,8,female,692,200,76,18,0,0,0,18,0
2013897,61,27,1952,7,male,460,199,120,18,12,0,0,18,12
1465578,108,5,1905,8,male,140,203,49,18,16,0,10,18,6
1333922,18,18,1995,8,female,715,199,64,18,3,14,2,4,1
2192664,18,8,1995,4,male,409,204,45,18,5,18,4,0,1
1611198,24,16,1989,12,male,409,198,113,18,14,18,6,0,8
1505057,30,6,1983,2,male,203,201,141,19,90,9,48,10,42
1477299,15,11,1998,4,male,543,203,106,19,38,14,7,5,31
1973075,19,4,1994,3,male,372,199,173,19,2,19,2,0,0
1173205,27,3,1986,3,male,272,202,188,19,7,19,4,0,3
2170670,14,18,1999,11,female,299,199,76,19,25,19,25,0,0
1775382,51,7,1962,7,male,782,198,155,20,2,6,2,14,0
1398323,18,11,1995,1,female,642,201,116,20,0,20,0,0,0
2179667,40,20,1973,4,female,175,201,102,20,15,20,10,0,5
1419334,23,16,1990,7,male,625,201,15,20,79,20,65,0,14
1510936,25,3,1988,4,female,237,198,104,20,60,20,49,0,11
1430728,103,19,1910,5,male,738,199,153,20,40,20,39,0,1
1369856,52,8,1961,3,female,375,199,172,21,12,0,3,21,9
1397705,18,21,1995,12,male,231,201,141,21,5,8,4,13,1
2191169,82,10,1931,1,male,737,204,144,21,26,14,14,7,12
1331285,14,19,1999,11,female,343,199,90,21,51,6,9,15,42
1272327,23,23,1990,3,male,142,199,147,21,121,20,48,1,73
1713643,27,14,1986,12,male,1399,200,98,21,44,16,30,5,14
1222635,24,19,1989,9,male,361,201,179,21,3,21,3,0,0
1753424,24,16,1989,10,male,741,202,117,22,0,6,0,16,0
1235759,108,9,1905,2,female,52,204,175,22,95,5,76,17,19
1566913,19,21,1994,11,female,565,198,144,22,15,20,15,2,0
1983984,21,2,1992,6,male,535,201,128,22,9,22,5,0,4
1348027,34,23,1979,6,male,1202,201,47,22,14,22,11,0,3
1018321,28,23,1985,6,female,346,198,154,23,10,0,7,23,3
2170502,25,27,1988,5,male,763,199,142,23,22,5,13,18,9
1304698,16,19,1997,1,female,392,201,108,23,161,14,50,9,111
2177123,22,17,1991,9,male,449,203,168,23,7,23,6,0,1
1766350,52,22,1961,1,male,762,200,84,23,29,23,21,0,8
1965523,16,13,1997,11,female,259,201,55,23,122,23,50,0,72
2096523,23,20,1990,10,male,910,203,96,23,53,23,38,0,15
1120605,25,25,1988,1,female,443,199,156,23,77,23,77,0,0
1847982,45,26,1968,12,male,149,200,158,23,35,23,16,0,19
1351243,21,31,1992,8,female,427,204,116,24,4,11,2,13,2
1926721,23,27,1990,8,male,322,200,112,24,18,7,4,17,14
2121008,54,14,1959,8,female,730,200,146,24,38,15,26,9,12
1906959,26,24,1987,7,female,229,201,60,24,0,24,0,0,0
1485647,23,2,1990,10,female,562,201,51,25,69,1,33,24,36
1511514,23,1,1990,1,male,360,202,135,25,16,13,10,12,6
1380889,29,15,1984,1,male,676,201,111,25,21,11,15,14,6
1667618,24,14,1989,4,female,376,202,58,25,99,9,58,16,41
1472384,26,3,1987,5,female,73,198,97,25,65,17,48,8,17
1751622,48,13,1965,6,female,732,200,104,25,39,24,10,1,29
1535404,15,22,1998,9,male,425,200,132,26,50,23,30,3,20
1809967,19,5,1994,10,male,766,200,128,26,14,26,14,0,0
1244646,20,20,1993,4,male,317,201,152,26,23,26,22,0,1
1597674,18,28,1995,11,male,220,200,106,26,51,26,48,0,3
1675339,14,4,1999,6,male,391,204,156,27,14,0,5,27,9
1601233,56,21,1957,11,female,684,200,130,27,15,0,6,27,9
1017272,29,14,1984,6,female,439,200,72,27,25,0,0,27,25
1624807,34,20,1979,6,female,564,200,76,27,8,24,6,3,2
1355177,103,28,1910,9,male,1207,198,132,27,38,27,34,0,4
1444173,20,19,1993,2,male,671,198,114,28,3,26,2,2,1
1632948,19,2,1994,11,male,146,202,177,28,0,28,0,0,0
1091225,20,6,1993,10,male,431,202,162,28,13,28,13,0,0
1684805,19,27,1994,11,male,430,199,139,28,31,28,16,0,15
1367996,18,6,1995,1,male,268,199,161,29,2,0,1,29,1
1517870,23,18,1990,10,male,391,199,123,29,7,3,2,26,5
1677418,108,1,1905,1,female,112,203,167,29,6,0,5,29,1
2056964,108,27,1905,5,male,2177,200,74,29,13,0,1,29,12
1853200,43,13,1970,3,female,643,199,92,29,50,12,38,17,12
1116747,25,29,1988,9,female,1194,202,100,29,9,29,9,0,0
1260658,108,1,1905,4,female,2254,198,89,29,14,29,10,0,4
1981712,108,10,1905,8,male,578,204,153,31,9,0,7,31,2
1845386,40,16,1973,10,female,379,202,131,30,75,0,28,30,47
1205457,51,3,1962,12,female,884,201,96,31,125,2,51,29,74
1527637,16,15,1997,5,male,506,203,132,31,7,17,6,14,1
1748881,53,10,1960,9,male,725,204,128,31,46,17,42,14,4
2150669,23,26,1990,6,female,536,204,137,31,63,30,27,1,36
1174830,25,27,1988,8,male,653,203,161,30,13,30,3,0,10
1183427,30,25,1983,3,male,940,200,40,31,11,31,1,0,10
1000549,30,17,1983,9,male,676,199,47,31,12,31,9,0,3
2062062,24,10,1989,5,female,312,200,137,31,107,31,60,0,47
1335254,36,20,1977,12,male,116,198,154,30,61,30,44,0,17
1384903,23,12,1990,12,male,228,203,180,32,11,32,9,0,2
1842583,28,14,1985,10,male,247,202,84,32,31,32,20,0,11
1520109,44,29,1969,7,male,345,201,111,32,35,32,27,0,8
1968223,26,17,1987,7,male,142,203,177,32,52,32,37,0,15
1190982,13,24,2000,3,female,468,200,69,33,31,26,13,7,18
1569648,23,16,1990,4,female,204,201,60,33,10,33,2,0,8
1323068,49,14,1964,8,female,189,201,16,33,11,33,5,0,6
2174810,15,2,1998,8,female,279,199,131,34,59,34,41,0,18
1038419,16,1,1997,4,female,187,204,140,35,13,6,3,29,10
1909650,24,16,1989,1,male,456,200,181,35,20,19,7,16,13
1960854,37,19,1976,9,male,991,200,106,36,117,16,43,20,74
1187553,66,19,1947,1,male,558,200,159,36,4,33,1,3,3
2013114,14,30,1999,5,male,596,204,154,35,46,29,16,6,30
1110565,16,16,1997,4,male,442,204,178,35,6,35,6,0,0
2058272,18,2,1995,4,male,309,201,176,36,7,36,1,0,6
1236941,106,12,1907,11,male,179,203,179,35,14,35,9,0,5
1005357,24,2,1989,2,male,881,200,98,36,48,36,42,0,6
1796650,26,1,1987,6,female,692,201,49,36,93,36,70,0,23
1426524,30,21,1983,9,male,211,198,174,36,84,36,52,0,32
2162267,16,3,1997,9,female,231,201,81,37,25,4,2,33,23
1503423,57,10,1956,7,male,1203,204,117,37,48,0,13,37,35
1597477,40,29,1973,3,male,286,198,141,37,112,36,69,1,43
1476192,18,22,1995,11,male,450,199,75,37,17,37,15,0,2
2121531,31,8,1982,1,female,481,204,95,38,27,0,7,38,20
2179839,50,18,1963,10,male,1374,202,92,38,122,1,72,37,50
1678249,61,23,1952,10,female,1336,200,139,39,126,0,56,39,70
1815442,18,5,1995,5,male,31,199,88,38,57,34,20,4,37
1718021,39,13,1974,4,male,1082,198,167,39,91,37,34,2,57
1635254,26,23,1987,12,female,290,200,168,38,2,38,2,0,0
1812616,36,25,1977,4,male,747,199,138,38,1,38,1,0,0
1975206,25,16,1988,12,male,336,200,182,38,7,38,6,0,1
1912002,18,7,1995,2,female,149,201,104,39,29,39,8,0,21
2135832,21,17,1992,4,male,434,202,146,39,54,39,49,0,5
2033074,23,10,1990,8,male,302,200,63,38,72,38,54,0,18
1194897,36,19,1977,2,male,363,203,155,38,75,38,13,0,62
1383455,16,11,1997,1,female,335,198,44,40,10,0,4,40,6
1404510,93,2,1920,3,male,390,198,49,40,26,18,10,22,16
1011053,104,24,1909,2,female,1815,200,23,40,13,40,3,0,10
1893845,27,15,1986,5,male,284,201,165,40,36,40,36,0,0
1770579,35,14,1978,4,male,306,198,175,40,66,40,65,0,1
1642794,26,30,1987,3,male,458,202,159,42,6,7,2,35,4
1306884,66,27,1947,6,female,1251,204,109,41,14,2,6,39,8
1469784,91,14,1922,2,male,690,200,91,41,25,0,4,41,21
1105630,108,28,1905,5,NA,2254,198,102,41,36,2,10,39,26
1200737,27,16,1986,8,male,831,202,150,42,35,29,28,13,7
1499972,34,30,1979,11,female,655,202,141,42,82,30,39,12,43
2027886,15,29,1998,7,male,474,199,135,41,6,41,4,0,2
1777531,20,2,1993,10,female,183,198,66,42,20,42,10,0,10
1226462,27,15,1986,9,female,850,198,84,41,44,41,39,0,5
1209412,33,4,1980,6,female,51,201,57,41,30,41,29,0,1
1478682,27,22,1986,11,male,422,200,139,41,70,41,59,0,11
1872466,20,3,1993,2,male,329,204,162,43,1,0,0,43,1
1202469,25,3,1988,9,male,257,198,144,43,0,0,0,43,0
2131713,20,15,1993,12,male,800,201,84,43,24,0,8,43,16
2000866,64,11,1949,1,female,1913,198,67,43,132,42,72,1,60
1864962,17,26,1996,9,male,425,204,144,44,0,44,0,0,0
1497169,46,21,1967,8,female,463,202,137,44,10,44,4,0,6
1931634,21,20,1992,5,male,194,204,109,43,45,43,38,0,7
2161001,24,26,1989,5,female,275,198,97,43,93,43,75,0,18
2081025,32,30,1981,1,female,552,204,127,43,121,43,87,0,34
1211555,108,9,1905,7,female,1177,201,102,44,153,44,132,0,21
1008216,23,24,1990,3,male,434,204,117,45,88,29,30,16,58
2060871,90,3,1923,6,female,1879,199,83,45,42,45,16,0,26
1308861,24,17,1989,12,female,277,202,125,45,69,45,57,0,12
1522485,102,20,1911,2,female,2267,198,119,46,9,26,6,20,3
1012510,18,10,1995,3,female,241,203,115,46,84,12,27,34,57
1683203,50,14,1963,7,male,287,199,91,46,137,33,113,13,24
2031463,24,7,1989,12,female,583,201,124,47,21,47,20,0,1
1149050,23,27,1990,9,female,625,199,53,46,69,46,50,0,19
1370601,50,27,1963,10,female,506,198,107,46,95,46,38,0,57
1759200,17,10,1996,5,male,553,201,155,49,3,0,0,49,3
1963242,23,28,1990,12,female,610,202,66,49,65,34,26,15,39
1035089,33,10,1980,6,male,1088,201,45,48,68,46,27,2,41
1644903,68,22,1945,7,male,1052,202,135,49,38,40,26,9,12
2141793,22,4,1991,12,male,665,198,96,48,16,48,15,0,1
2013129,23,21,1990,2,male,220,201,170,49,26,49,26,0,0
1187860,33,1,1980,6,male,426,198,113,48,95,48,34,0,61
1164858,56,25,1957,8,male,743,200,29,50,540,16,294,34,246
1448561,17,3,1996,10,male,480,204,99,50,65,48,29,2,36
1291476,19,25,1994,8,male,405,201,140,50,3,50,3,0,0
1963159,29,28,1984,4,male,887,202,145,50,8,50,7,0,1
2097906,29,21,1984,10,male,463,200,139,53,2,0,1,53,1
2113100,21,11,1992,9,female,449,203,154,52,202,26,49,26,153
1580064,34,23,1979,3,female,74,201,168,53,47,48,45,5,2
1418555,60,5,1953,9,female,1272,199,52,52,67,51,40,1,27
1672359,28,22,1985,11,male,458,198,126,53,257,49,218,4,39
2121473,27,19,1986,3,male,430,204,183,53,275,50,225,3,50
1852661,23,9,1990,7,female,718,203,38,52,27,52,13,0,14
1434641,34,21,1979,7,male,1322,204,104,53,12,53,7,0,5
2142975,39,3,1974,10,female,309,201,36,53,84,53,14,0,70
1580600,18,10,1995,11,female,454,200,152,55,362,20,148,35,214
2069539,23,12,1990,11,male,476,201,127,55,85,47,34,8,51
1232701,63,22,1950,6,male,1648,199,52,54,307,41,192,13,115
1138051,18,15,1995,10,female,274,198,94,54,21,54,17,0,4
1912125,18,6,1995,2,male,226,200,120,54,67,54,8,0,59
1493870,25,9,1988,11,male,298,202,133,54,33,54,24,0,9
1637328,24,25,1989,9,female,162,204,62,54,33,54,14,0,19
1261501,59,14,1954,7,male,1565,204,114,54,62,54,37,0,25
1613909,20,10,1993,5,female,218,204,117,55,95,55,51,0,44
1249458,25,21,1988,2,female,520,204,62,54,94,54,79,0,15
1294226,37,6,1976,6,male,219,198,16,54,113,54,77,0,36
1989247,108,1,1905,1,male,1636,198,93,57,70,1,22,56,48
1180487,16,2,1997,3,male,107,199,181,58,7,58,6,0,1
1411727,23,15,1990,11,male,268,203,150,56,24,56,19,0,5
2020382,93,11,1920,2,male,1192,198,103,58,40,58,25,0,15
1579843,18,9,1995,10,male,433,199,157,59,15,35,6,24,9
1600301,22,26,1991,2,male,684,202,85,60,60,59,27,1,33
2158955,37,31,1976,7,female,315,198,104,59,140,53,100,6,40
1959245,18,15,1995,11,male,79,200,107,60,19,60,13,0,6
2047496,21,25,1992,5,female,186,203,12,59,28,59,28,0,0
1234175,22,22,1991,7,male,447,203,122,60,30,60,18,0,12
1249043,108,16,1905,3,NA,1908,202,122,61,57,3,9,58,48
1478088,89,4,1924,3,male,1189,201,132,63,75,38,48,25,27
2188253,32,6,1981,10,male,300,200,83,61,30,58,20,3,10
1998169,18,25,1995,9,male,606,200,127,61,52,51,26,10,26
2032902,64,25,1949,1,male,1296,204,143,63,69,51,26,12,43
1956222,22,9,1991,12,male,786,201,144,62,19,62,7,0,12
1004950,24,23,1989,5,male,527,200,135,63,34,63,24,0,10
1894940,25,8,1988,8,male,753,202,96,62,66,62,57,0,9
1636977,28,22,1985,3,female,1228,201,77,64,47,27,18,37,29
2163787,20,25,1993,6,male,184,204,195,65,19,57,11,8,8
1110488,27,3,1986,1,male,337,201,94,70,40,0,13,70,27
1796664,52,8,1961,4,female,637,202,102,71,15,0,10,71,5
1032725,46,4,1967,10,male,255,204,144,70,67,12,44,58,23
1441935,96,28,1917,3,male,2157,204,122,69,79,0,53,69,26
1148053,50,5,1963,6,female,1712,204,85,69,61,18,37,51,24
1049210,19,1,1994,3,female,451,198,148,71,251,71,119,0,132
1606268,14,23,1999,4,male,297,201,142,72,42,5,23,67,19
1459281,62,15,1951,6,male,1712,204,53,74,20,6,7,68,13
1607453,55,28,1958,8,female,1893,200,110,73,499,65,298,8,201
2188134,17,7,1996,12,female,905,200,132,73,8,73,8,0,0
2064169,14,30,1999,10,female,413,198,57,76,67,0,18,76,49
1402057,28,1,1985,10,female,1240,201,139,77,150,38,61,39,89
1526838,19,26,1994,7,female,439,203,169,77,30,63,16,14,14
1059024,21,25,1992,5,female,459,198,90,75,61,69,39,6,22
2188426,28,19,1985,7,male,1282,199,115,75,137,72,117,3,20
1276656,53,14,1960,11,male,1451,202,148,77,60,77,45,0,15
1164402,42,21,1971,2,male,630,204,48,78,44,5,5,73,39
1257701,67,18,1946,2,male,296,199,103,79,1039,11,96,68,943
1063447,23,14,1990,9,female,402,202,136,80,80,46,42,34,38
1338854,13,26,2000,1,female,476,198,64,79,25,74,22,5,3
1647101,23,18,1990,12,male,672,200,57,78,27,77,19,1,8
1180935,107,1,1906,12,female,1505,200,89,80,150,77,105,3,45
1843617,21,15,1992,12,male,423,199,182,80,0,80,0,0,0
1843296,18,12,1995,5,male,279,204,176,79,68,79,59,0,9
1805076,38,14,1975,7,female,361,200,168,82,37,24,29,58,8
1874785,19,2,1994,6,male,355,202,161,81,41,81,41,0,0
1724186,62,11,1951,8,female,1586,204,108,82,23,82,13,0,10
1900591,56,6,1957,1,female,1351,202,133,82,58,82,40,0,18
2153952,26,4,1987,2,female,1495,199,127,86,180,4,73,82,107
1952464,45,27,1968,11,male,410,204,104,86,65,43,53,43,12
1215911,15,8,1998,11,female,310,201,92,87,148,87,7,0,141
1794606,33,8,1980,5,male,356,198,170,91,4,48,4,43,0
1437906,30,5,1983,4,male,496,204,136,89,624,63,579,26,45
1101094,16,9,1997,6,female,550,200,130,88,337,87,273,1,64
2064592,113,19,1900,2,female,1613,204,74,88,346,85,275,3,71
1617539,14,26,1999,3,female,496,200,146,90,0,90,0,0,0
1868314,34,6,1979,6,male,694,203,126,89,1,89,1,0,0
1494342,27,15,1986,10,male,200,202,158,89,22,89,21,0,1
1729142,52,16,1961,10,male,456,198,100,91,119,91,68,0,51
1449795,18,23,1995,7,male,527,198,51,90,260,90,259,0,1
1717953,14,31,1999,1,female,444,203,115,94,26,0,7,94,19
1821539,13,12,2000,5,male,271,198,108,95,7,19,5,76,2
2177430,48,21,1965,6,female,298,200,163,92,19,45,7,47,12
2178543,25,22,1988,4,female,445,204,98,92,162,85,125,7,37
1703368,34,1,1979,1,female,958,200,72,95,347,72,125,23,222
1658046,28,5,1985,9,female,156,198,67,94,92,94,83,0,9
1663588,65,27,1948,4,female,1349,201,46,99,16,0,9,99,7
1857677,24,10,1989,1,male,357,201,183,98,2,98,1,0,1
2101350,26,9,1987,10,female,311,200,73,98,20,98,9,0,11
1478416,49,23,1964,2,female,175,204,111,97,28,97,21,0,7
1878065,19,23,1994,11,male,59,198,184,101,195,59,102,42,93
1458559,22,26,1991,7,female,528,201,170,100,55,89,42,11,13
1676353,16,21,1997,5,female,526,204,111,100,1,99,1,1,0
1256180,100,2,1913,5,female,1202,203,115,102,32,101,24,1,8
1573361,22,9,1991,1,male,268,199,65,103,23,103,22,0,1
2124058,28,3,1985,10,female,499,198,55,101,21,101,20,0,1
1507050,71,6,1942,4,female,179,203,117,101,75,101,48,0,27
1651067,17,16,1996,6,female,223,199,94,102,399,102,360,0,39
1538309,14,16,1999,7,male,303,199,161,108,1,70,0,38,1
1261180,20,7,1993,1,male,792,201,121,105,148,71,31,34,117
1408135,30,16,1983,2,female,385,198,97,108,115,75,58,33,57
2180171,14,23,1999,2,female,536,203,49,107,24,107,23,0,1
1923333,17,3,1996,2,male,315,199,53,106,58,106,55,0,3
1181512,28,22,1985,11,male,201,201,171,105,66,105,57,0,9
2074327,15,18,1998,3,female,348,203,84,109,266,109,219,0,47
1125052,20,26,1993,8,male,267,204,173,112,1,0,1,112,0
1460220,55,25,1958,4,male,304,201,64,110,6,0,0,110,6
1801763,57,20,1956,8,female,415,202,100,110,49,0,12,110,37
2118423,68,23,1945,12,male,741,202,166,110,51,105,43,5,8
1195607,45,10,1968,5,male,1184,199,76,110,109,106,101,4,8
1750041,23,11,1990,9,male,409,203,143,110,20,110,8,0,12
1312310,19,29,1994,8,male,8,204,140,111,242,111,217,0,25
1103028,23,26,1990,9,female,402,198,125,112,244,112,66,0,178
1256484,22,11,1991,1,female,549,200,133,118,35,22,10,96,25
1549560,25,25,1988,12,male,171,200,166,116,109,15,44,101,65
1425883,58,7,1955,2,female,163,198,85,117,179,6,75,111,104
1003740,46,19,1967,10,female,640,198,132,119,170,73,133,46,37
1407426,15,28,1998,5,female,671,202,69,119,0,118,0,1,0
1113437,31,1,1982,8,female,591,200,135,114,30,114,17,0,13
1444010,60,1,1953,5,female,654,202,22,116,21,116,16,0,5
2150357,14,7,1999,4,male,385,201,100,115,73,115,60,0,13
1625740,38,26,1975,8,female,716,204,99,118,231,118,58,0,173
1658191,100,13,1913,9,female,769,202,151,123,94,7,51,116,43
1325167,44,28,1969,7,male,1145,204,39,124,457,76,225,48,232
1488849,98,7,1915,12,male,1827,200,100,120,91,93,79,27,12
1009656,17,28,1996,8,male,125,200,195,120,10,120,10,0,0
2089453,24,4,1989,9,female,244,198,48,123,40,123,21,0,19
1136726,103,20,1910,6,female,703,204,70,123,38,123,10,0,28
1067557,21,31,1992,12,male,448,201,132,120,108,120,89,0,19
2120729,25,25,1988,12,male,131,201,197,128,24,52,17,76,7
1816713,16,3,1997,9,male,94,200,152,126,46,126,38,0,8
1612979,53,29,1960,7,male,1879,204,90,127,43,127,35,0,8
1950232,26,27,1987,6,male,574,202,144,128,99,128,89,0,10
1662439,27,31,1986,10,male,449,202,91,125,121,125,102,0,19
2169932,16,19,1997,11,male,397,199,136,135,67,3,31,132,36
1956175,102,28,1911,8,male,926,201,135,134,55,13,1,121,54
1693530,25,20,1988,9,male,611,198,115,131,120,3,48,128,72
1060860,49,1,1964,8,male,446,203,161,135,35,92,15,43,20
1180780,55,24,1958,6,female,2061,198,62,134,76,55,59,79,17
1283917,59,8,1954,9,female,584,202,169,133,34,130,14,3,20
1385711,23,4,1990,9,male,507,202,106,139,17,0,6,139,11
1389227,20,25,1993,12,female,694,204,118,137,72,73,61,64,11
1419288,54,3,1959,2,female,1859,199,128,141,73,69,60,72,13
2176011,36,26,1977,12,female,278,199,134,140,127,73,107,67,20
1813770,49,3,1964,8,female,841,200,109,140,335,53,88,87,247
1245327,54,12,1959,9,male,580,201,161,137,30,130,21,7,9
1766847,113,30,1900,1,female,1219,198,89,138,155,120,144,18,11
2167578,18,3,1995,5,male,498,202,127,139,9,139,9,0,0
1007320,31,5,1982,6,male,562,200,169,143,14,143,14,0,0
1496300,52,12,1961,4,male,490,200,18,143,38,143,16,0,22
1874552,17,8,1996,4,female,312,202,159,138,330,138,271,0,59
1435403,17,20,1996,11,male,189,201,112,149,64,86,41,63,23
1330483,18,16,1995,2,male,371,200,128,146,115,135,93,11,22
2123587,22,19,1991,1,female,317,202,189,149,110,146,43,3,67
1841916,56,24,1957,12,female,1342,200,85,149,483,138,275,11,208
1128595,14,13,1999,9,female,462,198,116,147,36,147,31,0,5
2072960,47,17,1966,9,male,510,200,80,150,167,150,137,0,30
1215648,18,1,1995,1,male,236,200,34,154,74,6,40,148,34
1489661,63,19,1950,11,male,674,201,126,155,159,0,97,155,62
1717297,24,5,1989,8,female,284,201,97,154,108,57,69,97,39
1889162,15,24,1998,8,female,446,204,146,153,81,144,21,9,60
1025097,23,17,1990,2,male,253,200,115,151,28,117,22,34,6
1607206,98,1,1915,1,female,1493,200,144,157,126,129,41,28,85
1755745,51,17,1962,8,female,544,204,147,155,91,155,83,0,8
1050319,101,28,1912,10,female,658,199,104,151,90,151,71,0,19
1779545,51,10,1962,8,female,1239,202,109,160,148,14,38,146,110
1584223,112,5,1901,8,female,1347,203,94,163,345,6,236,157,109
1264266,47,1,1966,3,female,346,202,138,159,94,117,51,42,43
2118121,18,21,1995,9,female,295,203,92,159,261,127,187,32,74
2133635,50,5,1963,7,female,694,204,67,162,97,162,29,0,68
1415498,19,9,1994,12,female,405,199,80,158,158,158,131,0,27
1113750,20,6,1993,10,female,223,200,138,158,110,158,68,0,42
2009031,23,17,1990,7,female,502,200,38,163,104,163,101,0,3
1915984,98,26,1915,12,female,1665,204,91,163,123,163,119,0,4
1622777,66,29,1947,9,female,1574,201,100,164,521,164,241,0,280
1392370,102,5,1911,7,male,1739,198,100,165,54,1,20,164,34
1913112,32,8,1981,11,female,629,199,74,169,48,102,14,67,34
1901149,23,3,1990,2,male,355,203,129,166,279,64,120,102,159
1259286,32,17,1981,4,female,537,200,145,168,160,162,118,6,42
1254697,30,27,1983,9,male,2214,200,123,169,255,132,183,37,72
1408895,37,10,1976,8,male,765,204,88,165,281,165,261,0,20
1294317,21,15,1992,8,male,391,202,119,175,157,0,35,175,122
1853343,46,18,1967,6,female,97,198,168,179,240,38,124,141,116
1453690,27,23,1986,6,male,150,202,175,174,147,149,53,25,94
1892653,14,10,1999,2,male,355,202,103,176,12,176,11,0,1
1268287,15,29,1998,4,male,181,199,103,173,23,173,21,0,2
1861487,16,30,1997,4,male,430,202,80,173,89,173,79,0,10
1441971,17,10,1996,8,female,634,202,132,177,40,177,40,0,0
1628004,69,23,1944,6,female,1417,203,53,188,11,11,4,177,7
1681560,64,7,1949,9,female,196,204,118,185,367,0,77,185,290
1275335,28,15,1985,5,female,1103,204,120,184,590,70,548,114,42
2022741,24,5,1989,6,male,412,202,128,185,151,183,87,2,64
1016733,35,2,1978,9,female,452,203,165,183,140,176,66,7,74
2075418,23,30,1990,1,female,682,200,45,187,14,187,9,0,5
1798730,23,4,1990,2,male,721,198,126,189,77,189,61,0,16
2100654,20,8,1993,6,female,194,199,138,183,281,183,195,0,86
1747095,25,28,1988,7,female,25,204,110,182,281,182,178,0,103
1980465,52,26,1961,2,male,298,202,156,198,211,1,79,197,132
1454920,18,18,1995,10,female,413,200,94,198,218,83,136,115,82
1326908,37,4,1976,12,male,911,199,112,192,21,188,13,4,8
1573059,69,19,1944,9,female,730,200,168,191,0,189,0,2,0
1278795,21,1,1992,8,female,842,202,84,191,75,160,60,31,15
1906193,33,18,1980,7,female,1143,203,172,192,627,171,532,21,95
1115667,20,9,1993,11,female,76,201,188,207,129,17,115,190,14
1122872,50,28,1963,5,male,706,202,136,207,146,92,66,115,80
2034277,64,17,1949,10,female,1712,201,128,209,203,82,73,127,130
1362074,23,29,1990,3,female,507,204,90,207,232,168,150,39,82
1783187,55,15,1958,11,male,551,204,72,212,177,41,76,171,101
1973444,94,18,1919,6,female,784,199,104,215,129,90,61,125,68
1030424,19,19,1994,3,female,434,199,108,219,54,214,31,5,23
1436686,61,22,1952,8,female,1770,199,138,217,145,195,68,22,77
1935404,38,28,1975,6,female,47,202,69,221,300,220,214,1,86
1284911,48,9,1965,10,male,504,203,149,215,17,215,13,0,4
1235530,22,16,1991,5,male,278,202,119,217,89,217,74,0,15
1654653,25,29,1988,8,male,239,200,170,214,55,214,39,0,16
1617187,34,27,1979,9,male,249,201,161,219,108,219,105,0,3
1511871,40,10,1973,1,female,357,201,118,216,283,216,227,0,56
1196823,65,13,1948,4,female,207,198,174,219,281,219,174,0,107
1726927,69,11,1944,8,female,407,198,67,231,240,0,6,231,234
1302752,36,4,1977,3,female,1428,199,133,229,325,158,212,71,113
1017372,62,29,1951,12,female,2221,202,92,233,217,114,145,119,72
2188093,29,5,1984,5,male,709,202,95,228,237,191,100,37,137
1001196,53,12,1960,9,male,471,202,146,225,346,225,171,0,175
1611866,57,20,1956,7,male,418,198,124,244,140,13,36,231,104
1026948,56,22,1957,10,female,1070,204,184,242,39,241,34,1,5
1526214,16,15,1997,12,male,361,203,154,234,62,234,30,0,32
2125469,27,7,1986,4,female,790,198,66,241,79,241,65,0,14
1564743,35,13,1978,12,female,744,204,127,239,175,239,162,0,13
1922006,22,15,1991,3,female,1168,200,89,254,188,147,42,107,146
1788822,44,23,1969,4,female,2058,203,57,249,253,173,178,76,75
1109560,103,4,1910,6,female,1681,201,76,253,185,248,122,5,63
1232156,14,26,1999,10,male,137,198,188,250,22,250,18,0,4
1583287,56,13,1957,9,female,1716,199,68,261,278,215,134,46,144
1974488,19,10,1994,8,female,22,203,66,265,473,242,224,23,249
2056679,44,26,1969,2,female,427,204,110,261,28,261,23,0,5
1726798,24,14,1989,10,male,369,200,143,270,86,270,37,0,49
1596824,17,1,1996,11,female,379,202,84,276,217,276,132,0,85
1396576,22,31,1991,8,female,351,200,104,265,450,265,367,0,83
1063507,102,24,1911,10,male,1499,202,67,279,104,54,32,225,72
1210005,18,15,1995,11,female,431,201,106,283,131,88,46,195,85
1209482,23,2,1990,11,female,538,200,91,291,263,179,143,112,120
1235422,18,17,1995,5,male,599,201,151,283,14,277,11,6,3
1424346,19,5,1994,5,male,315,199,129,290,195,278,155,12,40
1169811,14,26,1999,9,female,334,200,158,282,21,282,19,0,2
1137577,55,16,1958,6,male,365,201,114,277,103,277,98,0,5
2160957,22,12,1991,8,female,490,201,107,282,249,282,184,0,65
1567760,49,10,1964,10,female,345,202,85,280,220,280,112,0,108
1049782,63,11,1950,10,female,1082,202,98,293,94,0,15,293,79
1799432,77,1,1936,2,male,260,202,100,301,82,0,3,301,79
1112977,24,29,1989,8,female,1323,203,139,297,64,127,28,170,36
1452354,21,20,1992,3,male,634,203,97,304,422,197,208,107,214
1348967,25,21,1988,5,male,265,203,52,293,308,132,100,161,208
2058782,50,22,1963,6,male,318,202,115,294,595,137,252,157,343
2163276,21,11,1992,10,female,525,204,57,300,204,294,82,6,122
2041719,31,25,1982,12,female,585,198,67,297,290,289,103,8,187
1546642,18,7,1995,10,male,615,198,117,298,95,297,86,1,9
2011017,82,1,1931,11,male,460,204,136,309,110,0,49,309,61
1036968,41,17,1972,12,female,88,201,91,320,97,147,34,173,63
1246927,17,3,1996,9,female,617,202,144,312,326,220,105,92,221
1054642,15,19,1998,8,male,258,202,140,321,39,263,27,58,12
1579360,27,12,1986,9,female,1974,199,63,318,166,318,131,0,35
1150940,17,16,1996,4,male,323,198,121,335,248,2,55,333,193
1438412,113,10,1900,9,female,1421,198,147,333,448,12,99,321,349
1531605,18,11,1995,2,male,299,201,175,344,9,113,5,231,4
1105437,25,18,1988,12,female,377,198,112,337,388,282,212,55,176
1378768,35,28,1978,10,female,396,204,102,344,406,278,257,66,149
1966521,37,2,1976,9,female,1788,204,139,337,374,321,201,16,173
1718312,15,28,1998,5,male,458,204,103,328,53,328,34,0,19
1679641,50,19,1963,10,female,2122,201,63,335,252,335,147,0,105
2027877,55,15,1958,8,female,1592,198,53,343,1030,343,581,0,449
1094727,28,3,1985,9,female,212,199,166,360,149,58,47,302,102
1472650,47,13,1966,9,female,116,203,106,365,85,214,60,151,25
2041447,17,24,1996,10,female,570,200,84,358,448,242,371,116,77
1783646,18,8,1995,4,female,230,200,147,357,73,310,33,47,40
2134927,18,21,1995,5,female,529,200,115,353,120,340,69,13,51
2023604,28,21,1985,5,female,279,200,173,362,253,358,176,4,77
1694800,55,21,1958,12,male,1812,199,90,352,636,306,352,46,284
1512428,27,5,1986,3,male,253,202,145,367,439,366,109,1,330
1526412,108,11,1905,11,male,1658,200,101,347,225,347,144,0,81
2156161,113,2,1900,4,female,2053,201,153,372,32,0,23,372,9
1865206,24,2,1989,12,female,422,201,40,371,63,261,47,110,16
1935582,96,13,1917,8,female,1769,204,78,383,178,237,113,146,65
1576329,25,10,1988,8,male,364,199,133,374,68,349,32,25,36
2074134,73,24,1940,3,female,1233,198,77,384,430,337,125,47,305
1071928,25,7,1988,1,female,295,204,143,418,27,221,17,197,10
1102994,48,25,1965,6,female,1647,198,120,420,188,89,112,331,76
1415575,21,23,1992,6,female,657,203,160,407,1130,242,838,165,292
2058188,29,7,1984,9,female,492,198,123,401,11,401,10,0,1
1168200,61,16,1952,5,female,1674,203,129,436,49,0,41,436,8
1931297,21,9,1992,4,male,377,203,122,422,588,282,299,140,289
1830493,70,13,1943,11,female,1706,198,61,435,328,253,234,182,94
1945674,41,28,1972,6,female,558,199,112,422,541,328,389,94,152
1504334,60,7,1953,11,female,2075,203,134,433,325,432,185,1,140
1863517,27,31,1986,7,male,217,202,132,430,54,430,39,0,15
1090189,49,10,1964,6,female,672,204,128,438,405,438,278,0,127
1870652,19,31,1994,5,female,124,200,161,460,239,459,206,1,33
1926623,19,26,1994,3,male,404,199,91,491,216,0,60,491,156
1395156,56,18,1957,12,female,1203,199,141,490,143,67,43,423,100
1378079,25,6,1988,11,female,920,198,60,512,364,211,124,301,240
1408515,17,22,1996,12,male,53,202,157,517,11,436,10,81,1
1811809,18,1,1995,1,male,307,199,136,496,166,496,128,0,38
1926619,22,14,1991,1,male,529,204,42,509,132,509,113,0,19
1791785,26,12,1987,12,male,423,203,155,488,181,488,171,0,10
1525267,33,13,1980,5,male,578,203,115,486,320,486,207,0,113
2031699,54,4,1959,8,female,200,198,144,519,403,519,273,0,130
1832103,78,11,1935,3,female,1395,198,65,559,172,0,45,559,127
1915888,15,19,1998,3,female,325,201,144,552,340,52,112,500,228
1860245,60,10,1953,4,female,1310,202,113,546,425,203,260,343,165
1414221,46,5,1967,10,female,588,204,130,553,67,533,46,20,21
1908768,17,26,1996,6,female,658,201,90,529,195,428,115,101,80
2089397,35,13,1978,9,male,567,198,67,526,392,489,307,37,85
1410389,17,24,1996,9,female,307,199,171,520,1130,446,958,74,172
1807374,21,25,1992,2,female,314,200,138,538,286,538,117,0,169
2127581,30,3,1983,9,female,552,198,89,532,252,532,192,0,60
1600186,103,4,1910,7,female,635,204,112,527,136,527,107,0,29
1879592,108,8,1905,12,female,1518,204,18,543,109,543,72,0,37
1548432,22,4,1991,11,female,271,201,53,539,562,539,228,0,334
1189248,16,1,1997,7,male,485,199,113,597,4,20,2,577,2
1910203,15,11,1998,11,female,489,204,127,577,206,302,96,275,110
1738253,65,14,1948,1,male,926,202,165,601,940,522,568,79,372
2079777,16,15,1997,10,male,421,202,48,589,47,589,41,0,6
1079563,59,1,1954,5,male,383,199,171,576,117,576,24,0,93
1971915,21,18,1992,11,female,202,201,101,586,412,586,362,0,50
1447295,18,11,1995,5,male,75,203,130,610,723,269,525,341,198
2154150,28,1,1985,5,female,333,200,174,651,326,622,180,29,146
1958746,34,1,1979,10,female,246,201,147,646,593,607,218,39,375
1472460,19,14,1994,9,female,52,199,111,613,400,608,210,5,190
1071837,21,7,1992,8,male,295,201,105,653,48,653,43,0,5
1181483,26,24,1987,3,female,482,204,95,614,45,614,27,0,18
1693582,78,20,1935,11,female,1262,203,79,615,21,615,20,0,1
1864735,29,5,1984,2,male,310,203,150,649,255,649,186,0,69
1982982,51,11,1962,4,female,1015,201,116,720,281,55,200,665,81
1234280,30,15,1983,3,female,494,204,111,670,820,197,459,473,361
2188213,60,4,1953,11,female,268,204,146,690,20,672,9,18,11
1718897,21,15,1992,8,female,368,198,135,676,136,628,97,48,39
2141499,25,11,1988,2,female,621,200,114,713,444,574,270,139,174
1996844,18,12,1995,8,male,61,200,185,706,230,706,205,0,25
1112671,46,2,1967,3,female,862,202,127,769,582,90,229,679,353
1852974,21,7,1992,12,male,271,203,105,752,826,314,495,438,331
1910577,27,13,1986,3,male,131,202,151,782,658,216,115,566,543
2074790,29,1,1984,4,female,1078,200,91,750,969,687,461,63,508
1983825,22,19,1991,4,female,514,199,107,793,86,793,40,0,46
1455660,41,1,1972,11,female,225,204,134,733,1157,733,939,0,218
1455395,68,12,1945,1,female,1593,200,134,834,710,115,477,719,233
2117487,30,1,1983,2,female,554,204,95,824,447,746,152,78,295
2020690,23,13,1990,10,male,305,199,160,831,27,831,26,0,1
1414747,55,9,1958,9,female,1033,199,147,799,304,799,125,0,179
2070616,62,14,1951,8,female,114,198,112,955,1446,1,32,954,1414
1520242,16,16,1997,5,male,120,200,51,943,2652,402,1104,541,1548
1407512,31,5,1982,9,female,1036,200,140,916,1004,804,471,112,533
1688366,47,17,1966,10,male,611,200,135,882,575,843,465,39,110
1649580,18,1,1995,10,male,661,202,112,912,301,912,238,0,63
1752397,108,14,1905,10,female,1619,202,158,995,35,7,17,988,18
1261906,44,10,1969,7,female,272,203,129,1034,424,228,158,806,266
1616591,52,23,1961,12,female,360,203,122,1028,263,293,159,735,104
1511267,41,5,1972,2,female,2166,198,98,1013,825,257,297,756,528
1545839,23,4,1990,3,female,1922,203,67,1034,397,996,273,38,124
1294965,16,26,1997,3,female,526,203,181,998,28,998,10,0,18
2124955,16,26,1997,7,female,197,203,136,1166,243,214,128,952,115
1940194,19,15,1994,3,male,118,199,149,1222,509,513,272,709,237
1010682,32,5,1981,10,female,1122,204,132,1216,1195,280,440,936,755
1590761,60,23,1953,6,female,1769,201,124,1248,934,944,342,304,592
1901959,67,24,1946,7,male,1353,200,125,1444,583,0,87,1444,496
1796924,23,26,1990,7,female,1465,200,88,1474,557,505,242,969,315
1809369,52,27,1961,8,female,443,201,82,1298,329,556,53,742,276
1848958,63,15,1950,10,female,2064,198,112,1467,1199,1465,735,2,464
1566304,44,22,1969,12,female,470,202,75,1402,210,1402,161,0,49
1080149,49,8,1964,12,female,1487,203,133,1441,371,1441,202,0,169
1493152,63,11,1950,2,female,1554,201,53,1465,1255,1465,477,0,778
2165328,71,22,1942,1,female,1593,200,70,1691,503,323,266,1368,237
1607891,34,28,1979,10,female,735,202,67,1630,1214,898,458,732,756
1308817,48,23,1965,9,female,939,200,128,1747,178,1336,96,411,82
1593209,16,5,1997,1,female,372,203,150,1660,323,1288,86,372,237
2053663,28,29,1985,9,female,655,202,184,1671,670,1310,559,361,111
1193997,33,16,1980,2,male,216,200,110,1741,1096,1338,665,403,431
1916851,36,10,1977,2,female,448,201,147,1758,265,1758,191,0,74
1378965,47,26,1966,3,female,1960,198,98,1700,85,1700,61,0,24
1105961,21,26,1992,2,female,51,198,145,1686,809,1686,462,0,347
1073154,39,10,1974,4,male,530,198,125,1604,622,1604,539,0,83
1763303,20,12,1993,8,female,38,204,184,2262,1255,61,343,2201,912
1364323,15,1,1998,12,female,916,204,161,2031,1817,226,798,1805,1019
2107588,57,10,1956,10,female,920,203,113,2049,3123,25,786,2024,2337
1616401,57,1,1956,2,female,1286,202,124,2232,739,1003,252,1229,487
1629858,19,20,1994,12,female,144,198,103,2012,1904,685,812,1327,1092
1173477,19,24,1994,10,female,103,200,152,2175,17,2049,14,126,3
1226930,18,29,1995,4,female,440,203,89,2169,647,2044,316,125,331
1538539,35,5,1978,2,male,1095,202,120,2074,1,2074,1,0,0
1875828,25,3,1988,8,female,185,202,95,2302,1635,2302,1484,0,151
1720230,18,12,1995,9,female,501,202,79,3172,809,394,267,2778,542
2132537,46,25,1967,6,male,1814,203,69,3222,970,1407,589,1815,381
1008445,15,28,1998,10,female,600,203,109,3437,285,3397,233,40,52
1334469,34,10,1979,11,female,1489,202,61,2452,3520,1859,2970,593,550
1750930,54,23,1959,6,female,499,198,135,3134,1820,3132,1182,2,638
1461590,35,5,1978,1,female,334,203,57,3210,1325,3210,1166,0,159
1976900,21,9,1992,3,female,208,204,152,3865,2058,702,1592,3163,466
1211816,53,9,1960,8,female,1510,198,117,3731,1128,418,541,3313,587
1113606,49,21,1964,9,female,241,200,163,6679,10,6679,7,0,3
1864183,80,2,1933,10,female,330,200,193,7395,361,7395,170,0,191
1920842,18,4,1995,3,female,632,203,109,6054,3440,6054,1745,0,1695
2183086,23,26,1990,4,female,365,212,168,8,4,8,2,0,2
1403994,24,19,1989,7,male,465,211,155,8,9,8,5,0,4
1751355,16,7,1997,4,male,615,211,37,8,25,8,23,0,2
1819689,17,22,1996,9,male,139,212,186,8,33,8,20,0,13
1689994,24,8,1989,3,male,355,206,148,8,14,8,14,0,0
1798162,68,17,1945,8,male,1352,207,57,8,21,8,15,0,6
1303982,20,4,1993,8,male,623,212,93,9,3,0,2,9,1
1682699,71,25,1942,4,male,1448,205,139,9,35,1,10,8,25
1732053,33,5,1980,2,male,135,205,169,9,8,2,1,7,7
1313977,16,5,1997,1,male,38,206,91,9,33,6,23,3,10
1510665,18,30,1995,12,female,676,210,81,9,23,6,22,3,1
1963945,21,1,1992,8,female,707,207,87,9,17,4,4,5,13
2160937,28,4,1985,3,female,393,207,112,9,167,5,109,4,58
1583160,16,28,1997,9,male,480,212,190,9,2,7,2,2,0
1074928,17,28,1996,2,female,249,208,34,9,14,8,5,1,9
1791536,26,29,1987,9,male,757,208,165,9,68,8,55,1,13
1023703,14,11,1999,11,female,271,207,130,9,2,9,2,0,0
1256020,30,19,1983,7,male,1010,206,69,9,2,9,2,0,0
1600982,23,11,1990,7,female,535,209,86,9,12,9,7,0,5
2045542,24,17,1989,8,female,313,205,32,9,18,9,16,0,2
1270637,21,5,1992,7,male,410,211,118,10,0,0,0,10,0
2139891,60,20,1953,9,female,2083,209,100,10,273,1,171,9,102
1065902,30,19,1983,6,male,177,205,126,10,1,9,0,1,1
1348815,33,10,1980,11,male,377,207,143,10,0,10,0,0,0
1364653,58,7,1955,4,male,548,211,138,10,1,10,1,0,0
1355719,22,12,1991,2,male,536,211,156,10,4,10,3,0,1
1165101,27,14,1986,10,male,149,210,172,10,48,10,31,0,17
1103156,29,17,1984,10,female,129,205,119,10,58,10,34,0,24
1242980,30,23,1983,3,female,994,207,102,10,31,10,31,0,0
1258213,47,20,1966,2,male,144,211,98,10,60,10,57,0,3
1548191,25,5,1988,5,male,216,211,142,11,11,0,6,11,5
1750506,100,1,1913,1,male,2461,206,114,11,52,1,22,10,30
1777815,45,2,1968,11,male,705,205,88,11,0,7,0,4,0
1906525,31,2,1982,6,male,577,206,130,11,2,5,2,6,0
1609106,24,10,1989,10,male,274,206,92,11,6,8,6,3,0
1593359,20,18,1993,1,male,380,209,116,11,10,10,7,1,3
1617970,25,15,1988,6,male,655,210,143,11,2,11,2,0,0
1547843,40,21,1973,6,female,178,206,187,11,3,11,2,0,1
1035891,41,5,1972,5,male,444,207,33,11,6,11,6,0,0
1941016,19,21,1994,12,female,117,208,46,11,128,11,118,0,10
1710879,20,8,1993,5,male,805,205,36,11,30,11,7,0,23
1078999,22,15,1991,6,female,396,212,61,11,35,11,16,0,19
1677457,23,9,1990,3,male,239,212,183,11,47,11,30,0,17
2023426,26,28,1987,8,male,515,207,116,11,82,11,62,0,20
2039232,54,13,1959,10,male,1130,210,100,11,23,11,11,0,12
1098146,59,23,1954,2,female,524,211,141,11,70,11,43,0,27
1519638,22,14,1991,7,male,759,210,109,12,2,0,2,12,0
1811174,74,14,1939,4,female,907,209,166,12,2,0,2,12,0
1568720,15,1,1998,1,male,516,207,98,12,20,0,6,12,14
1258633,18,10,1995,6,male,472,208,192,12,1,8,1,4,0
1213458,23,1,1990,1,male,523,206,99,12,5,3,3,9,2
1967310,19,20,1994,7,male,486,208,93,12,3,12,3,0,0
1797973,21,23,1992,11,male,218,210,166,12,8,12,7,0,1
2086620,99,25,1914,10,male,480,211,61,12,12,12,12,0,0
1831002,15,3,1998,5,female,80,207,22,12,23,12,22,0,1
1938033,23,12,1990,11,female,545,205,163,12,41,12,34,0,7
1530354,102,11,1911,11,female,644,205,42,12,28,12,22,0,6
1041192,26,3,1987,5,male,515,208,179,13,4,0,3,13,1
1707928,15,3,1998,9,female,23,212,164,13,20,2,2,11,18
2177928,47,23,1966,11,male,326,205,126,13,31,6,5,7,26
1618878,113,1,1900,1,male,1394,208,110,13,19,12,10,1,9
1039898,20,28,1993,11,male,492,211,186,13,7,13,6,0,1
2188705,14,12,1999,5,female,81,207,130,13,11,13,6,0,5
1053088,25,8,1988,10,male,219,208,164,13,27,13,21,0,6
1358406,26,19,1987,12,female,1039,206,137,14,0,0,0,14,0
1235926,16,12,1997,9,male,632,207,89,14,4,0,1,14,3
1869659,20,8,1993,11,male,575,208,176,14,11,4,0,10,11
1130618,64,27,1949,6,male,82,211,31,14,29,3,14,11,15
1486363,32,1,1981,9,female,386,210,147,14,7,13,5,1,2
2069107,21,6,1992,1,male,820,206,105,14,44,12,28,2,16
1209066,23,19,1990,11,male,710,209,47,14,6,14,5,0,1
1186843,24,1,1989,12,male,829,205,173,14,12,14,7,0,5
1111655,24,5,1989,7,female,812,208,41,14,68,14,61,0,7
2143717,28,29,1985,7,male,2198,207,143,14,47,14,31,0,16
1906898,32,29,1981,1,female,301,206,143,14,54,14,21,0,33
1835321,34,23,1979,8,male,159,205,89,14,29,14,25,0,4
1969903,65,23,1948,1,male,1515,206,105,15,61,0,27,15,34
1416906,18,12,1995,12,male,345,209,112,15,36,13,28,2,8
1204109,19,14,1994,8,female,405,209,73,15,6,15,6,0,0
1608718,25,25,1988,6,male,1829,212,55,15,3,15,2,0,1
1865746,18,25,1995,4,male,309,208,172,15,14,15,13,0,1
1335317,19,23,1994,7,male,35,212,202,15,14,15,14,0,0
1150662,61,12,1952,9,female,795,208,132,16,20,0,10,16,10
1720448,102,2,1911,5,female,1310,211,127,16,22,0,17,16,5
1668391,16,31,1997,1,male,95,205,186,16,13,15,12,1,1
1313337,25,9,1988,11,male,420,208,173,16,16,14,12,2,4
1440970,18,16,1995,8,male,185,205,142,16,0,16,0,0,0
1127253,45,12,1968,8,male,303,208,151,16,3,16,1,0,2
1886635,108,16,1905,9,male,1358,209,85,16,20,16,20,0,0
1821129,15,25,1998,6,female,456,212,78,16,37,16,24,0,13
1146626,19,9,1994,2,female,299,208,159,16,111,16,90,0,21
1200717,21,8,1992,8,female,377,207,41,16,120,16,63,0,57
1334533,50,21,1963,6,female,1134,208,70,16,31,16,11,0,20
1152533,68,1,1945,1,female,375,205,186,16,42,16,33,0,9
1663837,23,25,1990,3,female,583,205,85,17,1,17,1,0,0
2083543,52,24,1961,1,male,436,205,107,17,9,17,7,0,2
1785906,20,23,1993,12,male,1099,206,129,17,23,17,22,0,1
1717516,27,8,1986,1,female,786,209,39,17,33,17,25,0,8
1423023,100,14,1913,9,male,47,207,139,17,27,17,24,0,3
2081275,17,19,1996,10,male,186,208,178,18,2,0,0,18,2
1924925,108,5,1905,9,female,591,210,120,18,5,18,5,0,0
1866245,17,13,1996,4,female,392,211,90,18,31,18,15,0,16
2181140,20,1,1993,1,male,105,209,198,18,56,18,48,0,8
1688856,105,6,1908,9,male,881,205,107,18,107,18,49,0,58
2031981,16,10,1997,9,male,198,205,173,19,0,1,0,18,0
1977851,61,23,1952,9,male,1591,207,115,19,23,0,1,19,22
1212775,17,14,1996,4,male,409,210,62,19,46,0,14,19,32
1800489,81,29,1932,12,male,1627,210,135,19,42,0,25,19,17
1002060,21,15,1992,4,male,461,207,183,19,24,8,11,11,13
2167547,15,30,1998,8,female,206,209,164,19,61,12,42,7,19
1834087,25,20,1988,9,female,289,207,85,19,9,16,4,3,5
1210223,18,7,1995,6,male,266,205,181,19,23,16,10,3,13
1779005,20,1,1993,3,male,503,209,171,19,9,19,9,0,0
1973409,17,14,1996,5,male,521,209,76,20,10,0,4,20,6
1994537,28,9,1985,1,male,90,211,163,20,14,2,5,18,9
1239078,108,26,1905,4,female,20,205,196,20,16,0,5,20,11
1774814,55,25,1958,1,male,690,211,133,20,36,0,3,20,33
1583353,68,29,1945,5,male,892,210,114,20,4,14,2,6,2
1479865,108,23,1905,9,male,1156,209,76,20,1,15,0,5,1
1512651,18,25,1995,5,male,715,209,163,20,0,20,0,0,0
1838203,21,11,1992,4,male,328,211,45,20,2,20,1,0,1
1842817,60,6,1953,2,female,764,212,108,20,1,20,1,0,0
1912908,22,23,1991,9,male,466,210,147,20,8,20,6,0,2
1872170,19,3,1994,12,male,543,206,57,20,47,20,24,0,23
1970147,18,1,1995,3,female,480,210,104,21,24,4,21,17,3
1232678,14,20,1999,2,female,134,206,131,21,71,17,51,4,20
2151623,24,2,1989,1,female,461,211,192,21,0,21,0,0,0
1356801,21,10,1992,12,male,435,208,132,21,9,21,1,0,8
1369522,24,20,1989,7,male,374,210,139,21,10,21,9,0,1
1040049,25,10,1988,1,female,437,209,143,21,9,21,8,0,1
1962960,23,12,1990,4,male,799,212,88,22,8,14,3,8,5
1542626,19,29,1994,11,male,269,212,142,22,29,18,26,4,3
1146505,32,2,1981,4,male,637,207,182,22,2,22,0,0,2
1543589,108,31,1905,8,male,1969,211,91,22,0,22,0,0,0
1437403,18,7,1995,6,male,180,209,172,22,7,22,6,0,1
1188858,20,31,1993,12,male,250,212,126,22,6,22,5,0,1
1637716,18,12,1995,8,female,217,205,30,22,31,22,31,0,0
1906581,26,15,1987,7,male,423,208,175,22,14,22,14,0,0
1356077,15,15,1998,8,female,58,211,38,22,36,22,26,0,10
1968497,30,20,1983,8,male,555,207,125,22,39,22,38,0,1
1680645,61,1,1952,3,male,1224,205,69,23,1,0,1,23,0
1412512,90,9,1923,7,female,37,211,184,23,67,0,4,23,63
1005649,21,7,1992,1,male,359,210,79,23,2,7,0,16,2
1340542,17,19,1996,5,male,485,211,129,23,20,6,9,17,11
1599546,17,11,1996,12,male,650,206,150,23,6,18,5,5,1
1911946,15,27,1998,12,male,484,208,128,23,53,21,19,2,34
1244983,26,28,1987,10,male,397,207,168,23,6,23,6,0,0
1695562,23,1,1990,9,male,595,205,90,23,26,23,24,0,2
2166288,24,5,1989,8,female,337,211,56,24,9,1,5,23,4
1346044,21,25,1992,1,female,220,205,94,24,13,24,13,0,0
1389594,29,27,1984,4,male,228,208,63,24,92,24,79,0,13
1640674,51,13,1962,7,male,1852,208,145,25,27,4,8,21,19
1839498,27,24,1986,9,male,1320,206,156,25,29,17,10,8,19
2089441,27,15,1986,7,male,217,208,131,25,185,24,88,1,97
1548143,22,25,1991,3,female,471,205,68,25,37,25,30,0,7
1355906,50,17,1963,3,female,707,205,75,26,81,1,33,25,48
1525307,17,31,1996,1,male,279,210,35,26,5,6,0,20,5
1754984,18,26,1995,10,male,95,210,199,26,11,14,6,12,5
1869579,19,7,1994,6,male,348,209,106,26,7,16,7,10,0
1795996,17,13,1996,3,female,309,206,62,26,48,17,15,9,33
1583199,24,5,1989,4,male,495,210,161,26,7,22,3,4,4
2006801,19,12,1994,8,male,330,205,61,26,1,26,1,0,0
1968597,107,12,1906,12,male,1335,208,161,26,12,26,8,0,4
1217494,28,15,1985,3,male,71,210,179,26,31,26,25,0,6
1073473,22,17,1991,10,male,142,205,161,26,114,26,37,0,77
1537144,24,18,1989,8,female,109,210,204,26,554,26,552,0,2
1657154,28,16,1985,3,male,1102,212,98,26,58,26,53,0,5
1878386,50,16,1963,10,male,912,210,106,26,41,26,21,0,20
1928568,17,22,1996,2,male,10,209,45,27,122,4,103,23,19
1698726,25,31,1988,12,male,252,205,195,27,5,14,1,13,4
2028305,30,12,1983,8,female,1807,207,138,27,23,27,9,0,14
1007186,46,25,1967,12,male,1431,210,116,27,155,27,77,0,78
1633267,103,13,1910,4,male,1215,208,65,28,287,5,126,23,161
1977693,16,15,1997,8,female,314,205,164,28,121,26,74,2,47
1310306,39,17,1974,8,male,124,207,179,28,50,23,45,5,5
1948500,62,18,1951,5,female,1043,211,128,28,80,23,17,5,63
2024371,16,25,1997,1,male,265,207,98,28,20,28,19,0,1
1083379,18,15,1995,3,female,435,207,87,29,7,29,4,0,3
1119670,34,9,1979,1,male,610,210,166,29,44,29,22,0,22
1361195,36,23,1977,5,male,172,207,111,29,449,29,394,0,55
1903066,48,2,1965,3,female,490,206,32,30,36,0,5,30,31
1503531,58,25,1955,12,female,1037,207,108,31,19,0,9,31,10
1767208,31,2,1982,7,male,868,205,119,31,3,11,2,20,1
1352052,40,17,1973,11,male,1141,212,71,31,38,18,9,13,29
1727213,27,24,1986,6,male,378,208,54,31,0,29,0,2,0
2003950,21,31,1992,10,male,311,210,71,31,22,27,19,4,3
2188038,16,23,1997,9,male,420,211,120,31,2,31,2,0,0
1183136,20,2,1993,8,male,624,206,186,31,9,31,8,0,1
1758640,56,21,1957,5,male,1580,210,123,30,5,30,5,0,0
1689552,108,8,1905,11,female,484,208,87,30,31,30,29,0,2
1079365,16,30,1997,4,male,128,210,142,31,72,31,38,0,34
1034385,91,10,1922,12,female,443,207,153,30,82,30,79,0,3
1235269,17,28,1996,2,female,415,206,54,32,8,3,3,29,5
1664466,16,9,1997,7,male,423,206,157,32,31,26,1,6,30
1554130,106,15,1907,7,female,1025,208,68,32,13,32,1,0,12
1649711,56,14,1957,10,male,536,212,145,32,25,32,25,0,0
1731826,75,22,1938,10,male,811,210,33,33,61,5,27,28,34
1967210,108,17,1905,8,female,1208,208,67,33,82,0,15,33,67
2090222,51,24,1962,1,male,349,207,69,33,9,26,7,7,2
1894439,17,23,1996,8,male,451,210,191,33,4,33,2,0,2
1348513,103,10,1910,7,male,152,208,184,33,2,33,1,0,1
1817586,20,3,1993,3,male,467,212,149,33,27,33,23,0,4
2033481,23,31,1990,1,female,188,206,78,33,25,33,9,0,16
1156043,25,4,1988,8,male,636,208,84,33,35,33,34,0,1
1473142,108,29,1905,5,male,645,207,131,34,13,0,2,34,11
1235324,15,10,1998,9,male,191,209,158,34,4,31,3,3,1
1564602,27,13,1986,3,male,761,207,151,34,76,30,54,4,22
1006731,108,26,1905,3,male,205,207,169,34,61,27,25,7,36
1835126,18,17,1995,7,male,430,206,126,34,2,34,2,0,0
2015555,28,6,1985,5,male,39,205,192,34,2,34,2,0,0
2156812,20,29,1993,3,male,456,211,139,34,18,34,3,0,15
1694324,33,24,1980,7,female,480,207,122,35,35,33,27,2,8
1843590,76,25,1937,1,male,1782,207,58,35,179,31,83,4,96
2025598,25,20,1988,5,male,123,205,193,35,8,35,6,0,2
1528390,21,22,1992,8,female,649,207,145,37,5,6,1,31,4
1198325,65,3,1948,2,male,22,209,108,37,24,0,15,37,9
2034548,21,3,1992,8,male,346,208,54,37,79,37,65,0,14
1960821,49,13,1964,11,female,1813,207,163,37,65,37,37,0,28
1786608,52,6,1961,3,female,1090,205,138,39,0,0,0,39,0
1824709,24,10,1989,2,male,242,212,118,38,15,0,5,38,10
1259575,113,15,1900,11,male,1979,207,101,38,14,2,7,36,7
1018209,17,21,1996,9,male,350,210,90,39,24,11,17,28,7
1086150,92,30,1921,3,female,825,211,33,39,120,19,61,20,59
2042256,57,26,1956,1,female,1506,209,65,38,247,32,169,6,78
1193977,27,12,1986,1,female,718,209,37,38,7,38,4,0,3
1219839,21,5,1992,9,female,592,209,29,39,29,39,28,0,1
1302878,20,22,1993,3,female,621,210,63,38,85,38,85,0,0
2142943,24,5,1989,8,female,925,212,42,39,125,39,123,0,2
1506014,108,9,1905,7,male,928,207,84,40,12,12,6,28,6
1955328,24,9,1989,9,male,715,210,119,40,33,23,16,17,17
1825795,33,31,1980,5,male,302,207,191,40,3,40,2,0,1
1576678,103,3,1910,3,NA,2034,209,89,40,13,40,13,0,0
1680674,28,13,1985,7,male,786,209,119,41,72,24,17,17,55
1277875,30,13,1983,6,female,453,212,53,41,226,24,148,17,78
1537121,100,23,1913,4,male,1969,207,119,42,6,36,4,6,2
1939000,23,10,1990,5,female,395,212,76,42,84,32,48,10,36
1806131,35,1,1978,1,male,238,208,39,42,34,42,27,0,7
1433132,18,1,1995,9,female,572,207,134,44,62,44,36,0,26
1634930,27,12,1986,10,male,885,207,88,44,65,44,39,0,26
1383272,19,12,1994,12,male,477,206,190,43,110,43,75,0,35
1999979,44,25,1969,8,female,699,206,168,45,57,0,29,45,28
1957494,16,10,1997,5,male,388,205,176,45,60,21,24,24,36
1765421,27,17,1986,5,male,112,211,199,45,1,45,0,0,1
1599233,60,24,1953,5,male,1653,208,130,45,7,45,6,0,1
1871724,18,20,1995,2,female,536,209,72,46,2,26,2,20,0
1275706,25,15,1988,6,male,341,208,116,46,15,19,3,27,12
1422445,108,10,1905,9,male,1615,209,65,47,60,18,32,29,28
1044440,24,24,1989,5,male,325,205,11,46,455,20,354,26,101
1135775,26,30,1987,10,male,544,209,147,46,148,36,82,10,66
1611715,15,26,1998,8,male,201,206,103,46,60,46,47,0,13
1123335,16,24,1997,5,male,78,212,124,46,84,46,69,0,15
1586201,22,1,1991,2,male,885,212,141,46,109,46,93,0,16
1110532,96,13,1917,12,male,1167,206,115,47,163,47,139,0,24
1973985,21,2,1992,6,female,730,207,72,48,29,48,18,0,11
2022206,21,12,1992,9,male,441,212,187,49,66,49,52,0,14
1893178,103,8,1910,2,male,1184,208,122,48,42,48,23,0,19
1171675,20,1,1993,11,male,166,209,64,50,48,5,16,45,32
1842101,59,19,1954,12,female,538,206,171,50,20,21,2,29,18
1207841,22,26,1991,7,female,569,208,99,51,82,25,3,26,79
1845108,21,11,1992,9,male,567,208,96,51,43,50,9,1,34
1054038,30,4,1983,10,male,430,205,156,50,1,50,1,0,0
2137913,40,11,1973,8,male,326,210,158,51,18,51,17,0,1
2015899,49,24,1964,12,male,480,209,150,50,21,50,11,0,10
2082410,16,12,1997,9,male,10,207,173,51,58,51,47,0,11
1050665,34,22,1979,2,female,531,205,80,50,47,50,15,0,32
1691130,47,4,1966,4,female,96,207,169,50,249,50,189,0,60
2050276,22,8,1991,12,male,676,209,79,53,11,1,5,52,6
1074116,24,10,1989,10,female,248,207,113,53,41,11,11,42,30
1053762,51,30,1962,11,male,642,210,30,53,226,12,143,41,83
1495784,31,15,1982,7,male,200,209,176,52,15,52,8,0,7
1501304,16,11,1997,12,male,823,208,95,53,37,53,30,0,7
1260284,100,3,1913,1,male,1148,206,49,52,114,52,107,0,7
1116110,25,5,1988,8,male,338,207,173,54,22,6,12,48,10
1867523,57,24,1956,10,female,674,205,159,54,20,1,10,53,10
1302151,65,21,1948,9,female,1655,205,139,55,20,0,3,55,17
1602779,23,12,1990,1,female,135,207,89,55,176,10,107,45,69
1799627,16,20,1997,5,female,260,207,153,54,21,20,3,34,18
1105482,23,14,1990,8,female,482,209,98,55,73,46,41,9,32
1096528,42,2,1971,11,male,502,211,124,54,7,54,7,0,0
1047742,15,10,1998,3,male,798,208,53,55,27,55,24,0,3
2121614,14,26,1999,6,female,87,209,87,55,69,55,47,0,22
1929423,26,26,1987,3,male,426,209,90,56,34,24,10,32,24
1336591,108,30,1905,8,male,1635,206,57,57,16,33,11,24,5
1752946,14,26,1999,1,female,297,206,140,56,140,26,84,30,56
1965503,18,7,1995,2,female,525,206,129,56,37,55,20,1,17
1933808,22,18,1991,10,female,443,212,103,57,43,56,11,1,32
2100478,95,29,1918,3,female,1760,208,94,59,19,21,13,38,6
1110892,16,22,1997,1,female,112,209,158,59,7,59,3,0,4
1673495,18,3,1995,5,male,268,210,50,59,12,59,5,0,7
1194990,24,8,1989,6,male,402,205,180,59,11,59,9,0,2
1658031,108,5,1905,11,female,1563,205,49,60,35,60,11,0,24
1859034,88,20,1925,6,male,1443,209,134,62,48,2,11,60,37
1831016,21,9,1992,3,female,8,210,48,62,169,1,50,61,119
1951864,103,5,1910,1,male,963,210,126,61,65,17,43,44,22
2025316,19,1,1994,5,female,331,206,59,63,22,56,12,7,10
1711610,46,12,1967,7,male,821,211,121,62,480,45,298,17,182
1679300,15,25,1998,7,female,423,206,169,61,4,61,4,0,0
1905240,22,18,1991,9,male,306,212,137,61,70,61,59,0,11
1165562,73,22,1940,10,male,1111,209,128,63,91,63,54,0,37
1391045,24,19,1989,2,female,290,210,163,63,169,63,160,0,9
1159693,113,27,1900,8,female,1442,208,99,65,38,0,8,65,30
1548375,31,17,1982,9,female,1325,205,98,64,584,39,339,25,245
1735362,57,9,1956,9,female,1156,212,101,64,7,64,5,0,2
1181643,32,22,1981,4,male,171,207,190,65,47,65,41,0,6
1827660,32,2,1981,10,male,425,212,193,64,54,64,11,0,43
1946226,108,10,1905,5,male,1243,207,90,64,51,64,38,0,13
2106237,28,30,1985,12,female,528,206,42,64,122,64,77,0,45
1518495,29,17,1984,11,male,278,210,152,68,103,32,71,36,32
1671739,28,17,1985,6,male,322,210,188,68,7,56,5,12,2
2117654,29,29,1984,8,female,664,205,54,68,94,64,80,4,14
1093760,19,22,1994,9,male,353,211,118,66,12,66,12,0,0
1863153,14,27,1999,10,male,354,211,94,69,52,0,10,69,42
1632685,56,25,1957,1,female,1729,212,129,69,222,2,53,67,169
1373127,17,31,1996,7,female,158,211,171,69,10,42,2,27,8
2086829,19,4,1994,5,male,328,211,99,70,3,39,2,31,1
1193689,19,12,1994,9,male,803,212,150,70,14,31,10,39,4
1300293,40,23,1973,7,male,1440,205,83,69,302,63,92,6,210
1366545,31,25,1982,12,female,1066,212,146,70,53,70,50,0,3
1397407,33,18,1980,5,male,132,206,180,69,80,69,69,0,11
1013017,24,31,1989,7,female,290,211,179,73,21,2,2,71,19
2129191,14,27,1999,7,male,204,206,174,74,21,70,15,4,6
1975456,64,28,1949,9,male,1552,210,121,72,70,69,24,3,46
1940671,35,19,1978,12,female,361,207,136,72,172,72,81,0,91
1991435,67,1,1946,1,male,65,209,189,77,26,0,9,77,17
1666487,48,30,1965,3,female,303,209,81,77,126,5,34,72,92
1162460,36,30,1977,5,male,387,210,111,76,57,73,16,3,41
1903547,46,14,1967,8,male,480,211,187,76,111,57,83,19,28
1480108,26,8,1987,2,male,612,210,188,77,20,77,19,0,1
1914877,28,16,1985,7,male,381,210,123,75,237,75,223,0,14
1880735,21,28,1992,1,female,754,210,93,78,57,56,27,22,30
1638562,21,12,1992,10,female,297,205,136,80,33,80,20,0,13
1373137,22,1,1991,4,female,404,211,25,79,143,79,22,0,121
1806652,22,5,1991,10,female,414,207,155,79,162,79,158,0,4
1726366,62,30,1951,5,male,791,205,150,84,96,16,49,68,47
1500396,106,1,1907,12,female,1406,208,49,84,97,40,70,44,27
2038193,50,21,1963,6,female,2449,208,120,82,572,52,306,30,266
1814013,46,11,1967,3,male,707,209,88,84,9,76,7,8,2
1655949,25,18,1988,3,male,474,206,82,81,75,71,47,10,28
1307130,34,21,1979,10,male,487,206,140,83,249,69,199,14,50
2000802,17,15,1996,1,male,280,205,120,82,58,82,47,0,11
1184310,20,25,1993,10,male,438,210,157,82,90,82,78,0,12
1449360,33,5,1980,1,female,425,211,62,83,99,83,71,0,28
1519854,26,31,1987,10,female,309,211,63,82,186,82,123,0,63
1475771,108,1,1905,1,male,2392,207,107,85,15,0,11,85,4
2067518,14,17,1999,11,female,189,211,105,87,378,68,283,19,95
1292599,34,18,1979,5,female,117,212,59,85,81,85,70,0,11
1477537,20,3,1993,11,male,179,210,68,91,492,6,271,85,221
2124986,14,1,1999,9,female,284,206,165,88,9,88,8,0,1
1301003,18,20,1995,11,male,246,209,83,88,33,88,26,0,7
1186285,18,27,1995,1,male,471,210,128,89,48,89,47,0,1
1215123,21,15,1992,8,male,301,208,178,91,55,91,52,0,3
1125041,44,24,1969,10,male,303,208,77,92,5,16,5,76,0
1700317,49,20,1964,6,male,393,212,125,92,45,47,35,45,10
1359630,20,12,1993,9,male,776,208,167,92,7,83,5,9,2
2060862,33,10,1980,3,male,326,205,164,93,62,77,7,16,55
2012619,15,13,1998,7,male,274,209,186,95,14,95,13,0,1
1894137,24,14,1989,4,male,312,205,92,94,33,94,30,0,3
1282578,16,21,1997,3,male,431,209,49,95,257,95,246,0,11
1440363,70,17,1943,9,female,2098,207,112,97,11,0,0,97,11
1145812,31,28,1982,8,male,514,210,95,97,81,42,35,55,46
1436259,65,22,1948,4,male,430,206,80,99,3,99,2,0,1
1333487,22,27,1991,9,female,374,207,65,98,87,98,72,0,15
1329273,32,21,1981,12,female,570,209,44,101,111,4,31,97,80
1539980,23,5,1990,9,female,602,205,165,100,16,24,5,76,11
1758394,21,11,1992,11,female,346,209,172,101,55,46,12,55,43
1253573,19,20,1994,6,male,981,211,101,103,3,98,0,5,3
2053741,17,18,1996,7,male,535,212,159,100,12,100,10,0,2
1340718,21,28,1992,5,female,539,205,50,104,114,104,64,0,50
1042980,22,29,1991,9,female,404,212,61,102,63,102,33,0,30
1996469,23,16,1990,8,male,349,211,147,102,63,102,31,0,32
1919149,32,26,1981,6,female,496,209,8,102,142,102,55,0,87
1448117,88,7,1925,4,female,2077,209,67,106,11,0,6,106,5
1077172,16,10,1997,5,male,399,212,188,107,13,32,9,75,4
1392847,22,25,1991,12,male,400,211,149,105,90,58,28,47,62
1841508,35,23,1978,11,female,2231,208,97,109,447,75,290,34,157
1145439,20,3,1993,2,male,366,211,165,107,164,103,149,4,15
1765096,22,23,1991,10,male,483,211,146,107,14,107,14,0,0
1035661,19,30,1994,10,male,450,209,84,109,64,109,48,0,16
1489215,26,4,1987,3,female,329,206,103,108,56,108,45,0,11
1582363,22,3,1991,5,male,381,211,135,107,84,107,70,0,14
1487323,43,5,1970,7,male,232,209,18,106,71,106,38,0,33
1579695,31,16,1982,7,female,522,206,146,111,405,83,127,28,278
2129008,16,19,1997,11,male,657,206,58,112,9,112,8,0,1
2126467,13,14,2000,1,female,530,206,183,118,13,4,4,114,9
2086331,17,20,1996,11,female,104,212,66,114,63,112,17,2,46
1321085,45,13,1968,4,female,861,210,193,117,459,94,205,23,254
1395499,16,3,1997,7,male,293,205,127,114,13,114,6,0,7
1510508,24,31,1989,8,female,472,206,162,114,1,114,1,0,0
1191584,23,5,1990,3,female,465,211,199,115,67,115,59,0,8
1753167,21,9,1992,10,female,580,208,144,116,95,116,82,0,13
1183676,47,15,1966,10,female,305,212,153,118,72,118,43,0,29
1117954,18,7,1995,12,female,25,211,68,123,132,90,61,33,71
1939104,37,10,1976,9,female,409,206,188,124,127,119,77,5,50
2029746,58,23,1955,3,female,1823,209,58,121,91,111,68,10,23
1917917,32,24,1981,4,female,1900,207,152,121,497,109,335,12,162
1793059,22,26,1991,7,male,262,208,164,120,13,120,6,0,7
1181420,24,29,1989,4,male,203,210,152,123,6,123,6,0,0
1942233,52,12,1961,10,male,1161,212,57,123,116,123,91,0,25
1019994,57,29,1956,2,female,754,205,84,130,295,3,65,127,230
1688087,49,23,1964,1,female,1477,209,81,126,83,42,55,84,28
1466850,18,1,1995,8,male,693,207,112,128,253,32,81,96,172
1805343,16,9,1997,7,female,668,207,128,127,9,122,7,5,2
2066660,30,8,1983,1,female,425,206,126,130,360,124,202,6,158
1037185,32,17,1981,9,male,459,209,113,129,6,129,5,0,1
1827596,23,11,1990,5,female,573,210,60,126,57,126,41,0,16
1440268,22,28,1991,7,male,361,205,120,128,135,128,113,0,22
1348120,65,13,1948,8,male,1138,211,169,131,48,2,17,129,31
2114840,108,11,1905,3,female,2251,208,97,135,73,10,35,125,38
1868399,25,6,1988,3,female,117,207,165,133,83,65,56,68,27
1145110,57,8,1956,9,male,474,208,159,132,5,124,4,8,1
2168231,17,9,1996,12,female,35,205,30,136,123,99,39,37,84
1050982,24,13,1989,7,male,547,212,34,134,80,133,51,1,29
1044898,22,26,1991,9,female,256,209,165,132,107,132,84,0,23
1661759,33,3,1980,7,female,268,211,141,135,107,135,85,0,22
1131309,79,4,1934,3,female,491,210,122,136,86,136,62,0,24
1903439,101,11,1912,6,male,548,205,89,133,94,133,57,0,37
1498479,57,23,1956,7,male,617,209,46,140,113,0,46,140,67
2048351,21,9,1992,11,female,462,212,113,143,66,74,21,69,45
1386073,93,29,1920,4,male,1623,207,108,141,4,141,4,0,0
1016983,28,19,1985,12,female,172,205,71,141,27,141,19,0,8
1361996,100,21,1913,10,female,1835,206,74,139,54,139,35,0,19
1295903,14,3,1999,10,female,265,210,163,145,42,82,31,63,11
1614275,22,26,1991,8,male,176,210,85,145,98,145,68,0,30
1898021,64,16,1949,10,female,2389,207,83,157,203,2,94,155,109
1017507,17,27,1996,12,male,334,209,155,151,3,37,2,114,1
1189479,26,28,1987,3,male,208,208,175,156,103,46,16,110,87
1334575,16,14,1997,9,female,39,207,82,153,91,118,18,35,73
1194759,37,21,1976,1,male,97,205,180,153,75,136,35,17,40
1805654,19,3,1994,10,male,662,207,72,155,227,146,128,9,99
2012369,28,17,1985,1,female,602,211,102,153,217,152,194,1,23
1417758,34,19,1979,2,male,668,211,144,156,686,155,235,1,451
1163344,34,7,1979,2,male,418,208,24,154,21,154,7,0,14
1134467,59,15,1954,4,female,2203,207,55,156,91,156,74,0,17
1566408,38,18,1975,7,male,295,205,174,152,147,152,116,0,31
1324145,16,4,1997,11,male,336,209,133,158,80,1,52,157,28
1292416,19,17,1994,10,male,320,211,162,159,24,79,11,80,13
2142885,23,5,1990,6,male,599,211,109,161,54,103,28,58,26
1448060,25,15,1988,10,male,274,206,79,164,49,157,26,7,23
1382320,38,8,1975,4,female,1012,211,119,160,250,117,54,43,196
2023482,25,24,1988,7,female,318,212,169,160,257,159,73,1,184
1716103,22,17,1991,8,female,760,207,115,161,59,161,58,0,1
1068637,23,23,1990,12,female,1302,207,151,168,264,28,87,140,177
1292392,18,2,1995,10,female,384,212,73,170,256,35,164,135,92
1431245,22,8,1991,11,male,611,208,126,169,24,156,16,13,8
1659738,100,30,1913,10,male,1847,210,154,165,16,149,11,16,5
1886906,51,17,1962,5,female,1600,209,87,170,525,162,295,8,230
1266638,33,19,1980,3,male,279,209,121,166,158,165,155,1,3
2054489,16,24,1997,8,male,279,207,117,168,7,168,4,0,3
1800592,35,2,1978,8,female,427,210,138,165,27,165,23,0,4
1440217,67,10,1946,6,female,1783,206,109,170,134,170,89,0,45
1857036,30,22,1983,6,male,171,212,164,169,284,169,266,0,18
1074688,70,4,1943,10,female,706,208,78,177,33,0,14,177,19
1686342,70,21,1943,3,male,1841,212,118,175,195,9,40,166,155
2174006,14,22,1999,5,female,523,212,112,176,101,144,67,32,34
1205116,19,30,1994,12,male,352,208,185,175,98,137,91,38,7
1884150,56,24,1957,7,female,1261,207,130,177,79,163,61,14,18
1693967,19,13,1994,5,male,196,208,154,185,110,2,70,183,40
1221026,56,24,1957,9,female,502,212,82,185,303,13,92,172,211
1819820,23,5,1990,4,female,414,206,161,189,233,48,138,141,95
1889640,51,13,1962,8,female,1728,211,55,183,496,109,245,74,251
1110230,29,19,1984,10,male,175,212,138,186,312,179,217,7,95
1784375,15,5,1998,6,male,270,210,34,186,97,186,71,0,26
1382043,33,4,1980,4,female,52,207,18,189,36,189,34,0,2
1327276,36,4,1977,7,male,408,211,132,187,107,187,104,0,3
1621651,25,8,1988,7,female,381,210,34,186,284,186,242,0,42
2026602,56,1,1957,7,male,294,205,65,196,182,33,45,163,137
2089260,18,3,1995,10,male,454,207,152,196,40,74,15,122,25
1886553,20,3,1993,2,male,296,211,160,196,79,128,42,68,37
1641929,16,9,1997,6,male,717,208,123,191,148,42,26,149,122
1617553,33,30,1980,5,female,726,206,113,198,165,78,95,120,70
1683236,113,30,1900,8,female,1678,208,95,196,28,181,15,15,13
1506390,33,28,1980,10,male,205,209,80,195,39,150,8,45,31
1755140,50,12,1963,10,female,269,211,28,194,39,188,26,6,13
1215699,52,23,1961,12,female,509,212,155,193,34,169,6,24,28
1066706,42,19,1971,3,female,1145,207,129,200,290,176,223,24,67
1154876,46,1,1967,11,female,519,206,169,193,70,193,50,0,20
1842106,17,4,1996,5,female,353,210,64,194,597,194,341,0,256
2021232,22,15,1991,2,male,437,212,114,196,369,196,365,0,4
1929317,73,11,1940,8,male,1360,207,100,211,31,21,13,190,18
2092105,63,1,1950,4,male,476,207,178,205,145,8,46,197,99
1615043,16,22,1997,5,female,227,211,161,201,41,186,32,15,9
1569845,29,19,1984,12,female,581,209,144,202,240,182,67,20,173
1598582,31,28,1982,11,male,560,206,64,202,16,202,8,0,8
2107754,21,17,1992,6,female,387,209,60,210,168,210,115,0,53
1600741,21,26,1992,11,female,404,208,63,220,194,151,58,69,136
1654577,53,20,1960,3,female,1425,209,70,217,150,127,89,90,61
1576039,15,23,1998,8,female,276,211,125,220,13,217,10,3,3
1434342,34,14,1979,11,female,475,210,115,215,139,214,115,1,24
1929751,30,22,1983,2,female,311,209,182,214,10,214,5,0,5
1802894,91,20,1922,3,female,204,206,172,213,7,213,4,0,3
1946940,17,29,1996,11,female,156,212,161,217,180,217,115,0,65
1930490,18,15,1995,9,female,245,209,132,215,160,215,97,0,63
1835303,49,5,1964,1,male,534,212,54,230,99,0,55,230,44
1625259,47,3,1966,10,female,683,210,127,225,200,0,70,225,130
1538108,20,24,1993,9,male,295,205,110,225,137,215,127,10,10
1975887,43,25,1970,3,male,181,209,156,227,696,217,353,10,343
1962038,24,3,1989,6,male,361,206,134,223,7,223,4,0,3
1824596,40,13,1973,4,female,1384,209,160,230,155,230,100,0,55
1663919,57,19,1956,8,female,1600,205,172,227,150,227,123,0,27
1508426,70,23,1943,11,female,1195,208,167,238,119,0,52,238,67
1638727,33,2,1980,3,female,574,211,135,234,93,157,29,77,64
1947106,18,1,1995,3,male,453,209,185,236,20,232,16,4,4
1425322,108,28,1905,8,male,1847,206,123,238,15,218,12,20,3
1704317,67,16,1946,9,female,2048,206,99,244,122,188,44,56,78
2012847,27,16,1986,7,female,335,205,132,242,151,225,85,17,66
2099091,43,29,1970,7,female,918,208,128,240,319,205,103,35,216
1396394,39,2,1974,10,female,234,210,104,239,391,230,134,9,257
2022763,17,29,1996,10,female,523,205,84,237,93,237,39,0,54
2165441,47,6,1966,3,female,140,210,114,240,80,240,62,0,18
1561283,18,1,1995,9,female,244,206,81,256,67,102,52,154,15
1281633,54,4,1959,10,female,432,205,99,249,257,50,65,199,192
2042029,108,31,1905,3,female,2266,205,127,258,137,244,75,14,62
2060196,17,1,1996,1,male,145,212,165,257,122,255,85,2,37
2042103,16,21,1997,8,female,419,211,59,255,125,255,125,0,0
1314893,22,12,1991,10,female,576,210,138,251,192,251,117,0,75
1638083,29,31,1984,12,female,701,209,128,260,246,260,125,0,121
1860457,66,10,1947,8,female,1744,209,78,270,44,47,29,223,15
1537554,21,11,1992,11,female,983,212,133,267,399,3,215,264,184
1591935,79,2,1934,8,male,1570,209,154,270,30,175,25,95,5
1039909,49,1,1964,9,female,1418,205,98,273,69,121,16,152,53
1119961,68,29,1945,11,female,678,211,82,262,149,232,142,30,7
1577302,18,4,1995,1,female,164,206,106,263,39,263,21,0,18
2141074,65,3,1948,3,female,1930,210,69,285,826,0,159,285,667
1723098,21,23,1992,7,female,530,210,145,292,102,143,72,149,30
1690807,24,19,1989,9,female,680,209,176,289,279,177,212,112,67
2026377,36,5,1977,9,male,646,211,103,292,4,264,3,28,1
1223379,19,20,1994,8,female,156,212,117,280,269,263,56,17,213
1331846,52,10,1961,4,female,324,210,75,292,74,292,28,0,46
1725571,31,5,1982,9,female,673,208,111,280,381,280,240,0,141
2010859,40,16,1973,1,female,507,208,150,291,308,291,299,0,9
2157435,74,30,1939,3,female,2131,210,126,279,179,279,151,0,28
1292491,36,27,1977,3,female,292,207,72,307,250,110,135,197,115
1626124,62,18,1951,4,male,1438,208,96,303,436,131,176,172,260
1236738,32,23,1981,1,female,791,208,181,306,102,300,79,6,23
2152532,25,1,1988,9,male,383,210,146,301,217,250,132,51,85
1734778,30,4,1983,11,female,279,211,150,306,58,306,52,0,6
2004502,56,12,1957,9,female,716,207,106,300,407,300,274,0,133
1153046,18,11,1995,6,female,20,212,135,297,946,297,838,0,108
1776868,23,4,1990,2,male,631,207,130,317,36,74,29,243,7
1400774,103,17,1910,11,female,1019,210,108,326,119,100,61,226,58
1928884,21,13,1992,12,female,1735,209,97,310,152,284,118,26,34
1914774,62,12,1951,4,female,1437,210,116,313,146,293,122,20,24
1769414,21,18,1992,7,female,589,207,169,314,464,242,185,72,279
1428477,38,17,1975,11,male,677,211,124,320,243,294,229,26,14
1018332,24,16,1989,10,female,503,210,156,315,484,315,416,0,68
1136342,17,26,1996,7,female,223,211,138,342,423,20,156,322,267
1115086,21,24,1992,5,female,647,210,122,336,411,207,293,129,118
1169452,33,1,1980,12,female,556,208,73,338,127,330,82,8,45
1500851,45,27,1968,8,female,1827,210,99,329,176,297,116,32,60
1906583,17,3,1996,1,male,496,208,123,334,17,334,17,0,0
2011227,23,6,1990,12,male,526,209,113,330,88,330,34,0,54
1583990,55,4,1958,1,female,595,210,145,355,204,0,100,355,104
1289775,103,22,1910,8,female,338,212,63,364,64,4,9,360,55
1855783,15,27,1998,9,female,39,208,29,361,492,39,60,322,432
1093012,28,1,1985,1,female,34,212,158,359,757,31,347,328,410
1753023,15,11,1998,2,male,250,212,136,363,5,348,0,15,5
2183641,66,12,1947,11,female,1239,209,138,360,169,285,95,75,74
1878358,48,6,1965,6,female,1652,211,140,369,1246,274,670,95,576
1842301,25,1,1988,1,male,214,206,188,363,190,363,178,0,12
1670115,100,23,1913,8,male,1733,207,137,383,268,0,74,383,194
2116289,19,15,1994,8,female,322,212,151,383,583,15,148,368,435
1849725,17,14,1996,4,female,499,205,135,384,53,179,14,205,39
1090327,15,10,1998,1,female,322,205,132,384,134,96,68,288,66
1209827,18,29,1995,4,male,698,210,113,385,296,245,163,140,133
1453555,19,6,1994,10,female,237,205,116,370,342,80,123,290,219
1683673,50,13,1963,4,female,1658,209,135,385,188,298,92,87,96
1191112,36,19,1977,2,female,864,207,95,394,360,394,236,0,124
2146957,18,15,1995,10,female,1212,205,88,401,39,10,17,391,22
1271980,20,23,1993,5,female,500,209,154,401,386,183,121,218,265
1526312,55,26,1958,7,male,466,206,153,399,612,230,423,169,189
1079316,22,17,1991,10,female,361,212,144,419,175,410,137,9,38
1467728,65,27,1948,12,male,1693,206,104,416,162,319,121,97,41
1780818,53,20,1960,7,male,2000,206,104,414,306,413,198,1,108
1646334,23,3,1990,5,male,753,207,134,401,5,401,4,0,1
2116757,21,26,1992,7,female,157,211,170,413,199,413,123,0,76
1845410,15,6,1998,4,female,3,205,44,450,318,87,216,363,102
1987750,32,8,1981,10,male,719,209,158,435,610,295,429,140,181
1432899,15,22,1998,5,female,434,211,117,431,375,363,93,68,282
2153632,19,13,1994,3,female,158,212,118,443,347,438,262,5,85
1174871,24,16,1989,4,female,198,207,87,423,952,418,515,5,437
1840042,45,29,1968,12,female,596,210,92,442,61,441,16,1,45
1163447,19,20,1994,8,female,387,208,125,432,372,428,329,4,43
1535551,23,3,1990,1,male,646,212,115,443,770,443,664,0,106
1523865,108,13,1905,3,female,1190,208,84,459,113,0,57,459,56
1508001,44,26,1969,12,female,460,205,159,463,367,145,193,318,174
1456266,36,16,1977,6,female,251,205,137,466,441,374,387,92,54
1608445,57,15,1956,6,female,1086,209,153,466,814,360,721,106,93
1132779,25,27,1988,7,male,614,208,189,456,287,452,243,4,44
1989673,18,12,1995,10,male,335,211,152,464,211,464,98,0,113
2138103,19,10,1994,7,female,316,209,141,465,152,465,103,0,49
1719191,37,3,1976,11,male,619,207,78,462,124,462,74,0,50
1211434,47,6,1966,8,female,1788,207,101,459,442,459,417,0,25
1947696,61,28,1952,4,female,1804,209,169,511,174,360,123,151,51
1228683,53,28,1960,10,female,1443,205,93,518,356,449,145,69,211
1840085,27,4,1986,10,female,282,211,184,504,655,501,375,3,280
2003895,30,2,1983,3,male,551,207,143,511,122,511,95,0,27
2117085,63,10,1950,3,female,1267,205,141,485,82,485,68,0,14
1302532,51,22,1962,5,female,1832,207,120,500,305,500,236,0,69
1469903,47,25,1966,12,female,485,212,115,548,13,0,2,548,11
1257471,62,20,1951,6,female,56,206,174,539,298,7,144,532,154
1190284,71,13,1942,6,female,25,205,37,544,118,26,32,518,86
2143437,18,16,1995,11,female,32,211,139,534,749,101,263,433,486
1013470,17,23,1996,5,female,51,211,188,549,534,376,370,173,164
2081343,18,21,1995,4,female,286,210,145,540,12,509,7,31,5
1789715,63,20,1950,7,female,1867,210,94,538,742,402,419,136,323
1661627,18,23,1995,10,female,478,211,93,542,236,542,209,0,27
1888326,24,20,1989,7,male,514,208,99,549,267,549,99,0,168
1686638,21,24,1992,4,female,419,206,97,572,342,14,17,558,325
1652535,66,12,1947,11,female,147,207,56,593,211,0,6,593,205
1446833,20,4,1993,4,female,441,211,115,595,371,551,191,44,180
2025664,30,16,1983,6,female,620,212,148,600,393,505,213,95,180
1096053,46,25,1967,9,female,452,209,32,602,407,579,105,23,302
1418573,46,7,1967,11,female,691,205,92,591,293,591,176,0,117
1055706,64,27,1949,11,female,1332,210,59,607,300,607,183,0,117
1539359,21,11,1992,4,male,284,209,140,596,734,596,435,0,299
2063788,28,5,1985,11,female,213,208,161,594,475,594,371,0,104
1672028,61,1,1952,6,female,1922,206,67,642,809,85,299,557,510
2016665,22,10,1991,3,male,67,210,43,626,999,43,238,583,761
2079335,19,16,1994,9,female,812,208,117,661,636,153,310,508,326
1446745,18,15,1995,11,female,207,209,50,613,302,579,224,34,78
1836096,24,30,1989,8,male,452,208,110,656,170,632,108,24,62
1922690,30,10,1983,7,female,417,211,166,640,113,622,53,18,60
1401763,32,2,1981,6,female,421,207,154,633,178,572,78,61,100
1821917,27,1,1986,1,male,391,210,130,626,337,626,320,0,17
1497292,31,7,1982,6,male,365,205,169,640,209,640,207,0,2
1305789,54,11,1959,5,female,122,208,201,720,107,2,28,718,79
1392321,67,20,1946,9,female,1743,207,91,704,508,7,115,697,393
2108212,30,4,1983,7,female,300,208,125,682,44,675,23,7,21
1771213,99,30,1914,6,female,202,212,144,688,393,663,283,25,110
1994398,18,12,1995,6,female,212,212,104,666,878,535,475,131,403
2094291,55,19,1958,9,female,1280,209,142,719,537,606,236,113,301
1836140,19,1,1994,1,female,68,206,138,686,1153,676,531,10,622
1775540,21,3,1992,10,male,713,211,165,689,153,689,150,0,3
1092870,30,6,1983,4,female,280,211,49,721,214,721,182,0,32
1298896,22,6,1991,3,female,477,208,68,713,489,713,439,0,50
1868139,24,21,1989,12,male,481,205,133,700,563,700,477,0,86
2117497,23,1,1990,1,female,137,212,94,673,415,673,396,0,19
1643800,19,26,1994,7,female,185,207,117,770,935,523,457,247,478
2014865,70,15,1943,3,male,1306,208,127,774,613,330,132,444,481
1556136,14,27,1999,1,female,39,209,151,763,1324,224,843,539,481
2120443,23,14,1990,8,female,326,211,146,764,398,731,327,33,71
1303297,100,12,1913,9,male,559,207,129,773,345,773,291,0,54
1161505,14,24,1999,12,female,302,209,145,757,514,757,424,0,90
1287594,43,29,1970,7,female,153,208,178,828,166,90,75,738,91
1133115,59,1,1954,2,male,728,209,95,856,2712,375,1284,481,1428
1273621,21,11,1992,10,female,333,210,138,811,166,675,41,136,125
2156840,17,19,1996,7,female,188,208,48,837,1123,673,408,164,715
1139856,15,26,1998,12,female,680,212,127,867,10,867,8,0,2
1035378,19,6,1994,12,female,275,206,135,810,27,810,25,0,2
1166808,33,8,1980,7,female,171,209,43,844,442,844,351,0,91
1861515,26,15,1987,7,female,141,212,93,835,584,835,521,0,63
1617921,17,15,1996,3,female,656,205,115,915,695,149,206,766,489
1305857,62,25,1951,5,female,1922,209,132,976,632,398,222,578,410
1746262,28,18,1985,7,female,768,212,115,942,1016,942,729,0,287
2188264,35,29,1978,11,female,330,208,133,1019,434,75,70,944,364
1068087,32,23,1981,2,female,376,207,112,1050,507,269,212,781,295
1381824,56,27,1957,2,female,1802,207,49,1029,224,219,117,810,107
1866806,51,13,1962,5,female,1204,205,51,1037,1134,689,351,348,783
1466594,20,7,1993,9,female,559,206,146,1051,614,1032,174,19,440
1773838,44,9,1969,3,female,608,210,99,1084,452,1083,322,1,130
1758414,14,2,1999,5,female,364,206,32,1042,61,1042,48,0,13
1403752,19,2,1994,10,female,21,206,152,1212,1117,109,369,1103,748
1540735,23,30,1990,11,female,302,206,129,1195,632,754,251,441,381
2139021,108,16,1905,1,female,1337,208,117,1175,477,624,271,551,206
2016990,20,16,1993,12,female,1145,211,133,1262,1073,579,734,683,339
1181143,53,28,1960,11,female,1828,205,132,1260,765,953,351,307,414
1331438,31,17,1982,8,female,444,207,125,1146,766,828,517,318,249
2188252,19,12,1994,9,male,320,206,162,1193,35,1182,10,11,25
1304856,18,17,1995,7,female,296,207,57,1169,719,1168,507,1,212
1452513,33,18,1980,8,male,271,207,117,1227,181,1227,160,0,21
1608212,34,31,1979,8,male,500,208,91,1185,159,1185,143,0,16
1727652,58,11,1955,2,female,1511,208,144,1477,752,1387,379,90,373
1886550,20,15,1993,11,male,442,209,154,1487,1257,1449,521,38,736
1512378,14,26,1999,5,male,194,207,113,1454,23,1454,20,0,3
1290345,56,17,1957,6,male,504,210,33,1347,247,1347,209,0,38
1310249,68,7,1945,2,female,1891,212,168,1845,362,0,67,1845,295
2141296,49,2,1964,4,female,735,206,102,1731,1324,286,1009,1445,315
1909849,93,28,1920,2,male,1560,207,105,1856,1303,55,616,1801,687
1026843,18,2,1995,2,female,758,211,90,1780,953,1728,573,52,380
1694740,21,12,1992,12,male,622,212,103,1668,1001,1424,387,244,614
2130873,30,1,1983,6,female,893,210,128,1587,797,1518,378,69,419
1672924,61,22,1952,5,male,1401,208,117,1833,1203,1606,736,227,467
1909338,32,10,1981,4,male,246,209,181,1692,1207,1692,640,0,567
1127495,51,22,1962,1,female,1821,206,53,1729,1713,1729,1624,0,89
1979352,67,26,1946,12,male,1867,208,144,2038,2776,268,452,1770,2324
1632649,59,3,1954,3,female,1257,205,75,1926,405,1414,212,512,193
1826887,68,19,1945,10,female,1701,209,87,1892,684,1439,556,453,128
1956728,23,4,1990,4,female,279,211,112,2407,1582,487,215,1920,1367
1710049,25,27,1988,1,female,68,206,44,3467,2005,3467,1718,0,287
1402286,53,30,1960,9,female,1464,212,164,3122,741,3122,349,0,392
1546811,39,11,1974,12,female,29,212,145,8091,6730,3181,2457,4910,4273
1107270,52,8,1961,1,female,385,208,201,5844,179,5844,132,0,47
2155750,15,11,1998,12,female,226,216,172,0,0,0,0,0,0
1169763,14,19,1999,1,male,386,214,132,0,0,0,0,0,0
1678396,14,22,1999,4,male,478,214,102,0,3,0,1,0,2
1732004,15,10,1998,1,male,379,216,63,0,0,0,0,0,0
1409702,15,20,1998,5,male,634,220,149,0,17,0,2,0,15
1122704,15,24,1998,8,female,305,221,93,0,0,0,0,0,0
1055623,15,27,1998,8,female,295,216,142,0,0,0,0,0,0
2088510,15,7,1998,8,male,237,214,106,0,0,0,0,0,0
1933404,16,20,1997,8,female,125,216,26,0,2,0,0,0,2
1231970,16,7,1997,10,male,216,218,196,0,0,0,0,0,0
2083708,18,30,1995,12,male,322,213,106,0,1,0,1,0,0
1639874,17,18,1996,1,female,237,214,128,0,27,0,11,0,16
1827392,17,29,1996,8,male,608,215,182,0,0,0,0,0,0
1266600,18,1,1995,1,male,411,216,153,0,0,0,0,0,0
2137884,18,1,1995,4,male,392,219,132,0,1,0,0,0,1
1077369,18,30,1995,6,male,307,214,96,0,26,0,20,0,6
1738340,20,20,1993,11,male,355,213,43,0,0,0,0,0,0
1290274,19,27,1994,3,male,233,221,168,0,0,0,0,0,0
1097652,19,22,1994,5,female,438,219,121,0,86,0,46,0,40
1505668,19,3,1994,5,male,189,220,174,0,1,0,1,0,0
2145631,19,8,1994,6,male,629,216,198,0,0,0,0,0,0
1889769,19,12,1994,7,male,628,217,113,0,0,0,0,0,0
1224156,19,18,1994,7,male,494,221,196,0,0,0,0,0,0
1766116,19,16,1994,8,male,623,213,150,0,0,0,0,0,0
1154377,19,21,1994,8,female,598,219,151,0,3,0,2,0,1
1852198,19,27,1994,9,male,659,217,196,0,0,0,0,0,0
1397333,19,9,1994,9,male,656,220,204,0,0,0,0,0,0
2183776,19,27,1994,9,male,569,216,169,0,0,0,0,0,0
2157464,19,10,1994,9,male,379,215,61,0,5,0,0,0,5
2120501,19,14,1994,10,female,284,219,153,0,0,0,0,0,0
1480758,21,19,1992,11,male,548,215,120,0,0,0,0,0,0
1111465,21,17,1992,11,male,369,218,162,0,2,0,2,0,0
1613665,21,10,1992,12,male,676,215,54,0,2,0,0,0,2
1390582,20,17,1993,2,male,1201,221,98,0,0,0,0,0,0
1910249,20,28,1993,3,male,422,219,188,0,0,0,0,0,0
1787543,20,12,1993,4,male,740,218,122,0,0,0,0,0,0
1448784,20,25,1993,5,male,597,220,130,0,0,0,0,0,0
1484191,20,10,1993,8,male,652,219,53,0,0,0,0,0,0
1224342,20,14,1993,10,female,473,221,100,0,9,0,6,0,3
1852828,22,20,1991,11,female,191,213,171,0,0,0,0,0,0
1027266,22,4,1991,12,male,953,213,163,0,7,0,6,0,1
2190761,21,19,1992,1,male,532,218,172,0,0,0,0,0,0
1297401,21,10,1992,1,male,287,220,190,0,2,0,1,0,1
1663360,21,15,1992,2,male,1520,217,165,0,16,0,10,0,6
1237273,21,21,1992,6,female,535,217,154,0,1,0,1,0,0
2159085,21,9,1992,10,male,515,221,197,0,6,0,3,0,3
1186542,23,6,1990,12,female,754,219,111,0,0,0,0,0,0
1773201,22,23,1991,3,male,563,219,130,0,0,0,0,0,0
2123370,22,4,1991,3,male,362,215,85,0,0,0,0,0,0
1184558,22,7,1991,9,male,608,219,48,0,0,0,0,0,0
1210115,23,1,1990,1,female,583,217,179,0,0,0,0,0,0
1039066,23,19,1990,2,female,470,220,104,0,0,0,0,0,0
1325246,23,1,1990,2,female,1437,216,64,0,0,0,0,0,0
1985334,23,27,1990,6,male,893,214,127,0,3,0,3,0,0
1435751,23,4,1990,6,female,304,220,49,0,1,0,1,0,0
1236714,23,11,1990,6,male,269,218,197,0,7,0,7,0,0
1437908,23,25,1990,8,male,969,215,132,0,2,0,2,0,0
1054561,23,19,1990,9,male,822,218,88,0,0,0,0,0,0
1153130,25,10,1988,11,male,389,221,188,0,0,0,0,0,0
1288727,25,30,1988,12,male,741,216,197,0,3,0,0,0,3
1820146,24,18,1989,9,male,716,219,41,0,15,0,6,0,9
2018270,25,1,1988,1,male,216,220,205,0,7,0,6,0,1
1028788,25,5,1988,4,male,384,219,128,0,2,0,1,0,1
1557534,25,19,1988,7,male,483,217,191,0,9,0,7,0,2
2170161,25,18,1988,9,male,563,217,145,0,6,0,6,0,0
1925062,25,27,1988,9,male,96,214,209,0,2,0,2,0,0
1675338,26,19,1987,1,male,573,221,151,0,20,0,15,0,5
1271055,26,20,1987,1,male,284,214,175,0,0,0,0,0,0
2064017,26,2,1987,2,female,317,213,52,0,0,0,0,0,0
1521224,26,11,1987,5,male,693,214,195,0,0,0,0,0,0
1162838,26,22,1987,8,male,178,217,162,0,0,0,0,0,0
1210091,27,11,1986,2,female,197,219,211,0,0,0,0,0,0
2146325,27,16,1986,4,male,512,218,170,0,0,0,0,0,0
2009552,29,17,1984,12,female,603,213,65,0,0,0,0,0,0
1157031,30,23,1983,12,male,1542,215,197,0,0,0,0,0,0
1330984,31,6,1982,12,male,409,218,190,0,0,0,0,0,0
1618174,30,20,1983,8,male,435,218,171,0,21,0,21,0,0
1912206,32,27,1981,11,male,402,213,99,0,0,0,0,0,0
1008448,31,15,1982,2,female,232,219,152,0,0,0,0,0,0
1676815,31,8,1982,3,male,422,213,93,0,1,0,1,0,0
1151466,31,24,1982,3,male,259,214,163,0,0,0,0,0,0
2177772,31,15,1982,7,male,657,214,162,0,2,0,0,0,2
1567319,32,2,1981,8,male,125,213,210,0,2,0,0,0,2
2034354,32,16,1981,10,male,218,219,203,0,1,0,0,0,1
2016615,33,10,1980,1,male,321,215,200,0,5,0,4,0,1
1852382,33,10,1980,3,male,505,221,181,0,1,0,1,0,0
1398710,34,17,1979,7,male,369,216,177,0,0,0,0,0,0
1779220,38,4,1975,12,male,341,220,66,0,5,0,0,0,5
1920753,37,9,1976,2,male,102,220,184,0,0,0,0,0,0
1872862,41,17,1972,2,male,508,216,152,0,0,0,0,0,0
2130402,48,9,1965,10,male,1399,218,70,0,0,0,0,0,0
1382187,53,27,1960,4,male,1022,219,137,0,0,0,0,0,0
1279150,66,2,1947,4,male,569,217,171,0,1,0,1,0,0
1223821,68,30,1945,12,male,342,218,164,0,0,0,0,0,0
1151911,68,16,1945,6,male,1100,214,161,0,0,0,0,0,0
1853187,68,24,1945,6,male,682,220,152,0,0,0,0,0,0
1861116,70,16,1943,3,male,1980,217,51,0,0,0,0,0,0
1990880,78,20,1935,10,male,1530,220,80,0,0,0,0,0,0
1205787,85,5,1928,8,male,2133,218,107,0,0,0,0,0,0
2049735,98,12,1915,5,male,1070,219,166,0,6,0,6,0,0
1970270,99,23,1914,10,male,316,218,38,0,1,0,0,0,1
1647789,103,1,1910,1,male,804,214,159,0,11,0,7,0,4
1813135,103,16,1910,6,male,861,218,94,0,1,0,1,0,0
1801347,107,14,1906,11,female,160,219,189,0,7,0,5,0,2
2003233,108,25,1905,11,male,1020,215,165,0,0,0,0,0,0
2010528,113,19,1900,7,female,1809,219,135,0,2,0,0,0,2
1418660,15,10,1998,5,male,385,216,197,1,0,0,0,1,0
1129398,17,8,1996,1,male,182,216,170,1,0,0,0,1,0
1750872,19,19,1994,4,male,480,219,193,1,0,0,0,1,0
1656221,19,17,1994,7,male,369,213,168,1,0,0,0,1,0
1426349,15,13,1998,10,male,438,219,144,1,1,0,0,1,1
1747875,19,12,1994,2,male,227,221,182,1,1,0,0,1,1
1582843,44,29,1969,7,male,68,214,85,1,1,0,0,1,1
1135352,14,25,1999,3,male,332,217,99,1,4,0,4,1,0
1905297,20,2,1993,1,male,651,221,71,1,2,0,2,1,0
1670937,20,6,1993,3,male,224,217,173,1,3,0,1,1,2
1933566,29,31,1984,1,male,278,213,129,1,6,0,4,1,2
1660227,32,14,1981,11,male,338,215,207,1,16,0,9,1,7
1232062,36,7,1977,8,female,645,215,141,1,11,0,0,1,11
1045768,42,18,1971,5,male,355,216,42,1,43,0,25,1,18
1747820,46,30,1967,6,male,440,217,131,1,4,0,1,1,3
2081665,53,14,1960,1,male,512,215,85,1,2,0,2,1,0
1170255,108,12,1905,2,female,993,216,159,1,15,0,6,1,9
2060916,16,1,1997,6,female,445,219,153,1,0,1,0,0,0
2031170,16,13,1997,7,female,551,221,115,1,0,1,0,0,0
1053994,17,24,1996,3,female,301,221,52,1,0,1,0,0,0
2101298,19,29,1994,12,male,161,219,80,1,0,1,0,0,0
1082174,19,1,1994,1,male,368,214,72,1,0,1,0,0,0
2135740,20,5,1993,1,male,327,220,177,1,0,1,0,0,0
2097593,20,20,1993,7,male,737,219,136,1,0,1,0,0,0
1557555,22,27,1991,12,female,481,213,177,1,0,1,0,0,0
1052873,33,31,1980,1,male,877,216,100,1,0,1,0,0,0
1201046,40,13,1973,9,female,450,214,127,1,0,1,0,0,0
2126074,42,26,1971,8,male,420,215,105,1,0,1,0,0,0
1029637,45,28,1968,9,female,176,216,72,1,0,1,0,0,0
1149534,68,25,1945,5,male,910,216,102,1,0,1,0,0,0
1245097,18,23,1995,10,male,278,215,109,1,1,1,1,0,0
1446406,22,13,1991,5,male,452,220,130,1,1,1,0,0,1
1948063,30,26,1983,7,male,402,218,82,1,1,1,0,0,1
1813571,108,25,1905,11,male,764,216,133,1,1,1,1,0,0
2191792,108,21,1905,12,male,815,214,158,1,1,1,1,0,0
1903503,15,10,1998,10,female,446,217,76,1,6,1,5,0,1
1872300,18,24,1995,12,male,386,213,137,1,53,1,47,0,6
2121251,17,20,1996,3,male,159,213,130,1,5,1,5,0,0
1548131,18,28,1995,2,male,577,216,110,1,5,1,3,0,2
1582560,19,7,1994,7,female,345,216,154,1,10,1,10,0,0
1180659,20,2,1993,1,female,397,220,115,1,3,1,2,0,1
2120370,20,14,1993,8,male,162,220,179,1,3,1,2,0,1
1359992,21,4,1992,5,male,633,218,116,1,2,1,2,0,0
1737716,23,23,1990,5,male,305,214,90,1,17,1,12,0,5
2143996,28,10,1985,1,female,219,217,12,1,11,1,7,0,4
1253654,28,5,1985,5,female,635,214,118,1,3,1,1,0,2
1674805,34,29,1979,11,female,222,213,173,1,9,1,5,0,4
1816501,42,3,1971,11,male,600,218,143,1,7,1,6,0,1
1617075,51,21,1962,12,male,631,219,182,1,12,1,6,0,6
2068141,57,3,1956,4,male,971,220,111,1,3,1,1,0,2
1509448,58,27,1955,4,male,2162,218,106,1,15,1,8,0,7
1812436,62,7,1951,12,male,439,217,122,1,11,1,8,0,3
1546163,68,2,1945,12,male,1075,217,109,1,23,1,20,0,3
1767123,68,19,1945,12,male,235,218,131,1,3,1,3,0,0
1657749,18,9,1995,4,female,360,216,154,2,0,0,0,2,0
1156541,27,11,1986,12,female,885,218,125,2,0,0,0,2,0
1217072,34,27,1979,3,female,445,213,125,2,8,0,7,2,1
1089315,45,28,1968,3,female,343,219,43,2,4,0,3,2,1
1488914,47,12,1966,3,male,164,216,149,2,22,0,6,2,16
1463177,76,6,1937,10,male,1468,220,145,2,33,0,6,2,27
1711746,21,6,1992,12,male,629,213,160,2,1,1,1,1,0
2156645,15,23,1998,1,female,331,217,186,2,4,1,4,1,0
1538903,23,6,1990,11,male,517,218,152,2,9,1,7,1,2
1715440,14,24,1999,8,male,368,215,131,2,0,2,0,0,0
2154869,20,2,1993,2,male,249,215,132,2,0,2,0,0,0
1350557,23,21,1990,10,male,499,214,164,2,0,2,0,0,0
1928463,25,10,1988,10,male,614,218,118,2,0,2,0,0,0
1860249,43,17,1970,6,male,241,218,182,2,0,2,0,0,0
1289466,86,25,1927,5,female,733,213,38,2,0,2,0,0,0
2163449,16,17,1997,8,male,484,215,99,2,409,2,402,0,7
1587124,18,28,1995,11,male,393,217,188,2,12,2,10,0,2
2007662,17,5,1996,10,male,502,218,101,2,4,2,4,0,0
1945998,18,23,1995,1,male,1027,220,104,2,10,2,9,0,1
1222486,18,16,1995,6,male,238,221,203,2,3,2,1,0,2
1671535,18,5,1995,9,female,631,217,99,2,23,2,12,0,11
1862954,20,26,1993,4,female,229,217,128,2,17,2,5,0,12
1301261,22,12,1991,11,female,103,213,80,2,41,2,24,0,17
1536381,23,17,1990,12,female,587,220,128,2,3,2,3,0,0
2180622,22,29,1991,7,female,680,216,128,2,4,2,4,0,0
1421433,23,1,1990,6,male,398,214,159,2,9,2,1,0,8
1340923,25,15,1988,7,male,978,220,111,2,23,2,15,0,8
1049170,28,12,1985,5,male,478,218,191,2,3,2,2,0,1
1065525,36,10,1977,6,male,395,215,122,2,15,2,15,0,0
1924603,37,17,1976,7,male,753,215,157,2,10,2,0,0,10
1604607,68,6,1945,1,male,474,218,107,2,15,2,13,0,2
1899797,24,23,1989,7,male,690,220,188,3,0,0,0,3,0
1330687,53,28,1960,7,male,287,217,186,3,0,0,0,3,0
1638296,51,20,1962,6,male,1101,221,155,3,1,0,0,3,1
1291338,15,27,1998,3,female,358,214,79,3,10,0,0,3,10
1183863,27,8,1986,11,female,258,214,149,3,29,0,14,3,15
1015994,30,30,1983,8,male,445,214,165,3,9,0,2,3,7
1764384,61,15,1952,2,female,545,215,164,3,7,0,3,3,4
2019305,20,12,1993,12,male,224,221,81,3,0,2,0,1,0
1848366,23,26,1990,10,male,616,217,142,3,0,1,0,2,0
1487763,13,27,2000,4,male,183,219,200,3,27,1,6,2,21
1980865,31,21,1982,4,male,778,221,149,3,12,2,6,1,6
1668092,33,8,1980,5,female,802,214,96,3,5,1,5,2,0
1207708,108,11,1905,7,male,1609,217,92,3,17,1,14,2,3
1977046,19,12,1994,12,male,260,219,207,3,0,3,0,0,0
1174367,27,4,1986,5,male,552,217,140,3,0,3,0,0,0
1787503,18,1,1995,1,male,191,213,185,3,1,3,1,0,0
1354420,101,9,1912,3,male,454,217,188,3,1,3,1,0,0
2187530,23,1,1990,1,male,493,216,146,3,3,3,3,0,0
1902682,39,12,1974,7,male,1280,218,114,3,2,3,2,0,0
1790920,103,11,1910,3,female,549,214,71,3,3,3,2,0,1
1607069,17,23,1996,10,male,597,218,35,3,9,3,9,0,0
2116556,20,8,1993,11,male,256,221,87,3,5,3,5,0,0
1707628,19,13,1994,6,female,517,216,20,3,35,3,29,0,6
1886707,19,10,1994,8,female,240,219,85,3,17,3,9,0,8
2153189,20,30,1993,3,female,323,213,70,3,6,3,6,0,0
2098222,23,1,1990,12,male,1187,221,105,3,23,3,19,0,4
1775671,22,24,1991,6,male,553,216,129,3,44,3,24,0,20
1745161,25,13,1988,12,female,302,214,61,3,18,3,8,0,10
1333218,26,25,1987,8,male,1252,216,122,3,5,3,3,0,2
1690021,29,14,1984,2,male,269,216,173,3,16,3,16,0,0
1633959,30,25,1983,6,male,535,213,116,3,5,3,4,0,1
1945638,36,15,1977,11,male,1249,218,78,3,67,3,55,0,12
1963670,64,18,1949,12,male,1759,219,51,3,9,3,2,0,7
1312148,14,26,1999,11,male,382,221,189,4,0,0,0,4,0
2142261,108,3,1905,6,male,1264,213,56,4,0,0,0,4,0
1313653,20,26,1993,5,male,336,219,148,4,1,0,0,4,1
1128463,20,5,1993,3,male,287,213,150,4,8,0,7,4,1
2088376,20,12,1993,12,female,343,218,169,4,19,1,2,3,17
1811506,19,14,1994,8,male,244,219,188,4,9,2,5,2,4
1471898,18,8,1995,9,male,153,220,196,4,17,3,6,1,11
1540545,29,5,1984,11,male,1342,217,92,4,20,3,4,1,16
1139163,36,28,1977,7,female,322,217,134,4,0,4,0,0,0
1192751,44,12,1969,12,female,517,216,99,4,0,4,0,0,0
1413321,42,25,1971,4,male,768,216,144,4,2,4,0,0,2
2114865,23,27,1990,1,male,635,218,171,4,5,4,5,0,0
1439608,22,27,1991,12,female,277,214,82,4,16,4,8,0,8
1262879,21,8,1992,7,male,195,213,139,4,10,4,8,0,2
1547952,28,24,1985,5,male,1494,216,119,4,163,4,155,0,8
1974181,41,27,1972,4,male,575,218,91,4,9,4,4,0,5
1773238,46,9,1967,9,female,633,217,80,4,38,4,26,0,12
1607968,50,27,1963,3,female,554,216,63,4,10,4,8,0,2
1681836,53,27,1960,6,male,184,215,113,4,7,4,6,0,1
1355595,94,12,1919,2,female,2301,215,83,4,33,4,30,0,3
2102452,113,1,1900,1,male,1664,221,60,4,18,4,13,0,5
1434651,28,18,1985,8,male,196,220,182,5,3,2,0,3,3
1174143,48,1,1965,1,male,363,215,183,5,38,3,21,2,17
1048883,25,10,1988,10,male,181,219,196,5,0,4,0,1,0
2085703,22,5,1991,7,female,393,213,182,5,8,4,6,1,2
1147983,53,25,1960,3,male,2410,216,128,5,16,4,3,1,13
1806527,57,8,1956,7,male,388,217,61,5,9,4,2,1,7
1725106,19,14,1994,11,male,356,216,88,5,0,5,0,0,0
1800317,22,1,1991,9,male,543,216,63,5,0,5,0,0,0
1060262,23,1,1990,4,male,195,219,133,5,5,5,5,0,0
1896048,23,19,1990,5,male,809,219,100,5,5,5,3,0,2
1622379,103,4,1910,5,male,469,220,150,5,7,5,7,0,0
2015493,16,27,1997,10,male,420,219,87,5,29,5,15,0,14
1350686,25,26,1988,4,male,878,221,156,5,31,5,13,0,18
1119320,33,6,1980,8,male,227,219,166,5,45,5,43,0,2
1706418,43,7,1970,9,male,768,213,77,5,32,5,21,0,11
1566086,18,10,1995,8,male,340,215,91,6,3,0,0,6,3
1378444,63,4,1950,6,female,365,216,167,6,5,1,4,5,1
1296920,21,18,1992,10,male,1800,219,106,6,9,1,1,5,8
1287198,23,10,1990,8,female,148,216,70,6,15,0,6,6,9
1971576,16,6,1997,11,male,435,218,110,6,26,3,15,3,11
2060475,24,18,1989,11,male,628,216,16,6,0,5,0,1,0
1230897,23,20,1990,5,male,649,216,86,6,0,6,0,0,0
1682401,19,22,1994,1,male,343,217,159,6,1,6,1,0,0
1506037,22,20,1991,10,female,344,220,68,6,1,6,1,0,0
1885856,23,12,1990,8,male,453,220,204,6,2,6,1,0,1
1047759,23,4,1990,9,male,702,214,167,6,3,6,1,0,2
1702235,24,14,1989,8,male,430,214,121,6,2,6,2,0,0
1672263,103,6,1910,11,female,975,213,73,6,1,6,0,0,1
1438034,18,13,1995,6,male,438,218,106,6,5,6,4,0,1
1384923,24,10,1989,2,male,1292,215,117,6,6,6,4,0,2
1736788,28,9,1985,1,male,829,215,107,6,7,6,5,0,2
1526443,103,17,1910,9,male,481,217,143,6,4,6,4,0,0
1707439,18,12,1995,11,female,282,220,82,6,75,6,39,0,36
1174159,19,13,1994,2,female,123,219,136,6,18,6,5,0,13
1738438,19,23,1994,6,male,532,218,191,6,13,6,8,0,5
1676409,21,5,1992,2,male,117,216,167,6,11,6,1,0,10
1218642,23,1,1990,1,female,100,217,128,6,669,6,370,0,299
1496848,60,14,1953,9,male,366,219,23,6,22,6,15,0,7
1099067,19,1,1994,3,male,314,214,107,7,4,0,3,7,1
1082259,108,31,1905,1,male,1450,215,123,7,6,0,3,7,3
2032244,18,10,1995,1,male,329,216,196,7,12,0,2,7,10
1079516,22,5,1991,4,male,182,217,150,7,62,0,8,7,54
1011437,19,6,1994,2,male,404,219,164,7,0,2,0,5,0
1731683,19,30,1994,11,male,790,216,106,7,65,3,62,4,3
1826540,30,11,1983,3,male,881,215,101,7,34,3,16,4,18
1238882,34,26,1979,8,male,596,220,129,7,32,5,13,2,19
1183211,57,27,1956,3,female,1473,219,20,7,14,5,4,2,10
1968242,18,9,1995,1,male,694,218,79,7,1,7,0,0,1
2110398,25,10,1988,4,female,452,214,131,7,1,7,1,0,0
1779589,28,1,1985,11,male,343,221,216,7,6,7,5,0,1
1344070,22,13,1991,6,male,541,213,182,7,30,7,29,0,1
2071091,18,11,1995,3,female,279,220,137,8,1,0,1,8,0
1236296,103,12,1910,4,male,1379,219,97,8,1,0,0,8,1
1473331,30,17,1983,9,male,583,213,101,8,4,0,3,8,1
2128816,22,30,1991,9,female,767,214,145,8,4,2,2,6,2
1344950,33,24,1980,9,male,916,214,119,8,4,3,1,5,3
1916821,15,13,1998,3,male,677,218,110,8,9,3,1,5,8
1968150,16,26,1997,7,male,666,216,162,8,10,2,4,6,6
1224151,14,17,1999,6,female,160,216,153,8,2,7,1,1,1
1813475,16,10,1997,8,male,161,218,142,8,2,7,2,1,0
1498623,18,11,1995,4,female,143,215,92,8,10,6,2,2,8
1102650,18,3,1995,8,male,467,215,195,8,49,6,45,2,4
1166760,59,31,1954,5,female,1505,217,89,8,401,6,238,2,163
1810117,61,17,1952,5,male,477,218,119,8,113,7,47,1,66
2152136,15,27,1998,12,male,309,219,81,8,1,8,0,0,1
1246177,40,4,1973,5,female,635,219,113,8,4,8,3,0,1
2101052,23,1,1990,1,male,372,221,157,8,5,8,5,0,0
2047799,19,9,1994,3,female,428,214,160,8,29,8,10,0,19
1937970,17,12,1996,10,male,401,216,52,9,4,0,1,9,3
1246090,18,8,1995,9,male,318,217,189,9,6,1,6,8,0
1275018,38,9,1975,10,male,1523,215,61,9,11,0,1,9,10
1696888,108,25,1905,1,male,1540,219,41,9,35,0,30,9,5
1347175,100,15,1913,4,male,1565,213,75,9,2,7,0,2,2
1792321,13,30,2000,1,female,250,218,122,9,8,7,2,2,6
1229509,24,22,1989,8,male,292,220,156,9,10,7,7,2,3
1778297,23,19,1990,9,male,265,218,172,9,2,9,2,0,0
1057431,28,7,1985,4,male,710,214,137,9,7,9,4,0,3
1528124,22,14,1991,8,male,676,218,130,9,21,9,21,0,0
1562506,33,15,1980,1,male,32,220,61,9,28,9,24,0,4
1011699,37,31,1976,3,male,457,220,187,9,27,9,15,0,12
1427207,83,4,1930,3,female,471,213,77,9,51,9,32,0,19
2067132,16,2,1997,5,male,130,216,153,10,0,0,0,10,0
1149010,61,16,1952,5,male,1766,216,68,10,13,0,9,10,4
1661632,14,25,1999,8,male,226,221,120,10,8,9,4,1,4
1544752,22,21,1991,2,male,450,221,142,10,0,10,0,0,0
1339217,15,22,1998,12,male,537,217,150,10,5,10,5,0,0
1997488,21,1,1992,1,male,147,214,188,10,3,10,3,0,0
1836628,22,5,1991,6,male,191,218,74,10,4,10,4,0,0
2191756,103,2,1910,2,male,1081,213,102,10,3,10,0,0,3
1539819,22,16,1991,10,male,541,219,102,10,7,10,6,0,1
1379455,22,1,1991,11,female,988,216,126,10,8,10,5,0,3
1808945,26,24,1987,3,female,241,221,74,10,10,10,9,0,1
1421458,33,24,1980,11,female,631,219,112,10,11,10,7,0,4
1750144,113,1,1900,1,male,1467,213,101,10,11,10,11,0,0
1746781,18,2,1995,1,male,807,213,74,10,16,10,8,0,8
1803872,29,16,1984,10,male,589,218,122,10,19,10,16,0,3
1051646,16,13,1997,11,female,272,217,72,11,0,0,0,11,0
1122548,61,2,1952,1,female,1963,219,139,11,43,4,19,7,24
1362573,24,26,1989,2,male,921,215,47,11,1,10,1,1,0
1073879,62,12,1951,2,male,1145,218,81,11,12,9,4,2,8
1679197,18,21,1995,3,female,627,221,62,11,36,10,26,1,10
2067090,16,22,1997,12,male,411,220,173,11,0,11,0,0,0
1227160,24,24,1989,6,male,604,216,67,11,4,11,3,0,1
1628915,32,1,1981,6,female,1639,219,84,11,4,11,3,0,1
1341092,25,6,1988,4,male,108,218,193,11,15,11,13,0,2
1204563,27,15,1986,12,female,218,215,183,11,16,11,15,0,1
1188124,31,17,1982,9,male,1240,213,135,11,16,11,15,0,1
1430327,14,9,1999,7,male,183,216,192,11,22,11,7,0,15
1358970,18,27,1995,3,male,223,221,119,11,23,11,21,0,2
1624127,18,16,1995,10,male,174,219,184,11,47,11,33,0,14
1963091,21,15,1992,9,male,100,218,151,11,19,11,17,0,2
1927599,23,11,1990,6,female,386,217,176,11,33,11,20,0,13
2167890,24,28,1989,7,male,250,218,123,11,51,11,39,0,12
1738697,27,3,1986,10,male,846,214,154,11,32,11,31,0,1
1610783,23,26,1990,12,male,421,213,191,12,1,0,1,12,0
1591528,26,20,1987,9,female,548,221,24,12,1,0,1,12,0
2125005,54,8,1959,11,male,238,217,153,12,4,2,1,10,3
1407511,20,7,1993,4,male,389,215,131,12,41,2,39,10,2
1094519,54,16,1959,2,male,523,221,179,12,21,0,10,12,11
1930605,108,18,1905,9,male,1100,218,99,12,2,3,2,9,0
2128351,17,7,1996,2,male,332,219,206,12,7,11,7,1,0
1916633,103,21,1910,5,male,643,221,180,12,10,9,10,3,0
1426023,103,1,1910,5,male,711,214,177,12,1,12,1,0,0
1545481,25,27,1988,2,male,597,214,140,12,3,12,1,0,2
1451213,14,1,1999,1,male,312,219,192,12,13,12,13,0,0
2036209,32,15,1981,10,male,764,213,98,12,15,12,14,0,1
1713390,19,9,1994,10,male,534,219,72,12,29,12,4,0,25
1502532,40,28,1973,1,male,284,216,94,12,58,12,56,0,2
1660680,38,27,1975,2,female,368,214,177,13,2,0,1,13,1
1213837,60,12,1953,9,male,1283,220,90,13,149,1,86,12,63
1436305,18,6,1995,6,male,544,218,172,13,1,12,1,1,0
1664406,20,1,1993,1,male,474,217,77,13,1,13,1,0,0
1810789,21,14,1992,10,male,687,220,173,13,1,13,1,0,0
2076160,18,5,1995,2,male,419,221,194,13,3,13,3,0,0
1191501,18,7,1995,7,male,1223,214,195,13,3,13,3,0,0
1216834,30,11,1983,5,male,447,216,142,13,5,13,3,0,2
1365922,31,31,1982,3,female,551,219,120,14,365,0,34,14,331
2039410,102,9,1911,9,male,772,220,185,14,1,7,1,7,0
1627979,18,2,1995,4,male,1681,216,118,14,17,8,8,6,9
1537360,22,11,1991,6,male,564,218,155,14,1,13,0,1,1
1455896,39,18,1974,4,male,369,214,187,14,0,14,0,0,0
1138829,108,24,1905,11,female,1019,216,79,14,0,14,0,0,0
1315420,31,24,1982,3,male,398,215,189,14,3,14,1,0,2
1855810,102,19,1911,12,male,1230,220,131,15,0,6,0,9,0
1470671,95,12,1918,3,female,165,213,148,15,23,6,5,9,18
1457701,18,16,1995,1,male,176,217,159,15,8,13,5,2,3
1419083,20,26,1993,3,male,313,214,188,15,9,13,6,2,3
2055731,19,20,1994,9,male,571,216,105,15,5,15,4,0,1
1111652,23,3,1990,12,male,1089,213,134,15,4,15,3,0,1
1770765,29,10,1984,10,male,167,221,160,15,12,15,11,0,1
1610751,22,11,1991,9,female,667,221,70,15,118,15,50,0,68
1080415,26,9,1987,2,female,334,215,141,15,27,15,26,0,1
2044625,28,15,1985,10,male,281,213,161,15,131,15,45,0,86
1969457,21,10,1992,1,male,179,213,171,16,11,0,4,16,7
1637190,57,4,1956,3,female,1985,217,121,16,14,0,11,16,3
1281904,21,1,1992,1,male,589,215,83,16,64,1,14,15,50
1310859,24,16,1989,9,male,326,214,170,16,3,14,2,2,1
1700141,14,1,1999,4,female,452,215,87,16,71,15,30,1,41
1271722,19,7,1994,9,female,249,215,73,16,507,12,341,4,166
1991621,17,19,1996,11,female,551,215,118,16,6,16,3,0,3
1300190,35,20,1978,1,female,1922,215,143,16,5,16,5,0,0
1440862,20,13,1993,4,male,347,216,156,16,12,16,9,0,3
1645235,28,25,1985,12,male,369,218,184,16,19,16,17,0,2
1909252,19,24,1994,9,male,609,214,119,17,0,0,0,17,0
1770086,40,3,1973,1,male,740,220,174,17,1,0,1,17,0
1710554,19,1,1994,1,male,249,213,120,17,10,0,5,17,5
1952297,22,27,1991,2,male,241,218,109,17,5,0,3,17,2
1760016,71,21,1942,6,female,1567,220,94,17,78,0,49,17,29
1302161,25,19,1988,11,male,443,220,147,17,14,10,11,7,3
1861255,24,25,1989,5,male,578,217,98,17,76,4,17,13,59
1693672,18,17,1995,6,female,563,214,80,17,1,17,1,0,0
1755475,19,12,1994,1,female,487,215,104,17,24,17,18,0,6
1696132,37,5,1976,12,male,127,219,180,17,19,17,17,0,2
1435745,17,14,1996,8,male,297,219,115,17,30,17,19,0,11
1993573,23,10,1990,1,female,487,215,83,17,98,17,67,0,31
1415210,61,20,1952,9,male,1323,219,128,17,122,17,88,0,34
2113620,17,14,1996,7,male,531,217,137,18,5,0,3,18,2
1678427,24,29,1989,8,male,75,220,169,18,25,4,6,14,19
1858097,14,9,1999,7,male,222,217,154,18,1,18,0,0,1
1839779,22,1,1991,1,female,255,217,105,18,45,18,24,0,21
1297775,23,23,1990,10,female,225,221,21,18,29,18,20,0,9
1005655,37,10,1976,8,female,130,215,29,18,50,18,38,0,12
1542129,24,6,1989,9,male,710,218,143,19,29,10,22,9,7
1754574,30,13,1983,7,female,1050,220,130,19,5,19,2,0,3
1828576,39,28,1974,1,male,157,215,63,19,12,19,12,0,0
2180107,68,24,1945,7,female,353,217,61,19,24,19,22,0,2
1321697,15,23,1998,8,female,195,218,75,19,31,19,30,0,1
1139483,25,16,1988,5,female,10,213,54,19,70,19,20,0,50
1671534,27,19,1986,10,female,458,213,149,19,112,19,93,0,19
2167730,20,31,1993,3,male,374,215,165,20,0,0,0,20,0
1424858,18,15,1995,12,male,325,219,134,20,24,0,10,20,14
1419747,38,17,1975,8,male,1469,215,132,20,30,13,22,7,8
2117163,17,25,1996,11,female,559,221,94,20,0,20,0,0,0
1992635,28,24,1985,11,female,210,218,186,20,1,20,1,0,0
2103689,103,9,1910,3,male,584,213,140,20,2,20,2,0,0
1354914,16,13,1997,8,male,152,221,185,20,9,20,1,0,8
1007503,22,25,1991,2,male,643,221,167,20,8,20,6,0,2
1954578,32,23,1981,9,female,367,216,150,20,8,20,0,0,8
1231759,33,26,1980,6,female,537,219,146,20,52,20,9,0,43
1022266,108,13,1905,1,female,2149,217,113,21,18,0,5,21,13
1995636,17,31,1996,10,male,68,218,114,21,57,0,11,21,46
1090095,18,24,1995,3,male,186,213,188,21,71,0,23,21,48
1058411,77,1,1936,5,male,1199,217,135,21,22,14,6,7,16
1685187,100,21,1913,10,male,1211,218,113,21,19,21,13,0,6
1215430,26,16,1987,3,male,423,215,145,21,56,21,55,0,1
1190480,33,1,1980,1,male,266,216,47,21,45,21,12,0,33
1557985,18,20,1995,4,female,417,213,102,22,3,4,0,18,3
1130072,18,17,1995,10,male,254,217,204,22,1,13,0,9,1
1288107,23,3,1990,1,male,867,221,179,22,0,19,0,3,0
1066477,26,15,1987,5,male,362,221,169,22,3,22,3,0,0
1323189,14,22,1999,5,male,179,218,97,22,10,22,6,0,4
1013202,38,13,1975,11,male,816,213,121,22,12,22,10,0,2
1301973,47,14,1966,5,female,123,216,174,22,20,22,20,0,0
1765308,103,26,1910,4,male,514,218,148,22,15,22,15,0,0
1825845,14,4,1999,6,female,195,220,80,23,9,4,5,19,4
1796244,20,31,1993,7,male,237,220,115,23,33,0,15,23,18
2086021,23,10,1990,10,female,914,221,79,23,132,9,67,14,65
2179756,35,9,1978,11,male,676,214,75,23,7,23,4,0,3
1342799,50,19,1963,2,female,897,221,89,23,12,23,6,0,6
1982282,28,24,1985,1,male,359,218,96,23,14,23,9,0,5
1105779,20,26,1993,1,male,398,220,182,24,31,3,6,21,25
1190179,31,13,1982,2,male,327,216,193,24,237,21,121,3,116
1492562,16,3,1997,3,male,270,217,136,24,2,24,1,0,1
1599476,20,7,1993,10,male,376,215,193,24,3,24,1,0,2
1636709,33,1,1980,1,male,544,214,175,24,11,24,8,0,3
1655988,28,19,1985,10,female,696,218,86,24,46,24,32,0,14
1771552,80,5,1933,7,female,1674,220,61,25,10,0,5,25,5
1299313,32,23,1981,8,female,224,219,138,25,20,0,4,25,16
1237604,18,25,1995,9,female,571,213,135,25,31,9,21,16,10
1719418,18,1,1995,11,male,287,216,102,25,5,25,5,0,0
2061333,108,5,1905,10,male,576,213,186,25,15,25,15,0,0
1493111,26,10,1987,12,male,1410,215,123,25,38,25,33,0,5
1726485,23,10,1990,10,male,410,215,171,26,9,0,5,26,4
1317911,108,28,1905,2,male,1647,216,99,26,11,0,1,26,10
1079606,20,24,1993,9,female,53,220,203,26,6,26,6,0,0
1737665,14,10,1999,7,female,15,219,9,26,35,26,20,0,15
1955658,18,22,1995,7,female,559,213,71,26,23,26,20,0,3
1024783,54,9,1959,6,male,174,221,171,26,34,26,24,0,10
1496995,25,27,1988,8,male,235,221,148,26,66,26,39,0,27
1325935,27,30,1986,4,male,914,215,88,26,100,26,91,0,9
1443529,68,23,1945,1,male,289,221,196,27,0,0,0,27,0
1531381,43,9,1970,2,male,685,218,182,27,46,26,29,1,17
1169551,18,1,1995,1,male,460,213,123,27,12,27,6,0,6
1417055,15,15,1998,10,male,640,215,23,27,28,27,27,0,1
1852946,18,17,1995,5,male,930,219,167,27,59,27,49,0,10
1879861,20,17,1993,12,female,526,220,86,28,18,0,10,28,8
1201921,21,18,1992,6,female,1471,217,68,28,33,0,17,28,16
1373618,18,12,1995,5,female,428,217,158,28,62,4,18,24,44
1002597,16,29,1997,9,male,281,213,173,28,3,8,2,20,1
2124788,18,4,1995,5,male,995,220,167,28,0,12,0,16,0
1802084,31,23,1982,12,male,440,218,153,28,0,28,0,0,0
2164988,23,20,1990,7,male,365,216,139,28,10,28,10,0,0
2113571,20,19,1993,9,female,490,220,126,28,26,28,8,0,18
1740589,32,8,1981,8,male,1263,219,107,28,22,28,12,0,10
1533309,63,11,1950,5,male,73,217,168,29,54,1,31,28,23
1823100,23,25,1990,7,female,644,219,20,29,112,19,48,10,64
1017838,45,25,1968,4,male,205,221,184,29,8,28,8,1,0
2080502,26,4,1987,7,male,368,221,167,29,20,29,17,0,3
1492132,17,4,1996,7,female,650,213,120,29,67,29,65,0,2
1381138,22,23,1991,9,female,563,221,119,29,93,29,71,0,22
1066481,33,7,1980,6,male,946,216,81,29,45,29,10,0,35
1054412,15,14,1998,8,male,402,214,159,30,4,1,0,29,4
1653054,14,10,1999,6,male,431,220,112,30,22,1,4,29,18
1520847,58,12,1955,7,male,547,220,140,30,68,0,13,30,55
2059795,21,29,1992,6,female,87,217,30,30,16,9,3,21,13
1940353,22,22,1991,7,male,145,214,193,30,17,6,5,24,12
1390973,21,2,1992,5,male,280,219,179,30,38,13,30,17,8
1488063,15,7,1998,6,male,408,218,123,31,8,30,4,1,4
1853029,60,22,1953,4,male,678,218,182,31,18,28,10,3,8
1897630,28,23,1985,9,male,234,213,209,30,32,26,18,4,14
1761810,23,6,1990,11,female,533,214,46,30,172,27,64,3,108
1981798,19,28,1994,12,male,493,220,165,30,2,30,2,0,0
1086558,108,6,1905,6,male,907,218,80,31,4,31,4,0,0
2054052,26,15,1987,5,female,751,218,141,30,11,30,11,0,0
1849231,29,17,1984,8,male,238,213,171,31,10,31,4,0,6
1733790,95,11,1918,9,male,2168,216,112,30,5,30,5,0,0
1628146,18,30,1995,8,male,462,220,119,31,20,31,20,0,0
1471821,21,27,1992,7,female,237,219,52,31,27,31,22,0,5
1186937,19,17,1994,3,female,405,215,122,32,39,2,15,30,24
1712271,20,20,1993,3,female,185,216,47,32,124,32,81,0,43
1283691,58,6,1955,5,female,1205,219,128,32,179,32,160,0,19
1461422,55,26,1958,3,male,958,214,67,33,18,0,1,33,17
1857455,26,26,1987,10,male,551,214,165,33,31,0,1,33,30
2185376,61,12,1952,10,male,709,217,48,33,172,0,16,33,156
1317455,43,19,1970,11,male,788,218,155,33,45,33,32,0,13
1212924,106,10,1907,6,male,1135,213,120,33,46,33,19,0,27
1497050,28,18,1985,8,male,157,218,103,33,65,33,44,0,21
1252537,103,23,1910,6,male,466,217,172,33,55,33,26,0,29
1335609,23,29,1990,4,male,466,216,86,34,15,0,5,34,10
1225688,18,15,1995,8,female,300,219,139,34,43,3,14,31,29
1201071,19,5,1994,11,female,34,215,83,34,31,34,24,0,7
1310006,16,17,1997,11,male,419,217,170,35,1,0,0,35,1
1325352,108,21,1905,5,female,2138,213,111,36,3,6,2,30,1
1302535,99,4,1914,8,male,1260,214,135,36,31,25,16,11,15
1199022,48,11,1965,5,female,230,214,141,35,18,34,7,1,11
1430027,16,16,1997,6,male,500,217,150,35,34,34,16,1,18
1744792,20,6,1993,10,female,156,216,201,35,43,35,25,0,18
1646524,30,18,1983,11,male,382,216,119,36,47,36,44,0,3
1614783,20,4,1993,11,male,172,221,142,36,124,36,74,0,50
1254412,18,10,1995,8,male,535,221,138,37,23,36,14,1,9
1404234,23,26,1990,7,male,493,213,163,37,11,37,9,0,2
1727473,53,2,1960,9,female,645,219,40,37,33,37,23,0,10
1656026,42,7,1971,9,female,972,217,196,37,166,37,118,0,48
1553255,18,20,1995,8,female,195,213,162,39,38,21,8,18,30
1991871,20,30,1993,5,male,564,221,161,38,0,38,0,0,0
1251456,25,13,1988,8,female,143,216,162,38,2,38,1,0,1
2036922,15,25,1998,7,male,318,221,38,39,14,39,10,0,4
1057988,33,13,1980,2,female,618,221,61,40,24,0,4,40,20
1974238,76,16,1937,5,male,687,218,174,40,9,0,1,40,8
1499123,20,4,1993,11,male,488,215,174,40,2,40,2,0,0
2030616,35,11,1978,12,male,657,219,69,40,32,40,23,0,9
1172915,19,28,1994,7,male,221,218,138,41,16,0,9,41,7
1334076,22,9,1991,2,male,768,220,137,41,26,4,8,37,18
1852052,16,16,1997,7,male,321,219,66,41,30,11,3,30,27
1976587,50,31,1963,7,male,526,221,164,42,82,9,19,33,63
2170352,31,6,1982,9,male,418,214,132,42,176,33,112,9,64
1263208,41,28,1972,3,male,223,220,73,41,4,41,3,0,1
1240382,15,15,1998,5,male,326,217,161,41,9,41,5,0,4
1389385,15,26,1998,7,female,265,213,120,41,7,41,7,0,0
1412285,18,20,1995,1,male,424,221,188,42,25,42,20,0,5
1137430,22,16,1991,7,male,487,215,140,41,12,41,10,0,2
1062437,18,4,1995,4,female,393,213,56,41,69,41,60,0,9
1458206,23,7,1990,12,male,381,215,76,42,99,42,66,0,33
1089758,83,14,1930,8,female,1456,218,66,41,138,41,110,0,28
1015510,17,8,1996,1,male,524,218,79,44,54,7,13,37,41
1530313,27,13,1986,8,female,542,215,100,44,281,22,106,22,175
1305444,99,16,1914,3,male,855,216,111,44,10,44,10,0,0
1654132,42,22,1971,4,male,781,213,111,44,52,44,37,0,15
2043971,103,30,1910,9,male,635,214,129,44,43,44,24,0,19
1438643,71,26,1942,12,male,34,215,158,43,82,43,82,0,0
1251079,21,16,1992,10,female,241,216,195,45,3,2,0,43,3
1618355,15,23,1998,8,male,421,217,126,45,11,28,6,17,5
1643982,18,15,1995,9,female,822,215,96,45,138,21,74,24,64
1774668,18,23,1995,1,male,304,220,145,45,4,45,4,0,0
1503655,18,17,1995,4,male,329,218,115,45,14,45,6,0,8
1834133,42,11,1971,10,female,52,217,142,45,52,45,45,0,7
1149740,57,30,1956,5,male,70,215,215,47,0,0,0,47,0
1066488,64,3,1949,2,female,1557,214,129,46,52,0,7,46,45
2118277,101,30,1912,8,female,2370,213,108,47,139,0,56,47,83
1567846,31,9,1982,2,female,585,213,162,46,30,28,24,18,6
1486954,38,31,1975,8,male,569,218,33,47,32,25,11,22,21
1290219,43,4,1970,9,female,247,214,182,46,52,26,29,20,23
1891139,19,7,1994,6,male,1021,219,107,47,19,47,19,0,0
1488314,44,11,1969,1,female,1765,217,43,47,19,47,12,0,7
1110794,23,22,1990,4,female,757,220,134,46,57,46,56,0,1
1404546,33,17,1980,11,female,468,215,179,46,33,46,23,0,10
1566316,33,5,1980,10,female,530,218,135,49,18,0,1,49,17
1057570,33,17,1980,10,female,495,215,154,49,15,0,3,49,12
2061462,24,13,1989,2,female,278,220,119,48,18,30,6,18,12
1258576,18,25,1995,9,female,306,214,185,49,30,47,21,2,9
1532057,19,2,1994,3,female,748,219,155,49,238,37,136,12,102
1922025,27,28,1986,11,female,819,219,72,48,111,37,57,11,54
1827876,18,21,1995,9,female,595,214,11,48,0,48,0,0,0
1857412,62,26,1951,7,male,1049,219,201,48,9,48,7,0,2
1558442,19,18,1994,3,female,37,214,47,49,121,49,108,0,13
2189435,26,12,1987,12,male,189,213,181,49,120,49,93,0,27
1874655,18,4,1995,1,male,528,221,87,51,9,50,7,1,2
1712682,17,2,1996,10,male,415,215,152,50,3,50,3,0,0
1858911,108,11,1905,2,male,1238,221,59,50,2,50,1,0,1
1754139,22,19,1991,11,female,920,219,119,50,12,50,12,0,0
1780122,21,6,1992,2,male,221,217,116,50,94,50,46,0,48
1233587,67,18,1946,5,female,1666,213,79,52,6,10,3,42,3
1129908,35,13,1978,6,female,553,216,92,52,71,5,30,47,41
1851830,16,24,1997,12,female,312,218,108,52,0,52,0,0,0
1075891,18,26,1995,11,female,475,220,141,53,12,53,10,0,2
1201261,18,28,1995,6,male,115,219,207,52,16,52,16,0,0
1441655,24,10,1989,12,female,731,213,141,53,19,53,16,0,3
1682732,17,19,1996,8,male,399,216,131,54,70,1,29,53,41
1637868,23,26,1990,5,male,242,219,161,58,17,6,2,52,15
1520331,18,4,1995,6,female,330,217,140,57,167,32,105,25,62
1398802,19,28,1994,9,male,300,220,146,56,6,56,5,0,1
1051840,18,29,1995,10,female,259,219,120,57,63,57,44,0,19
2066314,20,1,1993,6,male,249,218,143,58,70,58,43,0,27
2039670,23,28,1990,4,male,605,213,84,56,69,56,43,0,26
1305409,33,1,1980,2,male,254,220,71,56,35,56,28,0,7
1963588,36,23,1977,2,female,637,217,68,57,274,57,75,0,199
1620401,90,15,1923,9,male,1930,221,107,60,22,21,6,39,16
2030245,14,9,1999,1,female,234,216,67,60,289,60,180,0,109
1017873,22,18,1991,11,male,525,218,156,59,102,59,89,0,13
1111829,26,17,1987,1,male,232,220,187,60,151,60,126,0,25
1344445,58,21,1955,7,female,1419,215,129,60,203,60,109,0,94
1172263,64,31,1949,1,female,995,220,94,63,452,0,242,63,210
1934558,20,23,1993,7,male,269,221,151,62,9,20,8,42,1
1955912,15,11,1998,12,male,730,221,113,62,67,14,19,48,48
1569174,66,22,1947,5,female,1254,215,157,63,145,45,82,18,63
1690226,25,18,1988,6,male,1174,213,198,63,48,50,39,13,9
1150965,99,30,1914,10,female,909,220,110,63,78,50,28,13,50
2125984,25,5,1988,5,male,435,218,189,63,8,63,5,0,3
1192805,15,28,1998,5,male,471,218,67,63,36,63,22,0,14
1405110,21,18,1992,5,male,434,216,150,62,18,62,16,0,2
1516297,31,8,1982,5,female,652,213,103,61,14,61,8,0,6
2064325,17,7,1996,8,female,219,213,88,62,55,62,50,0,5
2097359,19,8,1994,7,female,461,217,184,62,88,62,46,0,42
1104008,28,29,1985,8,male,286,220,156,63,48,63,37,0,11
1113037,42,2,1971,11,female,784,218,88,61,44,61,28,0,16
2132389,35,5,1978,5,female,403,214,89,61,115,61,114,0,1
1871396,17,9,1996,3,male,475,220,103,64,1,0,1,64,0
1981990,28,12,1985,4,female,359,218,164,65,260,0,37,65,223
1312638,19,5,1994,4,female,181,221,71,64,148,23,73,41,75
1291071,35,15,1978,8,female,1834,215,137,64,111,63,70,1,41
1151682,35,2,1978,6,male,614,219,153,64,21,64,18,0,3
1162911,54,5,1959,8,male,1491,219,101,64,21,64,9,0,12
1975741,19,4,1994,3,female,242,220,48,65,104,65,60,0,44
1504376,35,11,1978,10,female,353,214,99,65,236,65,226,0,10
1887131,103,18,1910,3,male,1141,220,142,67,4,0,0,67,4
1927132,45,28,1968,7,female,457,217,79,68,41,0,7,68,34
1154690,25,8,1988,12,female,720,215,123,66,81,1,39,65,42
1482275,44,7,1969,8,female,497,215,165,66,133,9,64,57,69
1501596,18,14,1995,8,female,163,219,104,67,100,22,50,45,50
1911167,17,24,1996,10,male,207,214,147,67,24,61,17,6,7
1229068,28,2,1985,3,male,723,218,158,68,3,68,0,0,3
1155523,31,15,1982,12,male,211,217,148,66,88,66,64,0,24
1162379,18,1,1995,1,male,575,216,150,67,288,67,263,0,25
1149837,34,24,1979,4,female,540,221,138,66,101,66,76,0,25
1855881,16,5,1997,3,male,389,216,177,71,1,0,0,71,1
1527359,74,19,1939,9,female,183,218,100,69,31,0,8,69,23
1047896,35,2,1978,8,female,165,220,105,70,142,12,27,58,115
2173153,23,26,1990,11,male,1025,221,141,69,89,41,47,28,42
1832986,56,4,1957,3,male,1762,216,37,70,132,64,80,6,52
1427019,18,21,1995,10,female,195,214,101,69,32,69,32,0,0
1559659,20,31,1993,7,male,1544,221,54,71,54,71,33,0,21
1573452,46,10,1967,1,female,298,217,119,74,30,10,11,64,19
1365903,49,16,1964,5,male,2290,217,67,74,230,49,151,25,79
1662645,23,20,1990,3,male,775,218,108,72,39,72,36,0,3
2047616,14,7,1999,9,male,221,221,150,76,0,15,0,61,0
1998688,24,27,1989,7,male,289,217,68,76,35,42,18,34,17
2090934,66,3,1947,2,female,1173,218,131,75,261,23,184,52,77
2169129,17,13,1996,7,male,1117,220,94,76,47,73,14,3,33
1022658,30,25,1983,4,female,697,221,109,77,132,68,55,9,77
1151413,15,20,1998,3,male,263,213,153,79,2,0,0,79,2
1636235,28,3,1985,10,male,1763,214,55,78,44,2,21,76,23
2043884,108,4,1905,2,male,1600,213,133,78,112,13,32,65,80
2188103,16,28,1997,11,female,5,219,180,79,31,57,25,22,6
1901628,19,14,1994,1,male,677,219,145,80,68,80,64,0,4
2158933,35,1,1978,8,female,492,213,136,79,49,79,9,0,40
1584153,19,15,1994,6,female,209,215,152,80,160,80,60,0,100
1069571,82,28,1931,6,male,228,219,154,84,112,0,20,84,92
1645252,101,1,1912,9,male,1946,217,156,81,79,0,46,81,33
2144418,58,27,1955,8,female,1755,214,149,83,212,0,108,83,104
1906222,30,15,1983,6,female,448,221,102,84,22,43,6,41,16
1562675,63,5,1950,9,male,1160,220,31,82,89,26,66,56,23
2024403,62,25,1951,7,female,2339,221,135,82,102,81,49,1,53
1781875,30,29,1983,12,male,300,214,106,82,28,82,22,0,6
1304431,36,4,1977,8,female,1301,214,103,84,65,84,38,0,27
2163406,95,8,1918,6,female,2294,213,41,85,62,0,7,85,55
1261849,32,20,1981,10,male,523,219,38,86,76,85,61,1,15
1149834,103,3,1910,4,female,1231,221,113,86,56,85,39,1,17
1244735,25,6,1988,3,female,1491,217,81,86,249,65,121,21,128
1726897,113,7,1900,4,male,1164,213,166,86,51,86,35,0,16
1487071,49,16,1964,6,female,238,216,200,85,446,85,247,0,199
1281829,99,29,1914,8,male,1193,216,117,87,224,87,179,0,45
1510160,18,7,1995,6,female,288,220,98,90,46,63,17,27,29
1504811,24,13,1989,10,male,287,214,147,89,80,58,25,31,55
1993131,28,29,1985,9,female,354,214,126,89,309,42,126,47,183
1993254,17,14,1996,12,male,565,213,116,89,25,79,14,10,11
2016373,34,3,1979,3,female,410,216,149,89,84,88,47,1,37
1780205,31,10,1982,8,female,369,221,124,90,35,90,28,0,7
1022156,15,14,1998,2,female,380,217,170,88,115,88,58,0,57
1588674,18,23,1995,9,female,230,214,173,89,78,89,66,0,12
1004997,29,20,1984,9,male,276,213,200,95,0,0,0,95,0
1698123,52,2,1961,1,female,672,216,131,93,176,0,66,93,110
1564612,106,15,1907,6,male,1184,214,152,92,98,85,73,7,25
2123891,19,6,1994,7,female,1507,220,61,92,567,75,141,17,426
1212719,31,5,1982,11,female,451,214,193,95,4,95,3,0,1
1757120,18,4,1995,3,male,550,215,177,92,21,92,15,0,6
1954539,26,15,1987,10,male,337,218,123,93,119,93,68,0,51
1184423,42,5,1971,1,female,149,219,117,92,1313,92,794,0,519
1837773,60,13,1953,8,female,1723,218,86,99,130,0,70,99,60
1513610,24,30,1989,10,female,116,221,68,99,123,45,55,54,68
1308623,16,13,1997,8,female,560,216,76,97,3,82,1,15,2
1736555,17,13,1996,9,female,673,218,105,97,18,95,15,2,3
1218010,31,7,1982,5,female,1007,218,128,98,79,96,42,2,37
1477754,53,3,1960,4,female,748,216,84,96,46,96,30,0,16
1705462,101,5,1912,2,male,1269,218,82,96,21,96,12,0,9
1420929,29,12,1984,8,female,179,221,155,98,96,98,60,0,36
1833610,106,24,1907,2,male,1412,221,111,102,4,0,3,102,1
1906932,21,6,1992,6,male,410,220,13,103,88,0,34,103,54
1006313,19,18,1994,10,male,490,218,89,102,72,24,28,78,44
1382856,20,7,1993,3,male,165,214,184,100,86,65,46,35,40
1240891,18,1,1995,12,female,39,217,75,101,452,35,292,66,160
1992719,26,8,1987,3,female,354,219,131,100,16,100,12,0,4
1935416,19,22,1994,11,female,380,219,83,100,262,100,100,0,162
2168826,22,15,1991,6,male,435,213,149,107,54,52,13,55,41
1448753,55,19,1958,6,female,853,214,125,106,4,100,2,6,2
2004187,59,24,1954,5,female,975,215,164,107,134,105,77,2,57
1977055,40,15,1973,4,male,52,213,99,107,17,106,9,1,8
2051218,20,26,1993,5,male,168,217,204,107,80,107,37,0,43
1372646,24,18,1989,8,male,527,216,137,108,75,108,65,0,10
1976018,68,9,1945,5,male,1255,213,115,108,95,108,56,0,39
1670875,101,21,1912,11,female,2255,214,158,111,4,24,3,87,1
1697155,17,14,1996,11,female,545,218,163,113,63,73,26,40,37
1235496,92,13,1921,12,male,1429,214,122,111,41,33,28,78,13
2124779,17,30,1996,1,male,876,217,156,111,94,42,19,69,75
1349150,14,13,1999,10,female,329,213,108,113,93,95,85,18,8
2157878,41,25,1972,1,female,686,221,67,110,76,94,39,16,37
1740420,18,23,1995,5,female,207,213,92,113,279,103,160,10,119
1524882,52,13,1961,3,male,1115,215,128,112,7,112,4,0,3
1746622,100,28,1913,10,male,872,216,178,112,31,112,26,0,5
2122740,28,3,1985,5,male,103,214,79,119,1,0,0,119,1
1038929,50,25,1963,2,male,322,215,205,114,6,21,2,93,4
2130822,17,16,1996,11,female,564,219,146,116,14,66,2,50,12
1717821,15,14,1998,6,male,458,215,114,114,71,78,32,36,39
1866774,33,15,1980,10,female,905,213,127,117,230,48,121,69,109
2099120,100,22,1913,3,female,1870,220,58,115,40,100,19,15,21
2069032,21,26,1992,2,female,472,215,66,117,154,101,99,16,55
1319819,31,5,1982,10,female,306,220,41,116,115,98,63,18,52
1661810,20,5,1993,3,female,373,214,181,119,57,119,10,0,47
1922265,38,12,1975,5,female,133,215,185,117,41,117,41,0,0
1521228,44,19,1969,5,female,363,213,154,120,69,0,13,120,56
1143862,19,12,1994,5,male,329,215,114,120,157,2,86,118,71
1616727,30,28,1983,7,female,937,221,128,121,369,14,186,107,183
2023459,66,2,1947,12,male,880,221,158,122,42,111,37,11,5
2020283,35,3,1978,11,female,296,213,84,121,153,112,135,9,18
1625970,18,5,1995,9,female,184,213,98,122,270,116,157,6,113
1303736,51,17,1962,12,male,1325,219,43,120,12,120,6,0,6
1214826,69,14,1944,10,female,1214,220,141,128,54,1,32,127,22
1765654,26,4,1987,2,male,1654,221,93,128,107,20,38,108,69
1218802,18,29,1995,8,female,167,216,78,128,108,65,40,63,68
1983524,28,1,1985,9,female,1157,218,75,127,95,58,49,69,46
1931520,26,15,1987,11,female,487,215,191,128,114,121,63,7,51
2132131,33,29,1980,12,female,678,214,101,127,91,105,37,22,54
1186125,16,15,1997,2,male,506,220,179,128,36,128,7,0,29
1553036,51,7,1962,9,female,709,214,31,128,59,128,32,0,27
2052007,39,19,1974,8,female,379,221,162,125,157,125,109,0,48
1416357,45,28,1968,10,female,646,216,121,131,289,28,61,103,228
1871236,57,14,1956,1,female,938,214,58,136,220,39,64,97,156
1230008,56,24,1957,1,female,529,218,165,133,9,133,6,0,3
2183475,66,1,1947,12,female,1186,213,62,132,26,132,13,0,13
1689920,50,30,1963,7,female,733,215,120,131,114,131,105,0,9
1178679,108,28,1905,3,female,1573,216,82,143,166,0,70,143,96
1469496,51,13,1962,8,female,955,214,118,137,78,38,14,99,64
1767375,55,28,1958,9,female,1396,216,131,139,49,42,20,97,29
1474435,16,1,1997,1,male,106,213,146,137,226,55,123,82,103
1807632,19,22,1994,12,female,816,217,112,139,232,86,117,53,115
2143747,24,16,1989,8,male,66,219,101,138,192,138,175,0,17
1348333,25,20,1988,4,female,2000,219,119,143,95,143,79,0,16
1343547,36,21,1977,10,female,788,219,110,143,268,143,224,0,44
1762398,21,8,1992,6,male,360,216,168,148,12,0,4,148,8
1058928,70,31,1943,5,female,606,213,180,148,55,0,7,148,48
1679238,23,7,1990,5,male,1343,220,172,145,38,137,32,8,6
1404363,14,15,1999,10,female,14,214,172,145,159,143,106,2,53
1440196,18,18,1995,7,male,615,214,161,146,85,146,66,0,19
2032971,35,13,1978,3,male,318,213,145,148,46,148,39,0,7
1275256,21,6,1992,1,female,187,217,135,149,148,149,47,0,101
2150140,32,20,1981,6,female,224,213,161,148,114,148,92,0,22
1321764,54,23,1959,11,male,1478,217,122,156,68,0,8,156,60
1643182,85,27,1928,4,male,1960,220,99,153,133,0,19,153,114
1013184,85,17,1928,9,male,2224,221,117,155,65,132,44,23,21
1446057,46,17,1967,3,female,1781,216,125,157,150,155,120,2,30
1150861,16,25,1997,11,female,289,218,118,155,85,155,76,0,9
1249968,18,12,1995,10,female,336,214,128,156,52,156,50,0,2
1750007,99,21,1914,1,female,1764,216,90,155,386,155,366,0,20
1962067,103,27,1910,4,male,1288,221,146,159,84,13,51,146,33
2160734,17,3,1996,2,female,508,218,149,162,101,30,50,132,51
2149015,18,19,1995,6,female,214,215,115,159,261,149,179,10,82
2179217,42,6,1971,12,male,666,213,75,158,1,158,1,0,0
1873374,42,17,1971,9,female,333,219,84,164,57,164,4,0,53
1172141,26,1,1987,1,female,749,217,98,165,143,106,75,59,68
1969133,22,3,1991,8,male,53,215,207,170,281,73,115,97,166
1648957,59,28,1954,3,female,2068,213,134,168,275,79,196,89,79
1533935,24,4,1989,4,male,144,220,178,165,65,165,58,0,7
1524510,20,14,1993,2,male,587,216,40,166,147,166,130,0,17
1982464,21,6,1992,5,female,156,218,116,167,149,167,114,0,35
2144075,103,6,1910,1,male,1535,215,113,180,177,3,27,177,150
2190595,51,13,1962,9,female,983,217,68,175,72,51,22,124,50
2169775,30,3,1983,11,male,353,219,148,177,212,125,165,52,47
1057866,108,25,1905,7,female,409,215,106,180,182,76,47,104,135
1225434,27,12,1986,9,female,270,214,86,178,285,174,190,4,95
1736371,39,2,1974,8,female,852,213,147,180,115,179,73,1,42
2019629,23,28,1990,12,male,332,216,50,177,32,177,25,0,7
2110240,24,9,1989,6,female,349,215,81,175,197,175,138,0,59
2058061,25,1,1988,1,female,92,216,155,177,204,177,187,0,17
1715522,26,7,1987,7,male,300,220,171,181,162,181,152,0,10
1558588,38,17,1975,9,female,324,215,52,176,173,176,138,0,35
1566262,19,16,1994,5,male,77,215,209,174,332,174,320,0,12
1409544,21,2,1992,5,female,528,218,124,183,8,0,4,183,4
1052567,108,8,1905,10,male,1437,214,151,186,205,1,104,185,101
1575659,62,14,1951,10,female,1352,218,172,183,339,1,78,182,261
1136023,28,17,1985,2,female,433,219,68,187,0,184,0,3,0
1839501,47,8,1966,12,female,1686,218,154,189,108,179,60,10,48
1631634,79,4,1934,3,female,2135,214,98,183,91,173,62,10,29
1400674,23,26,1990,10,female,137,220,100,184,273,156,178,28,95
1560335,62,28,1951,10,female,1601,213,93,185,124,177,76,8,48
2189980,25,13,1988,12,male,374,218,187,187,310,173,287,14,23
1319600,36,4,1977,10,male,205,216,120,185,13,185,11,0,2
1216999,43,8,1970,5,male,151,221,169,190,15,190,12,0,3
1999925,21,8,1992,12,female,1125,220,88,189,154,189,123,0,31
2112357,49,11,1964,9,female,2266,221,106,189,190,189,170,0,20
1391636,19,1,1994,2,male,273,218,148,191,11,1,6,190,5
1810059,44,19,1969,2,male,324,219,204,195,34,0,0,195,34
1580018,18,25,1995,1,female,274,218,158,194,1319,186,443,8,876
1948895,18,4,1995,3,male,281,217,184,196,20,196,18,0,2
1667103,25,9,1988,6,male,473,215,175,193,123,193,59,0,64
1322925,16,12,1997,5,female,582,215,85,211,80,122,33,89,47
1437849,21,22,1992,12,female,278,218,167,208,302,43,130,165,172
1573447,17,13,1996,12,male,260,219,143,209,47,167,33,42,14
1214549,17,30,1996,9,female,876,214,72,205,127,203,117,2,10
2123022,22,26,1991,2,male,435,221,165,204,248,202,149,2,99
1351307,21,20,1992,1,female,407,221,149,211,368,210,159,1,209
1578563,16,4,1997,4,male,76,213,168,209,118,209,98,0,20
1992135,31,7,1982,2,female,412,219,135,211,111,211,94,0,17
1846583,35,22,1978,11,male,223,219,179,208,126,208,106,0,20
1669148,48,21,1965,10,female,775,219,124,203,74,203,64,0,10
2044010,61,22,1952,7,female,296,221,162,215,178,0,67,215,111
1276517,20,13,1993,12,male,99,213,98,213,269,52,57,161,212
1991725,23,29,1990,3,male,156,216,193,218,253,200,175,18,78
2169685,23,30,1990,12,female,179,220,121,215,0,215,0,0,0
1139388,18,14,1995,3,female,24,213,39,216,97,216,88,0,9
1753699,15,6,1998,7,female,387,219,79,214,146,214,105,0,41
1962139,22,28,1991,8,male,274,219,183,212,144,212,64,0,80
2014474,21,22,1992,10,female,184,214,144,231,248,45,84,186,164
1430583,14,15,1999,8,female,319,218,44,229,375,111,49,118,326
1570456,45,28,1968,10,female,1941,214,117,225,342,144,249,81,93
1276435,53,8,1960,3,female,412,216,164,225,134,193,71,32,63
1381591,20,8,1993,2,female,432,214,165,233,164,218,106,15,58
1633021,22,2,1991,2,male,509,220,72,231,0,231,0,0,0
1605174,103,29,1910,9,female,1081,219,110,223,16,223,12,0,4
1642709,32,10,1981,8,female,522,219,128,244,88,0,34,244,54
1602221,47,4,1966,11,female,524,214,134,242,112,170,40,72,72
1092311,28,7,1985,4,female,1537,220,113,234,146,153,47,81,99
2109694,108,15,1905,10,male,1850,218,116,235,287,78,159,157,128
1633279,18,22,1995,10,male,338,217,129,242,391,182,201,60,190
1653954,17,6,1996,6,female,97,221,64,245,225,244,192,1,33
1564158,15,18,1998,5,female,286,213,90,237,54,237,48,0,6
1297574,31,12,1982,12,female,75,218,46,239,77,239,55,0,22
1709713,15,14,1998,2,female,458,217,49,238,322,238,262,0,60
1748734,18,13,1995,11,female,110,214,93,241,544,241,345,0,199
2165553,16,30,1997,12,female,385,221,87,249,147,8,35,241,112
1311187,65,13,1948,6,female,713,214,136,257,160,46,62,211,98
1625884,63,10,1950,7,female,983,216,112,250,875,0,123,250,752
1995859,24,7,1989,10,female,499,217,134,259,821,121,534,138,287
1765182,29,10,1984,12,male,280,218,177,252,139,250,66,2,73
1006805,18,14,1995,3,male,209,215,167,259,124,259,67,0,57
1303878,20,14,1993,8,male,315,219,179,254,46,254,32,0,14
1555844,20,10,1993,6,male,171,218,71,254,882,254,529,0,353
2040263,45,26,1968,8,male,435,214,164,253,420,253,334,0,86
1743968,66,20,1947,11,male,1774,217,132,272,41,0,6,272,35
1640594,18,11,1995,2,female,304,219,123,263,121,8,37,255,84
1953119,51,8,1962,9,female,737,213,40,266,129,52,69,214,60
1512518,26,10,1987,9,male,911,221,160,274,171,180,75,94,96
1579640,18,20,1995,10,male,441,214,159,262,59,207,18,55,41
1661748,23,28,1990,3,female,594,213,106,271,184,202,114,69,70
1708488,33,29,1980,7,female,1538,221,115,268,605,244,541,24,64
1767090,31,16,1982,10,male,616,214,176,269,26,268,19,1,7
1266684,28,18,1985,7,male,274,215,165,270,41,270,37,0,4
1368615,23,20,1990,10,male,383,217,185,265,48,265,47,0,1
1557627,25,15,1988,4,male,183,216,153,273,291,273,223,0,68
2110787,108,17,1905,9,female,1581,214,81,279,98,2,56,277,42
1295251,28,4,1985,3,female,825,219,169,283,559,170,418,113,141
1366328,24,17,1989,2,female,90,220,163,278,398,259,189,19,209
1322798,16,10,1997,2,male,317,213,125,282,62,282,45,0,17
1351135,48,15,1965,9,female,290,218,196,279,414,279,326,0,88
1494406,17,1,1996,1,female,2,215,185,292,478,292,244,0,234
1365504,24,6,1989,1,male,472,213,87,277,957,277,937,0,20
1168091,30,2,1983,10,male,225,221,139,301,272,100,208,201,64
2104672,48,15,1965,9,female,485,219,81,302,312,131,204,171,108
2087268,16,7,1997,2,female,879,219,115,294,95,280,45,14,50
2082970,55,30,1958,4,female,1293,215,122,299,491,247,372,52,119
1246861,16,27,1997,6,female,313,214,64,299,45,299,42,0,3
2121793,28,16,1985,8,female,617,218,197,307,2,307,2,0,0
1937941,23,24,1990,12,male,727,213,143,307,150,307,94,0,56
1335132,22,2,1991,9,female,240,220,91,304,258,304,256,0,2
1307282,108,30,1905,11,male,889,219,105,310,5,15,4,295,1
1482064,67,30,1946,12,male,1983,217,140,315,73,51,41,264,32
1509402,67,15,1946,2,female,1456,214,39,310,278,207,201,103,77
1220502,16,12,1997,1,female,140,213,113,309,108,309,104,0,4
2146424,20,5,1993,8,male,152,221,208,342,145,30,80,312,65
1915413,16,27,1997,8,female,411,214,175,340,123,160,62,180,61
1334470,39,14,1974,11,male,416,217,138,330,373,306,275,24,98
1273018,40,3,1973,9,female,906,217,155,332,191,332,159,0,32
1035869,63,30,1950,12,female,287,215,123,357,555,0,213,357,342
1092279,34,2,1979,11,female,673,219,174,351,120,307,98,44,22
1208850,29,7,1984,3,female,236,213,110,362,106,362,84,0,22
2099877,30,4,1983,4,female,343,216,67,350,190,350,188,0,2
2125543,32,8,1981,2,male,317,216,163,371,39,0,1,371,38
1952987,63,7,1950,5,female,1309,216,158,393,63,217,28,176,35
1644072,32,15,1981,9,female,174,214,175,381,182,381,174,0,8
1327293,42,18,1971,12,female,184,215,194,370,252,370,128,0,124
1789614,61,12,1952,6,female,484,218,167,406,96,259,64,147,32
1399332,14,4,1999,9,female,166,220,144,402,193,367,103,35,90
1071236,29,21,1984,12,female,577,217,160,404,230,327,156,77,74
1657775,69,31,1944,7,male,1537,220,115,404,174,390,98,14,76
1724481,32,26,1981,7,male,305,215,173,411,201,408,176,3,25
1397429,48,8,1965,12,female,717,219,108,411,672,407,465,4,207
1218493,35,8,1978,4,female,230,218,180,409,119,409,87,0,32
1427034,60,21,1953,12,female,1764,216,168,407,213,407,123,0,90
1246575,45,16,1968,10,male,251,216,91,408,456,408,405,0,51
1086027,25,22,1988,11,female,257,215,151,396,856,396,719,0,137
2081434,18,14,1995,9,male,136,216,192,446,1,60,1,386,0
1605848,49,10,1964,5,female,421,219,77,424,257,0,24,424,233
2177844,22,21,1991,3,female,536,219,123,445,371,78,111,367,260
1548090,91,9,1922,3,female,1254,215,124,450,208,168,91,282,117
1034628,46,22,1967,12,female,1266,217,159,445,358,247,231,198,127
1138553,21,27,1992,8,female,116,221,150,450,273,425,263,25,10
1993904,55,13,1958,10,male,1720,221,139,443,232,441,177,2,55
1006967,32,26,1981,6,female,591,214,154,422,565,419,458,3,107
2059710,27,19,1986,3,female,52,214,189,448,99,448,41,0,58
1933277,44,13,1969,2,male,437,217,5,477,556,68,144,409,412
1567259,59,20,1954,8,female,1758,220,134,452,421,0,179,452,242
1910358,23,7,1990,6,female,412,218,99,455,26,316,10,139,16
2172033,17,25,1996,12,female,174,220,119,452,555,213,353,239,202
1751292,18,22,1995,6,female,337,214,107,465,195,415,131,50,64
1304177,60,3,1953,9,female,1149,215,164,464,222,345,130,119,92
1751772,57,20,1956,12,female,716,217,88,510,167,273,29,237,138
2063980,63,8,1950,7,female,1539,220,150,494,255,156,173,338,82
2025249,28,28,1985,1,female,567,219,98,511,1008,350,831,161,177
1448227,66,6,1947,1,female,1644,214,82,507,296,460,204,47,92
2050823,62,12,1951,9,female,634,219,160,497,109,496,60,1,49
2041454,21,10,1992,1,male,538,215,131,500,50,500,46,0,4
1583300,20,22,1993,11,male,452,216,46,554,220,536,147,18,73
1880334,52,23,1961,12,female,314,219,187,527,288,504,197,23,91
1601640,18,9,1995,12,female,178,220,94,525,389,483,296,42,93
1423435,22,22,1991,6,male,515,213,127,554,448,545,223,9,225
1047694,100,22,1913,2,male,467,217,181,557,25,557,9,0,16
2113316,66,19,1947,3,female,1322,219,49,588,144,20,75,568,69
1854446,30,4,1983,11,female,354,215,146,607,281,155,123,452,158
2128526,56,18,1957,10,female,1436,221,178,564,217,553,151,11,66
1569592,34,13,1979,3,female,2251,220,152,589,2595,574,2150,15,445
1530405,16,13,1997,5,female,90,220,118,657,110,84,50,573,60
1726429,23,4,1990,10,male,448,217,105,634,332,113,159,521,173
2037318,18,2,1995,2,female,77,214,147,636,888,383,444,253,444
2186628,16,5,1997,7,female,354,216,200,613,62,554,35,59,27
1325999,33,25,1980,8,female,1100,213,146,631,105,631,48,0,57
1895380,19,19,1994,7,female,135,220,180,645,303,645,254,0,49
2148989,15,26,1998,9,female,292,219,150,675,469,73,281,602,188
1652555,68,1,1945,1,male,1754,214,103,705,275,473,159,232,116
2172040,108,1,1905,1,female,1998,213,99,708,431,276,245,432,186
1555076,26,10,1987,12,female,102,218,187,692,542,634,133,58,409
1878174,40,12,1973,2,female,500,213,117,681,522,631,240,50,282
1123126,62,12,1951,12,female,820,213,120,796,110,0,35,796,75
1510811,53,14,1960,9,female,564,213,159,788,211,45,32,743,179
2120141,30,20,1983,7,female,417,221,177,758,322,216,162,542,160
2026674,55,28,1958,12,female,1497,221,141,737,362,502,181,235,181
1729005,16,14,1997,2,female,792,218,121,761,736,184,266,577,470
1250135,33,9,1980,6,male,267,216,120,731,566,275,331,456,235
1981513,21,24,1992,4,female,647,215,69,794,772,627,589,167,183
1102171,31,9,1982,6,female,155,218,97,786,611,698,181,88,430
1320203,48,20,1965,11,male,299,220,154,743,418,743,281,0,137
1108341,15,24,1998,9,female,245,217,121,846,582,46,243,800,339
2053581,47,18,1966,9,female,1881,217,138,807,125,552,63,255,62
1352922,14,10,1999,3,female,32,217,130,854,349,458,107,396,242
1172067,51,27,1962,11,male,1608,216,112,819,472,501,318,318,154
1254942,108,22,1905,9,male,160,217,145,879,15,842,6,37,9
2112498,40,2,1973,2,female,1732,220,81,845,466,718,244,127,222
2097479,19,6,1994,12,female,491,218,111,820,614,804,560,16,54
2145945,23,25,1990,4,male,400,217,192,817,86,817,81,0,5
1272375,62,20,1951,1,female,409,216,151,893,205,9,94,884,111
1599710,15,24,1998,4,female,461,218,69,933,1225,161,1082,772,143
2006495,53,18,1960,6,female,1555,215,95,904,208,884,94,20,114
1381734,54,24,1959,8,male,1262,213,124,977,1817,925,781,52,1036
1048899,45,22,1968,10,male,655,214,161,893,212,893,132,0,80
1423293,54,17,1959,2,male,522,217,118,897,300,897,263,0,37
1327493,16,10,1997,2,female,541,221,109,1010,451,23,64,987,387
1788812,20,11,1993,1,male,26,217,194,1108,276,159,86,949,190
1770705,61,7,1952,4,female,385,216,78,1002,583,83,279,919,304
1088847,25,27,1988,12,male,376,221,144,1044,576,363,146,681,430
1785677,18,26,1995,7,female,20,218,131,1038,674,308,188,730,486
1292110,34,22,1979,11,female,85,214,176,1101,1113,520,313,581,800
1117584,21,6,1992,3,female,72,214,148,989,472,950,322,39,150
1603652,23,17,1990,6,female,112,217,208,1036,345,1024,328,12,17
1935947,20,6,1993,3,female,1418,214,121,1083,1357,847,1009,236,348
1813194,48,5,1965,11,female,274,218,106,1027,411,1024,164,3,247
1515615,18,28,1995,2,female,216,214,113,1004,850,1004,547,0,303
1976304,55,8,1958,11,female,422,217,184,1268,468,0,181,1268,287
1943476,18,10,1995,10,female,1017,214,124,1240,850,236,146,1004,704
1239132,57,3,1956,1,male,547,220,28,1264,1488,743,538,521,950
2032713,20,8,1993,8,male,164,220,149,1191,1971,309,563,882,1408
1249650,29,14,1984,8,female,259,214,139,1188,371,1163,226,25,145
1128630,17,11,1996,4,male,414,217,147,1287,111,1287,69,0,42
1522044,14,4,1999,1,female,147,215,201,1278,524,1278,466,0,58
1487627,27,15,1986,12,male,54,220,197,1164,445,1164,425,0,20
1664167,43,17,1970,9,male,487,217,173,1204,247,1204,183,0,64
1523741,53,24,1960,6,female,922,216,112,1296,626,4,262,1292,364
1219527,22,26,1991,11,female,278,215,125,1295,418,540,182,755,236
1406950,62,1,1951,4,female,854,221,72,1499,1649,306,415,1193,1234
1496533,100,2,1913,11,male,2321,221,108,1330,946,1330,784,0,162
1269226,14,26,1999,10,male,174,220,171,1601,244,1564,211,37,33
1279826,67,29,1946,4,female,1068,216,160,1567,337,1567,193,0,144
1876101,36,17,1977,1,female,456,217,165,2147,2171,192,1330,1955,841
2013414,26,5,1987,11,male,187,220,187,1968,726,1968,694,0,32
1855318,71,2,1942,11,female,703,215,112,2880,74,0,33,2880,41
1951292,15,20,1998,10,female,438,221,147,3229,1280,1595,475,1634,805
1508807,24,1,1989,2,female,571,218,157,2846,3865,1626,1401,1220,2464
1200392,15,14,1998,1,female,430,216,136,2595,381,2477,239,118,142
1826280,18,2,1995,1,male,640,215,110,2640,634,2501,419,139,215
1355016,32,19,1981,8,female,1004,213,100,3216,3330,2749,2462,467,868
1494106,75,3,1938,1,female,746,219,48,3159,302,3159,165,0,137
1245291,25,10,1988,1,female,47,221,81,2465,1072,2465,916,0,156
1943090,62,7,1951,2,male,549,213,95,3335,741,3335,247,0,494
1294122,30,23,1983,12,female,406,218,138,4262,908,1893,183,2369,725
1995416,19,28,1994,6,male,135,217,154,7038,3479,5610,1030,1428,2449
1164149,33,1,1980,1,male,155,216,128,5127,214,5127,206,0,8
1839818,58,31,1955,1,female,263,217,106,6680,7707,6680,2219,0,5488
1675787,15,6,1998,12,female,451,224,151,0,0,0,0,0,0
1535616,16,10,1997,12,male,257,230,133,0,0,0,0,0,0
1821662,15,1,1998,1,female,566,229,138,0,0,0,0,0,0
1375046,15,26,1998,3,male,102,225,85,0,0,0,0,0,0
1070474,15,7,1998,8,female,41,225,23,0,2,0,2,0,0
2101719,16,2,1997,2,female,458,227,29,0,0,0,0,0,0
1532202,16,29,1997,3,male,232,228,115,0,0,0,0,0,0
1880682,16,2,1997,3,male,174,230,141,0,2,0,1,0,1
1757100,16,20,1997,4,male,239,228,119,0,0,0,0,0,0
1028830,16,22,1997,5,female,979,224,94,0,0,0,0,0,0
1373999,16,28,1997,6,male,380,225,125,0,2,0,2,0,0
1486163,16,4,1997,8,male,504,226,152,0,14,0,3,0,11
1816300,16,12,1997,9,male,139,225,213,0,0,0,0,0,0
1675434,17,12,1996,2,female,269,227,53,0,0,0,0,0,0
1186192,17,15,1996,3,male,374,230,97,0,1,0,0,0,1
1410228,17,27,1996,4,female,249,225,58,0,0,0,0,0,0
1766158,17,6,1996,6,male,335,230,98,0,0,0,0,0,0
2173545,19,7,1994,12,male,414,225,182,0,0,0,0,0,0
1919931,18,1,1995,1,male,280,226,219,0,11,0,3,0,8
1567455,18,1,1995,1,male,194,225,178,0,2,0,2,0,0
1093547,18,13,1995,3,male,226,225,38,0,0,0,0,0,0
1507547,18,27,1995,5,male,393,223,139,0,0,0,0,0,0
1000905,18,8,1995,5,male,300,222,172,0,2,0,2,0,0
2043062,18,16,1995,6,male,167,230,214,0,0,0,0,0,0
1671190,18,31,1995,7,female,169,223,176,0,3,0,2,0,1
1575213,18,6,1995,9,male,580,228,189,0,0,0,0,0,0
2121034,18,8,1995,9,male,510,226,28,0,1,0,0,0,1
1332214,18,26,1995,9,female,126,230,150,0,0,0,0,0,0
2126052,18,30,1995,10,male,514,229,192,0,0,0,0,0,0
1106412,20,17,1993,11,female,357,224,107,0,11,0,11,0,0
1418881,19,23,1994,2,male,624,226,77,0,0,0,0,0,0
1753338,19,20,1994,2,female,520,227,163,0,12,0,6,0,6
1982860,19,31,1994,3,male,816,230,210,0,5,0,5,0,0
1293459,19,23,1994,3,female,728,223,138,0,2,0,1,0,1
1945049,19,14,1994,4,male,607,227,126,0,1,0,0,0,1
1010375,19,4,1994,4,male,143,225,204,0,2,0,1,0,1
1324198,19,10,1994,6,female,490,224,123,0,0,0,0,0,0
1201155,19,6,1994,6,female,485,226,91,0,0,0,0,0,0
1251554,19,7,1994,7,male,396,225,138,0,3,0,3,0,0
1165668,19,3,1994,7,female,287,225,96,0,0,0,0,0,0
1223025,19,12,1994,10,male,455,222,189,0,0,0,0,0,0
1303892,22,2,1991,12,male,548,227,214,0,2,0,2,0,0
1487784,21,21,1992,1,male,920,227,72,0,1,0,1,0,0
1516697,21,23,1992,2,female,665,226,116,0,41,0,16,0,25
1780177,21,29,1992,2,male,561,225,207,0,0,0,0,0,0
1629994,21,14,1992,2,male,344,230,28,0,0,0,0,0,0
1761701,21,27,1992,2,female,316,230,117,0,0,0,0,0,0
1965121,21,6,1992,5,female,270,229,12,0,0,0,0,0,0
1807838,21,1,1992,9,male,419,230,186,0,2,0,2,0,0
1995387,21,15,1992,10,male,361,224,200,0,0,0,0,0,0
2066651,22,6,1991,1,male,667,230,158,0,0,0,0,0,0
1074204,22,29,1991,1,male,444,228,163,0,0,0,0,0,0
1240377,22,7,1991,5,male,725,230,152,0,0,0,0,0,0
1897262,24,11,1989,11,male,718,228,187,0,0,0,0,0,0
1663552,23,10,1990,1,male,576,225,216,0,0,0,0,0,0
1823669,23,20,1990,5,male,212,228,95,0,0,0,0,0,0
1010048,23,28,1990,5,male,153,229,211,0,1570,0,822,0,748
1832058,23,28,1990,7,female,316,226,114,0,2,0,2,0,0
2072031,23,10,1990,9,male,661,225,203,0,0,0,0,0,0
1893243,23,14,1990,9,male,350,225,83,0,5,0,3,0,2
1695967,23,10,1990,10,male,395,223,188,0,0,0,0,0,0
1310452,24,8,1989,3,male,662,225,108,0,0,0,0,0,0
1777804,24,16,1989,3,male,439,223,121,0,95,0,76,0,19
1965627,24,9,1989,8,male,521,226,178,0,0,0,0,0,0
2135936,26,8,1987,11,female,481,225,164,0,1,0,0,0,1
1517652,25,12,1988,1,female,211,229,117,0,1,0,0,0,1
1473416,25,27,1988,7,female,461,224,200,0,0,0,0,0,0
1183853,26,1,1987,1,female,442,228,108,0,0,0,0,0,0
1215928,26,23,1987,8,female,641,224,76,0,0,0,0,0,0
1272957,26,17,1987,9,male,196,225,182,0,0,0,0,0,0
1504585,28,29,1985,12,male,1052,222,120,0,4,0,4,0,0
1644825,27,12,1986,5,female,406,228,162,0,31,0,4,0,27
1779397,27,29,1986,9,male,248,228,219,0,3,0,3,0,0
1660493,28,10,1985,4,male,1177,225,197,0,121,0,102,0,19
1232771,30,2,1983,11,male,197,228,197,0,7,0,7,0,0
1761340,30,25,1983,12,male,579,229,187,0,6,0,6,0,0
1244149,32,17,1981,12,male,685,225,146,0,11,0,4,0,7
1773496,31,19,1982,7,male,374,224,188,0,3,0,1,0,2
1771468,31,27,1982,8,male,400,228,223,0,0,0,0,0,0
1655554,37,27,1976,6,male,212,222,145,0,0,0,0,0,0
1300742,40,28,1973,1,male,641,225,101,0,4,0,4,0,0
2030627,43,3,1970,3,male,762,227,175,0,0,0,0,0,0
2155216,46,13,1967,11,male,667,224,175,0,1,0,1,0,0
1120695,47,28,1966,4,male,767,223,137,0,19,0,4,0,15
2123554,48,4,1965,5,male,647,226,171,0,0,0,0,0,0
1165549,48,1,1965,5,male,1335,229,98,0,0,0,0,0,0
1684325,50,26,1963,12,male,1251,229,151,0,1,0,1,0,0
1555294,58,14,1955,5,male,1179,222,170,0,7,0,3,0,4
1748959,59,16,1954,4,male,1091,224,135,0,11,0,8,0,3
1189480,59,5,1954,7,female,398,227,39,0,45,0,9,0,36
1171377,69,12,1944,9,male,960,227,193,0,0,0,0,0,0
1198093,73,22,1940,9,female,349,225,72,0,88,0,19,0,69
1690740,73,28,1940,10,male,632,223,179,0,0,0,0,0,0
1787759,82,24,1931,5,male,1594,224,102,0,0,0,0,0,0
1342393,101,23,1912,11,male,169,230,130,0,0,0,0,0,0
1248062,102,6,1911,8,female,1622,222,69,0,6,0,3,0,3
1195470,103,8,1910,8,male,717,223,211,0,0,0,0,0,0
1170913,108,20,1905,11,female,1886,229,49,0,0,0,0,0,0
1891152,108,12,1905,11,male,1441,228,70,0,0,0,0,0,0
2047661,113,28,1900,10,male,1282,228,129,0,22,0,19,0,3
1468504,16,3,1997,5,male,587,228,199,1,0,0,0,1,0
1069309,20,19,1993,3,male,414,230,139,1,0,0,0,1,0
1888756,24,11,1989,4,male,663,223,169,1,0,0,0,1,0
1257594,31,1,1982,12,male,407,223,99,1,0,0,0,1,0
1492637,17,14,1996,5,male,276,228,106,1,1,0,0,1,1
1419265,23,28,1990,1,male,900,224,137,1,1,0,1,1,0
1980558,16,22,1997,1,male,1240,224,115,1,3,0,2,1,1
1165541,23,14,1990,3,male,55,227,151,1,2,0,1,1,1
1107915,24,4,1989,2,male,898,230,95,1,2,0,2,1,0
1129133,45,1,1968,10,female,294,222,125,1,224,0,155,1,69
1525469,15,12,1998,9,male,350,222,185,1,0,1,0,0,0
1600734,19,19,1994,11,female,223,230,16,1,0,1,0,0,0
1756368,20,17,1993,11,female,516,224,73,1,0,1,0,0,0
1657771,20,22,1993,12,male,881,227,102,1,0,1,0,0,0
1629268,19,11,1994,3,female,332,224,75,1,0,1,0,0,0
1748898,19,4,1994,4,male,434,229,95,1,0,1,0,0,0
1980740,19,29,1994,9,male,730,229,104,1,0,1,0,0,0
1291400,20,16,1993,1,male,278,227,217,1,0,1,0,0,0
1139183,20,9,1993,4,female,418,222,198,1,0,1,0,0,0
1007483,20,19,1993,8,male,352,222,195,1,0,1,0,0,0
1489746,25,21,1988,8,male,692,230,205,1,0,1,0,0,0
1868171,26,3,1987,1,male,735,222,174,1,0,1,0,0,0
1249020,29,17,1984,12,male,597,229,106,1,0,1,0,0,0
1361077,28,10,1985,6,male,236,226,211,1,0,1,0,0,0
1154922,60,4,1953,11,male,1061,224,81,1,0,1,0,0,0
1470787,68,27,1945,9,male,1043,225,156,1,0,1,0,0,0
1529204,18,8,1995,6,male,713,229,166,1,1,1,1,0,0
1701978,18,8,1995,9,male,370,228,121,1,1,1,0,0,1
2147039,19,27,1994,5,male,238,228,207,1,1,1,1,0,0
1262149,21,11,1992,8,male,453,226,204,1,1,1,1,0,0
1181959,22,21,1991,5,male,454,225,174,1,1,1,0,0,1
1596064,30,15,1983,4,male,523,228,40,1,1,1,1,0,0
2164375,15,24,1998,1,female,68,224,149,1,3,1,2,0,1
1953624,16,1,1997,5,female,634,226,148,1,4,1,4,0,0
1411901,18,26,1995,12,male,420,224,125,1,4,1,4,0,0
2102017,17,11,1996,8,female,368,227,88,1,21,1,21,0,0
1246326,18,1,1995,6,female,152,228,38,1,4,1,4,0,0
1739760,18,10,1995,7,female,200,226,26,1,49,1,15,0,34
1142180,19,21,1994,8,male,373,227,112,1,2,1,1,0,1
1098591,21,11,1992,11,male,137,227,140,1,14,1,14,0,0
1350884,20,5,1993,7,male,508,223,130,1,104,1,72,0,32
1161328,20,13,1993,8,male,119,229,224,1,8,1,7,0,1
1525816,22,24,1991,12,female,1440,227,76,1,5,1,3,0,2
1882229,21,20,1992,1,male,446,229,168,1,11,1,8,0,3
1646750,23,17,1990,11,female,171,222,76,1,69,1,51,0,18
2145083,22,15,1991,3,male,155,222,203,1,6,1,6,0,0
1909274,23,25,1990,6,male,688,226,113,1,38,1,29,0,9
2148153,25,7,1988,11,male,443,229,151,1,2,1,2,0,0
1578805,24,29,1989,7,female,2135,229,92,1,11,1,10,0,1
1502388,25,9,1988,4,male,604,226,168,1,6,1,4,0,2
1465324,32,25,1981,12,male,961,222,141,1,3,1,3,0,0
2050163,33,3,1980,3,male,701,228,195,1,6,1,2,0,4
2112590,35,29,1978,9,male,122,227,183,1,9,1,6,0,3
1572388,36,23,1977,6,female,601,224,134,1,13,1,7,0,6
1161167,94,19,1919,12,female,1400,227,126,1,6,1,5,0,1
1374288,32,2,1981,4,male,1378,229,36,2,1,0,0,2,1
1980814,60,5,1953,6,male,2133,223,170,2,1,0,1,2,0
1404961,16,22,1997,8,male,955,224,126,2,7,0,1,2,6
1932810,18,4,1995,1,male,560,223,145,2,3,0,3,2,0
1064775,23,2,1990,10,male,271,228,180,2,6,0,0,2,6
1832000,55,24,1958,6,male,611,223,129,2,5,0,0,2,5
1968204,82,2,1931,2,male,1579,225,174,2,6,0,0,2,6
1592654,108,6,1905,1,male,1425,230,175,2,6,0,0,2,6
1193466,16,24,1997,7,male,571,222,133,2,0,1,0,1,0
2012703,39,12,1974,5,male,742,228,170,2,61,1,19,1,42
1457518,44,23,1969,4,female,601,230,162,2,5,1,4,1,1
1102634,18,3,1995,11,male,663,230,176,2,0,2,0,0,0
1466469,31,1,1982,1,male,568,224,99,2,0,2,0,0,0
1675504,100,31,1913,12,male,157,223,90,2,0,2,0,0,0
1362207,16,9,1997,9,female,555,222,126,2,1,2,1,0,0
1304711,17,8,1996,2,female,434,225,149,2,1,2,1,0,0
1364868,18,1,1995,1,male,612,225,106,2,1,2,1,0,0
1066683,19,18,1994,6,male,407,229,145,2,1,2,1,0,0
1112524,20,19,1993,4,male,437,223,168,2,2,2,2,0,0
1998715,15,5,1998,5,female,286,228,30,2,15,2,8,0,7
1708513,16,1,1997,1,male,321,226,187,2,12,2,8,0,4
1094273,19,28,1994,11,female,156,226,44,2,4,2,3,0,1
1372976,19,27,1994,12,male,74,228,202,2,7,2,6,0,1
1917267,19,6,1994,1,male,541,227,82,2,14,2,14,0,0
1431062,19,15,1994,4,male,362,229,104,2,14,2,12,0,2
1367861,19,12,1994,5,female,371,228,101,2,11,2,3,0,8
2069752,19,7,1994,7,male,571,229,54,2,6,2,4,0,2
2057618,20,29,1993,1,male,94,227,191,2,4,2,4,0,0
1531319,20,24,1993,5,male,724,223,123,2,37,2,6,0,31
1094988,20,19,1993,5,female,311,229,143,2,33,2,27,0,6
1988732,20,27,1993,9,male,233,230,213,2,39,2,36,0,3
2107747,20,12,1993,10,female,579,227,72,2,5,2,5,0,0
1929573,21,21,1992,1,female,284,230,119,2,17,2,9,0,8
1455473,21,6,1992,10,female,407,226,78,2,5,2,4,0,1
1387075,23,11,1990,2,male,732,226,68,2,9,2,8,0,1
1485847,27,29,1986,9,female,256,228,49,2,9,2,8,0,1
1314852,55,16,1958,6,male,481,227,103,2,8,2,6,0,2
1382167,16,12,1997,1,male,493,223,150,3,2,0,0,3,2
1236878,16,9,1997,5,male,196,230,152,3,3,0,1,3,2
1968341,24,26,1989,10,male,600,223,137,3,2,0,0,3,2
1947842,82,27,1931,4,female,440,225,201,3,2,0,1,3,1
1693343,16,24,1997,2,male,855,229,81,3,2,2,0,1,2
1559650,17,1,1996,11,female,290,229,91,3,4,1,1,2,3
1658489,14,26,1999,1,female,575,229,133,3,5,1,3,2,2
1473125,16,30,1997,4,male,344,224,187,3,7,1,3,2,4
1023270,31,11,1982,1,male,736,224,51,3,0,3,0,0,0
1982194,17,16,1996,6,female,169,222,115,3,1,3,1,0,0
1771561,18,31,1995,5,male,391,223,194,3,1,3,1,0,0
1380440,18,12,1995,10,male,416,229,168,3,1,3,1,0,0
1990050,103,14,1910,4,male,920,226,129,3,1,3,1,0,0
1036788,13,10,2000,3,male,221,225,175,3,4,3,3,0,1
1965162,25,15,1988,7,male,886,224,168,3,4,3,1,0,3
1184840,63,7,1950,3,male,1456,224,115,3,4,3,4,0,0
1252235,15,7,1998,12,male,310,222,146,3,5,3,4,0,1
1416168,21,5,1992,5,male,465,225,157,3,18,3,13,0,5
2117022,23,13,1990,11,female,307,222,121,3,11,3,6,0,5
1267397,23,7,1990,7,female,590,228,115,3,9,3,3,0,6
1943693,26,4,1987,9,female,483,228,159,3,24,3,3,0,21
2085733,35,17,1978,10,female,593,229,36,3,213,3,211,0,2
1424107,108,26,1905,4,male,882,227,127,3,14,3,13,0,1
1138415,108,17,1905,9,male,831,223,79,3,9,3,9,0,0
1681327,15,21,1998,4,male,655,223,51,4,0,0,0,4,0
1682949,22,2,1991,7,male,218,227,195,4,8,0,1,4,7
2098613,23,13,1990,1,female,280,228,171,4,32,1,12,3,20
1566982,23,29,1990,1,female,465,230,97,4,130,3,44,1,86
1552996,108,1,1905,1,female,2084,227,68,4,20,3,4,1,16
1355988,22,9,1991,7,male,600,229,152,4,0,4,0,0,0
1743429,25,21,1988,8,male,60,230,219,4,0,4,0,0,0
1874500,96,15,1917,6,male,905,229,166,4,0,4,0,0,0
1292320,108,9,1905,3,male,1237,226,135,4,1,4,0,0,1
1109471,23,9,1990,6,male,687,230,144,4,4,4,3,0,1
1677700,13,3,2000,7,female,13,230,77,4,107,4,81,0,26
1125872,14,11,1999,1,female,14,228,7,4,33,4,20,0,13
1749176,16,30,1997,7,female,523,229,66,4,22,4,17,0,5
1734925,20,1,1993,6,male,358,224,146,4,257,4,238,0,19
1868505,21,15,1992,6,male,395,225,62,4,220,4,188,0,32
1288630,22,11,1991,10,female,431,224,73,4,14,4,12,0,2
1109512,25,29,1988,2,female,555,223,94,4,9,4,9,0,0
1538508,28,20,1985,7,male,404,223,131,4,14,4,9,0,5
1500694,30,7,1983,11,male,1048,226,153,4,13,4,6,0,7
1980768,33,18,1980,10,male,851,223,108,4,80,4,77,0,3
2016748,103,11,1910,2,female,1305,230,98,4,81,4,76,0,5
1963855,62,20,1951,12,male,416,229,91,5,1,0,0,5,1
2120151,14,23,1999,1,male,433,228,132,5,4,0,2,5,2
1611996,67,11,1946,9,male,328,223,70,5,5,0,1,5,4
2004722,15,7,1998,9,male,462,228,210,5,109,0,23,5,86
1619450,17,19,1996,2,female,183,225,149,5,3,3,0,2,3
1509491,22,11,1991,3,male,121,226,220,5,3,2,0,3,3
1853404,17,3,1996,5,male,860,228,156,5,8,1,4,4,4
2165294,18,1,1995,2,female,202,222,106,5,38,1,12,4,26
2143172,19,9,1994,10,male,460,228,181,5,8,2,6,3,2
1257144,19,4,1994,1,male,383,228,199,5,0,5,0,0,0
1412152,54,3,1959,8,male,459,224,179,5,1,5,1,0,0
1857849,27,5,1986,12,male,696,229,111,5,49,5,28,0,21
1503145,33,7,1980,4,male,333,222,158,5,24,5,21,0,3
1531505,58,25,1955,9,male,1267,224,131,5,79,5,72,0,7
1759665,59,9,1954,4,female,1537,226,38,5,14,5,10,0,4
1486068,100,25,1913,11,female,1108,229,77,5,10,5,8,0,2
1707239,103,26,1910,1,male,1334,230,122,5,143,5,100,0,43
2004392,25,26,1988,4,female,111,224,27,6,2,0,0,6,2
2188897,102,21,1911,8,male,2341,224,109,6,16,0,1,6,15
1375154,108,1,1905,1,male,153,223,124,6,27,0,19,6,8
2098883,19,9,1994,8,male,163,230,64,6,4,3,1,3,3
1925513,16,10,1997,12,female,659,230,36,6,0,6,0,0,0
1406223,28,28,1985,11,female,346,228,93,6,0,6,0,0,0
1210198,32,28,1981,9,male,221,222,202,6,7,6,2,0,5
1913432,16,28,1997,10,male,444,230,108,6,22,6,18,0,4
1742271,21,2,1992,12,female,491,230,110,6,43,6,38,0,5
2151387,20,1,1993,8,male,902,223,111,6,17,6,15,0,2
2083348,22,25,1991,2,female,372,230,98,6,57,6,33,0,24
1595520,24,24,1989,8,female,1247,226,77,6,25,6,23,0,2
1927000,63,14,1950,5,female,877,230,64,6,10,6,9,0,1
1322909,24,19,1989,1,male,1420,229,55,7,0,0,0,7,0
2183668,26,18,1987,2,male,425,225,109,7,1,1,0,6,1
1555596,27,24,1986,7,male,561,229,147,7,2,0,0,7,2
1476152,48,6,1965,10,female,289,222,97,7,2,0,0,7,2
1664044,103,14,1910,10,male,842,230,191,7,2,0,1,7,1
1583867,66,8,1947,8,male,633,229,208,7,106,0,73,7,33
2106959,20,18,1993,3,female,466,230,36,7,27,5,24,2,3
2190084,113,13,1900,5,male,1524,223,53,7,3,6,1,1,2
1604364,15,14,1998,3,female,104,229,188,7,0,7,0,0,0
1471177,30,13,1983,4,male,299,227,33,7,4,7,3,0,1
1296013,18,28,1995,4,female,198,229,71,7,8,7,7,0,1
1007058,93,8,1920,3,female,484,229,148,7,6,7,6,0,0
1867071,108,27,1905,4,female,528,227,77,7,6,7,4,0,2
1636365,18,17,1995,6,male,377,224,81,7,274,7,232,0,42
1420516,18,25,1995,7,male,763,223,98,7,21,7,14,0,7
1969728,19,20,1994,7,female,51,225,19,7,155,7,122,0,33
1287535,19,31,1994,8,female,118,225,116,7,22,7,16,0,6
1307633,25,28,1988,4,male,1172,223,151,7,24,7,15,0,9
1669091,53,12,1960,8,male,631,225,143,7,114,7,88,0,26
2173460,21,7,1992,2,male,259,224,158,8,3,0,0,8,3
1435213,15,20,1998,5,female,218,228,192,8,13,0,4,8,9
1609123,20,6,1993,3,male,121,227,179,8,29,3,18,5,11
1813270,21,7,1992,7,male,714,226,116,8,1,7,1,1,0
1465568,108,26,1905,1,male,2085,223,98,8,1,6,0,2,1
1906562,22,28,1991,4,male,205,226,203,8,22,6,17,2,5
1406995,27,17,1986,6,female,539,228,201,8,26,7,12,1,14
1589801,17,15,1996,5,male,690,222,105,8,1,8,1,0,0
2164482,18,12,1995,6,male,378,229,138,8,0,8,0,0,0
1111209,19,23,1994,7,male,616,223,102,8,0,8,0,0,0
1325838,26,6,1987,3,male,361,224,146,8,1,8,1,0,0
2037676,103,16,1910,4,female,983,223,78,8,4,8,4,0,0
1461725,19,26,1994,9,female,362,229,152,8,7,8,5,0,2
1197391,20,17,1993,8,male,946,229,77,8,11,8,11,0,0
1424414,32,30,1981,7,male,1775,223,75,8,9,8,8,0,1
1586664,14,24,1999,9,female,39,227,76,8,59,8,23,0,36
1077983,18,11,1995,12,female,207,223,37,8,274,8,216,0,58
1047833,18,21,1995,9,female,698,228,49,8,22,8,22,0,0
1085929,22,24,1991,1,male,420,228,177,8,18,8,15,0,3
1766684,23,7,1990,2,male,203,226,148,8,61,8,34,0,27
1185172,60,1,1953,5,male,954,228,2,8,34,8,10,0,24
1590471,68,20,1945,7,female,1584,228,124,9,0,0,0,9,0
1240027,17,18,1996,2,male,293,227,98,9,13,0,5,9,8
1204619,16,14,1997,10,female,54,223,7,9,22,0,0,9,22
1655492,18,27,1995,4,female,583,223,42,9,20,0,15,9,5
1580711,21,10,1992,4,female,471,227,154,9,20,0,6,9,14
1366594,25,30,1988,4,male,547,230,129,9,62,1,15,8,47
1469399,17,14,1996,12,male,1050,228,106,9,77,6,41,3,36
1226976,22,22,1991,4,female,177,229,104,9,38,6,8,3,30
1389767,62,3,1951,3,male,1265,226,183,9,20,6,16,3,4
1003239,18,14,1995,6,female,433,229,97,9,0,9,0,0,0
1167664,21,10,1992,3,male,342,224,123,9,4,9,4,0,0
1074921,29,1,1984,6,female,219,224,80,9,2,9,1,0,1
1254133,25,1,1988,1,female,508,230,51,9,63,9,22,0,41
1267866,30,25,1983,12,male,498,227,117,9,44,9,32,0,12
2137387,29,5,1984,3,male,357,229,168,9,15,9,8,0,7
1078683,30,27,1983,8,male,618,226,39,9,14,9,11,0,3
1784430,68,2,1945,10,female,2293,227,115,9,23,9,12,0,11
1713978,93,1,1920,1,male,232,223,191,9,51,9,34,0,17
1528367,21,1,1992,12,male,392,227,162,10,29,0,10,10,19
2152640,21,20,1992,6,male,130,222,176,10,26,1,12,9,14
1653498,13,28,2000,1,male,414,230,145,10,0,4,0,6,0
1156361,63,16,1950,9,male,1755,230,169,10,10,7,7,3,3
2140123,91,22,1922,2,male,2081,230,123,10,23,7,12,3,11
1009988,17,26,1996,2,male,1172,229,196,10,5,10,4,0,1
1828451,16,11,1997,5,male,531,227,16,10,11,10,5,0,6
1213123,20,16,1993,4,female,624,230,85,10,7,10,3,0,4
1247873,17,28,1996,9,female,205,227,81,10,24,10,16,0,8
1417319,19,16,1994,7,male,534,226,193,10,32,10,2,0,30
1718231,32,10,1981,10,female,283,228,84,10,37,10,22,0,15
2095622,43,24,1970,12,female,507,222,199,10,61,10,47,0,14
1159031,20,22,1993,5,male,591,224,186,11,0,0,0,11,0
1564068,19,3,1994,11,male,517,223,171,11,29,2,3,9,26
1512093,18,17,1995,5,male,734,226,123,11,34,0,8,11,26
2158792,34,6,1979,3,male,554,229,40,11,23,0,6,11,17
1058533,14,26,1999,4,female,255,229,137,11,12,6,5,5,7
1174724,50,23,1963,5,female,1270,225,58,11,8,6,1,5,7
1226290,55,16,1958,9,male,765,223,189,11,10,6,6,5,4
2089866,23,16,1990,1,female,202,223,114,11,42,7,18,4,24
1936948,20,5,1993,2,male,490,225,190,11,0,11,0,0,0
1273471,60,14,1953,3,female,872,229,169,11,1,11,0,0,1
1977498,15,10,1998,3,male,338,227,171,11,5,11,4,0,1
1995334,20,3,1993,3,male,526,224,214,11,5,11,5,0,0
1338053,103,29,1910,4,male,807,226,166,11,2,11,2,0,0
1697956,31,2,1982,12,female,402,224,126,11,38,11,30,0,8
2146242,35,24,1978,9,female,428,226,70,11,57,11,31,0,26
1302403,54,28,1959,2,male,217,222,45,12,4,8,4,4,0
2174317,84,1,1929,3,male,1010,223,112,12,8,6,5,6,3
1448455,18,11,1995,5,male,448,223,195,12,6,12,3,0,3
1845105,20,6,1993,7,female,914,225,13,12,7,12,5,0,2
1370441,32,5,1981,9,male,513,229,200,12,12,12,8,0,4
1830851,46,3,1967,6,female,357,222,91,12,17,12,11,0,6
1240780,17,1,1996,10,male,544,230,168,13,7,1,0,12,7
1792734,18,1,1995,10,female,72,228,50,13,4,0,3,13,1
1508664,27,27,1986,11,male,359,226,73,13,18,0,8,13,10
1513710,21,24,1992,7,male,535,226,141,13,5,7,2,6,3
1703320,23,14,1990,2,male,897,225,78,13,159,7,98,6,61
1387751,24,14,1989,8,male,336,223,136,13,0,13,0,0,0
1738934,20,23,1993,11,male,473,223,172,13,5,13,4,0,1
1309962,43,1,1970,5,male,606,229,81,13,6,13,6,0,0
1610619,27,15,1986,1,female,1269,226,135,13,347,13,212,0,135
1117648,29,27,1984,1,female,235,222,98,13,61,13,50,0,11
1482984,20,16,1993,3,male,143,224,119,14,9,14,6,0,3
1508352,21,2,1992,1,male,218,230,137,14,21,14,17,0,4
1144450,48,20,1965,1,male,287,229,92,14,42,14,28,0,14
1941663,16,30,1997,9,male,476,222,146,15,2,0,0,15,2
1967391,102,1,1911,1,male,1469,229,125,15,62,0,55,15,7
1605781,24,21,1989,9,female,1493,229,79,15,1,5,0,10,1
1138621,22,12,1991,4,male,840,227,72,15,2,15,1,0,1
1974182,16,10,1997,8,male,467,222,162,15,8,15,7,0,1
1880193,18,12,1995,8,male,70,226,200,15,51,15,46,0,5
1015885,20,24,1993,10,male,445,226,116,15,53,15,37,0,16
1296212,108,1,1905,1,male,1531,229,126,16,4,0,3,16,1
1710122,14,10,1999,12,male,222,230,142,16,6,7,1,9,5
2152521,22,4,1991,4,male,506,228,135,16,68,14,26,2,42
1605448,103,15,1910,1,female,662,222,108,16,8,16,8,0,0
1755929,17,27,1996,6,female,351,228,85,16,13,16,10,0,3
1685804,22,17,1991,6,male,302,227,171,16,13,16,8,0,5
2107887,41,15,1972,2,female,150,223,44,16,10,16,10,0,0
1933135,28,2,1985,12,male,406,225,73,17,4,0,1,17,3
1213942,41,17,1972,6,female,1299,222,175,17,62,2,59,15,3
1439350,106,25,1907,5,male,1621,229,138,17,82,0,22,17,60
2112336,24,17,1989,11,male,98,222,170,17,22,16,10,1,12
1612259,17,29,1996,2,male,313,230,220,17,3,17,3,0,0
1914786,25,2,1988,9,male,1432,227,124,17,23,17,15,0,8
1317664,20,19,1993,3,female,521,225,32,17,93,17,41,0,52
1035955,94,11,1919,5,female,934,228,98,17,28,17,25,0,3
1653235,16,17,1997,9,male,1169,223,112,18,0,2,0,16,0
1216794,108,1,1905,1,male,1191,222,95,18,1,5,0,13,1
1453011,33,12,1980,1,male,21,227,191,18,15,17,11,1,4
1315224,18,12,1995,2,female,222,229,181,18,36,17,31,1,5
1232860,22,4,1991,2,male,898,224,65,18,2,18,2,0,0
1626434,25,6,1988,9,male,381,222,127,18,3,18,3,0,0
1752980,26,1,1987,1,male,326,222,198,18,10,18,10,0,0
1473050,108,10,1905,6,male,1304,226,139,18,26,18,20,0,6
2169749,19,6,1994,2,male,291,226,137,19,2,4,2,15,0
1039501,56,26,1957,11,male,1322,225,41,19,20,10,8,9,12
1022529,17,27,1996,12,female,770,228,185,20,12,10,9,10,3
1230287,29,12,1984,12,female,438,222,123,20,11,9,8,11,3
1345547,14,13,1999,5,female,195,224,74,20,28,17,18,3,10
2082442,51,15,1962,6,male,680,227,155,20,54,15,31,5,23
2174908,48,6,1965,11,male,208,229,140,20,2,20,1,0,1
1618572,25,9,1988,12,male,198,222,176,20,11,20,10,0,1
1747473,18,22,1995,6,male,831,229,142,20,28,20,8,0,20
1498233,18,10,1995,9,male,267,223,159,20,13,20,11,0,2
1148571,20,14,1993,10,male,292,226,211,21,6,5,3,16,3
1857757,21,10,1992,9,female,1737,226,74,21,26,8,24,13,2
1797431,28,5,1985,1,male,393,225,104,21,52,6,27,15,25
1124332,27,22,1986,5,female,701,229,127,21,11,18,7,3,4
1713427,45,3,1968,5,female,1382,226,73,21,4,21,2,0,2
1155710,52,21,1961,6,female,1550,227,141,21,33,21,23,0,10
1733521,21,3,1992,12,female,118,227,172,22,9,14,6,8,3
1815703,17,28,1996,11,male,315,224,176,22,5,16,5,6,0
1512615,27,23,1986,2,male,680,222,139,22,34,18,10,4,24
1754521,21,28,1992,9,female,575,229,53,22,88,22,23,0,65
1489894,26,1,1987,1,male,334,222,130,22,37,22,16,0,21
2027928,35,30,1978,9,female,323,228,151,22,42,22,38,0,4
1552494,17,8,1996,4,male,550,224,169,23,1,0,1,23,0
1004605,59,17,1954,2,female,288,226,173,23,208,0,48,23,160
1200223,55,20,1958,10,male,262,224,184,23,28,17,27,6,1
1139247,24,8,1989,12,male,627,229,120,23,40,21,16,2,24
2084512,31,28,1982,12,male,247,228,81,23,2,23,1,0,1
2080078,14,9,1999,7,female,473,230,53,23,4,23,4,0,0
1333403,26,1,1987,1,male,364,227,114,23,11,23,4,0,7
1426794,21,30,1992,4,male,468,228,204,23,90,23,86,0,4
1542785,26,3,1987,12,male,407,228,72,23,44,23,31,0,13
1953478,26,13,1987,6,male,491,224,207,23,78,23,74,0,4
1200275,108,23,1905,3,male,1683,227,133,24,10,0,8,24,2
1071438,14,2,1999,1,female,311,230,167,24,4,15,4,9,0
2050470,29,6,1984,6,male,1259,228,86,24,3,24,2,0,1
1815289,21,4,1992,3,male,299,230,80,24,14,24,12,0,2
1792730,21,30,1992,1,female,470,225,117,24,20,24,17,0,3
1083026,86,9,1927,7,female,40,223,4,24,35,24,22,0,13
1707735,59,7,1954,3,male,907,226,91,24,86,24,48,0,38
1817488,18,14,1995,7,male,226,230,164,25,0,0,0,25,0
1926827,21,8,1992,12,male,1657,224,120,25,25,4,8,21,17
1933434,22,20,1991,4,male,571,229,153,25,41,7,12,18,29
1458337,22,11,1991,11,female,497,222,103,25,36,20,9,5,27
2172732,30,15,1983,10,male,355,230,154,25,15,25,15,0,0
1400417,19,25,1994,8,female,440,228,120,25,21,25,19,0,2
1993065,17,10,1996,12,male,454,224,122,26,28,20,5,6,23
1965775,19,12,1994,10,female,278,227,149,26,48,25,36,1,12
1421484,37,8,1976,3,male,234,230,168,26,12,26,5,0,7
1952280,18,16,1995,9,male,467,227,80,26,20,26,19,0,1
1565854,22,9,1991,4,male,110,225,187,26,32,26,23,0,9
1302392,17,28,1996,1,male,269,230,141,27,7,0,0,27,7
2116918,25,22,1988,8,female,383,226,153,27,248,17,121,10,127
1590569,103,16,1910,3,female,753,228,155,27,108,26,57,1,51
1197652,15,7,1998,11,female,106,225,143,27,18,27,10,0,8
1022759,27,30,1986,3,female,416,223,87,27,61,27,36,0,25
1526428,16,24,1997,12,male,321,228,141,28,3,0,1,28,2
1142589,18,28,1995,7,female,250,222,69,28,42,1,17,27,25
1047664,25,28,1988,8,female,692,224,150,28,73,25,36,3,37
1264210,25,30,1988,6,male,232,222,151,28,2,28,2,0,0
1565736,18,1,1995,1,male,33,226,136,28,27,28,20,0,7
1296574,33,16,1980,12,female,1225,230,88,28,33,28,29,0,4
1222435,38,3,1975,10,female,140,225,54,28,342,28,278,0,64
2147313,44,27,1969,7,male,307,222,15,28,59,28,35,0,24
1102159,70,22,1943,7,female,2131,224,168,29,6,23,3,6,3
1656257,108,12,1905,6,male,1572,224,88,29,23,24,12,5,11
1785189,16,25,1997,11,male,441,224,106,29,17,29,17,0,0
1094145,22,21,1991,12,male,202,230,154,29,29,29,12,0,17
1183719,31,27,1982,1,female,380,229,146,29,30,29,20,0,10
1022505,74,1,1939,9,male,1751,225,60,31,44,0,13,31,31
1521466,70,18,1943,8,female,1435,230,100,30,4,30,1,0,3
1958610,21,1,1992,6,female,311,229,142,30,25,30,12,0,13
2000858,28,23,1985,5,male,688,226,180,30,22,30,13,0,9
2016703,22,23,1991,5,male,756,229,72,32,8,3,4,29,4
1375997,16,24,1997,8,male,246,225,182,32,20,3,1,29,19
1276582,25,10,1988,1,male,336,227,131,32,24,0,9,32,15
1816600,18,7,1995,9,male,973,227,122,32,36,11,12,21,24
1225016,32,29,1981,4,male,138,228,119,32,67,26,43,6,24
1326398,23,20,1990,7,male,557,230,101,32,67,32,60,0,7
1172662,67,24,1946,8,female,1078,227,147,33,172,0,15,33,157
1203320,18,30,1995,11,female,293,224,150,33,77,32,57,1,20
1486424,23,24,1990,4,female,222,228,134,33,42,33,23,0,19
1807584,25,19,1988,5,female,761,223,157,34,20,3,12,31,8
1454160,15,19,1998,3,male,483,230,195,34,75,3,20,31,55
1542486,15,29,1998,5,male,277,222,81,34,7,12,4,22,3
1990160,15,21,1998,3,male,243,225,116,34,8,34,8,0,0
1967748,23,13,1990,8,male,548,229,188,34,37,34,10,0,27
2191306,53,22,1960,3,male,491,227,157,36,0,7,0,29,0
1422322,18,17,1995,3,male,348,225,146,36,4,36,4,0,0
1114485,18,13,1995,2,female,118,223,21,36,34,36,25,0,9
1048566,33,29,1980,9,female,879,226,128,36,31,36,19,0,12
2143440,32,1,1981,5,female,552,228,65,36,81,36,25,0,56
2075450,17,13,1996,6,male,252,229,132,37,43,24,19,13,24
1633245,45,16,1968,1,male,137,223,202,37,198,10,16,27,182
1922766,28,23,1985,11,female,707,230,166,37,128,36,88,1,40
1271174,50,13,1963,1,male,808,224,27,37,60,35,18,2,42
1143419,14,22,1999,9,female,521,223,168,37,4,37,4,0,0
2062243,19,10,1994,5,male,824,230,162,37,0,37,0,0,0
1888888,64,26,1949,7,male,1532,222,62,37,14,37,6,0,8
1520639,103,20,1910,5,male,306,230,137,38,7,0,5,38,2
1578578,91,30,1922,9,male,1596,224,129,39,50,1,26,38,24
1343510,22,1,1991,1,male,642,225,138,38,74,35,35,3,39
2004031,20,9,1993,11,male,370,222,104,38,23,38,18,0,5
1114674,20,1,1993,1,male,193,229,179,39,36,39,23,0,13
2176369,52,5,1961,3,male,514,229,184,39,50,39,44,0,6
1810229,16,16,1997,3,female,228,230,79,38,345,38,245,0,100
1614120,64,30,1949,11,male,587,225,184,39,79,39,26,0,53
1031274,60,3,1953,6,female,1165,227,126,40,2,3,1,37,1
1159292,16,8,1997,7,male,1051,225,135,40,10,4,1,36,9
1848868,24,9,1989,5,male,417,222,102,40,70,8,15,32,55
2041675,33,20,1980,2,male,1182,230,112,40,1,37,0,3,1
1342511,26,10,1987,8,male,405,227,97,40,8,39,6,1,2
1592192,60,14,1953,5,female,1696,225,119,42,763,11,512,31,251
1824737,21,23,1992,2,male,491,229,156,42,36,41,25,1,11
1475529,73,9,1940,12,female,599,222,194,41,28,39,14,2,14
1362102,103,17,1910,11,female,2104,230,91,41,84,39,67,2,17
1094834,21,19,1992,10,male,450,223,134,42,14,42,14,0,0
1247866,18,22,1995,2,male,105,224,197,42,59,42,42,0,17
1264752,21,7,1992,3,male,222,222,116,41,127,41,95,0,32
1933697,101,10,1912,10,male,1715,228,121,43,25,4,14,39,11
1761384,30,19,1983,12,male,748,228,124,43,3,24,1,19,2
1415241,29,13,1984,4,female,655,222,196,44,30,18,8,26,22
1060605,16,15,1997,5,male,388,230,111,43,19,41,3,2,16
1222294,17,10,1996,7,male,235,226,201,43,0,43,0,0,0
1015248,28,15,1985,4,male,319,226,69,44,17,44,14,0,3
1941245,54,4,1959,2,male,511,228,139,43,22,43,18,0,4
1649353,93,5,1920,10,female,403,227,109,44,11,44,4,0,7
1159664,19,22,1994,9,female,673,229,129,44,42,44,29,0,13
1495595,25,25,1988,7,female,977,228,176,43,62,43,43,0,19
1963316,26,25,1987,5,male,303,226,115,45,24,45,24,0,0
1749037,54,7,1959,8,male,1529,224,112,45,74,45,51,0,23
1489390,20,15,1993,11,male,899,227,49,47,7,1,3,46,4
1212453,16,25,1997,10,male,378,225,115,47,93,0,63,47,30
1641983,17,5,1996,7,male,156,222,85,46,22,46,10,0,12
1496537,20,7,1993,8,male,668,226,135,46,22,46,11,0,11
2057583,24,4,1989,10,male,351,230,97,46,9,46,3,0,6
1323078,20,20,1993,3,female,339,225,137,46,42,46,20,0,22
1018211,102,22,1911,12,female,879,229,24,46,28,46,26,0,2
2091744,56,15,1957,8,female,810,222,133,46,101,46,43,0,58
1702612,13,15,2000,1,male,580,229,84,49,2,0,0,49,2
2053041,19,23,1994,3,male,704,223,55,49,19,48,19,1,0
1866691,26,10,1987,7,female,323,226,12,49,7,49,7,0,0
2145396,21,1,1992,12,female,462,225,115,49,129,49,57,0,72
2052101,18,30,1995,12,male,262,223,70,51,173,8,132,43,41
1579785,34,16,1979,5,female,252,222,174,51,94,7,58,44,36
1890173,46,20,1967,5,female,792,227,83,50,286,0,42,50,244
1121564,54,20,1959,12,male,410,227,181,50,168,2,39,48,129
1742043,14,17,1999,10,male,89,230,187,50,73,34,21,16,52
1299046,35,10,1978,2,male,616,228,113,51,32,16,12,35,20
1706019,26,25,1987,11,female,360,222,129,50,46,45,16,5,30
1390167,51,20,1962,5,female,79,225,215,50,107,47,100,3,7
1598835,40,24,1973,12,male,929,224,152,51,22,51,19,0,3
1160275,27,19,1986,1,male,721,225,71,53,487,52,352,1,135
1500550,17,29,1996,12,male,746,224,171,52,2,52,2,0,0
1047901,28,20,1985,11,male,541,225,165,52,3,52,1,0,2
1633083,101,10,1912,8,female,472,230,102,52,0,52,0,0,0
1700173,30,18,1983,7,male,262,226,187,52,42,52,26,0,16
1916138,32,8,1981,10,female,590,222,88,53,61,53,23,0,38
1393998,21,16,1992,8,female,300,230,82,52,81,52,67,0,14
1124704,99,29,1914,8,male,11,223,202,53,506,53,344,0,162
1061781,18,18,1995,10,male,54,229,214,55,59,55,24,0,35
1741397,41,24,1972,9,female,226,226,191,54,62,54,52,0,10
1378604,19,27,1994,12,female,471,230,66,58,178,3,38,55,140
1728448,52,13,1961,1,female,999,223,72,58,109,2,77,56,32
1531316,17,13,1996,1,male,782,223,142,56,58,28,16,28,42
1762341,103,1,1910,1,male,1268,222,129,56,2,55,2,1,0
1126843,25,20,1988,1,male,438,226,179,58,37,50,27,8,10
1462247,69,23,1944,5,male,1542,224,97,57,51,55,20,2,31
1435015,19,23,1994,3,female,368,227,97,56,5,56,2,0,3
2147664,21,14,1992,4,male,594,224,169,57,11,57,9,0,2
1299547,16,25,1997,3,female,287,230,82,57,66,57,61,0,5
1706728,19,12,1994,10,female,758,227,95,56,36,56,36,0,0
1704691,53,21,1960,8,male,566,226,193,57,88,57,55,0,33
1744410,18,14,1995,7,female,406,222,153,60,64,40,47,20,17
1367531,46,17,1967,1,female,945,226,142,60,176,31,144,29,32
1561861,17,4,1996,1,female,92,230,46,60,76,60,67,0,9
1878538,21,9,1992,2,female,445,223,170,59,69,59,51,0,18
1967855,36,13,1977,1,male,569,227,58,59,57,59,57,0,0
2169270,18,20,1995,5,male,383,227,130,61,35,52,23,9,12
2079455,18,7,1995,9,male,561,224,106,61,9,61,9,0,0
1245038,18,10,1995,2,male,425,225,207,62,11,62,11,0,0
1514320,21,18,1992,5,male,1160,222,130,61,45,61,29,0,16
1862550,22,14,1991,1,male,214,224,122,63,83,63,34,0,49
1886790,24,2,1989,6,female,847,229,80,62,73,62,32,0,41
1976806,33,4,1980,9,female,16,225,203,62,65,62,49,0,16
1398421,103,5,1910,1,male,602,222,160,61,58,61,55,0,3
1368803,36,25,1977,9,male,774,226,135,61,666,61,341,0,325
1172495,41,22,1972,3,female,1954,227,80,61,656,61,389,0,267
1042120,41,10,1972,6,female,275,222,128,63,102,63,78,0,24
1507812,61,16,1952,2,male,1273,227,80,65,0,0,0,65,0
2165012,23,8,1990,12,male,479,226,149,65,82,6,41,59,41
1434415,61,14,1952,12,male,506,227,156,64,75,0,4,64,71
1580487,24,26,1989,4,male,164,223,125,65,107,34,53,31,54
1107659,15,22,1998,12,female,213,224,56,64,145,60,87,4,58
1649610,46,8,1967,1,female,1228,226,117,65,121,59,110,6,11
1240154,33,8,1980,4,female,608,226,157,65,48,65,28,0,20
1524346,14,12,1999,3,male,46,223,196,68,16,0,5,68,11
1239000,49,24,1964,1,male,543,228,145,66,22,7,10,59,12
1871229,20,14,1993,2,female,297,222,146,66,56,20,18,46,38
1866665,20,5,1993,9,female,437,229,110,68,127,48,60,20,67
1336299,28,28,1985,8,female,929,225,66,66,177,27,53,39,124
1870307,19,14,1994,3,male,157,226,170,66,362,62,98,4,264
1616680,59,21,1954,1,female,1383,226,51,67,324,61,191,6,133
1603518,21,3,1992,5,male,471,224,148,66,10,66,10,0,0
1306939,41,14,1972,12,male,543,226,169,67,0,67,0,0,0
1065982,22,25,1991,2,female,131,229,124,68,198,68,152,0,46
1375581,101,2,1912,8,male,1352,222,88,70,186,13,51,57,135
1854043,20,13,1993,4,male,231,224,177,69,99,45,71,24,28
2123103,27,6,1986,5,female,392,229,202,70,123,29,83,41,40
2190285,27,10,1986,7,male,125,223,201,70,147,32,93,38,54
1738428,18,19,1995,2,male,281,226,155,70,6,69,5,1,1
1878898,18,7,1995,2,female,608,225,95,71,39,71,31,0,8
1075480,29,4,1984,1,male,220,222,36,70,24,70,12,0,12
1825494,55,21,1958,4,female,536,227,72,71,48,71,30,0,18
1912163,63,1,1950,5,female,459,225,22,73,109,70,73,3,36
1080464,65,25,1948,10,female,427,223,44,74,56,73,39,1,17
1716532,23,19,1990,8,male,32,228,211,74,199,55,182,19,17
1547081,16,13,1997,8,male,203,228,124,73,6,73,6,0,0
1288091,18,4,1995,5,female,224,226,199,74,29,74,28,0,1
1956250,23,30,1990,10,male,494,226,161,72,37,72,37,0,0
1793842,33,1,1980,1,male,993,229,137,72,80,72,78,0,2
1084342,18,16,1995,10,male,217,222,110,72,111,72,89,0,22
1593010,60,12,1953,5,male,200,226,202,76,19,3,13,73,6
1779424,69,28,1944,9,male,743,224,140,76,16,0,5,76,11
2093745,57,8,1956,8,male,1819,223,111,75,93,49,38,26,55
1042606,37,19,1976,3,male,481,224,121,77,122,65,86,12,36
1357335,32,8,1981,8,male,720,230,197,77,10,77,9,0,1
1321921,108,29,1905,7,female,1694,230,121,77,34,77,30,0,4
1747065,73,4,1940,9,female,675,225,146,77,68,77,58,0,10
1777941,26,19,1987,12,male,912,225,157,79,11,0,8,79,3
1144883,99,3,1914,3,male,1883,223,65,80,189,3,48,77,141
1240034,108,19,1905,1,female,1650,229,77,78,28,34,14,44,14
1343972,16,9,1997,2,male,508,228,126,78,44,74,33,4,11
1745318,23,24,1990,6,male,731,222,146,80,44,75,12,5,32
2104827,21,19,1992,11,female,345,223,150,80,263,77,166,3,97
1525133,16,25,1997,10,female,115,226,101,78,67,78,51,0,16
1613145,19,20,1994,12,female,300,223,36,80,333,80,209,0,124
1872497,64,26,1949,12,female,1475,226,161,80,181,80,91,0,90
1311862,15,12,1998,7,female,247,230,104,83,312,7,99,76,213
1965870,30,15,1983,11,female,1893,226,142,81,48,33,34,48,14
2156928,18,11,1995,10,female,701,225,83,81,183,80,156,1,27
1616704,45,5,1968,7,female,686,225,119,83,210,82,194,1,16
1788759,62,12,1951,11,male,229,222,152,81,91,81,59,0,32
1934108,29,2,1984,3,female,412,226,177,86,82,54,16,32,66
2014938,20,12,1993,12,female,363,225,85,86,175,52,82,34,93
1436412,15,12,1998,8,female,767,225,164,86,83,80,63,6,20
1564674,34,16,1979,11,female,280,226,94,90,130,7,17,83,113
1820447,30,5,1983,11,male,764,227,155,88,30,27,18,61,12
1707759,18,28,1995,4,male,368,230,100,91,18,84,8,7,10
1095566,24,6,1989,5,female,435,229,170,91,4,91,2,0,2
1081414,20,4,1993,4,male,516,222,116,90,30,90,12,0,18
1593843,63,31,1950,1,female,636,224,153,93,58,0,6,93,52
1653953,21,8,1992,7,female,641,230,48,92,97,91,62,1,35
1730189,56,28,1957,10,male,457,222,180,92,214,74,133,18,81
1834385,31,5,1982,7,female,517,224,118,92,7,92,7,0,0
1403559,68,10,1945,3,female,1061,225,111,93,15,93,13,0,2
1081870,15,4,1998,11,female,440,222,78,93,32,93,31,0,1
1847656,18,4,1995,1,male,294,230,125,92,71,92,53,0,18
1626225,23,10,1990,12,female,35,227,50,95,135,95,102,0,33
1357631,44,1,1969,2,male,1425,225,125,99,10,85,6,14,4
1215135,18,11,1995,11,male,389,223,144,98,46,96,37,2,9
2091928,20,5,1993,9,female,216,222,126,96,28,93,26,3,2
1416422,18,20,1995,10,male,157,224,107,99,44,99,25,0,19
1722109,25,16,1988,7,male,211,222,170,98,79,98,34,0,45
1460501,16,16,1997,2,male,474,228,118,100,12,2,5,98,7
1213782,42,9,1971,5,female,412,230,187,104,196,2,142,102,54
1684229,19,23,1994,4,male,427,224,177,100,16,60,9,40,7
2042003,27,19,1986,6,female,568,222,174,101,127,92,88,9,39
1888450,36,7,1977,2,female,1722,222,149,103,171,87,101,16,70
1744526,108,7,1905,3,female,1289,222,92,102,428,100,293,2,135
1727914,30,14,1983,2,male,540,227,174,100,27,99,24,1,3
1081665,51,17,1962,2,female,1555,223,85,103,64,103,47,0,17
1054582,53,20,1960,4,female,353,227,93,104,86,104,44,0,42
1790359,21,28,1992,7,female,235,222,173,108,20,2,14,106,6
1951740,30,11,1983,7,male,319,223,109,107,33,0,13,107,20
2154305,43,11,1970,11,female,493,224,105,106,120,3,31,103,89
2072382,22,7,1991,6,female,563,225,153,109,81,106,32,3,49
2062662,45,28,1968,12,male,259,228,121,106,14,106,8,0,6
2001647,16,25,1997,10,male,216,229,114,113,63,10,11,103,52
1472185,108,27,1905,3,female,2063,225,97,110,152,1,113,109,39
1166849,16,2,1997,3,female,667,223,173,113,49,98,35,15,14
1877667,59,1,1954,11,male,573,230,167,117,6,0,2,117,4
1590882,60,9,1953,12,male,585,224,107,115,364,0,111,115,253
1739879,23,8,1990,10,male,175,226,162,119,14,47,5,72,9
2149907,19,12,1994,12,female,235,227,177,119,215,65,109,54,106
2115428,18,25,1995,12,female,199,227,62,115,44,100,26,15,18
1562677,52,15,1961,3,female,2067,228,145,115,216,87,152,28,64
1286799,16,21,1997,4,male,263,223,99,116,63,116,50,0,13
1462607,27,1,1986,1,male,721,229,91,116,50,116,47,0,3
1200952,108,2,1905,6,male,983,227,173,114,95,114,82,0,13
2164067,63,5,1950,9,male,750,224,95,121,76,1,30,120,46
1834439,33,9,1980,3,female,1535,228,73,123,179,113,58,10,121
1595281,15,18,1998,4,male,548,224,116,122,132,122,56,0,76
1024669,23,17,1990,8,female,373,230,198,123,466,123,354,0,112
1016776,15,27,1998,2,male,349,225,144,126,110,22,23,104,87
1408406,16,5,1997,2,male,370,222,175,128,57,126,49,2,8
1405567,37,12,1976,6,male,391,226,51,125,68,113,46,12,22
1095798,21,31,1992,10,female,381,224,106,129,118,121,50,8,68
1630036,18,21,1995,8,female,681,227,159,126,96,125,38,1,58
1266819,29,25,1984,2,male,417,223,124,130,18,130,13,0,5
1020637,20,6,1993,5,male,168,223,201,126,54,126,54,0,0
1710348,27,20,1986,11,female,533,226,158,127,32,127,31,0,1
1532408,18,27,1995,6,male,370,225,162,125,116,125,99,0,17
1495268,16,5,1997,7,female,533,230,118,131,67,57,56,74,11
2025968,30,26,1983,11,female,734,225,110,131,124,74,70,57,54
1920223,52,4,1961,8,female,776,224,176,133,45,117,22,16,23
1956539,23,26,1990,1,female,563,225,174,134,92,128,68,6,24
1734019,26,1,1987,12,female,152,228,32,133,1,133,1,0,0
1791569,92,1,1921,11,male,461,226,74,142,41,84,24,58,17
1116481,103,9,1910,12,female,939,226,111,139,33,32,9,107,24
1432425,32,25,1981,10,female,601,230,204,138,358,51,190,87,168
1564910,23,27,1990,10,female,585,224,118,137,185,113,142,24,43
1530494,24,4,1989,3,female,932,229,108,143,160,105,61,38,99
1579668,25,12,1988,9,female,485,230,149,139,86,138,53,1,33
1865484,39,12,1974,10,male,916,228,195,139,6,139,5,0,1
1302123,18,4,1995,8,female,661,226,187,143,33,143,27,0,6
1438140,36,8,1977,11,male,609,225,186,145,166,37,58,108,108
1670624,26,5,1987,5,female,367,225,143,146,354,99,188,47,166
1059580,40,19,1973,11,male,309,223,42,148,90,148,65,0,25
2006273,23,24,1990,10,female,821,229,129,144,156,144,129,0,27
1782367,17,8,1996,5,male,109,229,143,149,331,149,312,0,19
2187242,55,5,1958,10,male,515,222,59,151,236,12,86,139,150
1048129,16,26,1997,3,male,286,225,123,151,2,150,2,1,0
1131364,19,19,1994,6,male,211,230,116,153,46,153,44,0,2
1557399,18,2,1995,4,female,387,226,213,155,226,155,126,0,100
1023992,63,31,1950,3,female,2368,228,70,154,147,154,84,0,63
1196254,14,7,1999,8,female,157,223,141,154,246,154,74,0,172
1341658,108,1,1905,1,male,1693,228,138,161,133,3,74,158,59
1350355,86,23,1927,1,male,1033,226,140,163,9,93,7,70,2
1273078,16,29,1997,10,male,558,225,49,158,414,48,249,110,165
1080776,19,24,1994,2,male,171,225,145,158,575,110,385,48,190
1514608,19,15,1994,6,male,349,224,198,164,85,149,52,15,33
1857409,58,1,1955,12,male,196,225,166,164,47,164,30,0,17
1090624,103,31,1910,10,male,1255,225,108,169,40,0,25,169,15
1312132,17,2,1996,3,male,454,226,149,168,89,57,45,111,44
1012994,19,22,1994,4,male,276,229,157,167,83,167,30,0,53
1200649,63,14,1950,3,male,880,229,133,167,84,167,82,0,2
1365779,108,1,1905,1,male,1576,227,181,172,68,172,48,0,20
1905922,19,21,1994,7,female,616,225,25,165,192,165,178,0,14
2128473,25,3,1988,10,female,787,225,34,165,430,165,325,0,105
1346720,46,31,1967,8,female,2342,224,86,178,210,34,155,144,55
1337579,107,23,1906,2,male,2027,227,154,187,82,21,13,166,69
1363386,40,13,1973,1,female,415,227,112,184,207,5,44,179,163
2180617,20,3,1993,2,female,190,230,127,188,62,99,30,89,32
1578226,22,16,1991,10,female,205,223,92,184,166,103,58,81,108
1951024,22,24,1991,9,male,496,225,122,190,23,166,10,24,13
1154956,36,1,1977,7,female,750,229,155,184,315,144,207,40,108
1913549,18,3,1995,5,female,207,224,164,186,48,186,43,0,5
1882969,18,26,1995,6,male,756,229,88,198,275,127,253,71,22
1122974,27,30,1986,3,male,488,229,191,193,421,81,99,112,322
2015351,33,12,1980,3,female,235,222,63,196,110,185,64,11,46
1182364,104,19,1909,9,female,466,230,61,191,84,186,60,5,24
2175149,113,17,1900,8,female,1573,227,118,193,76,187,47,6,29
1995173,31,18,1982,4,female,501,228,76,193,358,182,94,11,264
1840539,18,18,1995,7,female,44,227,115,191,215,191,101,0,114
1810020,31,22,1982,12,male,670,229,179,197,181,197,144,0,37
1691361,34,16,1979,1,male,387,228,171,193,281,193,241,0,40
1956677,51,3,1962,9,female,1122,230,100,210,373,189,235,21,138
2157223,33,30,1980,5,female,1519,224,63,205,32,205,25,0,7
1223809,19,23,1994,8,male,328,227,169,203,82,203,27,0,55
1560600,58,19,1955,6,female,122,229,40,208,102,208,74,0,28
1813973,60,15,1953,9,female,1265,225,134,206,148,206,73,0,75
1322944,17,12,1996,7,male,280,228,176,215,33,7,1,208,32
1810090,49,23,1964,9,male,766,223,115,212,151,0,54,212,97
2021494,14,16,1999,11,female,512,224,180,218,6,155,2,63,4
1176971,24,16,1989,7,female,360,230,194,220,100,68,71,152,29
1920019,57,23,1956,4,female,1170,229,70,217,138,65,95,152,43
1514284,14,11,1999,6,female,383,226,133,219,0,200,0,19,0
1243160,55,30,1958,12,male,1798,225,147,217,55,211,8,6,47
1768914,44,27,1969,8,male,213,224,214,218,5,218,5,0,0
1932410,19,16,1994,10,female,991,227,165,216,199,216,195,0,4
1379769,29,23,1984,11,female,409,225,199,220,139,220,94,0,45
1826911,33,2,1980,2,male,563,222,143,220,218,220,176,0,42
1071079,65,22,1948,11,female,580,227,135,222,127,0,38,222,89
2044783,17,1,1996,1,male,133,229,210,226,38,192,35,34,3
1360662,19,1,1994,1,male,684,230,107,230,109,229,95,1,14
1428620,25,5,1988,2,male,364,225,154,232,33,232,28,0,5
1377477,100,31,1913,12,female,1604,230,174,233,64,233,45,0,19
1379976,77,25,1936,5,female,1750,222,87,240,204,18,58,222,146
1208558,53,25,1960,5,female,1005,222,105,238,91,73,31,165,60
1168362,38,10,1975,6,female,711,227,113,244,266,168,193,76,73
1107333,29,13,1984,10,female,1315,222,95,244,40,234,16,10,24
1796793,22,28,1991,10,male,502,227,144,245,306,225,83,20,223
1230204,23,21,1990,12,male,456,222,199,236,12,236,12,0,0
1318356,30,8,1983,10,male,932,222,127,239,178,239,167,0,11
1211474,27,30,1986,8,female,1785,225,153,248,81,187,40,61,41
1164633,18,2,1995,8,female,246,224,163,256,209,226,114,30,95
2156611,38,14,1975,3,female,1340,222,105,247,446,221,194,26,252
1732813,50,27,1963,1,female,1893,225,124,247,49,245,35,2,14
1687614,18,20,1995,8,female,737,224,133,276,44,3,2,273,42
1021235,31,7,1982,5,male,248,226,198,264,2,1,1,263,1
1302823,18,25,1995,11,male,63,224,217,270,95,0,35,270,60
1306377,108,27,1905,5,female,1367,222,159,270,62,5,43,265,19
1538669,18,14,1995,12,female,1167,229,101,266,458,2,64,264,394
1442095,39,17,1974,5,female,1345,225,129,276,343,142,171,134,172
1010897,32,1,1981,11,female,1357,225,107,267,492,142,264,125,228
1900864,29,14,1984,8,female,194,229,152,276,264,200,73,76,191
1094949,38,15,1975,8,female,542,227,191,261,219,244,107,17,112
1040581,100,5,1913,3,male,1809,224,111,270,171,270,127,0,44
2167733,83,1,1930,3,male,1303,230,68,285,72,0,21,285,51
1899919,48,4,1965,4,male,49,227,78,280,1039,24,394,256,645
1452161,38,22,1975,10,male,2202,226,129,289,1420,94,973,195,447
2083182,21,12,1992,10,female,206,227,58,289,181,277,69,12,112
1144533,22,2,1991,1,female,551,228,101,278,312,265,184,13,128
1357899,17,1,1996,1,male,182,228,200,283,43,283,43,0,0
1689462,22,27,1991,11,female,147,230,206,285,366,285,283,0,83
1921793,45,7,1968,4,male,1487,227,59,278,224,278,210,0,14
2001867,53,5,1960,5,female,408,222,102,304,79,20,37,284,42
1565549,93,19,1920,10,female,1394,224,70,308,324,61,103,247,221
1300655,23,4,1990,3,female,558,225,138,301,2036,216,1020,85,1016
1274347,55,4,1958,4,female,1262,223,89,299,262,296,65,3,197
1416186,17,4,1996,7,female,154,222,213,301,221,301,217,0,4
1939853,58,11,1955,3,female,1453,229,183,311,276,44,171,267,105
2024430,103,12,1910,11,male,978,223,86,319,241,53,70,266,171
1582479,19,1,1994,1,male,508,229,169,319,73,147,52,172,21
1728967,18,14,1995,2,male,427,225,117,317,56,278,34,39,22
2166481,72,28,1941,5,female,1573,227,130,316,57,269,35,47,22
1845813,21,17,1992,6,male,217,222,180,312,44,312,36,0,8
2008909,23,13,1990,10,male,186,224,181,315,24,315,10,0,14
2019710,26,26,1987,1,male,175,225,209,335,157,0,147,335,10
1528053,48,12,1965,12,male,1240,225,144,329,996,47,745,282,251
1649724,108,1,1905,1,male,1327,222,138,344,118,99,58,245,60
1586238,28,16,1985,8,male,721,228,98,345,111,331,76,14,35
1667490,22,18,1991,6,male,227,230,156,334,226,264,141,70,85
1861530,26,28,1987,4,male,795,228,167,346,629,264,374,82,255
1852151,108,8,1905,1,female,1064,229,156,332,42,332,23,0,19
2166918,51,22,1962,7,female,1322,226,133,345,380,345,256,0,124
1801057,24,1,1989,2,female,531,226,184,359,418,2,173,357,245
2139824,45,5,1968,7,female,306,223,109,351,217,32,103,319,114
1703815,42,29,1971,9,female,209,224,157,350,109,233,70,117,39
1393108,18,18,1995,7,female,91,229,89,367,377,156,141,211,236
1211146,23,8,1990,7,female,267,230,119,347,479,236,69,111,410
1539916,18,9,1995,8,female,251,223,156,367,474,308,181,59,293
1509295,50,22,1963,2,male,155,222,156,366,169,366,95,0,74
1173243,43,27,1970,3,female,402,222,73,355,220,355,174,0,46
1204503,55,9,1958,11,female,581,223,156,374,72,0,14,374,58
2010546,62,29,1951,10,male,932,223,106,372,538,39,296,333,242
1131468,23,9,1990,6,female,17,229,193,376,389,200,338,176,51
1115666,27,19,1986,3,female,430,227,76,377,273,94,150,283,123
1764425,19,27,1994,4,male,176,223,170,376,228,370,215,6,13
1986691,54,20,1959,7,female,1818,225,145,375,75,305,67,70,8
1525275,16,9,1997,1,male,289,222,188,373,6,373,6,0,0
1346983,15,5,1998,5,male,170,223,199,375,113,375,86,0,27
1653548,25,1,1988,8,female,370,228,153,374,149,374,78,0,71
1201580,32,12,1981,7,male,514,227,128,371,178,371,147,0,31
1402078,62,3,1951,10,female,91,229,195,388,410,388,299,0,111
2048657,21,18,1992,6,female,531,229,146,396,113,18,66,378,47
1142316,46,8,1967,6,male,1303,228,171,402,82,21,38,381,44
1349718,66,10,1947,1,female,2180,222,19,410,202,257,110,153,92
1522510,32,27,1981,6,female,449,228,168,418,66,406,22,12,44
1645066,36,15,1977,5,female,1082,224,129,403,122,372,70,31,52
2015870,52,28,1961,6,female,1510,229,177,407,245,299,113,108,132
1994981,102,2,1911,5,male,1926,230,147,415,620,397,287,18,333
1212730,36,29,1977,1,female,1268,228,178,410,254,409,179,1,75
1136291,21,9,1992,10,male,168,224,196,399,45,399,37,0,8
1266166,18,9,1995,12,male,892,230,127,422,34,31,3,391,31
1838056,36,19,1977,4,female,677,223,184,444,802,332,449,112,353
1787404,19,10,1994,8,male,493,227,136,439,22,439,18,0,4
2161058,25,21,1988,1,female,288,222,105,447,77,447,77,0,0
2172793,39,20,1974,2,male,404,223,136,424,443,424,340,0,103
1938940,49,7,1964,6,male,334,229,189,452,531,0,117,452,414
1989774,58,26,1955,6,female,96,225,203,458,578,22,97,436,481
1427216,23,13,1990,11,male,458,223,133,474,70,228,23,246,47
1569420,58,9,1955,8,male,714,228,194,461,83,451,40,10,43
1397403,19,7,1994,2,female,630,226,168,478,430,429,176,49,254
1397911,16,29,1997,3,male,326,223,156,453,306,449,104,4,202
1162221,61,19,1952,1,female,283,230,31,463,520,461,171,2,349
1296150,65,13,1948,4,male,1116,229,122,474,94,474,70,0,24
1439570,108,1,1905,9,female,1630,230,91,471,267,471,251,0,16
2143302,55,9,1958,8,female,1295,227,118,507,266,45,128,462,138
2078322,18,3,1995,12,female,271,222,55,505,491,14,253,491,238
1621887,25,30,1988,7,female,465,222,115,516,567,36,144,480,423
1587864,20,17,1993,8,female,1479,227,129,518,545,105,109,413,436
1917016,18,25,1995,6,male,594,230,133,484,64,410,30,74,34
1549755,21,28,1992,1,female,359,222,96,497,602,365,307,132,295
1067916,57,27,1956,12,female,1405,223,150,512,440,508,363,4,77
1955366,45,13,1968,7,male,763,228,1,519,154,519,104,0,50
1471993,18,28,1995,4,male,329,224,147,505,472,505,252,0,220
2027503,29,18,1984,4,female,1182,225,142,497,583,497,477,0,106
1659528,42,24,1971,12,female,400,222,114,487,574,487,126,0,448
1871768,20,3,1993,4,male,197,225,77,521,48,269,25,252,23
2043962,19,2,1994,5,female,697,226,179,551,226,236,127,315,99
1513933,13,16,2000,4,male,189,228,166,545,58,542,21,3,37
1760961,31,28,1982,10,female,1950,224,141,552,301,548,289,4,12
1391484,18,23,1995,12,female,214,224,175,561,4,561,4,0,0
1045835,58,12,1955,7,female,334,227,166,579,462,0,31,579,431
1149518,26,23,1987,10,female,107,229,181,603,381,164,195,439,186
1938635,64,1,1949,10,female,1863,223,143,572,363,159,198,413,165
2159644,62,18,1951,1,female,1321,223,117,569,140,557,94,12,46
1002862,55,5,1958,1,female,1156,225,143,605,754,601,443,4,311
1842468,50,14,1963,3,female,2020,226,146,575,367,575,237,0,130
1780190,65,21,1948,1,female,1484,222,118,616,215,205,109,411,106
2014629,25,1,1988,7,female,290,225,87,650,470,353,192,297,278
2181339,63,17,1950,12,female,2000,222,125,633,289,625,191,8,98
2067718,93,14,1920,10,male,724,230,163,650,317,569,225,81,92
1840935,19,28,1994,8,female,254,227,178,662,427,655,386,7,41
2108686,39,23,1974,10,female,197,227,65,646,599,545,404,101,195
1796682,17,25,1996,3,female,347,224,175,655,47,649,17,6,30
1967715,35,18,1978,1,male,591,230,160,662,522,662,395,0,127
1484072,19,4,1994,2,female,25,225,117,676,707,73,226,603,481
1876826,57,16,1956,5,female,748,227,118,683,719,0,195,683,524
1438951,42,19,1971,12,male,180,224,195,723,165,687,141,36,24
1584183,41,22,1972,2,female,501,224,190,710,679,536,276,174,403
1376944,54,19,1959,9,female,1504,227,59,674,83,671,32,3,51
1961090,50,21,1963,9,female,335,230,116,681,598,679,395,2,203
1347560,74,31,1939,5,female,1768,228,91,707,114,707,71,0,43
1019055,64,26,1949,8,female,1574,225,130,665,129,665,102,0,27
1477093,78,4,1935,6,female,58,230,65,699,141,699,61,0,80
1805323,32,12,1981,3,female,292,225,201,738,88,156,29,582,59
1251569,17,20,1996,9,male,158,227,196,747,181,270,108,477,73
1285938,41,26,1972,8,female,1261,230,121,751,425,220,235,531,190
1090349,54,31,1959,5,female,2206,229,102,753,642,283,384,470,258
2193005,22,1,1991,12,female,277,224,140,735,581,540,392,195,189
2133016,33,6,1980,4,female,884,227,159,739,651,702,434,37,217
2112518,17,3,1996,7,female,410,225,73,785,232,783,120,2,112
2101795,28,9,1985,10,female,427,224,158,787,636,782,567,5,69
1878216,29,11,1984,2,female,723,226,199,789,436,789,416,0,20
2135789,28,1,1985,6,female,261,230,68,783,665,783,589,0,76
1541577,108,12,1905,10,female,1296,226,93,865,326,464,144,401,182
1609282,18,3,1995,10,female,825,227,93,844,1091,775,592,69,499
2097760,59,8,1954,4,female,1057,224,122,858,299,855,174,3,125
1018377,30,14,1983,12,female,534,229,147,868,453,868,422,0,31
1453455,14,3,1999,12,female,318,224,136,816,500,816,372,0,128
1051643,53,25,1960,9,female,1491,230,75,981,838,88,364,893,474
1879132,98,15,1915,12,female,57,222,206,945,810,166,166,779,644
1693482,16,17,1997,11,female,196,227,120,944,452,641,369,303,83
1017521,19,13,1994,12,female,151,226,114,978,2049,942,1814,36,235
1888665,28,1,1985,3,female,608,222,76,894,663,894,578,0,85
2084758,31,19,1982,10,male,1991,225,131,1018,1594,385,817,633,777
1062569,17,1,1996,6,female,377,224,95,1082,370,1000,162,82,208
1885553,24,15,1989,4,male,355,222,177,1158,553,31,124,1127,429
1001260,86,19,1927,1,male,1252,222,116,1165,288,54,90,1111,198
1844258,103,30,1910,7,female,1153,230,92,1151,713,130,166,1021,547
1247009,24,4,1989,7,female,151,225,166,1204,2225,0,141,1204,2084
2175931,16,8,1997,9,female,155,222,107,1206,425,837,297,369,128
1906085,47,4,1966,5,female,1811,228,106,1236,568,370,221,866,347
1143292,32,19,1981,10,female,445,228,148,1223,370,965,225,258,145
1160979,47,9,1966,7,male,372,222,169,1250,112,1250,95,0,17
1193506,16,9,1997,6,male,134,225,182,1420,200,8,105,1412,95
1517995,53,8,1960,2,female,2025,229,107,1355,653,171,191,1184,462
1319152,17,13,1996,1,female,35,224,193,1506,1003,282,135,1224,868
1686052,58,2,1955,3,female,991,228,85,1480,994,3,201,1477,793
1263230,59,6,1954,5,male,1706,227,173,1349,693,677,351,672,342
1875167,19,15,1994,2,female,690,225,133,1289,66,1279,62,10,4
2173444,25,30,1988,8,female,65,225,60,1293,826,1288,638,5,188
1164578,81,10,1932,5,male,554,224,180,1331,218,1331,178,0,40
1123191,68,3,1945,5,female,1365,223,83,1807,461,0,237,1807,224
2028369,29,16,1984,12,female,712,224,67,1556,337,890,239,666,98
1624306,53,28,1960,9,female,646,224,188,1579,482,495,261,1084,221
1147563,108,1,1905,4,female,1761,228,140,1579,430,1579,248,0,182
2004939,20,19,1993,5,female,181,230,113,1731,2147,1731,2032,0,115
1375110,19,24,1994,12,female,287,226,123,2170,811,118,325,2052,486
1557201,23,22,1990,6,female,211,226,155,2242,338,1306,164,936,174
1629111,20,8,1993,9,female,571,227,126,1888,1078,624,359,1264,719
2058595,51,4,1962,9,female,1725,225,149,2135,1121,635,852,1500,269
1441676,20,5,1993,8,female,253,230,73,2078,178166,1982,138561,96,39605
1168954,22,11,1991,11,female,187,224,38,1917,781,1917,721,0,60
1199480,43,30,1970,8,female,308,223,126,2152,969,2152,396,0,573
1404486,64,14,1949,3,female,238,224,160,1993,802,1993,793,0,9
1299693,66,2,1947,2,female,304,222,213,3268,174,0,52,3268,122
2036489,73,24,1940,5,female,1079,224,150,2390,30,1,3,2389,27
1116597,62,12,1951,2,female,1006,228,149,2790,1584,0,176,2790,1408
1867838,41,23,1972,9,female,195,224,170,2400,1057,1254,519,1146,538
1891996,19,28,1994,4,female,268,227,166,2958,1311,2259,818,699,493
1112447,21,26,1992,4,female,158,230,42,2582,1085,2582,779,0,306
1204088,28,11,1985,11,female,601,225,54,2462,736,2462,636,0,100
1544470,35,16,1978,11,female,84,229,159,2960,1177,2960,1127,0,50
2164343,43,8,1970,7,female,1003,227,129,2649,2369,2649,1317,0,1052
1192430,62,16,1951,6,female,368,224,30,4671,4986,0,392,4671,4594
1184396,53,25,1960,9,female,373,225,53,7791,649,7578,462,213,187
2092316,22,25,1991,1,female,253,225,166,3731,1842,3435,1652,296,190
1735550,49,26,1964,9,female,795,224,50,5235,996,5176,769,59,227
1312813,14,15,1999,11,female,247,236,161,0,0,0,0,0,0
1598556,14,16,1999,1,male,262,232,67,0,0,0,0,0,0
1261781,14,19,1999,1,male,153,236,183,0,1,0,1,0,0
1699284,14,16,1999,5,male,401,235,159,0,7,0,7,0,0
2007728,16,8,1997,12,male,494,239,167,0,0,0,0,0,0
1130439,15,27,1998,2,male,258,238,149,0,0,0,0,0,0
2163142,15,2,1998,4,male,963,238,191,0,156,0,73,0,83
1950301,15,18,1998,5,male,582,233,91,0,0,0,0,0,0
1404909,15,28,1998,5,male,426,232,62,0,20,0,14,0,6
1962622,15,10,1998,5,male,350,235,189,0,1,0,0,0,1
1172299,15,13,1998,6,male,508,233,176,0,15,0,5,0,10
1408296,16,13,1997,3,male,741,235,171,0,3,0,3,0,0
1212641,16,11,1997,5,male,428,233,202,0,64,0,57,0,7
1698996,17,25,1996,4,female,592,233,60,0,27,0,17,0,10
2130968,17,22,1996,4,male,498,236,201,0,0,0,0,0,0
1028644,17,5,1996,7,male,758,239,149,0,0,0,0,0,0
1037255,17,21,1996,8,female,597,236,91,0,0,0,0,0,0
1137331,17,14,1996,8,male,193,237,152,0,0,0,0,0,0
1393886,19,27,1994,12,male,442,239,150,0,0,0,0,0,0
1062240,19,5,1994,12,male,385,240,203,0,6,0,5,0,1
2070399,18,14,1995,1,male,710,232,127,0,0,0,0,0,0
1217836,18,23,1995,1,male,208,233,178,0,0,0,0,0,0
2114486,18,1,1995,3,male,299,240,217,0,0,0,0,0,0
1445950,18,1,1995,4,female,503,240,220,0,0,0,0,0,0
1051669,18,21,1995,6,male,967,231,88,0,0,0,0,0,0
1116306,18,11,1995,6,male,369,235,201,0,2,0,0,0,2
2020552,18,22,1995,10,female,370,238,133,0,7,0,5,0,2
2075596,20,30,1993,11,male,445,237,149,0,0,0,0,0,0
2130279,20,12,1993,12,male,609,240,183,0,0,0,0,0,0
1225653,20,10,1993,12,female,531,234,30,0,22,0,11,0,11
1626648,20,28,1993,12,female,345,238,95,0,2,0,2,0,0
1865982,19,10,1994,1,male,425,237,196,0,0,0,0,0,0
1869459,19,30,1994,6,male,131,231,208,0,3,0,3,0,0
1490882,19,15,1994,8,male,439,240,122,0,0,0,0,0,0
2014526,19,2,1994,8,male,436,240,153,0,0,0,0,0,0
1665052,21,5,1992,12,male,576,240,39,0,9,0,2,0,7
1623848,20,14,1993,2,male,244,238,104,0,1,0,1,0,0
1699403,20,16,1993,6,male,565,239,188,0,0,0,0,0,0
1613821,20,8,1993,8,male,420,231,180,0,2,0,1,0,1
1435018,20,10,1993,9,female,670,231,158,0,1,0,0,0,1
1350174,20,23,1993,9,male,637,231,183,0,0,0,0,0,0
1172587,20,1,1993,9,male,234,234,98,0,1,0,1,0,0
1164993,21,12,1992,1,female,624,235,160,0,65,0,44,0,21
1800573,21,24,1992,3,male,463,236,183,0,0,0,0,0,0
1781219,21,17,1992,7,male,1475,240,120,0,2,0,2,0,0
1614927,21,4,1992,7,female,483,236,119,0,25,0,12,0,13
1715904,21,16,1992,8,female,505,238,110,0,0,0,0,0,0
2116118,21,11,1992,10,female,870,233,65,0,1,0,1,0,0
1525398,21,9,1992,10,male,643,238,165,0,0,0,0,0,0
2089432,21,21,1992,10,male,585,238,177,0,0,0,0,0,0
1539700,21,10,1992,10,male,532,240,185,0,0,0,0,0,0
2102372,23,27,1990,11,male,801,236,147,0,1,0,1,0,0
1382559,22,15,1991,2,male,739,236,166,0,0,0,0,0,0
1904763,22,3,1991,2,male,398,239,213,0,7,0,3,0,4
1506768,22,28,1991,2,male,346,231,187,0,0,0,0,0,0
2130784,22,8,1991,2,male,289,238,18,0,3,0,3,0,0
2054178,22,26,1991,4,male,344,238,201,0,1,0,0,0,1
1820945,22,27,1991,4,male,321,232,67,0,1,0,1,0,0
1065889,22,15,1991,7,male,498,231,135,0,0,0,0,0,0
1686120,22,8,1991,7,male,333,238,84,0,0,0,0,0,0
1012220,24,18,1989,11,male,346,233,210,0,0,0,0,0,0
1269411,23,17,1990,3,male,545,231,108,0,0,0,0,0,0
1909684,23,23,1990,3,male,347,234,224,0,2,0,2,0,0
2008248,23,22,1990,6,male,498,235,143,0,0,0,0,0,0
1365777,23,7,1990,7,male,385,233,186,0,5,0,4,0,1
1677619,23,14,1990,8,male,749,237,193,0,0,0,0,0,0
1307858,23,10,1990,10,male,1068,235,136,0,1,0,0,0,1
1656920,25,20,1988,12,male,705,231,124,0,1,0,1,0,0
1756214,24,21,1989,1,male,448,231,176,0,2,0,2,0,0
2008109,24,3,1989,4,male,99,240,233,0,2,0,2,0,0
1948707,24,29,1989,7,male,397,240,221,0,1,0,0,0,1
1183038,24,9,1989,8,male,811,231,204,0,0,0,0,0,0
1142324,24,25,1989,9,female,354,231,100,0,0,0,0,0,0
1093306,24,6,1989,10,female,1331,240,92,0,3,0,1,0,2
2091974,26,31,1987,12,female,422,231,21,0,0,0,0,0,0
1851519,25,5,1988,1,female,327,240,69,0,0,0,0,0,0
1754699,25,20,1988,1,female,279,234,181,0,0,0,0,0,0
1327744,25,2,1988,7,male,589,231,186,0,1,0,1,0,0
1469344,25,3,1988,7,male,518,234,198,0,0,0,0,0,0
1808237,25,26,1988,7,female,437,240,196,0,0,0,0,0,0
1319667,25,12,1988,9,male,144,238,206,0,0,0,0,0,0
1230603,25,1,1988,11,male,1677,233,58,0,7,0,2,0,5
1547998,26,11,1987,3,male,821,239,196,0,34,0,13,0,21
1580750,26,13,1987,4,male,642,239,191,0,0,0,0,0,0
2121090,26,21,1987,5,male,462,240,162,0,1,0,1,0,0
1578037,27,22,1986,10,male,759,231,163,0,0,0,0,0,0
2114743,28,5,1985,6,male,681,237,164,0,6,0,4,0,2
1431402,28,20,1985,6,male,341,232,198,0,1,0,1,0,0
1678715,30,28,1983,4,male,1046,239,186,0,1,0,1,0,0
1012890,33,26,1980,8,female,243,238,199,0,0,0,0,0,0
1023718,34,1,1979,1,male,1630,231,82,0,4,0,4,0,0
1016262,34,27,1979,5,male,623,232,146,0,0,0,0,0,0
1800926,36,4,1977,5,male,203,238,182,0,1,0,1,0,0
1382461,37,14,1976,2,female,671,240,104,0,4,0,2,0,2
1880498,37,14,1976,4,male,690,234,161,0,1,0,1,0,0
1832981,37,18,1976,7,male,923,238,133,0,0,0,0,0,0
1137218,37,13,1976,9,male,955,234,126,0,0,0,0,0,0
1758100,41,25,1972,5,male,1216,232,70,0,2,0,0,0,2
1302139,45,30,1968,7,female,486,240,47,0,2,0,2,0,0
1503296,48,30,1965,1,male,807,238,139,0,2,0,0,0,2
2103944,48,15,1965,3,female,232,233,74,0,4,0,3,0,1
1955818,49,7,1964,1,male,159,237,222,0,7,0,4,0,3
2062647,53,3,1960,3,male,312,233,210,0,1,0,1,0,0
1039722,53,17,1960,6,female,462,231,48,0,1,0,1,0,0
1516676,56,29,1957,5,male,390,238,54,0,0,0,0,0,0
1875954,56,8,1957,8,male,563,235,138,0,0,0,0,0,0
2129072,59,30,1954,8,male,1576,240,81,0,0,0,0,0,0
1799832,60,13,1953,3,male,744,236,113,0,2,0,2,0,0
1106070,68,4,1945,12,male,37,237,229,0,13,0,10,0,3
1103708,75,7,1938,7,male,718,231,46,0,1,0,0,0,1
1118199,81,11,1932,9,female,238,233,97,0,0,0,0,0,0
1686481,83,9,1930,7,female,901,233,142,0,0,0,0,0,0
1494401,90,2,1923,3,male,1640,238,112,0,4,0,4,0,0
1291939,99,26,1914,11,female,528,238,183,0,0,0,0,0,0
1596521,100,12,1913,9,male,236,238,139,0,0,0,0,0,0
1280073,103,8,1910,1,male,440,234,130,0,0,0,0,0,0
1724083,103,19,1910,5,male,1181,236,145,0,24,0,11,0,13
1030948,105,22,1908,4,male,199,231,21,0,0,0,0,0,0
1957398,108,28,1905,11,male,493,233,145,0,5,0,2,0,3
1804248,108,25,1905,12,female,884,233,69,0,0,0,0,0,0
1220652,113,17,1900,9,male,1884,239,130,0,8,0,7,0,1
1553982,16,5,1997,7,male,329,231,179,1,0,0,0,1,0
1128777,21,5,1992,9,male,509,237,224,1,0,0,0,1,0
1602493,29,2,1984,11,male,277,240,136,1,0,0,0,1,0
1066223,58,10,1955,11,male,1714,234,40,1,0,0,0,1,0
1128625,19,10,1994,3,male,328,232,158,1,235,0,47,1,188
1595385,20,13,1993,6,male,436,235,135,1,2,0,0,1,2
1180845,23,19,1990,10,male,292,237,116,1,18,0,12,1,6
2120396,60,16,1953,10,female,554,231,136,1,2,0,1,1,1
1767157,16,1,1997,7,male,698,232,116,1,0,1,0,0,0
1590733,18,3,1995,1,male,718,231,143,1,0,1,0,0,0
1359569,18,9,1995,8,female,575,237,114,1,0,1,0,0,0
1175400,19,10,1994,8,male,244,236,212,1,0,1,0,0,0
2060930,24,1,1989,7,male,336,237,184,1,0,1,0,0,0
1590707,33,4,1980,2,male,568,240,182,1,0,1,0,0,0
1582391,103,26,1910,1,male,1460,237,83,1,0,1,0,0,0
1826041,103,23,1910,4,male,1647,231,99,1,0,1,0,0,0
2011942,103,5,1910,5,male,567,231,175,1,0,1,0,0,0
1831950,103,21,1910,10,male,550,238,108,1,0,1,0,0,0
1119005,18,13,1995,6,male,160,238,41,1,1,1,1,0,0
1890290,19,22,1994,6,male,397,233,179,1,1,1,1,0,0
1065444,19,24,1994,7,female,502,239,60,1,1,1,0,0,1
2034022,19,10,1994,8,female,369,233,13,1,1,1,1,0,0
1361340,21,28,1992,8,male,441,236,185,1,1,1,1,0,0
1405873,23,16,1990,3,male,394,234,47,1,1,1,1,0,0
1109804,24,25,1989,9,male,122,237,219,1,1,1,1,0,0
1722191,15,30,1998,11,male,420,231,162,1,6,1,6,0,0
1150667,14,23,1999,9,female,138,231,92,1,14,1,14,0,0
1844169,14,1,1999,10,male,364,239,231,1,12,1,4,0,8
1788624,17,3,1996,4,male,493,231,69,1,4,1,4,0,0
1507441,17,17,1996,8,male,408,234,197,1,13,1,10,0,3
2019585,19,21,1994,11,male,658,232,142,1,2,1,1,0,1
1527929,18,22,1995,1,female,155,232,50,1,10,1,6,0,4
1544360,18,1,1995,1,male,328,238,150,1,2,1,1,0,1
1598116,18,12,1995,2,male,579,239,40,1,13,1,13,0,0
1580500,19,16,1994,7,female,232,232,180,1,4,1,3,0,1
1040481,19,4,1994,9,male,683,237,134,1,3,1,0,0,3
1249831,20,1,1993,1,male,312,240,102,1,15,1,12,0,3
1673592,20,22,1993,2,female,188,233,131,1,15,1,9,0,6
1637290,20,1,1993,8,female,225,234,19,1,13,1,2,0,11
1002428,20,15,1993,9,male,206,231,138,1,4,1,4,0,0
1201238,21,23,1992,3,female,127,232,24,1,2,1,0,0,2
1311484,24,2,1989,12,female,959,232,116,1,13,1,6,0,7
1951217,23,25,1990,3,male,872,238,133,1,14,1,13,0,1
1827532,25,25,1988,8,male,425,240,231,1,15,1,14,0,1
1459283,31,31,1982,12,male,486,235,199,1,21,1,8,0,13
2050382,30,13,1983,1,male,481,237,168,1,4,1,3,0,1
1515154,33,7,1980,1,male,446,233,178,1,8,1,8,0,0
1352111,54,8,1959,2,female,379,236,174,1,4,1,4,0,0
1578579,73,22,1940,7,male,1406,236,99,1,3,1,3,0,0
1118573,22,13,1991,12,male,747,238,151,2,0,0,0,2,0
1241269,19,28,1994,9,male,643,231,213,2,2,0,0,2,2
2193135,24,24,1989,10,male,744,236,208,2,2,0,1,2,1
2097662,18,1,1995,9,male,413,235,142,2,36,0,4,2,32
1925554,19,18,1994,8,female,326,238,205,2,18,0,0,2,18
1573347,77,1,1936,5,female,100,237,91,2,32,0,15,2,17
1635503,15,12,1998,9,female,216,236,106,2,37,1,13,1,24
1781883,17,7,1996,11,female,530,237,37,2,0,2,0,0,0
1300944,17,10,1996,1,male,218,233,129,2,0,2,0,0,0
1713171,14,30,1999,9,female,181,237,108,2,1,2,0,0,1
1709641,27,29,1986,9,male,466,240,200,2,1,2,0,0,1
1262193,108,25,1905,3,male,1149,232,129,2,1,2,1,0,0
1511678,18,28,1995,6,male,979,240,135,2,2,2,2,0,0
1617768,21,18,1992,6,male,1120,238,183,2,2,2,1,0,1
2032587,51,1,1962,1,male,752,233,181,2,2,2,1,0,1
1990884,18,29,1995,12,female,508,237,169,2,5,2,2,0,3
2011504,18,8,1995,3,male,369,238,50,2,8,2,5,0,3
1463392,18,4,1995,6,female,282,234,37,2,7,2,5,0,2
1035532,18,2,1995,7,female,467,236,180,2,15,2,15,0,0
1683543,21,27,1992,12,male,410,235,106,2,3,2,3,0,0
1724709,20,20,1993,1,male,810,240,137,2,49,2,39,0,10
1963612,22,24,1991,10,male,660,235,134,2,10,2,3,0,7
1092421,29,4,1984,12,male,454,237,99,2,141,2,44,0,97
1375966,40,21,1973,6,male,239,238,95,2,7,2,5,0,2
1406832,53,10,1960,1,female,366,231,148,2,4,2,3,0,1
2063167,106,21,1907,2,female,1301,240,61,2,5,2,4,0,1
1364936,16,3,1997,8,male,562,237,154,3,0,0,0,3,0
1869555,101,31,1912,3,male,2165,234,29,3,0,0,0,3,0
1895067,15,17,1998,3,male,701,239,200,3,1,0,0,3,1
1891907,24,10,1989,2,male,1469,232,125,3,1,0,0,3,1
1552507,24,1,1989,6,male,718,234,118,3,1,0,0,3,1
1750181,66,26,1947,6,male,1230,236,36,3,1,0,1,3,0
1003400,23,15,1990,10,male,455,232,201,3,3,0,1,3,2
1805480,22,31,1991,8,male,402,234,56,3,68,0,20,3,48
1209499,23,5,1990,4,male,378,239,191,3,6,0,3,3,3
1391056,48,30,1965,1,female,451,239,78,3,6,0,2,3,4
1099038,52,31,1961,12,male,1443,234,125,3,7,0,3,3,4
1256056,30,6,1983,11,male,569,238,184,3,8,2,4,1,4
1748739,16,24,1997,2,male,812,239,120,3,0,3,0,0,0
1594727,22,22,1991,7,female,575,232,137,3,0,3,0,0,0
1880547,23,14,1990,7,male,378,239,225,3,0,3,0,0,0
1481481,26,2,1987,3,male,667,237,32,3,0,3,0,0,0
2091963,28,7,1985,4,male,539,232,130,3,0,3,0,0,0
2050971,23,8,1990,4,male,497,238,116,3,1,3,1,0,0
1634195,22,2,1991,1,male,489,233,173,3,4,3,3,0,1
1951070,30,22,1983,3,male,301,233,155,3,3,3,3,0,0
1947281,16,20,1997,2,male,1206,234,110,3,20,3,13,0,7
1643730,16,25,1997,8,male,741,235,93,3,30,3,4,0,26
1649310,18,2,1995,1,male,217,232,207,3,24,3,22,0,2
1768844,18,23,1995,3,male,298,231,172,3,9,3,9,0,0
1433561,21,7,1992,10,male,445,239,123,3,12,3,9,0,3
1533604,22,12,1991,5,female,290,237,24,3,5,3,5,0,0
1369030,23,21,1990,5,male,554,232,188,3,9,3,8,0,1
1924742,27,10,1986,1,male,541,234,143,3,10,3,10,0,0
1550916,27,1,1986,10,male,367,239,179,3,8,3,7,0,1
1063548,21,13,1992,9,male,320,236,145,4,0,0,0,4,0
1206406,21,25,1992,1,male,631,236,127,4,1,0,1,4,0
1278202,108,30,1905,1,male,1342,236,153,4,3,0,0,4,3
2118905,23,7,1990,10,male,972,240,143,4,10,0,8,4,2
1976389,56,11,1957,3,female,458,233,85,4,6,0,0,4,6
1485841,69,6,1944,2,male,852,232,46,4,20,0,2,4,18
1335497,15,24,1998,10,male,138,232,181,4,1,3,1,1,0
2119287,43,26,1970,10,male,562,232,22,4,82,3,29,1,53
1097287,24,17,1989,8,male,584,237,135,4,0,4,0,0,0
1882361,25,14,1988,1,male,259,239,195,4,0,4,0,0,0
1396648,38,25,1975,11,male,319,233,208,4,0,4,0,0,0
1882598,68,10,1945,5,male,1300,236,150,4,0,4,0,0,0
1147791,20,30,1993,9,male,697,236,136,4,2,4,2,0,0
1199884,25,6,1988,10,male,238,238,170,4,1,4,1,0,0
1188231,16,31,1997,1,female,618,235,115,4,51,4,27,0,24
1146991,19,11,1994,1,female,414,232,91,4,8,4,8,0,0
2164958,19,31,1994,10,male,687,235,154,4,93,4,72,0,21
2035434,27,18,1986,4,male,354,237,189,4,9,4,6,0,3
1025993,27,2,1986,10,female,381,236,118,4,29,4,22,0,7
1903214,30,27,1983,7,female,97,236,159,4,6,4,1,0,5
1989150,52,21,1961,4,male,1210,231,170,4,95,4,76,0,19
2180247,108,9,1905,6,male,743,231,171,4,11,4,9,0,2
2040179,15,1,1998,1,male,257,234,51,5,0,0,0,5,0
1810862,18,7,1995,6,female,849,236,180,5,0,0,0,5,0
2145564,21,22,1992,6,female,756,238,118,5,1,0,1,5,0
1263627,23,23,1990,3,male,396,236,64,5,2,0,0,5,2
1923017,20,18,1993,9,male,225,233,210,5,10,0,7,5,3
1150988,28,28,1985,8,male,332,240,209,5,0,5,0,0,0
2099209,17,26,1996,9,male,347,233,95,5,3,5,3,0,0
1352354,32,23,1981,2,male,1855,235,107,5,3,5,3,0,0
1689577,103,4,1910,10,male,790,235,192,5,2,5,2,0,0
1052404,18,6,1995,11,male,178,239,150,5,6,5,5,0,1
2150681,23,3,1990,12,male,559,238,88,5,7,5,5,0,2
1788683,27,23,1986,12,male,402,231,94,5,4,5,4,0,0
1827354,29,5,1984,10,male,746,233,168,5,5,5,2,0,3
1489649,33,9,1980,2,male,396,238,216,5,5,5,4,0,1
1171860,103,13,1910,1,female,718,234,43,5,6,5,4,0,2
1611164,19,24,1994,6,male,36,238,185,5,76,5,43,0,33
1776374,21,23,1992,6,male,361,234,153,5,14,5,11,0,3
2072226,30,20,1983,11,male,606,232,146,5,15,5,14,0,1
2056861,40,21,1973,11,male,239,237,215,5,18,5,6,0,12
1203935,45,8,1968,7,male,1025,231,72,5,12,5,11,0,1
1651922,108,17,1905,8,male,249,238,193,5,126,5,99,0,27
1379868,43,5,1970,1,male,1082,233,86,6,2,0,0,6,2
1244649,44,17,1969,10,male,531,232,152,6,7,0,0,6,7
1550755,24,10,1989,12,female,547,232,206,6,0,6,0,0,0
1333557,16,25,1997,3,male,477,233,151,6,1,6,1,0,0
1234107,16,31,1997,7,female,169,240,142,6,3,6,3,0,0
1464416,19,21,1994,7,male,157,239,214,6,1,6,1,0,0
1408484,109,1,1904,1,male,2192,239,139,6,1,6,1,0,0
1009250,18,14,1995,2,female,306,237,38,6,7,6,1,0,6
1719526,29,20,1984,10,male,205,235,2,6,4,6,3,0,1
1031246,103,6,1910,8,female,2014,235,99,6,7,6,5,0,2
1280568,15,10,1998,1,female,160,233,157,6,21,6,9,0,12
1834413,15,14,1998,6,male,380,236,133,6,21,6,20,0,1
1991534,18,25,1995,7,male,342,231,170,6,30,6,27,0,3
1772149,25,1,1988,1,female,747,239,116,6,30,6,28,0,2
1747866,28,12,1985,4,male,510,240,195,6,35,6,27,0,8
1633388,14,16,1999,11,female,426,232,142,7,0,0,0,7,0
1639389,68,1,1945,4,male,901,233,205,7,1,0,0,7,1
1808667,16,5,1997,11,male,406,238,131,7,5,1,5,6,0
2108058,16,7,1997,9,female,147,237,112,7,27,0,16,7,11
1475912,18,14,1995,5,male,564,237,208,7,52,2,12,5,40
1829311,21,13,1992,12,female,474,235,145,7,69,5,56,2,13
1186086,25,25,1988,10,female,1633,236,56,7,11,5,6,2,5
1731150,14,27,1999,1,female,374,232,160,7,1,7,1,0,0
1372284,23,7,1990,2,male,975,231,193,7,1,7,0,0,1
1099116,19,18,1994,11,female,871,237,109,7,2,7,1,0,1
1323700,108,2,1905,5,female,1054,239,104,7,3,7,3,0,0
1148770,23,1,1990,8,male,245,232,114,7,5,7,3,0,2
2008132,18,29,1995,11,male,673,232,182,8,1,0,1,8,0
1946463,42,29,1971,3,male,283,232,214,8,2,0,0,8,2
1781845,34,25,1979,1,male,549,231,152,8,5,0,2,8,3
1118320,60,23,1953,11,male,876,240,154,8,5,0,0,8,5
1011423,80,25,1933,9,female,267,239,85,8,6,1,5,7,1
1365557,18,24,1995,12,male,180,237,147,8,5,2,5,6,0
2149846,16,28,1997,5,female,238,240,124,8,43,2,17,6,26
2034621,51,17,1962,10,male,83,238,178,8,78,2,36,6,42
1351162,18,16,1995,5,female,283,235,78,8,52,7,37,1,15
1749974,14,4,1999,5,female,510,236,128,8,1,8,0,0,1
1875547,20,1,1993,1,male,546,232,150,8,3,8,3,0,0
1782771,29,4,1984,5,female,94,233,145,8,4,8,1,0,3
1289117,53,22,1960,12,male,639,234,146,8,3,8,3,0,0
2093279,19,10,1994,11,male,305,237,186,8,10,8,7,0,3
1842692,19,2,1994,7,male,237,231,189,8,5,8,4,0,1
1347343,17,17,1996,4,female,404,232,150,8,182,8,144,0,38
1572026,20,5,1993,2,male,330,234,164,8,43,8,32,0,11
1748632,44,9,1969,7,male,520,231,173,8,17,8,8,0,9
2146852,45,18,1968,1,male,703,240,180,8,12,8,11,0,1
2093262,18,20,1995,3,female,762,231,83,9,0,0,0,9,0
1526876,24,21,1989,12,male,499,237,100,9,0,0,0,9,0
1505672,53,10,1960,7,male,395,233,203,9,2,0,0,9,2
1496164,56,1,1957,1,male,178,235,194,9,5,0,0,9,5
1040386,27,10,1986,12,male,405,231,110,9,22,2,11,7,11
1271689,24,23,1989,3,male,542,233,199,9,1,9,1,0,0
1642742,25,1,1988,1,male,236,234,226,9,2,9,2,0,0
1573220,34,13,1979,2,male,313,236,175,9,2,9,2,0,0
1979696,27,12,1986,2,male,1009,237,75,9,11,9,11,0,0
2129398,31,27,1982,9,female,495,240,220,9,9,9,8,0,1
1612144,33,4,1980,4,male,364,237,129,9,13,9,5,0,8
1788316,21,18,1992,4,female,336,234,33,9,37,9,18,0,19
1468196,25,2,1988,3,male,353,232,34,9,135,9,132,0,3
1044583,86,18,1927,4,male,862,238,168,10,2,0,1,10,1
1651059,15,5,1998,12,male,409,237,176,10,12,0,4,10,8
2165989,108,22,1905,3,male,907,232,151,10,8,0,1,10,7
1185777,29,2,1984,9,male,1338,231,110,10,212,1,89,9,123
1088892,18,15,1995,6,male,210,240,204,10,12,5,7,5,5
2051382,25,14,1988,2,male,283,233,121,10,1,8,1,2,0
1543734,24,22,1989,10,male,420,237,86,10,3,8,2,2,1
1755733,34,12,1979,9,male,374,233,154,10,44,9,30,1,14
1804863,27,28,1986,8,male,510,231,195,10,0,10,0,0,0
1217153,93,20,1920,11,male,2173,240,143,10,8,10,7,0,1
1741181,103,1,1910,1,male,545,232,155,10,7,10,6,0,1
2120509,21,30,1992,8,male,405,235,136,10,29,10,29,0,0
1173495,22,13,1991,7,male,193,235,173,10,61,10,49,0,12
1147584,20,5,1993,12,male,508,234,188,11,26,0,9,11,17
1993959,22,1,1991,6,male,163,239,213,11,3,3,0,8,3
1316082,100,7,1913,9,male,589,234,119,11,14,9,8,2,6
1265484,21,10,1992,11,female,563,237,212,11,2,11,2,0,0
2108029,20,25,1993,2,male,395,233,215,11,5,11,1,0,4
1617344,25,13,1988,8,female,1258,231,58,11,5,11,3,0,2
1503939,26,30,1987,9,male,1275,232,125,11,13,11,8,0,5
1606586,19,29,1994,10,male,360,231,173,11,48,11,34,0,14
1990507,27,31,1986,3,male,770,238,151,11,26,11,23,0,3
1775578,29,12,1984,11,male,1396,232,71,11,18,11,15,0,3
1301520,20,28,1993,1,male,763,239,164,12,0,0,0,12,0
1687917,93,15,1920,1,female,1288,233,196,12,21,0,3,12,18
1700466,25,7,1988,3,male,537,232,125,12,4,4,0,8,4
2143214,31,23,1982,9,female,1187,236,166,12,7,5,3,7,4
2007297,108,10,1905,12,male,2252,237,127,12,40,11,37,1,3
1470431,36,18,1977,5,male,633,236,113,12,4,12,4,0,0
1092712,19,22,1994,12,male,811,234,152,12,9,12,7,0,2
1280839,33,1,1980,1,male,724,239,186,12,32,12,32,0,0
1559177,25,20,1988,3,male,378,236,126,13,0,0,0,13,0
1467472,53,31,1960,5,male,1337,239,197,13,1,0,0,13,1
1504284,26,24,1987,9,female,264,240,205,13,3,13,2,0,1
1960923,24,22,1989,5,male,273,235,102,13,11,13,7,0,4
1342373,21,26,1992,9,female,576,235,168,13,53,13,22,0,31
1972801,26,24,1987,7,female,85,231,26,13,49,13,42,0,7
1275136,31,5,1982,6,male,887,239,180,13,59,13,33,0,26
1490107,79,1,1934,12,female,1377,233,78,13,101,13,73,0,28
1991686,103,15,1910,12,female,336,239,39,14,0,2,0,12,0
1627627,20,27,1993,8,female,689,239,122,14,4,8,2,6,2
1368836,18,6,1995,5,male,166,231,92,14,1,14,1,0,0
1282207,18,1,1995,7,female,342,234,191,14,8,14,8,0,0
1691041,18,26,1995,2,male,114,238,197,14,11,14,7,0,4
1080026,14,6,1999,12,male,260,233,175,15,6,1,2,14,4
1831413,108,14,1905,8,male,202,233,146,15,4,2,4,13,0
1042476,32,8,1981,7,female,404,234,150,15,35,2,6,13,29
1223556,27,22,1986,7,male,1031,240,176,15,154,4,115,11,39
1610173,29,31,1984,3,male,825,234,179,15,18,14,8,1,10
2192680,18,12,1995,5,male,196,239,144,15,2,15,2,0,0
2077017,13,2,2000,3,female,225,231,98,15,12,15,8,0,4
1161656,20,11,1993,2,male,480,239,221,16,4,0,0,16,4
1402177,21,25,1992,8,male,667,236,168,16,7,4,5,12,2
2060654,23,7,1990,4,male,118,235,131,16,83,6,53,10,30
1216454,39,10,1974,1,female,373,235,220,16,13,12,9,4,4
1427638,103,17,1910,3,male,564,238,159,16,68,16,42,0,26
1107385,18,11,1995,12,female,144,236,142,17,14,2,5,15,9
1197288,61,18,1952,10,male,458,233,211,17,128,0,15,17,113
1879858,15,5,1998,6,female,429,237,116,17,2,13,1,4,1
1909723,23,9,1990,10,male,664,237,222,17,16,16,13,1,3
1046854,17,11,1996,1,female,123,233,146,17,81,16,53,1,28
1378843,23,20,1990,12,female,447,237,200,17,165,17,135,0,30
1534346,13,4,2000,1,male,39,233,215,18,15,2,6,16,9
1341750,16,26,1997,1,female,406,238,210,18,40,0,2,18,38
1770207,14,17,1999,4,male,670,238,62,18,137,6,55,12,82
1562768,21,8,1992,11,male,286,237,167,18,15,17,8,1,7
1103812,20,18,1993,5,male,249,235,152,18,2,18,1,0,1
1988863,31,5,1982,5,male,601,240,204,18,20,18,20,0,0
2153938,20,4,1993,10,female,417,232,96,18,120,18,76,0,44
1299058,25,13,1988,7,male,405,233,71,18,29,18,26,0,3
1666475,22,28,1991,3,male,1292,233,76,19,4,16,1,3,3
1560318,15,9,1998,6,male,575,234,170,19,15,14,14,5,1
1490015,14,28,1999,5,female,450,233,110,19,3,19,2,0,1
1104436,20,2,1993,1,female,712,239,81,19,0,19,0,0,0
2159551,18,2,1995,8,female,224,233,142,19,18,19,14,0,4
2080761,18,1,1995,4,female,458,237,177,19,30,19,16,0,14
2121437,30,6,1983,10,female,774,231,31,19,166,19,120,0,46
2030361,44,4,1969,10,male,764,231,123,19,73,19,50,0,23
1252356,28,19,1985,3,male,1512,231,147,20,26,13,7,7,19
1712917,19,4,1994,5,female,246,232,170,20,34,12,27,8,7
1387104,19,18,1994,6,female,454,236,72,20,7,20,7,0,0
2080743,19,25,1994,2,female,870,231,165,20,13,20,12,0,1
1099589,13,21,2000,2,female,120,238,58,20,77,20,44,0,33
1458946,28,1,1985,1,female,520,238,43,20,56,20,44,0,12
1695903,113,2,1900,9,NA,2278,240,136,21,5,3,3,18,2
1892730,22,4,1991,4,male,305,232,173,21,0,20,0,1,0
1625297,17,17,1996,12,female,225,240,6,21,0,21,0,0,0
1060902,29,6,1984,5,male,516,237,148,21,0,21,0,0,0
1237741,56,11,1957,10,male,901,232,114,21,3,21,3,0,0
1174312,102,25,1911,12,male,356,234,192,21,6,21,4,0,2
1906153,16,21,1997,4,male,320,236,131,21,60,21,34,0,26
1415005,17,16,1996,6,female,133,233,86,21,45,21,41,0,4
2112855,18,1,1995,8,female,627,233,195,22,15,2,9,20,6
1142494,61,18,1952,5,male,1852,232,128,22,51,4,17,18,34
2079723,20,31,1993,8,male,297,232,165,22,10,21,2,1,8
1880793,106,20,1907,5,female,1387,235,72,22,16,22,10,0,6
1839472,29,1,1984,8,female,477,236,74,23,69,11,20,12,49
1965155,103,24,1910,11,female,1843,236,114,23,10,21,5,2,5
1740918,19,26,1994,2,male,528,232,20,23,62,17,38,6,24
1601670,24,6,1989,12,male,501,234,132,23,57,22,17,1,40
1544896,18,7,1995,1,male,256,240,176,23,1,23,1,0,0
1305924,21,14,1992,9,female,399,233,35,23,13,23,9,0,4
1664236,22,21,1991,1,female,698,239,157,23,8,23,4,0,4
1929116,13,20,2000,3,female,413,235,182,23,15,23,4,0,11
1885801,20,10,1993,7,female,622,240,176,24,7,0,1,24,6
1903085,23,10,1990,10,male,1237,240,125,24,7,10,4,14,3
1330050,54,12,1959,10,female,1190,239,97,24,48,7,29,17,19
1828752,46,20,1967,9,male,1667,236,180,24,27,24,17,0,10
1063829,15,7,1998,1,male,138,239,87,24,42,24,36,0,6
1115847,36,7,1977,8,male,480,235,178,24,106,24,100,0,6
1700352,17,17,1996,2,male,504,237,88,25,47,16,24,9,23
1552051,16,15,1997,6,male,214,237,123,25,37,19,20,6,17
1479980,34,10,1979,1,male,454,232,200,25,124,19,58,6,66
1558480,103,7,1910,7,female,666,234,134,25,8,25,7,0,1
2145874,26,2,1987,12,male,396,238,82,25,47,25,33,0,14
1173562,17,18,1996,2,male,208,237,161,26,7,19,2,7,5
1340537,67,25,1946,4,female,1591,235,163,26,17,25,10,1,7
1761846,108,28,1905,2,male,1520,231,89,26,72,19,48,7,24
1825879,29,7,1984,4,female,589,237,85,26,3,26,2,0,1
1309599,26,1,1987,1,male,651,234,146,26,10,26,2,0,8
1740405,46,11,1967,11,female,765,236,194,26,11,26,8,0,3
2130060,18,22,1995,8,male,406,234,76,27,2,4,2,23,0
1576629,20,20,1993,11,female,915,233,86,27,1,22,0,5,1
1986687,19,3,1994,3,male,460,233,23,27,41,20,20,7,21
1205276,18,1,1995,8,female,218,232,196,27,5,27,5,0,0
1743298,29,10,1984,5,male,257,233,221,27,5,27,4,0,1
1759326,35,18,1978,9,male,1612,235,167,27,10,27,4,0,6
1354428,48,20,1965,8,male,198,236,226,27,5,27,1,0,4
1831233,108,17,1905,10,male,120,233,170,27,15,27,13,0,2
1829424,18,13,1995,4,male,474,233,176,27,32,27,8,0,24
1583941,19,31,1994,7,male,477,240,75,27,27,27,26,0,1
1841316,22,3,1991,8,female,279,238,39,27,36,27,26,0,10
1359390,17,10,1996,10,female,20,234,66,27,85,27,58,0,27
1777335,103,30,1910,11,female,521,239,111,27,457,27,425,0,32
2017632,27,8,1986,10,male,1241,237,122,28,29,25,21,3,8
1811102,20,2,1993,5,female,448,236,90,28,3,28,2,0,1
1417416,25,11,1988,12,female,543,233,40,28,27,28,23,0,4
2191244,44,9,1969,4,female,530,233,153,28,20,28,18,0,2
1269241,18,11,1995,8,male,494,237,34,28,57,28,56,0,1
1025975,17,11,1996,4,male,300,231,196,29,6,29,6,0,0
1310675,21,25,1992,10,female,675,236,94,29,13,29,7,0,6
1469494,20,15,1993,3,female,528,237,157,29,30,29,28,0,2
2002146,16,11,1997,9,male,393,235,156,31,4,0,3,31,1
1455775,29,5,1984,2,male,473,232,167,30,12,0,1,30,11
1417057,106,9,1907,7,male,1132,234,160,31,12,0,5,31,7
1044248,63,10,1950,2,female,583,239,190,30,23,0,3,30,20
1094080,44,1,1969,6,male,450,232,88,31,291,9,179,22,112
1709078,18,2,1995,2,male,144,236,229,30,4,30,4,0,0
1771787,34,28,1979,6,male,504,233,47,31,3,31,3,0,0
1004076,28,8,1985,4,male,599,234,144,30,18,30,12,0,6
1671869,17,30,1996,8,male,258,233,95,30,60,30,48,0,12
1979141,18,14,1995,10,female,92,231,70,31,65,31,58,0,7
1082710,24,2,1989,5,male,280,239,130,31,123,31,93,0,30
1522432,17,21,1996,2,male,459,238,115,32,37,3,11,29,26
1305564,26,9,1987,10,male,600,236,179,32,45,32,40,0,5
2055411,15,21,1998,2,female,197,239,171,32,69,32,67,0,2
1623683,73,1,1940,4,female,1281,237,124,32,166,32,75,0,91
1087795,101,23,1912,3,male,1349,240,113,32,75,32,53,0,22
1909853,29,14,1984,6,male,402,236,197,33,72,0,30,33,42
1101882,22,20,1991,6,male,147,238,223,33,4,8,1,25,3
1740893,16,17,1997,9,female,180,235,34,33,14,29,8,4,6
1894742,28,31,1985,7,male,461,233,160,33,109,29,50,4,59
1073045,16,8,1997,8,male,566,235,149,33,0,33,0,0,0
2158661,20,14,1993,2,male,1081,232,200,33,1,33,1,0,0
2155828,18,16,1995,5,male,231,234,96,33,20,33,13,0,7
1244936,21,10,1992,6,male,694,232,182,33,11,33,11,0,0
1129847,21,23,1992,12,female,627,238,171,33,40,33,39,0,1
1940937,27,18,1986,12,male,386,231,178,33,33,33,27,0,6
1184191,14,3,1999,3,male,317,236,76,34,53,6,5,28,48
1254686,29,1,1984,7,female,379,233,152,34,32,20,6,14,26
1460846,31,17,1982,8,male,477,231,123,34,3,34,0,0,3
1966499,101,6,1912,9,male,779,236,133,34,2,34,2,0,0
2127671,30,3,1983,3,male,224,235,217,34,11,34,11,0,0
1067130,106,17,1907,4,male,1511,238,107,34,9,34,9,0,0
1209174,24,31,1989,7,female,291,237,95,34,50,34,21,0,29
1097746,22,1,1991,1,male,826,237,187,35,7,0,4,35,3
2018602,24,17,1989,1,female,277,237,24,36,82,17,20,19,62
1040900,23,6,1990,6,female,2029,239,159,36,39,36,19,0,20
1687006,26,14,1987,2,female,364,233,162,36,30,36,29,0,1
1058038,25,2,1988,10,male,417,236,173,36,82,36,63,0,19
1000315,46,28,1967,2,male,251,233,150,35,82,35,69,0,13
1420435,19,1,1994,1,male,543,231,136,37,12,0,1,37,11
1993696,52,5,1961,5,male,603,239,68,37,23,16,7,21,16
1315497,15,24,1998,7,male,110,231,115,37,0,28,0,9,0
1515903,17,1,1996,10,female,176,239,64,37,71,34,45,3,26
1681747,66,15,1947,5,female,1335,235,66,37,74,34,65,3,9
2014315,29,26,1984,5,male,323,233,170,37,22,37,16,0,6
1656072,26,19,1987,3,female,497,240,215,37,26,37,26,0,0
1498127,37,28,1976,1,female,322,240,146,37,127,37,97,0,30
1133400,17,27,1996,8,male,235,238,141,38,0,0,0,38,0
1860755,31,9,1982,8,female,265,233,116,38,2,0,0,38,2
1574029,18,7,1995,3,male,329,232,183,38,11,23,7,15,4
2128886,33,17,1980,10,female,233,236,122,38,36,21,12,17,24
1167529,31,17,1982,9,female,398,235,191,38,117,28,20,10,97
1275567,17,19,1996,6,male,303,236,190,38,18,38,12,0,6
1529026,20,14,1993,4,female,380,238,108,39,30,39,29,0,1
1957356,25,29,1988,8,male,288,236,196,38,31,38,24,0,7
1561297,26,8,1987,1,male,581,237,196,40,19,0,18,40,1
1947834,19,20,1994,4,female,344,234,110,40,128,14,74,26,54
1033545,34,10,1979,5,female,15,232,93,40,473,31,156,9,317
1758246,15,17,1998,2,female,225,236,217,40,3,40,2,0,1
2164353,29,2,1984,3,female,423,235,164,40,44,40,42,0,2
1118847,19,26,1994,5,male,703,237,215,42,16,24,9,18,7
1369495,17,18,1996,10,male,367,233,175,42,19,40,15,2,4
1827744,13,27,2000,7,female,342,240,173,41,32,35,18,6,14
2153147,18,26,1995,4,male,567,236,123,41,93,31,66,10,27
1640523,29,12,1984,4,male,555,233,187,41,8,41,7,0,1
1506870,60,5,1953,6,male,865,240,176,41,15,41,11,0,4
1691670,17,1,1996,6,male,165,236,106,42,170,42,70,0,100
1758473,22,29,1991,12,male,632,235,128,42,95,42,64,0,31
1471407,21,9,1992,1,female,134,234,47,41,104,41,39,0,65
1818168,31,20,1982,1,male,272,231,215,41,188,41,174,0,14
2054435,32,7,1981,3,male,617,235,49,42,68,42,32,0,36
1020457,29,10,1984,4,female,1389,235,196,44,149,0,32,44,117
1507033,18,29,1995,7,male,474,237,172,44,0,19,0,25,0
1348687,31,30,1982,5,male,484,237,176,44,3,44,3,0,0
1615658,18,1,1995,1,male,365,233,87,43,85,43,47,0,38
1807716,14,15,1999,4,female,237,232,169,45,27,2,5,43,22
1153295,15,17,1998,12,female,286,233,96,45,84,14,60,31,24
1335895,27,15,1986,9,female,423,236,115,45,46,44,31,1,15
1559822,33,13,1980,3,female,378,237,163,45,44,45,30,0,14
1226667,41,3,1972,9,male,373,236,113,46,13,35,8,11,5
1229913,103,19,1910,2,female,1610,238,106,46,23,46,23,0,0
1038200,21,2,1992,2,male,149,240,224,47,36,47,34,0,2
1599669,44,20,1969,3,female,684,232,163,49,9,0,5,49,4
2053212,19,19,1994,7,male,475,231,150,49,19,49,19,0,0
1547152,31,25,1982,11,female,1142,238,140,49,61,49,45,0,16
1788503,14,15,1999,11,male,522,234,172,50,8,1,2,49,6
1586397,19,18,1994,12,male,603,233,154,50,9,26,7,24,2
1572462,113,1,1900,1,male,2246,237,134,51,192,33,165,18,27
1624223,14,24,1999,10,male,574,236,138,51,89,47,71,4,18
1257668,15,1,1998,4,male,261,239,172,50,36,50,36,0,0
1981553,19,14,1994,5,male,309,239,132,50,32,50,31,0,1
1932911,22,6,1991,6,male,1737,236,166,51,65,51,55,0,10
1908519,28,13,1985,5,female,561,235,110,50,37,50,36,0,1
1607918,18,31,1995,5,female,43,231,33,50,243,50,166,0,77
1842310,54,18,1959,9,female,1678,234,90,51,263,51,164,0,99
1518017,14,26,1999,2,female,56,232,214,53,15,12,4,41,11
1141402,63,15,1950,4,male,1016,235,186,52,53,22,38,30,15
2090401,14,26,1999,11,male,242,238,108,53,17,53,8,0,9
1217910,93,16,1920,11,male,814,239,148,52,14,52,10,0,4
1849996,84,7,1929,2,female,2161,237,149,54,102,0,54,54,48
1383015,13,9,2000,6,male,485,240,167,54,42,11,20,43,22
2159199,15,25,1998,8,female,130,240,54,55,7,55,7,0,0
1749363,20,28,1993,5,female,422,232,159,55,6,55,5,0,1
1813286,27,12,1986,12,male,360,235,223,54,24,54,22,0,2
2001945,20,18,1993,8,female,281,236,99,54,43,54,38,0,5
1778891,62,12,1951,9,female,446,239,187,58,56,0,27,58,29
1292134,108,1,1905,1,male,1191,238,95,57,45,3,19,54,26
1826441,73,1,1940,1,female,533,231,78,57,535,0,40,57,495
2110253,22,29,1991,1,male,1105,235,99,57,17,52,12,5,5
2131322,18,25,1995,1,male,439,236,112,58,13,58,6,0,7
2000422,15,14,1998,5,female,433,234,177,58,76,58,68,0,8
1927999,20,22,1993,6,male,603,238,166,56,48,56,48,0,0
1713168,23,26,1990,7,male,350,234,185,56,43,56,15,0,28
2072219,25,1,1988,1,male,1035,231,91,58,80,58,50,0,30
2122185,58,4,1955,11,female,1598,238,156,58,60,58,46,0,14
2068259,18,11,1995,4,male,198,236,41,57,181,57,76,0,105
1912708,62,1,1951,1,male,884,236,71,57,181,57,124,0,57
1575401,108,25,1905,7,female,1341,239,128,59,57,0,8,59,49
1508988,19,30,1994,12,female,637,240,75,59,6,46,3,13,3
2043737,33,26,1980,9,male,294,240,183,59,7,59,3,0,4
1234944,49,19,1964,4,female,263,236,221,63,5,0,0,63,5
2084257,19,6,1994,5,female,612,239,171,61,30,0,2,61,28
1158045,49,28,1964,5,male,440,236,110,61,15,3,6,58,9
1466237,26,18,1987,6,male,231,239,112,61,116,8,70,53,46
1371975,16,27,1997,4,male,676,236,186,63,10,40,6,23,4
1567176,18,16,1995,10,male,268,237,110,61,46,53,46,8,0
1558914,22,10,1991,10,female,415,235,87,62,67,62,54,0,13
2103083,22,29,1991,9,female,337,235,168,61,146,61,120,0,26
2177524,27,10,1986,10,male,142,238,213,61,112,61,46,0,66
1528038,21,12,1992,6,male,234,231,104,64,3,13,1,51,2
1804274,24,15,1989,8,female,634,232,158,64,191,64,85,0,106
1389234,17,26,1996,12,male,188,235,104,67,24,3,8,64,16
1080973,54,15,1959,12,male,1036,236,82,68,31,0,4,68,27
1313183,20,18,1993,3,male,416,232,143,68,46,16,11,52,35
1535165,24,31,1989,3,male,505,235,216,67,12,67,7,0,5
1569867,24,25,1989,1,female,421,231,172,66,213,66,66,0,147
1267305,85,8,1928,11,female,279,235,164,69,12,0,2,69,10
1736769,49,13,1964,6,male,585,236,10,69,52,0,18,69,34
1912493,56,15,1957,9,male,1730,233,123,71,184,3,119,68,65
1938892,35,27,1978,11,male,261,235,72,71,39,23,6,48,33
1211840,38,24,1975,3,male,763,236,197,71,134,17,23,54,111
1327832,40,23,1973,7,female,238,231,156,70,41,70,28,0,13
1720863,39,21,1974,9,female,545,231,119,69,55,69,30,0,25
1521976,33,23,1980,5,male,1109,238,171,74,1,0,1,74,0
1983240,17,26,1996,1,male,536,231,73,72,78,14,33,58,45
1485855,54,15,1959,6,female,123,231,183,72,15,69,11,3,4
1860355,21,22,1992,9,male,1049,233,153,74,125,69,90,5,35
1147881,49,21,1964,8,female,1338,237,57,73,128,67,81,6,47
1264055,24,25,1989,8,male,686,240,156,72,61,72,59,0,2
1837272,83,30,1930,8,female,1731,239,128,73,423,73,273,0,150
1112012,16,8,1997,10,male,121,239,225,77,6,77,5,0,1
1598541,51,25,1962,6,male,266,237,166,76,11,76,8,0,3
1397463,26,10,1987,6,male,254,234,182,76,185,76,124,0,61
1458803,40,3,1973,6,female,635,238,170,77,138,77,101,0,37
1698133,14,8,1999,6,female,264,238,117,80,125,14,36,66,89
1643712,24,5,1989,7,male,399,234,171,78,62,55,17,23,45
1253450,27,28,1986,3,female,111,240,179,80,113,44,54,36,59
1312481,18,25,1995,7,female,580,231,101,78,66,72,32,6,34
1163652,21,10,1992,12,female,603,236,107,80,97,63,41,17,56
1952136,34,14,1979,5,female,564,233,107,79,102,79,73,0,29
1908110,68,28,1945,10,female,568,240,118,79,155,79,146,0,9
1244340,63,28,1950,2,female,1617,237,152,83,15,0,7,83,8
1962074,16,22,1997,2,male,605,232,162,81,33,33,10,48,23
1768674,71,27,1942,9,female,1526,234,117,84,69,51,37,33,32
1859351,100,1,1913,1,NA,1870,234,183,83,81,17,43,66,38
1273692,19,19,1994,11,male,405,231,199,82,30,69,16,13,14
1884605,30,11,1983,7,female,377,235,129,84,99,67,24,17,75
1021577,61,2,1952,2,female,361,239,102,81,289,80,80,1,209
1401690,15,8,1998,1,male,514,239,118,83,15,83,15,0,0
1854606,16,3,1997,4,female,156,234,82,82,45,82,30,0,15
1872559,18,10,1995,5,female,608,239,111,82,35,82,32,0,3
1253521,100,12,1913,10,female,473,232,212,82,79,82,73,0,6
1881286,42,21,1971,6,male,1323,236,132,87,181,51,121,36,60
1475800,27,9,1986,12,female,465,235,214,86,11,67,2,19,9
1823055,38,24,1975,5,female,413,234,130,86,40,74,18,12,22
1535730,18,26,1995,6,male,153,236,106,85,311,85,293,0,18
1477179,25,16,1988,5,female,594,231,139,85,133,85,100,0,33
1830092,18,24,1995,8,male,354,240,181,88,14,1,6,87,8
1737387,22,20,1991,8,male,146,232,195,91,8,0,2,91,6
1899751,33,22,1980,7,male,613,236,126,90,37,3,1,87,36
1800399,21,29,1992,12,male,423,238,148,90,57,65,36,25,21
1239804,30,15,1983,9,female,892,232,137,88,84,26,56,62,28
1261946,15,23,1998,9,female,518,238,89,91,23,66,13,25,10
1113028,22,8,1991,2,female,334,233,129,88,106,77,43,11,63
1184931,59,4,1954,4,female,744,236,56,91,136,82,102,9,34
1758758,19,14,1994,8,male,420,232,187,89,5,89,3,0,2
1182458,19,30,1994,5,male,471,239,131,89,19,89,16,0,3
1673764,20,25,1993,7,female,465,240,65,90,59,90,46,0,13
1230924,24,2,1989,6,male,449,239,88,95,46,66,16,29,30
1286532,85,10,1928,9,male,277,232,125,94,48,20,35,74,13
1304741,18,10,1995,1,male,640,233,137,93,79,34,36,59,43
2020736,41,3,1972,1,female,531,235,104,95,52,71,28,24,24
1205515,28,13,1985,1,male,248,240,198,95,98,84,50,11,48
1301292,27,17,1986,3,female,1377,231,74,93,247,70,158,23,89
1380676,24,1,1989,7,male,552,236,173,94,8,94,8,0,0
1943494,29,22,1984,8,male,300,238,131,95,4,95,4,0,0
1539162,22,1,1991,1,male,128,236,134,94,347,94,218,0,129
1373183,26,16,1987,4,female,116,232,172,94,158,94,123,0,35
1585979,52,11,1961,12,female,534,237,168,98,436,0,119,98,317
1715184,41,9,1972,8,male,1690,238,61,96,188,64,156,32,32
1424077,14,13,1999,4,female,110,231,107,97,68,96,37,1,31
2141881,17,30,1996,7,female,311,238,188,99,39,99,28,0,11
1100681,25,1,1988,1,male,289,231,141,97,42,97,20,0,22
2129576,28,31,1985,8,female,30,233,221,96,29,96,16,0,13
1914274,16,12,1997,3,female,562,231,91,100,2,0,0,100,2
1184859,55,22,1958,2,female,954,240,173,103,41,0,16,103,25
1807156,21,17,1992,2,female,461,238,96,103,95,1,34,102,61
1097502,23,26,1990,11,female,53,239,196,102,125,14,80,88,45
1792320,63,1,1950,1,male,1875,235,94,103,169,2,113,101,56
1662004,18,6,1995,3,male,504,234,139,103,25,100,14,3,11
1272662,16,3,1997,8,female,890,238,75,104,72,102,43,2,29
1478905,27,5,1986,2,male,301,233,171,103,130,94,93,9,37
1806532,52,11,1961,3,female,1503,238,103,102,204,101,84,1,120
1406297,15,12,1998,11,male,535,234,134,104,56,104,48,0,8
1825953,18,15,1995,11,male,335,238,61,102,114,102,82,0,32
1398656,100,7,1913,2,female,754,237,99,104,94,104,60,0,34
2114587,18,29,1995,6,male,153,235,217,106,3,0,0,106,3
1918703,24,11,1989,12,female,971,240,69,108,153,16,89,92,64
1172912,53,29,1960,12,female,1725,238,119,108,211,1,67,107,144
1961745,102,31,1911,1,male,1662,237,87,105,159,6,64,99,95
1530293,42,30,1971,9,female,1134,231,126,108,186,61,132,47,54
1103901,19,3,1994,3,male,46,239,212,105,24,103,18,2,6
2033374,20,6,1993,4,female,292,240,113,105,66,103,31,2,35
1269977,43,11,1970,3,female,2069,235,68,106,195,98,163,8,32
1423862,21,28,1992,1,female,671,238,45,107,114,106,104,1,10
1198393,18,24,1995,12,female,163,234,80,106,287,106,223,0,64
1261266,21,5,1992,8,female,193,240,70,108,182,108,147,0,35
1635441,24,25,1989,9,female,334,236,143,113,91,6,32,107,59
1417997,49,29,1964,6,female,1953,232,159,110,237,21,145,89,92
1797133,17,18,1996,11,female,151,239,133,113,237,73,98,40,139
1824940,16,11,1997,6,female,38,238,150,111,64,109,35,2,29
1563313,18,10,1995,8,female,435,240,45,111,115,108,75,3,40
1733188,20,8,1993,8,male,170,237,154,113,120,106,64,7,56
1135044,23,26,1990,1,male,470,233,188,110,27,109,10,1,17
1381135,15,15,1998,4,female,53,237,71,113,134,113,84,0,50
2062580,60,23,1953,8,female,206,238,121,112,90,112,61,0,29
2013393,26,18,1987,7,female,505,234,103,113,248,113,135,0,113
2112624,51,8,1962,10,female,2197,237,118,110,218,110,40,0,178
1379001,58,2,1955,8,male,2027,239,97,119,364,32,117,87,247
1452199,16,7,1997,12,female,339,233,150,116,42,94,15,22,27
1534829,15,15,1998,7,female,103,240,204,115,99,103,75,12,24
1388802,15,21,1998,1,female,274,238,187,116,6,116,6,0,0
2004337,21,5,1992,2,female,638,231,130,116,61,116,46,0,15
1974416,26,10,1987,10,male,325,232,128,119,60,119,55,0,5
1868631,62,16,1951,8,female,1853,237,126,114,101,114,48,0,53
1241805,103,11,1910,10,male,410,235,159,122,42,0,30,122,12
1105052,19,21,1994,11,male,408,239,162,123,129,47,86,76,43
1952138,14,21,1999,3,female,653,232,130,123,224,87,84,36,140
1351995,103,28,1910,2,male,1102,239,127,122,57,92,28,30,29
1243037,60,15,1953,9,male,1640,239,65,120,97,117,41,3,56
1444847,23,12,1990,11,male,678,238,168,121,249,101,57,20,192
1383661,38,14,1975,7,female,421,231,165,122,218,101,165,21,53
1299837,18,16,1995,12,male,567,238,194,123,85,122,37,1,48
1312728,55,30,1958,7,male,75,233,118,122,249,121,154,1,95
1581030,14,5,1999,2,male,95,233,195,121,6,121,3,0,3
2146480,24,31,1989,10,male,431,233,133,121,61,121,44,0,17
1755556,25,15,1988,6,female,358,232,211,124,59,124,37,0,22
1677952,19,31,1994,7,female,492,231,150,121,162,121,150,0,12
1738144,34,17,1979,4,female,1365,237,117,120,90,120,87,0,3
2120475,67,2,1946,3,female,171,232,201,121,122,121,96,0,26
1365920,68,20,1945,6,male,712,231,140,124,147,124,91,0,56
1103885,103,1,1910,7,female,1570,240,133,127,87,0,33,127,54
2117460,108,30,1905,3,female,941,234,189,130,93,0,21,130,72
1325996,23,20,1990,11,male,33,231,215,125,135,87,50,38,85
1163243,16,8,1997,9,male,356,232,166,125,46,121,15,4,31
1114738,55,20,1958,3,male,1815,231,63,130,68,129,18,1,50
1494780,23,3,1990,4,male,632,231,182,130,1,130,0,0,1
1715370,14,18,1999,1,female,267,237,94,128,57,128,46,0,11
1417262,17,4,1996,4,male,42,235,221,125,35,125,34,0,1
1355295,23,23,1990,6,female,612,231,101,126,147,126,135,0,12
1272693,43,9,1970,7,female,1798,231,125,136,136,24,47,112,89
1675996,46,17,1967,9,male,287,231,113,136,28,75,15,61,13
1270469,50,25,1963,12,male,559,233,63,132,86,87,48,45,38
1336039,19,23,1994,7,female,407,239,182,133,94,108,64,25,30
2132624,19,7,1994,11,female,309,231,75,131,79,131,48,0,31
1477481,96,12,1917,12,female,193,235,194,137,79,0,13,137,66
1891634,108,1,1905,3,female,858,238,154,141,113,6,57,135,56
1072214,19,1,1994,3,female,209,231,186,142,71,138,49,4,22
1735149,15,16,1998,9,male,551,238,162,139,0,139,0,0,0
2184996,18,10,1995,10,male,310,238,215,141,20,141,19,0,1
1359376,15,23,1998,3,male,253,236,98,137,60,137,60,0,0
2140891,14,20,1999,3,male,412,231,97,145,4,63,1,82,3
1632705,15,26,1998,3,male,278,231,208,146,203,86,84,60,119
1555743,18,19,1995,9,male,277,232,197,149,100,149,96,0,4
1008606,37,8,1976,9,male,1542,231,96,144,133,144,98,0,35
1406149,57,7,1956,5,male,144,239,210,153,18,0,3,153,15
1704481,70,24,1943,8,female,1294,240,60,151,657,0,19,151,638
1272133,16,31,1997,10,female,156,231,121,156,136,46,66,110,70
1901844,19,11,1994,3,male,425,232,60,157,72,126,28,31,44
1589394,16,20,1997,12,female,908,240,165,151,121,123,99,28,22
1755148,21,4,1992,7,female,286,233,191,153,260,151,118,2,142
1667352,21,7,1992,1,female,284,238,210,161,270,4,83,157,187
1140637,37,8,1976,6,female,774,234,149,160,101,106,56,54,45
1780584,43,29,1970,6,female,1263,240,100,164,220,48,65,116,155
1446987,43,31,1970,1,female,1486,231,116,158,286,140,106,18,180
2050150,19,27,1994,2,male,419,233,134,161,3,161,1,0,2
1534312,16,12,1997,5,male,606,232,174,168,46,22,37,146,9
1257621,15,23,1998,1,female,830,238,154,171,41,43,31,128,10
1835422,18,14,1995,11,male,747,239,206,172,34,53,7,119,27
1509280,20,25,1993,10,male,249,232,95,170,854,80,190,90,664
1435764,16,9,1997,8,female,563,239,135,170,28,170,14,0,14
1698197,21,3,1992,1,female,724,236,158,169,149,169,59,0,90
1901693,26,14,1987,12,male,341,232,157,167,116,167,113,0,3
2165106,49,2,1964,3,female,1572,235,90,178,201,1,40,177,161
1888629,19,11,1994,11,male,238,237,165,177,281,17,122,160,159
1705142,106,19,1907,5,male,1572,240,199,180,95,110,77,70,18
1978630,14,28,1999,1,female,426,233,124,178,378,70,48,108,330
1106828,57,3,1956,1,female,1381,235,123,178,319,44,32,134,287
1876473,16,4,1997,4,male,289,239,127,181,171,178,120,3,51
1743377,20,9,1993,2,female,386,231,166,177,264,130,117,47,147
2176682,53,25,1960,12,male,331,235,80,174,119,161,77,13,42
1218962,69,26,1944,7,female,1696,232,107,176,139,161,104,15,35
2103371,32,6,1981,12,female,321,237,173,190,82,173,55,17,27
1401769,48,1,1965,11,female,724,232,145,187,154,140,54,47,100
1035463,51,4,1962,10,female,1580,236,118,185,152,183,100,2,52
1201337,22,9,1991,1,female,720,238,185,190,575,181,448,9,127
1865137,57,20,1956,5,female,702,237,152,189,365,160,200,29,165
1270872,29,21,1984,3,female,474,232,174,189,433,189,238,0,195
1290652,30,11,1983,5,male,280,239,132,193,3,19,3,174,0
1237577,22,21,1991,10,female,458,237,206,191,150,2,40,189,110
1005933,28,28,1985,11,female,714,237,116,195,102,163,58,32,44
1349140,53,24,1960,11,male,1881,240,136,196,100,193,82,3,18
1188684,54,29,1959,7,female,1705,232,108,206,76,141,37,65,39
2175888,14,19,1999,12,female,281,240,91,211,248,89,235,122,13
2153772,21,14,1992,4,female,242,237,178,211,253,172,75,39,178
1745852,49,5,1964,2,male,434,232,66,201,201,198,105,3,96
1889377,108,23,1905,6,male,30,234,229,209,144,202,80,7,64
1184838,91,6,1922,4,male,1376,231,101,208,41,208,32,0,9
1562163,47,5,1966,10,female,486,236,79,218,88,2,23,216,65
2067503,22,12,1991,4,female,192,234,74,214,176,47,35,167,141
2185972,20,5,1993,10,female,494,238,180,212,41,196,39,16,2
1641948,23,13,1990,10,female,821,235,112,216,98,178,63,38,35
1114079,24,3,1989,9,male,305,232,178,221,217,205,203,16,14
1617987,27,11,1986,9,female,101,235,194,220,189,191,108,29,81
1770800,54,16,1959,9,female,395,239,117,218,275,179,186,39,89
2103328,21,12,1992,11,female,346,233,85,219,330,189,316,30,14
1031041,28,13,1985,9,female,1222,233,127,219,365,179,144,40,221
1385153,49,11,1964,3,female,349,239,114,212,156,212,95,0,61
1333371,55,29,1958,4,female,524,240,138,220,248,220,137,0,111
1134595,108,30,1905,8,male,1264,237,69,218,152,218,68,0,84
1921332,15,24,1998,12,male,217,232,90,233,83,0,21,233,62
1011493,67,18,1946,6,female,1207,233,33,231,134,4,24,227,110
1590340,25,24,1988,9,female,475,236,51,231,193,0,72,231,121
1136818,19,12,1994,6,male,1688,235,109,227,222,99,135,128,87
1841078,18,25,1995,11,female,417,240,196,226,118,218,54,8,64
1290836,20,30,1993,6,female,674,232,113,233,254,192,140,41,114
1471120,24,10,1989,8,female,837,235,132,227,176,198,38,29,138
1383695,57,28,1956,11,female,1715,234,109,226,407,221,204,5,203
1394249,33,14,1980,11,female,1303,234,171,227,144,227,120,0,24
1053529,25,4,1988,10,female,117,235,190,234,342,141,234,93,108
1209494,100,9,1913,11,male,1860,233,128,236,336,150,255,86,81
1881706,22,1,1991,4,male,423,234,176,235,379,96,78,139,301
1509127,29,31,1984,3,female,700,235,142,240,411,162,129,78,282
1713265,24,21,1989,9,female,261,233,201,245,234,221,180,24,54
1110033,15,9,1998,8,male,190,240,199,245,99,245,77,0,22
1490653,66,4,1947,10,male,800,238,164,238,127,238,97,0,30
1389770,19,18,1994,3,male,104,238,168,236,193,236,174,0,19
1592144,55,18,1958,11,female,1575,232,136,247,48,0,11,247,37
1640356,18,4,1995,6,female,148,239,193,249,276,175,128,74,148
1583392,15,1,1998,9,male,185,238,113,252,118,252,112,0,6
1559247,16,15,1997,2,female,462,240,105,258,139,258,131,0,8
1788454,80,12,1933,8,female,49,233,156,251,267,251,134,0,133
1958149,113,14,1900,1,female,1969,233,87,249,496,249,397,0,99
1077855,49,21,1964,12,female,2280,232,137,274,193,35,126,239,67
1874966,16,17,1997,9,male,507,240,114,266,240,56,154,210,86
2166972,24,26,1989,9,male,275,231,163,272,221,183,110,89,111
1538187,61,24,1952,11,female,621,234,141,276,1398,191,635,85,763
1476223,60,3,1953,7,male,2311,233,190,264,105,208,50,56,55
1522240,72,8,1941,9,female,1830,237,147,269,131,267,69,2,62
1088791,25,27,1988,3,female,121,231,151,271,590,271,490,0,100
1983725,59,21,1954,10,male,422,240,142,281,111,0,41,281,70
1365489,32,6,1981,3,female,385,231,82,286,7,82,4,204,3
1849118,17,14,1996,3,male,178,235,109,291,173,291,102,0,71
1736896,28,10,1985,10,female,1041,235,94,278,55,278,24,0,31
1195836,66,26,1947,8,female,1696,233,158,280,95,280,79,0,16
1158426,33,30,1980,1,female,732,237,206,283,257,283,195,0,62
1153951,25,6,1988,3,female,51,231,96,284,1538,284,1465,0,73
1632293,49,6,1964,9,female,1224,232,96,297,407,80,152,217,255
1734707,21,2,1992,4,male,400,239,125,308,530,147,400,161,130
1367768,24,1,1989,6,female,133,240,94,306,933,210,404,96,529
1336226,19,5,1994,1,female,576,233,94,299,91,279,58,20,33
2162067,32,10,1981,9,male,606,237,169,295,149,268,61,27,88
2083296,14,11,1999,7,female,94,239,118,301,222,235,148,66,74
1176003,52,6,1961,1,female,640,234,104,303,664,286,186,17,478
1205673,26,21,1987,11,male,533,237,167,299,840,299,752,0,88
1812011,20,5,1993,11,male,333,240,200,317,11,7,9,310,2
1859183,30,19,1983,5,female,681,239,148,323,238,15,25,308,213
2024048,46,29,1967,12,female,2255,231,126,314,243,29,129,285,114
1474107,69,8,1944,12,female,1640,234,130,327,80,282,41,45,39
2060379,22,16,1991,1,male,390,231,192,311,350,227,241,84,109
1680872,19,25,1994,3,male,186,238,129,315,129,315,117,0,12
2027539,25,28,1988,3,female,484,232,121,322,146,322,143,0,3
1786178,35,28,1978,4,male,79,237,157,315,105,315,99,0,6
1837099,67,19,1946,9,female,1193,237,152,345,47,0,25,345,22
1718258,52,25,1961,9,male,1006,232,163,332,233,51,54,281,179
1911093,31,15,1982,5,female,1157,237,89,337,224,177,140,160,84
1851684,103,1,1910,1,female,2199,238,51,334,80,328,13,6,67
1131859,14,26,1999,4,female,403,236,169,336,394,318,194,18,200
1040884,23,31,1990,8,female,1656,237,160,336,263,320,231,16,32
1484519,34,1,1979,12,male,385,237,164,330,471,292,361,38,110
1916613,19,9,1994,9,female,840,237,141,340,670,267,325,73,345
1725497,29,27,1984,12,male,214,237,153,346,46,346,34,0,12
1210113,15,6,1998,1,male,264,238,187,343,78,343,63,0,15
2123038,24,2,1989,12,male,287,234,80,338,290,338,278,0,12
1968605,23,1,1990,1,female,106,235,167,337,269,337,213,0,56
1023513,21,29,1992,4,female,810,231,124,333,534,333,252,0,282
1409405,24,11,1989,12,female,208,233,107,362,416,99,143,263,273
1032595,35,10,1978,11,female,417,237,106,348,232,251,140,97,92
1556926,108,3,1905,10,female,1965,231,111,351,300,186,71,165,229
1507007,16,1,1997,7,female,235,240,157,367,123,331,68,36,55
1870696,40,24,1973,11,female,553,233,157,349,142,320,73,29,69
1271662,20,12,1993,11,female,656,239,154,356,386,348,205,8,181
1252063,21,14,1992,6,male,311,238,124,349,240,332,137,17,103
1105013,56,16,1957,7,male,284,235,166,365,356,322,231,43,125
1512413,17,22,1996,8,female,107,236,198,360,149,359,71,1,78
2093483,21,11,1992,10,male,418,240,156,367,158,367,132,0,26
1655962,21,1,1992,2,male,459,235,71,381,44,4,21,377,23
1478885,21,29,1992,7,male,435,236,153,394,416,1,47,393,369
1328739,28,20,1985,5,female,660,235,150,390,150,371,70,19,80
1007707,31,3,1982,5,female,663,239,102,381,289,349,86,32,203
1134553,23,12,1990,12,male,191,232,207,374,157,374,139,0,18
1279471,23,19,1990,9,male,291,237,132,388,174,388,157,0,17
1653547,18,19,1995,9,female,210,236,24,377,297,377,137,0,160
1129338,44,25,1969,12,female,511,236,140,389,286,389,205,0,81
1824814,17,4,1996,2,male,307,238,179,398,20,0,3,398,17
2077291,67,7,1946,10,female,1801,235,93,415,181,0,118,415,63
1738846,52,9,1961,11,female,1504,231,160,404,139,170,120,234,19
2154770,23,14,1990,10,female,386,238,165,411,332,217,251,194,81
1757231,108,23,1905,5,female,1514,235,103,395,54,382,19,13,35
1340896,27,3,1986,6,female,436,235,118,414,313,311,149,103,164
1646430,31,19,1982,6,female,1407,232,128,408,607,384,533,24,74
1353886,31,14,1982,12,male,71,235,172,414,71,414,57,0,14
2027310,34,22,1979,5,female,446,238,127,398,102,398,50,0,52
1488345,57,22,1956,12,female,1652,233,37,420,154,420,103,0,51
2019426,16,1,1997,12,female,595,232,116,412,294,412,232,0,62
1117757,23,24,1990,10,male,228,237,183,417,640,417,557,0,83
2178929,59,29,1954,10,female,1838,231,146,424,76,70,59,354,17
1920862,19,8,1994,2,male,597,235,119,437,281,395,192,42,89
1139409,40,3,1973,3,male,711,239,146,427,428,425,353,2,75
2176935,20,4,1993,9,male,658,240,178,439,83,439,76,0,7
2133422,26,23,1987,4,male,500,235,193,422,167,422,167,0,0
1021996,75,29,1938,1,female,517,234,153,426,254,426,124,0,130
1159108,26,10,1987,1,female,610,231,175,435,395,435,358,0,37
1621852,34,8,1979,1,female,526,232,144,425,594,425,518,0,76
1971064,24,13,1989,12,female,312,233,174,461,474,43,52,418,422
1877019,65,5,1948,12,female,141,237,144,473,417,0,188,473,229
1340922,30,19,1983,5,male,529,239,120,467,57,467,55,0,2
1550103,23,17,1990,1,female,691,232,50,458,590,458,555,0,35
1413365,93,8,1920,7,female,1365,232,81,501,334,100,203,401,131
1955319,15,21,1998,8,male,66,235,199,490,292,428,179,62,113
2079563,18,5,1995,9,female,805,239,142,511,100,465,55,46,45
2074436,23,7,1990,3,female,361,239,120,488,107,358,55,130,52
1770792,64,12,1949,7,male,594,231,147,501,272,501,192,0,80
1585150,43,30,1970,10,female,1708,236,117,514,320,514,142,0,178
2082469,46,18,1967,7,male,677,231,106,486,570,486,491,0,79
1378296,51,26,1962,4,female,373,237,128,523,77,1,16,522,61
1864045,108,21,1905,6,male,1290,240,45,520,410,0,131,520,279
1413206,113,10,1900,6,female,2192,237,151,561,514,306,282,255,232
2138128,20,15,1993,5,female,503,235,59,549,925,263,525,286,400
1616214,16,7,1997,11,female,497,231,128,539,295,455,204,84,91
1716557,44,1,1969,7,male,233,240,97,520,832,508,425,12,407
1406911,33,31,1980,3,male,288,235,209,544,83,541,37,3,46
1585608,62,14,1951,8,female,496,238,111,562,118,0,30,562,88
1266549,16,11,1997,4,male,305,239,208,567,83,199,26,368,57
2032479,62,8,1951,12,female,1841,237,157,586,34,126,24,460,10
1890453,40,12,1973,3,male,321,234,224,564,150,290,98,274,52
2018725,64,13,1949,11,female,1327,231,44,573,19,441,4,132,15
2027689,16,27,1997,7,female,432,233,185,601,341,534,216,67,125
2133725,24,26,1989,2,male,514,237,162,572,99,532,49,40,50
1824660,16,20,1997,8,female,398,240,133,607,740,488,299,119,441
1483121,18,10,1995,9,female,119,238,49,573,249,573,145,0,104
1676967,48,17,1965,7,female,627,232,133,662,260,209,130,453,130
1138961,33,23,1980,9,male,884,235,117,636,1092,434,237,202,855
1210573,41,10,1972,1,female,2352,238,145,631,472,501,334,130,138
1087084,23,31,1990,8,female,171,239,136,617,1288,470,483,147,805
1306274,14,6,1999,10,female,325,235,96,659,419,658,303,1,116
1370202,21,16,1992,1,male,499,232,142,649,159,649,133,0,26
1474323,23,21,1990,6,male,348,239,131,639,264,639,218,0,46
2144289,27,1,1986,1,male,295,235,157,657,290,657,255,0,35
2176761,51,23,1962,6,female,333,233,106,690,251,0,18,690,233
1438699,42,27,1971,3,female,1100,237,156,688,739,113,284,575,455
1549177,24,18,1989,9,female,660,231,216,714,300,170,134,544,166
1246249,13,21,2000,3,female,440,240,152,672,730,458,337,214,393
1674952,66,13,1947,1,female,1755,237,116,718,53,604,22,114,31
2032669,18,25,1995,9,female,448,239,138,670,153,622,117,48,36
1534185,20,29,1993,11,female,199,238,171,712,314,617,159,95,155
1322720,47,11,1966,1,female,1035,236,124,664,630,659,210,5,420
1917124,25,30,1988,10,female,735,238,76,720,150,720,138,0,12
1765078,108,26,1905,1,female,1471,234,27,710,320,710,301,0,19
1331047,18,14,1995,11,female,550,237,190,749,208,283,67,466,141
1170202,22,2,1991,5,female,1071,239,122,783,167,235,114,548,53
1341928,58,3,1955,4,male,1185,240,111,753,475,407,147,346,328
1684618,66,1,1947,7,female,670,240,161,754,932,260,604,494,328
1684255,18,15,1995,2,female,186,232,121,763,367,741,265,22,102
1286897,62,27,1951,8,female,1205,231,168,751,512,658,222,93,290
2096812,45,3,1968,9,female,1595,233,124,769,1363,761,1245,8,118
1621505,14,18,1999,11,female,198,235,152,729,29,729,21,0,8
1583548,14,30,1999,6,male,376,237,158,812,186,797,114,15,72
1782615,30,16,1983,8,female,1212,235,100,808,694,680,451,128,243
1510398,53,27,1960,12,female,1800,231,135,836,861,699,447,137,414
1550332,19,12,1994,11,female,424,239,137,814,655,814,302,0,353
1279162,18,23,1995,8,female,340,232,89,952,1111,435,286,517,825
1905026,24,21,1989,2,female,602,231,189,943,728,262,301,681,427
1193000,78,22,1935,6,male,2111,235,150,952,253,823,141,129,112
1605594,25,3,1988,9,female,544,234,189,885,312,882,248,3,64
1454433,46,11,1967,10,male,950,237,127,883,577,876,351,7,226
1282469,14,23,1999,1,female,273,237,152,899,104,899,90,0,14
1637209,26,20,1987,12,female,461,237,173,938,1269,938,1058,0,211
1778877,68,1,1945,11,female,1587,232,154,1056,335,0,26,1056,309
1585347,41,22,1972,7,female,700,235,151,1071,403,474,102,597,301
1636395,61,24,1952,9,female,2313,237,76,1083,231,403,128,680,103
1909578,45,25,1968,3,female,1113,234,146,1040,644,366,393,674,251
1712939,19,5,1994,6,female,358,240,94,1109,725,1107,695,2,30
1595486,24,6,1989,6,female,269,231,144,1045,118,1045,114,0,4
1291467,14,18,1999,2,female,420,232,119,1267,18,241,13,1026,5
1540042,50,13,1963,10,female,1034,231,132,1207,738,165,191,1042,547
1746943,33,29,1980,6,female,1356,240,148,1236,1301,1234,1037,2,264
1647703,28,17,1985,6,female,532,236,62,1165,523,1165,504,0,19
1961240,26,31,1987,12,female,200,234,113,1197,830,1197,708,0,122
2052436,14,23,1999,2,male,220,238,145,1313,16,795,9,518,7
1193498,56,20,1957,3,male,357,234,135,1523,620,1035,360,488,260
1481798,14,3,1999,6,female,419,233,173,1516,191,1493,82,23,109
1454707,17,4,1996,1,male,207,237,159,1510,1429,1184,877,326,552
1663476,22,9,1991,2,female,268,232,85,1410,1369,1395,1260,15,109
1247833,32,23,1981,12,female,72,238,111,1338,253,1333,226,5,27
2176895,50,20,1963,9,female,163,240,107,1866,2395,47,1464,1819,931
2184584,69,18,1944,3,female,1146,240,175,1868,1714,56,1266,1812,448
1694069,26,2,1987,2,male,182,239,145,1814,3863,17,1835,1797,2028
1811123,108,25,1905,8,male,1368,236,66,1582,72,1524,25,58,47
1416879,48,23,1965,12,female,839,233,107,1552,1420,1458,653,94,767
1705524,50,5,1963,4,female,2221,231,165,1603,1361,1542,1175,61,186
1745754,34,2,1979,4,female,1109,235,165,1622,746,1608,389,14,357
1569359,33,13,1980,1,female,1109,233,101,1654,1628,1646,495,8,1133
2072207,14,24,1999,8,female,107,235,114,2278,1094,71,290,2207,804
1686375,28,27,1985,2,female,1015,236,126,2084,1056,1913,870,171,186
1221219,69,11,1944,5,female,856,232,179,1992,475,1992,372,0,103
1917943,52,10,1961,11,male,394,235,115,2894,4463,189,1643,2705,2820
1088044,113,21,1900,8,female,1561,232,95,3544,514,2465,286,1079,228
1089468,48,6,1965,4,female,1762,234,131,3050,3128,1536,1395,1514,1733
1132507,93,20,1920,6,male,809,232,60,2499,1803,2101,1256,398,547
1552617,66,9,1947,8,female,2208,234,141,4524,1645,9,670,4515,975
1657710,25,27,1988,7,female,369,233,168,3970,7092,285,3010,3685,4082
1297178,74,14,1939,5,female,1531,232,133,3677,1297,774,441,2903,856
1007032,60,24,1953,8,female,1729,233,180,3631,563,3501,183,130,380
1557529,42,14,1971,8,female,1491,238,105,4873,3450,4000,3037,873,413
1034411,14,25,1999,5,female,46,250,29,0,1,0,1,0,0
1350798,14,9,1999,7,female,112,242,94,0,0,0,0,0,0
2088157,15,7,1998,6,female,349,243,179,0,54,0,53,0,1
2066168,15,8,1998,8,male,435,246,184,0,0,0,0,0,0
1801079,15,9,1998,9,male,298,248,97,0,5,0,5,0,0
1571870,17,5,1996,12,male,683,249,220,0,2,0,1,0,1
1673022,16,28,1997,1,female,236,243,1,0,0,0,0,0,0
1875874,16,3,1997,3,female,117,248,231,0,0,0,0,0,0
1150256,16,27,1997,7,female,414,244,73,0,0,0,0,0,0
1310782,16,6,1997,10,male,328,249,208,0,0,0,0,0,0
1181347,18,12,1995,12,male,340,247,218,0,1,0,1,0,0
1297733,17,1,1996,1,male,258,246,121,0,0,0,0,0,0
1984343,17,16,1996,4,male,584,246,163,0,0,0,0,0,0
1067289,19,5,1994,11,male,487,246,64,0,0,0,0,0,0
1437035,19,31,1994,12,male,345,247,200,0,7,0,2,0,5
1186577,18,10,1995,4,male,884,243,159,0,4,0,3,0,1
1562528,18,25,1995,5,male,486,250,193,0,9,0,9,0,0
1853602,18,5,1995,5,female,249,248,127,0,2,0,1,0,1
2011309,18,14,1995,6,male,149,245,227,0,5,0,5,0,0
1492576,18,18,1995,7,female,137,243,75,0,1,0,1,0,0
1466644,20,16,1993,11,male,392,244,200,0,0,0,0,0,0
1378271,20,12,1993,11,female,215,247,125,0,0,0,0,0,0
1162901,19,25,1994,1,male,577,242,203,0,2,0,2,0,0
1109276,19,4,1994,1,male,348,249,133,0,35,0,29,0,6
2114723,19,17,1994,5,male,356,250,213,0,3,0,2,0,1
1022353,19,19,1994,5,male,291,244,203,0,2,0,2,0,0
1514166,19,25,1994,6,male,528,248,191,0,0,0,0,0,0
1273468,19,7,1994,7,female,294,242,44,0,0,0,0,0,0
1005121,19,5,1994,10,male,365,249,207,0,0,0,0,0,0
1418410,20,2,1993,2,female,251,249,18,0,5,0,5,0,0
1877802,20,3,1993,3,male,412,242,142,0,1,0,1,0,0
1416411,20,1,1993,6,male,800,245,171,0,0,0,0,0,0
1301644,20,7,1993,8,male,946,249,185,0,5,0,0,0,5
1326047,20,22,1993,10,male,748,246,203,0,1,0,1,0,0
1728501,21,4,1992,1,female,650,245,216,0,3,0,1,0,2
1660207,21,19,1992,4,male,387,249,242,0,32,0,16,0,16
1775103,21,8,1992,6,female,278,241,70,0,0,0,0,0,0
1054666,21,21,1992,7,male,465,244,176,0,1,0,0,0,1
1595093,21,22,1992,7,male,427,244,175,0,0,0,0,0,0
2055511,21,19,1992,9,male,499,247,207,0,0,0,0,0,0
1090918,22,6,1991,6,male,197,248,192,0,0,0,0,0,0
1697802,22,13,1991,9,female,751,247,115,0,16,0,13,0,3
1438550,22,7,1991,10,female,277,250,7,0,9,0,9,0,0
1119156,22,1,1991,10,male,597,245,161,0,10,0,3,0,7
2021598,24,7,1989,11,male,427,244,223,0,1,0,1,0,0
1691460,24,25,1989,11,male,379,245,174,0,2,0,2,0,0
1750625,24,17,1989,11,male,298,250,140,0,2,0,2,0,0
2172813,23,1,1990,1,male,222,242,73,0,2,0,2,0,0
1897181,23,28,1990,2,female,642,249,47,0,0,0,0,0,0
1851952,23,15,1990,2,male,392,242,182,0,0,0,0,0,0
1924263,23,3,1990,3,male,165,250,240,0,0,0,0,0,0
1010393,23,5,1990,5,female,402,247,35,0,0,0,0,0,0
2178853,23,22,1990,6,female,572,246,178,0,0,0,0,0,0
2153868,23,1,1990,6,male,444,243,173,0,0,0,0,0,0
1935581,23,18,1990,7,male,813,246,141,0,9,0,8,0,1
1624210,23,9,1990,8,female,777,244,124,0,0,0,0,0,0
1372811,24,13,1989,1,male,636,245,125,0,3,0,3,0,0
1421940,24,2,1989,2,male,534,241,213,0,0,0,0,0,0
1560877,24,2,1989,2,male,258,241,234,0,15,0,13,0,2
2083820,24,17,1989,3,male,658,249,103,0,1,0,1,0,0
1952573,24,7,1989,8,male,446,245,182,0,0,0,0,0,0
1619197,26,26,1987,12,male,1131,243,217,0,0,0,0,0,0
1874271,25,11,1988,3,female,542,249,48,0,0,0,0,0,0
1000406,25,12,1988,5,male,358,243,196,0,6,0,2,0,4
2101948,25,12,1988,6,male,653,249,89,0,0,0,0,0,0
1600133,25,3,1988,7,male,908,247,177,0,12,0,6,0,6
1688127,27,30,1986,11,male,523,241,194,0,1,0,1,0,0
1584274,27,8,1986,12,male,583,247,179,0,16,0,16,0,0
1855179,26,13,1987,4,male,569,245,211,0,1,0,0,0,1
1998185,26,17,1987,10,male,990,244,7,0,0,0,0,0,0
1020348,27,25,1986,8,female,986,241,118,0,10,0,1,0,9
1165290,27,6,1986,9,male,488,243,163,0,0,0,0,0,0
1754301,28,10,1985,2,male,1723,241,164,0,1,0,1,0,0
1378086,28,29,1985,7,male,534,247,172,0,0,0,0,0,0
1520068,29,5,1984,2,female,255,245,190,0,10,0,6,0,4
1041605,31,7,1982,12,male,506,242,50,0,0,0,0,0,0
1007217,31,12,1982,12,male,281,244,194,0,0,0,0,0,0
1724883,30,29,1983,6,male,510,249,54,0,0,0,0,0,0
1011959,30,7,1983,6,male,460,250,247,0,15,0,4,0,11
1831985,31,7,1982,7,male,696,242,116,0,2,0,2,0,0
1467950,31,4,1982,7,female,480,242,142,0,0,0,0,0,0
1092412,32,10,1981,2,male,427,243,126,0,0,0,0,0,0
1944177,35,7,1978,11,male,587,245,231,0,0,0,0,0,0
1005921,36,19,1977,10,male,621,241,152,0,5,0,4,0,1
2159415,38,30,1975,11,male,191,244,224,0,0,0,0,0,0
1163009,37,28,1976,7,male,296,249,199,0,1,0,1,0,0
1776876,41,6,1972,10,male,385,243,136,0,3,0,3,0,0
1904021,43,1,1970,12,male,208,244,43,0,1,0,1,0,0
1298229,43,27,1970,1,male,984,246,175,0,26,0,24,0,2
1305708,48,25,1965,3,male,461,244,180,0,0,0,0,0,0
1546039,50,10,1963,12,male,246,241,217,0,108,0,85,0,23
2160501,49,23,1964,3,male,294,248,37,0,7,0,3,0,4
1425229,50,10,1963,8,male,413,243,172,0,2,0,0,0,2
1346389,53,18,1960,1,male,1243,247,103,0,0,0,0,0,0
1899080,53,24,1960,9,male,783,241,128,0,1,0,1,0,0
1051831,64,8,1949,3,male,1529,243,87,0,0,0,0,0,0
1348758,68,23,1945,5,male,758,245,161,0,0,0,0,0,0
1169248,74,1,1939,1,male,1611,248,146,0,3,0,2,0,1
1269151,75,2,1938,1,male,842,248,182,0,0,0,0,0,0
1632719,80,3,1933,4,female,983,244,94,0,0,0,0,0,0
1276416,87,9,1926,10,male,1432,248,96,0,3,0,3,0,0
1372951,93,23,1920,5,female,1505,242,78,0,0,0,0,0,0
1207284,103,15,1910,12,female,907,241,121,0,13,0,3,0,10
1272005,103,2,1910,2,male,710,246,157,0,2,0,2,0,0
1975898,103,1,1910,2,male,602,250,149,0,1,0,1,0,0
1368716,103,25,1910,8,male,723,241,207,0,0,0,0,0,0
1578348,105,18,1908,7,male,1559,247,88,0,0,0,0,0,0
1466484,108,1,1905,1,female,193,246,176,0,0,0,0,0,0
1098125,108,18,1905,6,male,365,242,231,0,0,0,0,0,0
1314798,17,14,1996,9,male,956,250,99,1,0,0,0,1,0
1524075,19,27,1994,6,female,692,243,204,1,0,0,0,1,0
2016045,23,23,1990,11,female,594,245,98,1,0,0,0,1,0
1270394,35,1,1978,7,male,548,246,219,1,0,0,0,1,0
1596080,67,10,1946,6,male,300,247,113,1,0,0,0,1,0
1845906,16,27,1997,12,male,307,245,161,1,1,0,0,1,1
1732928,15,28,1998,3,male,426,247,174,1,8,0,3,1,5
1037297,15,26,1998,3,male,208,243,133,1,61,0,39,1,22
1858600,16,26,1997,4,male,561,242,150,1,2,0,1,1,1
2057281,17,4,1996,5,male,548,242,217,1,12,0,4,1,8
1953746,19,13,1994,12,male,1190,245,155,1,5,0,1,1,4
1913293,19,17,1994,12,male,390,248,168,1,25,0,11,1,14
1741756,18,20,1995,1,male,698,250,140,1,2,0,0,1,2
1780736,18,22,1995,5,male,424,250,150,1,3,0,2,1,1
2089597,28,23,1985,4,female,600,249,91,1,7,0,2,1,5
2177096,29,22,1984,10,male,1390,248,116,1,15,0,3,1,12
2093719,80,15,1933,1,male,1075,244,84,1,2,0,0,1,2
1609883,16,2,1997,2,female,457,245,135,1,0,1,0,0,0
2055313,17,26,1996,6,male,562,243,106,1,0,1,0,0,0
1669561,21,10,1992,2,male,593,247,51,1,0,1,0,0,0
2185611,23,4,1990,4,male,583,249,203,1,0,1,0,0,0
1246358,23,1,1990,10,male,438,241,208,1,0,1,0,0,0
1311534,25,7,1988,1,male,105,243,200,1,0,1,0,0,0
1046945,27,16,1986,5,male,738,242,155,1,0,1,0,0,0
1581755,108,10,1905,5,female,107,244,32,1,0,1,0,0,0
1337280,20,19,1993,3,female,670,247,126,1,1,1,0,0,1
2122371,16,21,1997,12,female,140,242,73,1,82,1,59,0,23
1978521,20,10,1993,11,female,791,241,162,1,2,1,2,0,0
1049097,21,4,1992,3,male,253,245,139,1,23,1,21,0,2
1054793,21,27,1992,3,male,221,246,72,1,66,1,27,0,39
1184629,22,5,1991,8,male,1244,245,134,1,27,1,13,0,14
1648397,23,15,1990,4,male,172,249,177,1,3,1,2,0,1
1075246,26,23,1987,11,male,175,249,84,1,2,1,0,0,2
1966664,25,31,1988,5,male,359,246,39,1,2,1,2,0,0
1050295,25,20,1988,7,male,289,242,72,1,14,1,11,0,3
1855929,26,14,1987,9,female,485,250,99,1,9,1,6,0,3
1920708,26,10,1987,10,male,236,249,228,1,32,1,21,0,11
1415906,29,8,1984,8,male,1087,241,217,1,23,1,11,0,12
1184407,30,13,1983,1,male,699,249,161,1,12,1,12,0,0
1123492,31,12,1982,3,male,541,246,154,1,2,1,0,0,2
1488993,32,1,1981,8,male,282,242,128,1,66,1,47,0,19
1429173,33,29,1980,1,male,627,249,174,1,13,1,12,0,1
1441517,33,17,1980,7,male,585,250,164,1,2,1,2,0,0
1099649,40,22,1973,9,male,398,245,184,1,5,1,4,0,1
1426453,41,14,1972,8,female,398,250,63,1,3,1,3,0,0
1954490,59,11,1954,12,male,2328,247,52,1,6,1,5,0,1
1781427,94,29,1919,4,male,1181,244,171,1,17,1,17,0,0
1633832,94,17,1919,4,male,580,245,117,1,8,1,8,0,0
1016463,103,31,1910,12,male,966,243,86,1,7,1,7,0,0
1622583,103,15,1910,3,male,1161,244,210,1,5,1,0,0,5
2019282,103,1,1910,3,female,1104,244,101,1,3,1,2,0,1
1889539,17,28,1996,12,male,694,247,147,2,0,0,0,2,0
1846714,19,11,1994,3,female,418,250,122,2,0,0,0,2,0
1140144,30,24,1983,9,male,485,250,209,2,2,0,1,2,1
1946486,75,4,1938,4,male,295,241,37,2,2,0,1,2,1
1245835,15,22,1998,11,male,529,243,132,2,10,0,5,2,5
1004601,15,26,1998,7,female,241,242,148,2,11,0,1,2,10
1292297,17,10,1996,10,male,297,241,203,2,4,0,0,2,4
1064480,30,28,1983,11,male,333,243,76,2,22,0,2,2,20
2130543,21,11,1992,12,male,325,249,206,2,0,1,0,1,0
2094775,23,15,1990,8,male,1131,249,103,2,0,1,0,1,0
2001526,16,5,1997,8,female,921,242,156,2,47,1,28,1,19
2089101,34,23,1979,8,male,1509,247,76,2,43,1,1,1,42
1473187,16,22,1997,1,male,433,247,138,2,0,2,0,0,0
1310702,17,22,1996,4,male,94,243,232,2,0,2,0,0,0
1808992,27,11,1986,11,male,639,249,100,2,0,2,0,0,0
1507678,26,6,1987,1,male,404,245,28,2,0,2,0,0,0
1884051,20,27,1993,5,male,261,246,206,2,1,2,0,0,1
2156386,24,27,1989,9,male,626,247,215,2,1,2,1,0,0
1901892,27,1,1986,4,male,896,246,127,2,1,2,1,0,0
1633302,33,20,1980,3,female,1159,245,74,2,1,2,1,0,0
1030666,19,8,1994,12,female,280,241,99,2,16,2,16,0,0
2005016,18,14,1995,7,male,602,249,201,2,11,2,5,0,6
1228344,18,3,1995,10,male,589,248,149,2,15,2,14,0,1
1552828,19,15,1994,5,male,578,247,175,2,3,2,3,0,0
2125933,21,22,1992,10,male,726,249,171,2,4,2,4,0,0
1821056,24,15,1989,10,male,918,244,223,2,24,2,24,0,0
1329606,25,19,1988,4,male,420,242,117,2,9,2,9,0,0
1293384,25,19,1988,4,male,490,250,198,2,12,2,11,0,1
1272674,25,11,1988,9,male,203,242,217,2,3,2,3,0,0
1516418,30,3,1983,9,male,659,241,177,2,6,2,4,0,2
1385904,39,17,1974,10,male,602,247,216,2,38,2,33,0,5
1495025,103,11,1910,7,male,570,246,144,2,21,2,18,0,3
1919005,20,14,1993,11,male,483,243,216,3,0,0,0,3,0
1507136,108,1,1905,1,male,1562,248,38,3,4,0,4,3,0
1783602,16,4,1997,3,male,834,250,195,3,1,2,0,1,1
1605618,15,11,1998,10,male,574,249,163,3,7,1,6,2,1
1974283,19,24,1994,6,male,648,245,145,3,8,2,0,1,8
1744015,19,12,1994,12,male,641,245,161,3,0,3,0,0,0
1850409,29,10,1984,9,male,1502,249,113,3,0,3,0,0,0
1399551,14,17,1999,3,male,432,242,170,3,1,3,0,0,1
1712204,31,20,1982,7,male,710,246,225,3,1,3,0,0,1
1468550,103,22,1910,11,female,1053,244,87,3,1,3,1,0,0
1909835,17,16,1996,4,male,397,244,161,3,4,3,4,0,0
1671062,20,17,1993,11,male,380,242,225,3,2,3,2,0,0
1336558,21,23,1992,3,female,539,245,134,3,2,3,2,0,0
2018323,14,6,1999,3,male,71,250,226,3,6,3,2,0,4
1386874,19,22,1994,2,male,330,243,97,3,42,3,32,0,10
2003255,20,6,1993,6,female,224,244,27,3,35,3,27,0,8
2145200,21,5,1992,4,female,425,245,164,3,77,3,34,0,43
1503090,23,28,1990,11,female,427,243,189,3,44,3,32,0,12
1065423,23,28,1990,1,male,387,246,212,3,8,3,7,0,1
1559162,24,8,1989,1,male,684,244,87,3,31,3,24,0,7
1405963,26,17,1987,1,female,561,243,169,3,7,3,4,0,3
1582840,27,12,1986,2,male,548,248,210,3,13,3,13,0,0
1721656,38,9,1975,2,male,233,241,51,3,5,3,5,0,0
1073196,14,19,1999,4,male,445,249,170,4,0,0,0,4,0
1385897,14,30,1999,7,male,247,248,204,4,0,0,0,4,0
2192625,17,12,1996,2,female,590,241,128,4,0,0,0,4,0
2102785,21,15,1992,11,male,217,245,182,4,4,0,3,4,1
1818936,54,3,1959,10,male,2391,243,152,4,11,1,3,3,8
1535172,100,4,1913,9,NA,2031,250,156,4,7,2,4,2,3
1125956,16,4,1997,1,female,494,242,181,4,0,3,0,1,0
1009300,18,13,1995,7,male,377,241,198,4,2,3,1,1,1
1516902,19,13,1994,9,female,665,246,102,4,0,4,0,0,0
1205595,21,9,1992,9,male,711,247,195,4,0,4,0,0,0
1658952,93,28,1920,7,male,843,243,159,4,2,4,0,0,2
1328566,13,24,2000,3,male,428,248,64,4,4,4,4,0,0
1387290,13,27,2000,4,male,31,243,210,4,4,4,1,0,3
2047194,14,11,1999,12,male,232,244,191,4,6,4,6,0,0
1535130,14,1,1999,1,male,122,243,98,4,31,4,22,0,9
1954749,17,10,1996,2,female,327,245,152,4,11,4,2,0,9
1394146,20,30,1993,12,male,240,242,184,4,13,4,10,0,3
1566522,21,9,1992,12,female,553,243,123,4,6,4,6,0,0
1844584,21,15,1992,12,female,443,249,104,4,27,4,12,0,15
1592579,22,19,1991,11,male,699,242,203,4,30,4,30,0,0
1019960,24,1,1989,5,male,480,241,176,4,11,4,2,0,9
1037491,47,27,1966,2,male,1070,245,111,4,31,4,28,0,3
1323932,53,20,1960,6,male,407,244,125,4,7,4,6,0,1
1960632,30,1,1983,1,male,483,244,183,5,0,0,0,5,0
1512397,34,18,1979,10,female,889,247,157,5,24,4,9,1,15
1144167,14,13,1999,1,male,425,245,177,5,0,5,0,0,0
1695700,19,14,1994,4,male,478,243,172,5,0,5,0,0,0
1538738,23,5,1990,1,male,282,242,40,5,1,5,1,0,0
1758675,63,13,1950,2,male,878,246,170,5,3,5,3,0,0
1519061,60,19,1953,12,female,142,242,142,5,6,5,6,0,0
1758557,14,20,1999,7,female,291,250,205,5,10,5,1,0,9
1616931,17,10,1996,10,female,459,241,57,5,13,5,7,0,6
1670550,21,25,1992,12,female,403,249,42,5,9,5,6,0,3
1568949,26,4,1987,9,male,588,247,204,5,10,5,10,0,0
2046945,27,22,1986,3,male,645,248,148,5,56,5,53,0,3
1032527,15,2,1998,7,female,277,249,104,6,3,1,3,5,0
1723035,17,16,1996,8,male,369,243,184,6,3,0,2,6,1
1024088,16,26,1997,7,male,488,241,191,6,8,0,1,6,7
1462425,23,7,1990,12,male,146,248,121,6,14,0,1,6,13
2053857,108,22,1905,2,female,13,248,240,6,30,0,14,6,16
1157520,16,16,1997,11,male,236,246,128,6,2,4,0,2,2
1779626,15,2,1998,5,male,613,248,199,6,5,4,4,2,1
1430703,108,1,1905,1,male,1605,242,115,6,13,2,12,4,1
1204564,17,25,1996,9,female,217,249,68,6,2,6,1,0,1
1086771,29,8,1984,4,male,424,241,139,6,3,6,2,0,1
1753745,96,17,1917,7,female,553,249,71,6,3,6,2,0,1
2160595,22,13,1991,3,male,921,241,107,6,8,6,8,0,0
1696564,55,26,1958,8,male,263,243,68,6,6,6,2,0,4
1318764,16,13,1997,9,female,163,245,42,6,52,6,32,0,20
1311935,21,10,1992,5,male,91,250,187,6,16,6,15,0,1
1052359,23,9,1990,10,female,294,243,225,6,14,6,5,0,9
1172669,26,27,1987,10,female,363,241,104,6,266,6,257,0,9
1759810,29,5,1984,5,male,430,250,107,6,11,6,11,0,0
1860305,33,30,1980,12,female,398,241,191,6,9,6,4,0,5
1584436,108,31,1905,1,male,244,250,188,6,12,6,10,0,2
1614314,28,3,1985,9,female,336,248,41,7,1,0,1,7,0
1364980,62,13,1951,3,male,1927,250,86,7,1,0,1,7,0
1533692,16,8,1997,10,female,743,244,132,7,4,0,0,7,4
2158566,30,24,1983,11,female,338,241,50,7,9,0,6,7,3
1312511,20,24,1993,3,female,654,242,77,7,8,2,1,5,7
1567792,22,18,1991,1,male,579,241,91,7,7,4,2,3,5
1634449,108,21,1905,9,male,845,248,136,7,1,7,1,0,0
1367229,23,3,1990,1,female,521,241,172,7,7,7,4,0,3
1122815,55,16,1958,9,male,1361,242,144,7,8,7,5,0,3
1962423,21,28,1992,12,female,202,247,72,7,22,7,19,0,3
1705925,21,27,1992,10,male,502,247,111,7,13,7,9,0,4
1891529,28,18,1985,11,male,614,244,119,7,49,7,17,0,32
1728913,94,9,1919,9,male,676,244,190,7,55,7,51,0,4
1384211,15,8,1998,6,male,491,247,205,8,0,0,0,8,0
1700979,66,19,1947,4,female,561,244,169,8,94,0,28,8,66
1548535,30,30,1983,12,male,823,242,76,8,11,2,5,6,6
1777242,69,3,1944,6,female,519,245,150,8,23,5,7,3,16
1250844,18,23,1995,12,male,707,241,188,8,4,8,4,0,0
2031310,23,19,1990,11,male,587,247,178,8,4,8,4,0,0
1666624,19,10,1994,4,male,159,244,205,8,7,8,7,0,0
1690006,20,4,1993,2,female,682,248,142,8,5,8,5,0,0
1011501,22,26,1991,8,male,709,243,129,8,11,8,10,0,1
1417526,48,2,1965,7,male,448,247,103,8,10,8,10,0,0
1490913,108,3,1905,9,female,1473,250,132,8,9,8,9,0,0
1618935,17,1,1996,11,female,1158,244,123,8,144,8,82,0,62
1605388,22,3,1991,1,female,610,250,124,8,30,8,14,0,16
1258523,52,28,1961,1,male,293,248,188,8,192,8,186,0,6
1141301,24,17,1989,5,male,414,243,59,9,1,0,1,9,0
1297840,64,7,1949,8,male,144,248,173,9,4,0,1,9,3
1294131,14,10,1999,2,female,462,250,56,9,6,0,5,9,1
1979579,69,17,1944,8,female,1574,241,104,9,24,0,9,9,15
1078795,17,14,1996,10,male,269,248,80,9,7,3,5,6,2
1424207,78,1,1935,1,male,153,248,180,9,0,7,0,2,0
1881870,17,31,1996,12,male,686,242,88,9,0,9,0,0,0
1550499,16,18,1997,9,female,493,241,108,9,5,9,5,0,0
1715830,23,27,1990,5,male,208,241,97,9,2,9,1,0,1
1098349,20,15,1993,5,female,286,250,47,9,8,9,7,0,1
1000157,23,8,1990,2,male,382,241,123,9,14,9,12,0,2
1861188,23,27,1990,3,female,209,244,190,9,15,9,10,0,5
1145380,108,4,1905,3,male,1696,244,58,10,7,0,4,10,3
1414725,25,21,1988,8,female,1210,249,76,10,6,4,3,6,3
1352194,35,9,1978,5,female,373,249,120,10,177,7,149,3,28
1008165,20,13,1993,12,male,328,244,225,10,2,9,1,1,1
1162961,68,17,1945,8,male,638,245,187,10,6,10,4,0,2
1985823,14,15,1999,5,female,72,243,42,10,23,10,22,0,1
1703036,19,25,1994,1,female,639,241,120,10,19,10,3,0,16
1683889,19,18,1994,9,male,699,250,191,10,16,10,16,0,0
1162812,19,17,1994,10,male,507,241,178,10,28,10,26,0,2
1464575,16,18,1997,5,male,436,241,129,11,78,2,6,9,72
1583065,15,11,1998,2,female,406,248,165,11,32,5,21,6,11
1033594,18,13,1995,3,female,655,241,180,11,23,10,13,1,10
2044921,108,20,1905,1,male,46,241,218,11,39,9,14,2,25
1640323,15,28,1998,1,female,253,244,133,11,0,11,0,0,0
1570704,15,14,1998,3,male,576,249,134,11,0,11,0,0,0
2180623,15,1,1998,5,female,762,245,146,11,0,11,0,0,0
2150853,21,15,1992,12,male,309,241,117,11,3,11,2,0,1
1050370,27,15,1986,3,female,231,250,50,11,2,11,2,0,0
2018038,30,4,1983,10,male,410,243,188,11,6,11,5,0,1
1621913,18,11,1995,7,female,263,242,195,11,12,11,11,0,1
1857616,26,24,1987,10,male,1121,241,212,11,18,11,16,0,2
2157331,47,29,1966,7,male,637,249,170,11,101,11,76,0,25
1679030,24,9,1989,8,male,555,242,46,12,0,0,0,12,0
1344451,28,6,1985,7,male,1313,249,154,12,0,1,0,11,0
1815616,23,30,1990,12,male,99,249,82,12,11,1,6,11,5
2054638,88,25,1925,4,female,1365,245,94,12,19,0,12,12,7
1295526,108,6,1905,1,male,90,243,179,12,8,4,2,8,6
1918921,26,18,1987,7,male,247,249,207,12,76,11,61,1,15
1013672,14,3,1999,9,male,384,244,45,12,0,12,0,0,0
1275154,16,7,1997,2,female,213,243,125,12,0,12,0,0,0
1515366,22,15,1991,3,male,404,248,176,12,4,12,0,0,4
1088371,18,13,1995,2,male,98,241,204,12,11,12,11,0,0
1337542,23,13,1990,7,female,249,250,199,12,17,12,11,0,6
1073417,29,2,1984,8,male,821,246,197,12,12,12,11,0,1
2068230,21,12,1992,10,male,618,243,48,12,23,12,20,0,3
1096583,24,12,1989,9,male,481,241,190,12,29,12,15,0,14
2189628,25,24,1988,4,male,1316,250,140,12,92,12,87,0,5
1185811,31,2,1982,2,male,434,243,235,12,25,12,25,0,0
1478920,38,22,1975,12,male,843,247,122,12,78,12,46,0,32
1548553,14,3,1999,5,female,76,242,40,13,7,2,4,11,3
1821421,30,12,1983,2,female,409,250,140,13,14,1,4,12,10
2008436,19,2,1994,4,male,745,245,197,13,2,3,0,10,2
1686094,113,21,1900,8,female,2086,246,117,13,3,9,3,4,0
1996572,19,27,1994,5,male,265,246,152,13,16,13,15,0,1
1373868,19,24,1994,12,male,182,241,201,13,23,13,20,0,3
1304326,103,11,1910,8,female,1000,249,102,13,105,13,36,0,69
1226589,21,14,1992,1,male,585,249,104,14,2,0,1,14,1
2144640,19,2,1994,12,male,813,246,150,14,6,0,3,14,3
1818537,35,15,1978,5,male,620,241,162,14,0,9,0,5,0
1247719,18,11,1995,3,male,248,242,129,14,9,3,6,11,3
1985186,21,9,1992,8,female,469,250,60,14,1,14,0,0,1
1504128,19,12,1994,4,female,250,241,151,14,11,14,9,0,2
1507422,25,26,1988,2,male,468,246,155,14,18,14,9,0,9
1741263,23,18,1990,3,female,64,247,215,14,39,14,18,0,21
1191583,19,24,1994,10,male,499,243,217,15,0,0,0,15,0
1306827,16,24,1997,11,female,561,246,100,15,6,1,2,14,4
1634349,21,1,1992,7,male,890,245,76,15,15,4,10,11,5
2124062,18,2,1995,12,female,258,249,191,15,0,15,0,0,0
1441620,14,23,1999,8,male,263,242,221,15,7,15,7,0,0
2067748,17,5,1996,2,male,269,245,171,15,8,15,7,0,1
1057476,18,1,1995,1,female,39,246,109,15,11,15,9,0,2
1463116,28,18,1985,4,male,636,244,136,15,109,15,52,0,57
1896672,22,28,1991,2,female,145,242,11,16,2,0,2,16,0
1689069,103,2,1910,11,male,1153,247,160,16,5,16,1,0,4
1627943,17,3,1996,9,male,679,248,156,16,19,16,13,0,6
1756822,25,12,1988,2,male,573,241,190,16,18,16,18,0,0
1667629,16,12,1997,4,male,263,242,214,16,69,16,21,0,48
1640923,18,18,1995,5,male,244,245,45,16,51,16,29,0,22
1532545,23,8,1990,4,male,470,247,100,16,42,16,5,0,37
1285219,31,3,1982,2,male,180,250,175,16,193,16,113,0,80
1380513,72,30,1941,4,female,1937,241,42,16,29,16,25,0,4
1909172,13,24,2000,5,male,236,247,82,17,1,0,1,17,0
1691491,19,17,1994,11,female,432,248,197,17,25,1,8,16,17
1470638,18,23,1995,1,male,323,244,125,17,112,4,27,13,85
1343002,22,24,1991,2,male,334,250,172,17,26,16,12,1,14
1881517,20,18,1993,4,female,293,241,172,17,15,17,13,0,2
1038792,24,5,1989,8,male,1318,243,108,17,25,17,13,0,12
1027069,19,13,1994,12,male,745,245,41,17,55,17,36,0,19
1587547,21,2,1992,7,female,672,243,117,17,99,17,97,0,2
1683497,26,1,1987,1,male,208,244,156,17,50,17,13,0,37
1518069,36,5,1977,5,female,345,248,41,17,37,17,17,0,20
1609950,46,29,1967,3,female,242,250,224,17,60,17,48,0,12
1879813,103,20,1910,10,male,597,246,135,18,2,3,1,15,1
2000353,51,17,1962,7,male,278,246,162,18,91,4,66,14,25
1783209,80,14,1933,4,male,189,243,180,18,1,16,1,2,0
1858396,16,9,1997,10,male,531,247,166,18,0,18,0,0,0
1507515,76,1,1937,9,female,223,242,129,18,9,18,5,0,4
1870958,97,15,1916,10,male,1882,248,189,19,0,0,0,19,0
1203607,34,12,1979,2,male,443,249,213,19,19,0,5,19,14
1673146,68,16,1945,2,female,221,250,66,19,12,0,9,19,3
1377468,62,26,1951,10,male,795,249,54,19,52,0,1,19,51
2008509,17,25,1996,4,male,915,242,137,19,0,19,0,0,0
1730265,27,12,1986,8,male,494,243,200,19,5,19,4,0,1
1542024,17,2,1996,5,female,416,247,61,19,121,19,77,0,44
2183899,29,2,1984,5,female,338,249,152,19,64,19,51,0,13
1645995,93,1,1920,1,male,1740,245,108,20,3,11,0,9,3
1251186,63,3,1950,3,female,1071,245,221,20,16,10,6,10,10
1090854,108,26,1905,8,male,883,248,153,20,10,20,5,0,5
1811755,46,4,1967,6,female,735,245,60,21,260,0,62,21,198
1202029,110,4,1903,10,male,1311,243,203,21,28,8,15,13,13
1268188,20,26,1993,10,female,111,247,128,21,17,20,14,1,3
1126555,21,8,1992,1,female,740,248,149,21,15,21,6,0,9
1349554,28,9,1985,4,male,572,244,196,21,17,21,5,0,12
1168553,20,12,1993,9,female,452,250,65,21,100,21,78,0,22
2002612,26,10,1987,2,female,374,242,62,22,17,12,9,10,8
1721773,113,25,1900,2,female,1567,249,83,22,19,19,12,3,7
1325969,23,31,1990,1,male,339,247,128,22,33,20,15,2,18
1287998,14,1,1999,9,female,673,248,185,22,2,22,1,0,1
1472208,17,26,1996,1,female,209,242,133,22,3,22,0,0,3
1618909,26,17,1987,10,male,389,241,191,22,37,22,30,0,7
1397569,18,19,1995,12,male,492,241,126,23,0,23,0,0,0
1778967,29,5,1984,7,male,298,243,202,23,16,23,7,0,9
1345380,26,6,1987,10,male,730,244,112,23,45,23,45,0,0
2110427,18,16,1995,1,male,182,250,169,25,37,1,25,24,12
1718377,45,10,1968,4,female,584,250,155,25,265,12,119,13,146
1840783,21,25,1992,7,male,959,245,141,25,38,20,33,5,5
1530144,25,29,1988,4,male,813,241,197,26,3,26,3,0,0
1432194,20,18,1993,8,female,580,243,135,26,21,26,20,0,1
1746173,16,27,1997,1,female,267,243,123,27,1,27,0,0,1
1509889,108,14,1905,6,male,540,244,187,27,3,27,2,0,1
1157658,16,30,1997,6,male,150,242,104,27,31,27,29,0,2
1530832,101,18,1912,7,female,583,245,62,27,31,27,28,0,3
1567071,20,6,1993,11,male,277,242,166,27,67,27,64,0,3
1517485,28,16,1985,6,female,184,247,90,27,156,27,120,0,36
1639735,18,25,1995,7,male,415,244,118,28,2,9,2,19,0
1959565,100,14,1913,5,male,1038,242,162,28,9,28,8,0,1
1488254,19,12,1994,11,female,404,246,192,28,20,28,10,0,10
2110184,27,21,1986,1,male,475,241,226,29,10,0,3,29,7
2130260,17,1,1996,2,male,500,243,218,29,11,14,6,15,5
1678971,27,24,1986,11,female,592,249,211,29,29,15,25,14,4
1156644,17,7,1996,1,female,291,247,144,29,87,20,45,9,42
1306050,16,27,1997,11,female,364,247,137,29,41,27,15,2,26
1539630,17,19,1996,7,female,243,248,188,29,80,25,14,4,66
1027209,19,8,1994,10,female,52,243,65,29,27,29,11,0,16
1163912,17,4,1996,9,male,374,244,71,29,131,29,73,0,58
1514788,22,8,1991,8,female,698,247,126,29,65,29,25,0,40
1409072,94,9,1919,3,male,661,246,109,29,53,29,31,0,22
1852723,15,2,1998,10,male,404,241,225,31,6,18,6,13,0
1979526,108,1,1905,1,male,2218,249,77,30,93,13,39,17,54
1263276,19,6,1994,9,male,750,249,105,31,1,31,1,0,0
1580364,18,22,1995,2,female,226,245,174,31,16,31,15,0,1
1633851,21,28,1992,7,male,378,241,201,31,14,31,13,0,1
1930470,103,15,1910,9,male,616,249,172,30,11,30,8,0,3
1715696,24,19,1989,9,female,283,247,129,30,88,30,79,0,9
1350598,24,26,1989,9,female,697,242,80,32,243,12,101,20,142
2064168,18,30,1995,8,male,466,248,186,33,1,33,1,0,0
1525256,18,3,1995,4,female,138,246,50,33,39,33,39,0,0
1873794,26,15,1987,12,male,449,247,102,33,74,33,55,0,19
1140140,40,22,1973,8,male,519,243,111,33,146,33,114,0,32
1555930,17,5,1996,2,female,433,241,204,34,32,12,27,22,5
1879129,22,12,1991,1,female,702,246,60,34,14,33,9,1,5
1469705,53,14,1960,12,male,435,249,84,34,22,25,4,9,18
1571159,94,10,1919,2,female,2591,243,71,34,147,27,80,7,67
2165817,20,28,1993,7,male,226,243,204,34,2,34,2,0,0
2056988,15,17,1998,1,female,291,243,114,34,23,34,13,0,10
1514626,23,1,1990,1,male,470,250,170,34,65,34,49,0,16
1431715,19,31,1994,7,male,111,248,226,35,11,5,4,30,7
1120603,66,28,1947,2,male,1575,248,59,36,40,0,11,36,29
1323743,108,4,1905,2,male,2009,249,101,35,43,0,3,35,40
2094219,28,10,1985,6,male,422,248,102,36,9,17,2,19,7
1322483,15,2,1998,9,male,609,241,134,36,22,24,12,12,10
1922254,17,20,1996,3,male,142,247,220,36,37,23,24,13,13
1886248,17,1,1996,3,female,478,245,139,35,23,25,16,10,7
1346477,18,25,1995,6,male,454,248,80,36,92,12,70,24,22
1933552,17,20,1996,6,male,248,242,172,35,9,31,7,4,2
1928901,51,5,1962,3,female,540,248,208,36,158,36,96,0,62
1485987,94,26,1919,2,male,1277,248,149,37,36,4,12,33,24
1586298,22,16,1991,12,female,452,241,161,37,122,37,59,0,63
1973095,108,15,1905,10,male,2064,241,175,38,40,7,21,31,19
1536010,40,1,1973,1,male,84,249,221,38,130,37,60,1,70
1246342,53,18,1960,3,female,369,249,159,39,13,39,8,0,5
1397543,28,1,1985,1,male,372,243,217,38,26,38,26,0,0
1828392,33,19,1980,8,male,1348,246,5,39,44,39,40,0,4
1449996,19,6,1994,7,male,192,249,86,38,123,38,100,0,23
1537628,30,23,1983,11,male,309,249,145,38,57,38,23,0,34
1050848,93,24,1920,7,male,1381,245,97,40,70,0,12,40,58
1113565,98,4,1915,9,female,1454,244,64,40,85,0,11,40,74
1940851,18,6,1995,7,female,557,250,102,40,95,19,20,21,75
1938889,99,3,1914,8,male,1136,243,141,40,1,37,0,3,1
1337729,28,9,1985,6,female,780,247,57,40,98,40,48,0,50
1934507,113,3,1900,8,female,1533,250,102,41,11,0,7,41,4
1140513,21,20,1992,4,male,287,249,158,42,51,7,50,35,1
1867525,23,21,1990,9,male,549,247,207,41,29,0,2,41,27
1910098,28,12,1985,4,female,1728,243,131,41,109,39,58,2,51
1939391,19,30,1994,5,male,1666,248,147,41,22,41,16,0,6
2043007,20,28,1993,3,male,562,247,77,43,1,0,0,43,1
1603685,17,18,1996,3,male,417,241,117,43,8,1,1,42,7
1601267,31,29,1982,12,male,496,249,183,43,15,0,3,43,12
2109883,63,25,1950,2,female,522,250,174,44,8,6,3,38,5
1308729,62,25,1951,5,female,677,244,170,44,62,0,5,44,57
1651456,22,23,1991,6,female,930,245,194,44,66,7,6,37,60
1112795,22,13,1991,10,male,695,248,229,44,18,20,4,24,14
2153968,19,10,1994,3,female,744,242,138,44,61,19,28,25,33
1069686,14,6,1999,4,female,543,245,76,43,90,18,19,25,71
1629115,17,26,1996,10,female,243,241,182,44,108,32,49,12,59
1453680,20,8,1993,10,male,185,248,228,43,134,38,24,5,110
1629098,108,29,1905,8,female,989,244,109,43,5,43,1,0,4
1641551,22,6,1991,2,male,325,245,228,43,26,43,14,0,12
1681797,110,14,1903,12,female,2222,241,211,43,24,43,21,0,3
1044096,18,15,1995,9,male,385,241,216,44,33,44,15,0,18
1181820,28,4,1985,6,female,696,250,68,44,89,44,77,0,12
1564008,32,31,1981,10,female,427,246,196,43,93,43,59,0,34
2015874,30,22,1983,10,male,322,242,52,45,11,0,6,45,5
1427545,108,1,1905,1,male,1822,243,117,45,133,0,68,45,65
1545210,32,18,1981,4,male,783,244,116,45,32,31,20,14,12
1114864,23,14,1990,2,female,1511,241,121,45,118,32,97,13,21
1049280,16,14,1997,9,female,516,244,88,46,1,3,0,43,1
1896597,28,3,1985,10,male,238,245,133,46,23,3,22,43,1
1157190,68,1,1945,7,male,523,247,193,46,16,6,3,40,13
1720132,18,24,1995,5,female,266,245,90,47,164,28,68,19,96
1524150,108,1,1905,1,female,2222,243,69,46,116,41,42,5,74
1088961,16,21,1997,5,male,322,250,166,46,0,46,0,0,0
1744308,21,10,1992,5,female,765,241,205,46,13,46,13,0,0
1842343,22,23,1991,9,male,606,241,218,46,18,46,18,0,0
1171684,108,20,1905,10,male,2215,249,108,48,89,0,48,48,41
2042208,47,29,1966,3,female,1481,244,91,49,93,19,35,30,58
1307970,52,13,1961,4,female,368,246,204,48,273,10,154,38,119
1614996,16,10,1997,6,male,262,242,116,49,40,49,34,0,6
1182124,18,5,1995,7,female,349,243,76,48,44,48,43,0,1
1958635,18,19,1995,2,female,164,241,78,48,202,48,177,0,25
2099256,18,29,1995,5,male,45,249,229,48,133,48,58,0,75
1352760,38,15,1975,8,male,125,249,133,51,329,27,157,24,172
1225461,18,6,1995,5,male,1148,244,148,50,35,43,0,7,35
1376499,100,16,1913,8,male,2301,243,122,50,102,49,95,1,7
1929594,17,30,1996,12,male,298,245,164,50,15,50,14,0,1
1659618,19,2,1994,6,female,467,241,108,51,101,51,65,0,36
1588526,14,4,1999,7,male,379,244,178,52,2,0,1,52,1
1981593,18,18,1995,6,male,292,249,63,52,49,4,22,48,27
1540945,53,28,1960,3,female,1803,243,161,52,101,51,50,1,51
1933474,32,17,1981,2,female,1568,249,123,52,142,52,60,0,82
1301588,38,31,1975,7,female,452,243,175,53,88,53,58,0,30
2094280,69,6,1944,1,female,1048,241,86,54,20,0,6,54,14
1821503,14,30,1999,6,female,147,244,155,54,105,10,71,44,34
1704065,17,2,1996,6,female,1411,249,136,55,50,46,41,9,9
2016559,22,21,1991,2,male,1023,243,113,55,7,55,3,0,4
1748261,93,1,1920,1,male,126,241,210,54,5,54,4,0,1
2033513,51,29,1962,10,male,391,250,220,56,20,0,7,56,13
1986919,22,19,1991,4,male,115,248,42,57,53,1,11,56,42
1572533,56,2,1957,5,male,434,250,37,58,78,8,41,50,37
1749429,23,24,1990,9,male,180,244,221,57,78,16,42,41,36
1663765,25,20,1988,6,female,509,241,110,58,238,29,91,29,147
1104353,84,15,1929,12,male,1355,245,174,57,23,55,13,2,10
1814969,102,13,1911,7,male,1074,246,148,56,36,50,32,6,4
2153569,15,7,1998,10,female,617,244,178,57,4,57,3,0,1
1215420,57,11,1956,6,male,537,244,147,56,7,56,7,0,0
1446131,16,13,1997,4,male,108,248,205,59,23,0,13,59,10
1136269,73,15,1940,10,female,1465,245,170,59,53,0,24,59,29
1621000,103,14,1910,2,male,551,245,98,60,81,24,33,36,48
1452778,18,21,1995,4,female,165,245,130,59,365,30,102,29,263
1226703,23,7,1990,11,male,401,243,189,59,84,56,40,3,44
1608707,21,23,1992,9,male,219,243,228,59,30,59,30,0,0
1562695,51,2,1962,1,female,379,250,88,59,33,59,12,0,21
1319219,24,17,1989,11,male,684,246,138,59,58,59,46,0,12
1088737,27,4,1986,3,male,1249,241,179,59,41,59,24,0,17
1707357,52,22,1961,4,male,935,243,95,59,88,59,82,0,6
1944547,21,18,1992,8,male,587,250,176,61,7,7,6,54,1
1787437,105,1,1908,1,female,2224,243,124,61,21,0,15,61,6
1945048,20,21,1993,11,female,35,241,53,63,118,52,37,11,81
1506100,47,22,1966,6,female,1770,243,135,63,114,61,84,2,30
2121762,62,27,1951,11,female,919,241,87,61,130,57,111,4,19
1727538,25,18,1988,11,female,811,249,114,62,12,62,8,0,4
2144346,93,21,1920,6,male,535,245,154,62,53,62,42,0,11
1527494,21,18,1992,9,female,92,243,184,61,400,61,299,0,101
1659636,40,3,1973,8,female,933,244,145,62,156,62,149,0,7
2006115,20,25,1993,12,male,469,250,161,64,16,62,10,2,6
1266905,31,26,1982,11,male,1619,246,93,65,0,65,0,0,0
1945070,72,22,1941,11,female,1038,241,164,66,4,8,4,58,0
1924760,24,22,1989,5,male,969,249,187,66,59,29,53,37,6
2044139,23,17,1990,9,female,414,242,205,66,97,57,55,9,42
1680342,24,5,1989,4,male,775,246,204,68,0,68,0,0,0
1740931,26,10,1987,1,male,1108,243,93,66,7,66,6,0,1
1632553,23,30,1990,8,male,937,246,132,67,361,67,271,0,90
1946423,14,8,1999,9,female,73,245,138,69,104,14,40,55,64
1915975,33,20,1980,12,male,579,248,208,70,4,65,3,5,1
1474448,29,19,1984,7,male,295,248,179,69,129,63,107,6,22
1110678,39,4,1974,1,female,968,250,121,69,129,60,91,9,38
1115418,21,14,1992,4,male,776,249,182,71,29,71,19,0,10
2151324,19,18,1994,6,female,760,249,122,71,104,71,84,0,20
1104411,23,10,1990,10,female,583,246,89,72,35,71,32,1,3
1166791,20,3,1993,3,female,299,249,116,73,98,67,69,6,29
1628557,113,12,1900,5,female,1722,248,170,73,81,70,47,3,34
1943930,20,24,1993,9,male,297,248,160,72,286,72,185,0,101
1379644,24,26,1989,9,female,628,249,107,75,67,75,39,0,28
1673761,35,1,1978,4,male,309,246,219,77,72,77,52,0,20
1573943,103,23,1910,8,female,926,242,142,78,35,0,10,78,25
1973021,108,7,1905,3,female,1380,247,100,80,100,0,8,80,92
1842227,20,1,1993,1,male,882,247,77,78,236,30,116,48,120
1004427,24,3,1989,5,female,621,247,211,80,67,80,58,0,9
1732821,21,15,1992,7,male,593,247,96,81,19,0,3,81,16
1834815,64,24,1949,2,female,1038,247,145,83,15,12,8,71,7
1479122,45,18,1968,8,female,554,248,149,82,45,40,17,42,28
1706016,108,15,1905,9,male,1585,244,98,81,46,39,14,42,32
1791807,19,11,1994,1,male,301,247,89,84,85,71,46,13,39
1637615,25,9,1988,6,male,414,248,173,83,73,79,45,4,28
1894313,21,6,1992,2,male,360,242,229,81,1,81,1,0,0
1018106,17,8,1996,8,female,603,246,77,84,115,84,104,0,11
1922071,21,9,1992,9,female,497,249,77,83,192,83,121,0,71
1175484,60,19,1953,5,male,404,249,72,86,94,0,54,86,40
1412511,17,17,1996,10,male,468,250,139,85,77,46,33,39,44
1623894,33,24,1980,1,male,154,242,83,87,65,62,3,25,62
1912750,31,30,1982,7,female,214,246,169,87,244,73,114,14,130
2030680,23,14,1990,3,female,436,249,182,87,24,87,21,0,3
1720516,21,4,1992,12,female,771,248,68,86,75,86,63,0,12
1995812,22,13,1991,12,male,1020,249,120,85,74,85,62,0,12
1217816,19,15,1994,9,female,251,243,181,90,25,2,22,88,3
1608307,103,1,1910,9,female,1040,243,92,88,234,0,59,88,175
1826222,19,6,1994,5,female,16,244,181,88,116,33,69,55,47
2141832,15,20,1998,2,female,179,249,94,88,59,82,40,6,19
2030650,17,19,1996,8,female,319,241,160,89,129,75,39,14,90
1590361,33,25,1980,11,male,438,244,210,89,53,89,46,0,7
1781608,33,2,1980,9,female,97,243,128,90,45,90,28,0,17
1526137,83,28,1930,3,female,1691,247,166,89,18,89,14,0,4
1696053,100,22,1913,3,female,1082,242,147,91,24,91,20,0,4
1709566,15,7,1998,5,female,114,243,90,89,104,89,93,0,11
1173742,47,11,1966,8,male,282,246,139,94,37,0,7,94,30
1377297,29,10,1984,4,female,566,249,188,92,129,48,22,44,107
1197756,26,6,1987,7,male,782,246,44,94,51,94,48,0,3
1915335,17,1,1996,5,male,92,242,143,93,84,93,59,0,25
1393053,19,17,1994,8,male,545,247,219,93,57,93,48,0,9
1181020,47,26,1966,6,female,754,248,145,98,115,0,27,98,88
1063311,29,20,1984,6,male,365,241,203,97,35,20,11,77,24
1149516,57,15,1956,2,male,1165,246,153,99,89,94,32,5,57
1225781,100,14,1913,8,female,2228,247,80,99,110,89,83,10,27
2034935,26,15,1987,4,male,380,242,164,96,4,96,3,0,1
1913140,18,23,1995,12,male,350,245,144,99,82,99,77,0,5
1422769,20,27,1993,10,female,1159,248,132,98,63,98,56,0,7
1404473,24,14,1989,11,male,1547,246,150,97,100,97,45,0,55
2157724,27,1,1986,7,male,269,241,149,97,60,97,34,0,26
1483940,23,15,1990,11,female,436,248,210,101,13,1,9,100,4
1225931,18,6,1995,9,male,386,246,144,104,79,66,28,38,51
1654656,52,17,1961,2,female,1659,249,189,104,85,55,28,49,57
1622622,18,21,1995,7,female,739,241,171,102,88,92,35,10,53
1707848,19,13,1994,5,female,418,245,88,101,265,99,188,2,77
1167868,56,31,1957,12,female,1286,243,143,100,184,97,128,3,56
1841848,25,25,1988,4,male,636,241,140,103,77,103,54,0,23
1997797,18,1,1995,11,male,586,244,181,108,37,0,15,108,22
1003457,100,6,1913,3,female,2273,249,85,107,35,0,1,107,34
1899638,21,26,1992,1,male,198,249,196,109,200,32,73,77,127
1952128,23,12,1990,3,female,426,246,153,108,55,105,42,3,13
1331000,16,11,1997,7,female,193,241,149,106,68,96,66,10,2
1800603,18,4,1995,5,female,524,243,124,107,173,92,74,15,99
1639075,31,8,1982,4,female,2389,245,110,109,147,109,103,0,44
1897966,32,28,1981,10,female,437,241,64,105,373,105,203,0,170
2188934,23,27,1990,4,male,279,242,169,113,411,63,294,50,117
1572523,16,3,1997,8,male,112,248,224,110,17,102,11,8,6
1140753,68,20,1945,10,male,1998,250,108,113,68,88,48,25,20
1928813,27,3,1986,1,male,403,246,175,112,119,112,70,0,49
1643511,86,25,1927,8,male,1354,243,109,116,18,61,6,55,12
1704580,66,30,1947,5,female,1688,241,123,114,129,29,94,85,35
1564184,15,13,1998,4,male,485,247,124,114,2,114,2,0,0
1704649,24,8,1989,12,female,721,246,138,116,27,116,22,0,5
1058363,27,15,1986,9,male,260,246,199,119,26,119,15,0,11
2045662,19,20,1994,6,male,423,241,203,115,100,115,70,0,30
1528382,26,2,1987,11,male,261,241,168,119,119,119,91,0,28
1538390,53,12,1960,5,male,1538,248,125,124,92,4,57,120,35
1648298,15,8,1998,2,male,353,241,202,121,26,117,20,4,6
1975939,20,11,1993,12,male,414,243,164,120,129,100,78,20,51
1144408,17,23,1996,3,male,806,247,118,120,12,120,9,0,3
1151036,20,12,1993,5,male,45,250,185,123,68,123,64,0,4
1431606,24,3,1989,1,male,590,242,195,123,115,123,100,0,15
1912902,108,25,1905,4,male,1699,250,162,130,20,0,5,130,15
1522559,102,2,1911,4,female,1689,245,106,130,91,8,42,122,49
2184539,22,14,1991,6,female,271,241,108,127,265,51,98,76,167
1136366,16,12,1997,1,female,276,245,197,126,14,122,12,4,2
1271681,18,17,1995,8,male,27,246,185,125,315,122,207,3,108
1983310,55,20,1958,2,male,1509,248,175,128,2497,107,1093,21,1404
1230562,18,24,1995,2,male,73,241,186,126,151,126,120,0,31
1511516,31,8,1982,4,female,256,247,173,127,127,127,100,0,27
1798321,44,11,1969,4,female,517,242,132,130,343,130,209,0,134
1702973,42,24,1971,1,female,1038,241,136,136,378,1,306,135,72
1686755,18,6,1995,9,male,912,250,110,135,33,62,26,73,7
1073926,25,18,1988,7,male,883,246,157,134,188,27,153,107,35
1427693,20,27,1993,11,male,130,244,227,132,149,101,106,31,43
1650145,21,6,1992,5,female,1130,245,145,136,198,132,132,4,66
1180800,24,26,1989,3,female,921,244,124,138,50,0,27,138,23
2142958,28,19,1985,12,male,957,248,217,142,106,89,81,53,25
1490628,16,7,1997,12,female,391,244,55,143,72,137,35,6,37
2036749,13,26,2000,3,female,636,249,115,145,382,3,38,142,344
1648900,53,25,1960,12,female,1299,244,116,150,285,24,74,126,211
1678713,49,16,1964,11,male,559,247,206,148,120,148,72,0,48
1153038,69,18,1944,9,female,2211,241,107,146,174,146,129,0,45
1422033,17,11,1996,7,female,613,244,169,155,259,0,61,155,198
1466627,67,22,1946,4,male,520,243,133,153,231,21,49,132,182
2111156,23,1,1990,2,female,310,244,87,151,252,108,105,43,147
1366575,108,1,1905,1,male,1048,248,58,151,19,148,12,3,7
1572621,33,1,1980,1,female,492,250,31,155,49,155,26,0,23
1443982,18,20,1995,4,female,408,250,113,152,269,152,168,0,101
1610132,33,14,1980,6,male,590,249,199,158,108,51,34,107,74
2010020,20,26,1993,4,female,108,249,68,164,76,157,51,7,25
1999982,23,17,1990,10,female,450,247,179,162,124,138,106,24,18
1198907,26,15,1987,10,male,331,249,225,161,11,161,3,0,8
1761961,19,12,1994,1,male,410,243,164,162,373,162,338,0,35
1611549,38,26,1975,2,male,537,246,164,158,298,158,268,0,30
1051644,54,23,1959,8,male,712,243,45,166,48,0,19,166,29
1821237,20,16,1993,12,female,467,246,137,166,136,133,50,33,86
1752906,27,3,1986,3,female,410,246,156,170,32,170,29,0,3
1349200,58,25,1955,11,male,311,247,225,172,78,172,66,0,12
1631355,19,12,1994,2,male,498,245,85,172,105,172,60,0,45
1814854,54,26,1959,6,female,449,247,66,176,124,0,35,176,89
1304829,34,29,1979,6,female,921,250,67,179,73,71,30,108,43
1218095,20,7,1993,5,male,475,249,140,174,251,174,78,0,173
1099442,24,23,1989,2,female,608,242,106,173,148,173,88,0,60
1045528,39,20,1974,4,female,548,243,182,178,118,178,105,0,13
2024509,16,2,1997,5,female,158,246,195,185,114,109,35,76,79
1910071,15,10,1998,2,female,179,241,185,188,165,146,84,42,81
1066023,24,3,1989,4,male,225,247,216,184,42,183,28,1,14
1456313,108,17,1905,7,male,897,242,159,187,15,187,12,0,3
1751884,20,10,1993,8,female,341,248,73,187,68,187,47,0,21
1642563,58,8,1955,9,male,910,249,128,184,111,184,76,0,35
1588775,29,1,1984,1,male,340,248,111,186,202,186,98,0,104
2025971,55,17,1958,4,female,1322,243,104,196,65,9,9,187,56
1655067,13,28,2000,3,female,153,242,203,191,79,48,29,143,50
1919553,59,14,1954,12,male,757,243,173,191,51,55,32,136,19
1556485,59,11,1954,9,female,2418,249,135,198,359,121,235,77,124
2183893,29,18,1984,3,female,295,248,144,199,213,192,98,7,115
1851774,22,29,1991,8,male,378,249,201,198,13,198,6,0,7
1933322,18,27,1995,10,male,98,242,206,191,195,191,139,0,56
1009541,78,20,1935,4,female,1077,246,71,211,95,26,48,185,47
1578684,21,4,1992,6,male,480,246,178,207,240,16,130,191,110
1683707,19,12,1994,10,female,443,246,168,206,17,141,4,65,13
2011081,16,23,1997,8,male,86,242,208,209,128,55,44,154,84
1988152,17,7,1996,5,female,371,248,121,203,125,123,68,80,57
1194367,108,29,1905,7,female,2030,246,188,208,254,119,123,89,131
1044520,20,23,1993,6,male,370,249,152,204,133,204,120,0,13
1018767,15,10,1998,1,male,417,246,89,221,222,42,107,179,115
2174329,20,10,1993,11,male,248,246,110,221,219,151,79,70,140
1294242,34,23,1979,11,female,862,249,131,216,231,184,111,32,120
1412388,103,27,1910,7,female,911,243,20,214,78,214,66,0,12
1127599,21,7,1992,4,female,419,245,150,218,301,218,232,0,69
1645610,47,30,1966,3,male,973,250,77,224,372,156,229,68,143
1167739,41,11,1972,2,female,299,249,65,228,101,224,47,4,54
1374572,21,23,1992,11,female,28,241,37,231,96,231,57,0,39
1485287,49,13,1964,9,female,424,241,77,227,129,227,113,0,16
2075919,19,15,1994,5,female,506,245,148,224,315,224,311,0,4
1128387,64,23,1949,9,male,1334,242,83,241,547,3,264,238,283
1119725,16,30,1997,12,female,588,242,132,235,125,227,66,8,59
1207853,58,28,1955,10,female,931,241,202,240,49,240,40,0,9
2137958,63,4,1950,3,female,2375,247,114,246,57,246,52,0,5
1868761,29,30,1984,10,female,934,248,122,240,334,240,192,0,142
1357878,57,10,1956,12,male,215,241,193,245,362,245,307,0,55
1168246,21,8,1992,4,male,207,241,182,250,191,157,104,93,87
1358757,54,23,1959,3,female,1101,245,75,254,357,181,218,73,139
1010139,100,21,1913,7,female,1804,250,160,250,134,240,95,10,39
1884939,24,1,1989,2,male,1848,250,112,249,262,197,174,52,88
1608919,19,11,1994,10,female,291,248,215,254,131,253,116,1,15
1366147,15,20,1998,7,female,251,249,168,257,156,257,115,0,41
2192460,30,18,1983,10,male,1475,246,133,253,52,253,44,0,8
1507848,24,1,1989,11,male,385,247,61,249,324,249,199,0,125
1197790,46,10,1967,3,male,260,242,37,275,65,0,19,275,46
1708028,23,11,1990,7,female,387,241,137,276,34,273,15,3,19
1418969,18,19,1995,10,male,395,245,173,266,134,244,111,22,23
2139129,59,25,1954,4,female,1299,244,142,267,141,250,107,17,34
1074049,26,18,1987,10,female,858,246,203,268,246,234,209,34,37
1492711,15,9,1998,12,male,310,241,160,274,1,274,1,0,0
1176854,47,3,1966,4,female,378,245,173,274,118,274,95,0,23
1350746,24,5,1989,3,female,463,243,76,265,162,265,98,0,64
1463848,18,22,1995,2,male,513,248,159,287,72,21,22,266,50
1107438,53,14,1960,3,male,598,249,217,289,123,0,37,289,86
1101511,28,17,1985,11,female,172,247,194,282,331,185,181,97,150
1343362,20,17,1993,8,female,41,250,33,285,143,276,97,9,46
1683923,14,7,1999,4,female,551,250,124,284,403,258,334,26,69
1689221,25,29,1988,7,female,206,244,159,286,484,245,295,41,189
1352000,18,23,1995,7,male,452,244,165,283,126,283,120,0,6
1640933,17,10,1996,10,male,179,241,171,286,789,286,755,0,34
2112700,54,30,1959,1,female,464,249,60,300,56,0,9,300,47
1156800,18,16,1995,7,male,143,244,164,303,727,54,363,249,364
2131888,39,28,1974,2,male,2055,246,217,300,527,0,143,300,384
1552893,75,11,1938,1,female,2090,244,119,293,661,0,75,293,586
1894719,15,7,1998,4,male,523,241,198,303,5,171,4,132,1
1022114,15,4,1998,3,female,853,248,156,303,742,75,338,228,404
1387571,20,28,1993,12,female,362,247,149,301,104,246,53,55,51
1559894,50,11,1963,8,female,626,250,75,295,242,261,193,34,49
1741435,103,10,1910,1,male,377,243,114,308,73,308,65,0,8
1578122,24,19,1989,11,female,545,248,139,302,415,302,104,0,311
1365328,29,9,1984,11,female,542,247,119,293,213,293,97,0,116
1830584,99,11,1914,5,female,1125,243,113,309,102,29,21,280,81
2012178,51,2,1962,1,female,1469,247,132,327,394,309,214,18,180
1800987,108,30,1905,10,female,2290,243,115,314,324,281,156,33,168
2048526,33,14,1980,10,male,341,250,157,321,186,321,135,0,51
2173643,49,28,1964,3,female,910,241,120,318,105,318,54,0,51
1721169,26,16,1987,7,female,484,241,177,313,195,313,162,0,33
1758657,65,20,1948,11,female,1077,242,152,344,46,0,9,344,37
1417922,35,14,1978,1,female,542,244,126,343,110,154,34,189,76
1987440,14,18,1999,9,female,760,250,108,336,347,231,153,105,194
1521745,96,18,1917,10,female,2353,245,67,332,622,232,464,100,158
1876163,19,19,1994,8,female,565,242,137,335,196,275,75,60,121
1148483,19,30,1994,10,female,1727,248,156,333,129,251,73,82,56
1334496,26,12,1987,2,female,457,243,159,330,229,256,76,74,153
1044212,25,14,1988,11,male,329,242,201,335,58,335,35,0,23
1604130,20,26,1993,6,male,568,245,131,341,251,341,148,0,103
2098651,108,22,1905,12,female,1488,242,90,355,30,217,15,138,15
1937313,64,18,1949,9,female,752,248,65,366,167,76,37,290,130
1061810,18,24,1995,12,female,340,250,154,351,324,183,62,168,262
1843778,25,9,1988,5,female,643,245,176,352,495,242,215,110,280
1613272,37,18,1976,7,female,1902,243,60,358,305,113,116,245,189
1744204,63,16,1950,10,female,310,248,53,351,232,179,74,172,158
2085521,51,7,1962,10,female,1678,241,44,361,743,173,523,188,220
1285696,21,1,1992,10,female,527,246,171,349,204,268,89,81,115
1484017,18,30,1995,8,female,221,250,162,351,281,309,137,42,144
1472621,20,15,1993,12,female,608,247,203,354,325,291,205,63,120
2007372,61,4,1952,1,female,1556,244,142,360,904,317,615,43,289
1823059,15,17,1998,3,female,284,244,125,350,19,350,17,0,2
1422637,21,1,1992,3,female,150,246,63,369,217,369,176,0,41
1772734,46,14,1967,3,male,223,250,158,350,79,350,78,0,1
1517406,26,23,1987,9,male,296,243,124,363,1347,363,1110,0,237
1962088,51,9,1962,8,female,225,250,195,374,120,4,33,370,87
1771230,22,12,1991,8,female,2148,245,104,393,511,33,331,360,180
1389381,64,11,1949,6,female,1287,247,164,374,266,0,22,374,244
1450492,108,22,1905,10,female,1391,241,94,372,893,55,575,317,318
2003957,18,29,1995,10,male,503,245,206,394,7,330,6,64,1
1978112,62,4,1951,5,male,1499,244,166,373,320,348,86,25,234
1293249,20,20,1993,9,male,304,247,204,376,0,376,0,0,0
1643348,25,1,1988,1,female,74,249,30,370,92,370,85,0,7
1995810,34,7,1979,1,male,162,250,81,394,996,394,759,0,237
1499036,53,20,1960,5,male,572,243,174,421,166,175,93,246,73
1834968,14,14,1999,11,female,288,249,98,416,309,328,202,88,107
1877237,20,3,1993,11,female,497,250,36,421,36,419,24,2,12
1832351,18,8,1995,10,female,369,248,160,406,299,403,297,3,2
1618150,29,5,1984,4,female,460,242,164,398,133,398,94,0,39
1198641,17,21,1996,11,male,19,244,195,427,451,195,158,232,293
2032056,45,12,1968,3,female,1137,242,121,434,317,213,77,221,240
1278227,46,27,1967,1,female,458,248,115,445,562,137,246,308,316
1576741,14,18,1999,3,male,192,246,152,449,264,419,125,30,139
1565146,25,3,1988,4,male,325,249,203,434,254,376,80,58,174
2110397,27,9,1986,1,female,542,249,154,445,204,415,156,30,48
1607792,50,1,1963,1,female,305,241,153,443,78,371,66,72,12
2122244,24,1,1989,2,female,486,246,192,446,322,436,211,10,111
1257572,36,9,1977,8,female,1532,249,150,445,190,443,122,2,68
1865298,22,9,1991,12,male,356,250,184,444,194,444,186,0,8
1310532,20,3,1993,2,female,812,242,98,429,378,429,300,0,78
1256701,92,13,1921,2,female,1298,241,122,464,278,44,62,420,216
1479789,22,10,1991,1,female,563,249,194,462,331,289,155,173,176
1352010,44,25,1969,7,female,1364,241,97,471,563,186,307,285,256
1079481,37,15,1976,2,female,118,242,52,473,270,473,241,0,29
2084125,59,24,1954,9,female,457,247,207,468,589,468,297,0,292
1903105,43,12,1970,4,female,1988,241,114,479,1031,479,837,0,194
1756257,20,15,1993,3,female,603,242,158,510,391,500,140,10,251
2146305,21,22,1992,3,female,216,244,193,493,479,371,190,122,289
1762817,32,27,1981,7,female,646,249,159,490,617,364,442,126,175
1368908,48,10,1965,6,female,1009,244,123,514,416,381,181,133,235
2128222,52,29,1961,3,male,519,243,161,517,898,404,633,113,265
1277017,62,9,1951,3,female,1809,246,146,489,435,488,204,1,231
1971131,50,15,1963,7,male,43,245,239,504,5,504,2,0,3
1575677,34,29,1979,6,female,507,249,153,503,247,503,199,0,48
1488352,19,18,1994,11,female,179,242,87,559,210,391,122,168,88
2142728,21,5,1992,8,female,449,249,176,535,662,241,316,294,346
1987247,65,8,1948,4,female,1809,247,215,536,428,181,245,355,183
1394809,55,3,1958,7,female,1286,250,149,523,220,391,162,132,58
1484575,14,31,1999,3,male,95,244,169,523,113,523,84,0,29
2131972,22,1,1991,1,male,299,250,228,555,236,555,198,0,38
1542113,51,25,1962,7,female,1930,245,164,585,1121,148,715,437,406
1882179,23,5,1990,10,male,640,247,221,656,21,654,10,2,11
1725656,25,31,1988,12,female,256,243,114,660,90,659,77,1,13
1623374,49,25,1964,2,male,36,250,90,657,83,657,69,0,14
1652083,16,17,1997,8,male,520,245,221,716,172,218,57,498,115
1452741,19,22,1994,9,male,67,243,235,689,422,477,217,212,205
1412782,51,14,1962,8,female,1261,245,143,713,638,219,272,494,366
2106794,27,15,1986,2,male,600,245,227,723,1493,339,167,384,1326
1158524,102,6,1911,8,female,2268,248,141,690,276,655,180,35,96
2182122,30,3,1983,1,female,397,243,170,709,1566,575,1188,134,378
1355976,18,30,1995,9,female,689,249,152,682,100,678,81,4,19
1366964,26,28,1987,11,female,307,244,129,690,148,690,97,0,51
1218279,58,8,1955,11,female,671,248,111,706,192,706,92,0,100
1709461,66,8,1947,4,female,879,248,133,779,838,0,74,779,764
1197094,62,29,1951,1,male,838,249,107,769,322,483,199,286,123
2049936,21,14,1992,3,male,163,245,197,792,253,775,109,17,144
1071710,24,19,1989,7,male,439,241,143,752,397,691,249,61,148
1976906,18,21,1995,11,male,507,249,100,744,687,594,179,150,508
2021401,33,26,1980,8,female,418,245,148,817,487,35,80,782,407
1867324,17,4,1996,5,female,757,247,151,829,452,454,257,375,195
1061681,20,14,1993,8,female,584,244,105,799,398,181,136,618,262
1060399,22,14,1991,7,male,237,245,212,838,830,469,475,369,355
1001608,31,9,1982,6,female,479,241,167,854,1284,388,381,466,903
1693459,57,7,1956,9,female,1612,244,186,869,141,653,84,216,57
1925829,18,14,1995,11,male,377,245,137,821,604,734,476,87,128
2129061,23,12,1990,1,female,629,243,189,839,952,815,733,24,219
1858485,16,16,1997,4,female,119,249,214,927,369,415,241,512,128
1452042,19,5,1994,5,female,510,244,173,918,69,899,65,19,4
1257486,19,11,1994,7,male,382,242,180,906,358,889,289,17,69
1912353,22,30,1991,9,male,144,243,217,986,554,842,386,144,168
1630225,37,25,1976,9,female,170,247,178,917,2467,917,2065,0,402
1983907,60,17,1953,10,female,1480,245,106,912,1521,912,1308,0,213
1261138,86,6,1927,9,female,1472,245,130,1004,501,3,147,1001,354
2120548,54,13,1959,9,female,1830,243,138,1064,1045,162,593,902,452
2043528,41,6,1972,10,female,960,244,195,990,872,635,588,355,284
1740595,43,12,1970,12,female,1248,245,176,1074,694,406,290,668,404
1811661,40,26,1973,3,female,295,245,112,1016,657,982,120,34,537
1356183,16,21,1997,10,female,124,245,180,1014,1431,1009,858,5,573
1392233,108,2,1905,4,male,467,249,151,1042,441,1042,428,0,13
1508343,27,8,1986,4,female,594,241,118,1005,703,1005,519,0,184
1344079,19,23,1994,11,male,578,244,156,1226,461,1,131,1225,330
1127631,59,25,1954,4,female,123,250,157,1132,598,0,50,1132,548
2068149,14,8,1999,6,female,233,250,152,1288,762,406,230,882,532
1064270,50,25,1963,8,female,860,250,113,1237,432,257,212,980,220
1151726,62,26,1951,7,female,1489,248,128,1268,463,852,285,416,178
1496900,87,17,1926,2,male,364,245,146,1154,616,322,165,832,451
1196631,72,30,1941,7,female,1567,249,147,1227,390,1196,283,31,107
1497105,33,1,1980,7,female,1660,246,150,1232,979,1203,577,29,402
1100836,53,18,1960,2,female,1476,245,60,1191,1618,1089,1268,102,350
1324288,16,7,1997,9,male,420,248,179,1329,407,588,288,741,119
1970980,55,21,1958,4,female,1727,245,157,1433,426,1316,168,117,258
1467703,33,3,1980,9,female,2052,249,89,1432,1153,1098,549,334,604
1392329,26,6,1987,7,male,379,246,147,1312,94,1312,87,0,7
1116542,38,30,1975,3,male,593,243,195,1345,241,1345,224,0,17
1661085,61,13,1952,6,female,1592,242,116,1376,537,1376,213,0,324
1323258,54,7,1959,11,female,1838,248,184,1645,1498,0,668,1645,830
1515643,18,23,1995,12,female,359,241,151,1528,939,682,572,846,367
1165892,19,21,1994,5,female,389,242,150,1848,1891,1215,1104,633,787
2050624,57,3,1956,11,female,1767,250,144,1844,619,1731,398,113,221
1127850,20,19,1993,10,female,242,250,94,1804,1191,1609,774,195,417
1671939,28,1,1985,2,female,276,246,60,1755,564,1755,477,0,87
2186349,23,8,1990,1,female,132,242,107,1539,3032,1539,2719,0,313
1038038,21,5,1992,5,female,12,242,238,2194,1214,237,657,1957,557
1267671,19,18,1994,1,female,702,250,147,2319,1778,0,358,2319,1420
1454645,15,7,1998,7,female,448,246,204,2205,5916,233,1887,1972,4029
2030888,19,17,1994,4,female,73,241,206,2359,1318,517,390,1842,928
1686792,21,24,1992,11,male,202,248,151,1989,1223,1018,794,971,429
1322200,37,25,1976,11,female,555,242,167,1979,1832,807,547,1172,1285
1838460,21,9,1992,3,female,486,241,159,2096,403,2083,349,13,54
2085443,24,4,1989,1,female,1112,247,118,2240,1038,2240,311,0,727
1947979,48,6,1965,7,female,289,244,178,1920,554,1920,456,0,98
1213261,53,10,1960,12,female,710,250,145,1872,743,1872,639,0,104
1934754,100,11,1913,8,female,261,249,171,1897,336,1897,302,0,34
1739601,20,26,1993,4,male,343,242,81,2442,204,1159,69,1283,135
1207312,24,6,1989,7,male,39,250,165,3146,3484,1230,2377,1916,1107
1322931,38,2,1975,3,NA,2162,244,100,2906,4993,1760,3126,1145,1867
1301623,24,7,1989,7,female,479,247,194,3096,931,2992,494,104,437
1612602,21,3,1992,5,female,83,246,63,2691,2187,2090,1713,601,474
1884487,30,18,1983,5,female,323,241,184,2664,2748,2653,756,11,1992
1173917,56,21,1957,3,female,1332,248,133,2898,113,2898,43,0,70
2018576,18,7,1995,3,male,193,246,145,3721,634,3685,434,36,200
2053552,34,25,1979,8,female,591,245,167,4930,1311,4930,955,0,356
1411625,17,8,1996,9,male,33,250,190,7018,4892,7018,4744,0,148
1427488,14,14,1999,11,male,297,256,164,0,0,0,0,0,0
2181311,15,16,1998,11,male,579,258,183,0,5,0,5,0,0
1848813,14,1,1999,1,male,200,261,249,0,0,0,0,0,0
1516119,14,20,1999,2,female,370,261,97,0,17,0,4,0,13
1797963,14,10,1999,4,female,421,254,138,0,7,0,4,0,3
1310466,14,31,1999,10,male,330,252,195,0,0,0,0,0,0
1700039,16,14,1997,12,female,398,254,15,0,0,0,0,0,0
1239399,15,6,1998,1,male,319,253,240,0,0,0,0,0,0
1431519,15,1,1998,1,male,311,255,153,0,3,0,2,0,1
1570776,15,19,1998,3,male,234,254,211,0,0,0,0,0,0
1061960,15,3,1998,6,male,570,251,180,0,1,0,1,0,0
2014021,15,5,1998,8,male,654,251,117,0,1,0,1,0,0
1861569,17,16,1996,11,male,529,254,211,0,1,0,0,0,1
1547160,17,10,1996,11,female,430,260,169,0,7,0,6,0,1
1929961,17,22,1996,12,female,400,257,171,0,0,0,0,0,0
2108758,16,6,1997,2,female,532,259,43,0,3,0,0,0,3
1931382,16,30,1997,7,male,423,253,207,0,0,0,0,0,0
1655439,16,3,1997,7,male,57,252,238,0,0,0,0,0,0
1490305,18,20,1995,12,male,507,255,188,0,2,0,1,0,1
1642536,17,14,1996,2,female,208,255,88,0,0,0,0,0,0
2135403,17,9,1996,4,female,314,260,161,0,0,0,0,0,0
1809844,17,18,1996,5,male,394,256,229,0,33,0,31,0,2
1038387,17,16,1996,7,female,251,259,77,0,0,0,0,0,0
1318264,17,12,1996,7,female,94,254,111,0,0,0,0,0,0
1244502,17,21,1996,8,male,694,259,161,0,0,0,0,0,0
1416098,17,6,1996,9,male,303,255,180,0,4,0,2,0,2
1597007,18,7,1995,1,male,408,255,134,0,27,0,3,0,24
1182894,18,1,1995,1,male,430,256,170,0,1,0,0,0,1
1069228,18,6,1995,2,male,630,260,236,0,0,0,0,0,0
1692302,18,28,1995,2,male,469,253,90,0,0,0,0,0,0
1348642,18,28,1995,2,female,316,256,194,0,22,0,14,0,8
1397224,18,13,1995,2,male,239,257,108,0,0,0,0,0,0
1652889,18,22,1995,3,male,593,255,169,0,1,0,1,0,0
1072083,18,5,1995,5,male,731,256,161,0,0,0,0,0,0
1226599,18,2,1995,5,male,349,254,211,0,1,0,1,0,0
1540698,18,30,1995,5,male,107,259,129,0,0,0,0,0,0
1621109,18,9,1995,6,female,517,259,30,0,0,0,0,0,0
1153000,18,6,1995,6,female,272,256,195,0,17,0,10,0,7
2181873,18,14,1995,9,male,284,260,206,0,2,0,0,0,2
1239997,18,27,1995,9,male,225,259,249,0,0,0,0,0,0
1227057,18,5,1995,10,male,770,255,204,0,13,0,9,0,4
1574498,20,4,1993,12,male,320,253,147,0,2,0,2,0,0
2179520,19,17,1994,1,male,350,259,220,0,20,0,17,0,3
1956225,19,1,1994,1,male,639,258,194,0,3,0,2,0,1
1346787,19,24,1994,2,male,707,251,132,0,16,0,4,0,12
1637442,19,1,1994,4,female,287,256,55,0,5,0,1,0,4
1688812,19,17,1994,5,male,1263,258,183,0,0,0,0,0,0
1362660,19,10,1994,6,male,1032,260,188,0,0,0,0,0,0
1427057,19,20,1994,6,female,667,251,82,0,0,0,0,0,0
1374933,19,20,1994,8,male,851,252,171,0,31,0,19,0,12
1617047,19,10,1994,8,male,428,254,176,0,36,0,30,0,6
1027393,21,10,1992,11,male,1248,259,229,0,0,0,0,0,0
1396587,21,14,1992,11,male,449,256,160,0,11,0,11,0,0
1047702,20,25,1993,2,male,687,251,211,0,0,0,0,0,0
1277541,20,27,1993,2,male,293,252,104,0,0,0,0,0,0
1079549,20,11,1993,7,male,411,252,207,0,0,0,0,0,0
1360664,20,13,1993,7,male,356,251,156,0,0,0,0,0,0
1618179,20,8,1993,8,male,682,252,86,0,0,0,0,0,0
1490273,20,7,1993,10,male,317,255,58,0,14,0,9,0,5
1090047,21,20,1992,1,male,171,257,123,0,9,0,6,0,3
1553481,21,28,1992,2,male,262,258,189,0,14,0,14,0,0
1168020,21,17,1992,3,male,563,260,202,0,2,0,0,0,2
1716384,21,2,1992,3,female,403,258,83,0,6,0,6,0,0
1511177,21,4,1992,4,female,815,251,78,0,1,0,0,0,1
1886686,21,19,1992,4,male,268,255,85,0,0,0,0,0,0
1381749,21,13,1992,9,male,1329,253,189,0,0,0,0,0,0
2074284,22,1,1991,1,male,1025,257,116,0,3,0,3,0,0
1554429,22,1,1991,1,female,590,257,149,0,0,0,0,0,0
1753095,22,7,1991,2,male,609,258,184,0,4,0,3,0,1
1314366,22,22,1991,5,male,701,253,202,0,1,0,1,0,0
1859487,22,3,1991,6,female,455,259,83,0,0,0,0,0,0
1192583,22,2,1991,6,male,247,258,226,0,0,0,0,0,0
1590103,24,2,1989,11,female,812,257,66,0,0,0,0,0,0
1815064,23,1,1990,1,male,394,256,147,0,0,0,0,0,0
1827047,23,14,1990,2,female,428,260,164,0,0,0,0,0,0
1214633,23,12,1990,3,male,355,256,71,0,3,0,0,0,3
1262212,23,11,1990,3,male,348,253,203,0,0,0,0,0,0
1354411,23,17,1990,3,male,257,251,175,0,0,0,0,0,0
1690322,23,12,1990,8,male,128,261,232,0,9,0,7,0,2
1179108,23,1,1990,10,male,610,253,84,0,0,0,0,0,0
2006398,25,27,1988,11,male,533,255,174,0,0,0,0,0,0
1598890,24,20,1989,1,female,848,260,141,0,2,0,2,0,0
1105948,24,17,1989,1,male,549,256,107,0,0,0,0,0,0
1194404,24,24,1989,4,male,434,261,190,0,0,0,0,0,0
1249398,26,5,1987,11,female,551,259,141,0,3,0,3,0,0
1179967,25,29,1988,7,male,1020,256,99,0,0,0,0,0,0
1102083,26,9,1987,2,female,616,260,189,0,0,0,0,0,0
2165429,26,10,1987,7,female,680,261,103,0,0,0,0,0,0
1190616,26,17,1987,7,male,403,255,231,0,0,0,0,0,0
2054145,28,10,1985,12,male,230,261,230,0,2,0,1,0,1
2093728,27,25,1986,3,female,986,260,80,0,2,0,2,0,0
1061730,27,24,1986,7,male,527,259,144,0,1,0,1,0,0
1173287,27,26,1986,10,male,495,251,169,0,1,0,0,0,1
1422410,28,29,1985,1,male,787,258,110,0,13,0,7,0,6
1619259,28,13,1985,4,female,409,254,138,0,3,0,1,0,2
1292606,28,5,1985,5,male,640,256,224,0,0,0,0,0,0
2128786,30,20,1983,7,male,620,252,214,0,5,0,0,0,5
1843810,31,15,1982,3,male,618,251,184,0,9,0,7,0,2
1633543,33,19,1980,2,male,889,252,145,0,2,0,2,0,0
2139601,34,23,1979,5,male,583,254,66,0,5,0,3,0,2
2192510,35,28,1978,7,male,509,252,234,0,18,0,17,0,1
1909818,36,11,1977,4,male,472,256,186,0,18,0,16,0,2
1784995,37,1,1976,6,male,337,257,133,0,1,0,1,0,0
1245248,42,24,1971,3,female,363,261,152,0,0,0,0,0,0
1388040,46,3,1967,4,male,475,253,215,0,0,0,0,0,0
1233490,49,2,1964,11,female,443,257,119,0,0,0,0,0,0
1319390,53,15,1960,6,female,659,259,150,0,1,0,1,0,0
2126267,57,27,1956,5,male,573,253,124,0,1,0,1,0,0
1639746,62,17,1951,7,male,956,251,42,0,1,0,1,0,0
1037228,68,17,1945,8,female,157,258,95,0,3,0,3,0,0
1624156,71,10,1942,4,male,337,253,200,0,11,0,5,0,6
1696360,101,10,1912,4,male,472,260,93,0,0,0,0,0,0
2059675,103,18,1910,6,male,671,257,188,0,3,0,3,0,0
1605537,105,2,1908,4,male,1303,253,201,0,2,0,2,0,0
1126382,108,30,1905,11,male,418,260,203,0,0,0,0,0,0
1995133,108,30,1905,3,male,853,258,178,0,0,0,0,0,0
1098805,111,4,1902,7,male,1320,259,132,0,0,0,0,0,0
1061154,21,2,1992,2,female,643,255,183,1,0,0,0,1,0
1228054,103,24,1910,11,male,1304,254,180,1,1,0,1,1,0
2134341,13,15,2000,4,male,380,252,194,1,2,0,2,1,0
1740076,14,28,1999,1,female,447,260,205,1,3,0,2,1,1
2068523,19,24,1994,12,male,490,254,141,1,17,0,0,1,17
1607467,57,24,1956,6,female,2093,254,188,1,2,0,2,1,0
1742870,17,22,1996,2,male,315,261,215,1,0,1,0,0,0
1149875,18,23,1995,1,male,493,252,139,1,0,1,0,0,0
2090026,18,28,1995,5,male,95,254,230,1,0,1,0,0,0
2039601,20,16,1993,12,male,587,252,140,1,0,1,0,0,0
1921871,20,15,1993,6,female,601,251,107,1,0,1,0,0,0
2162048,22,11,1991,6,male,741,255,234,1,0,1,0,0,0
1487838,24,29,1989,6,male,857,258,206,1,0,1,0,0,0
1976549,24,3,1989,10,female,379,257,204,1,0,1,0,0,0
1848973,26,5,1987,7,male,506,256,221,1,0,1,0,0,0
1221559,39,3,1974,6,male,867,261,74,1,0,1,0,0,0
1219477,53,14,1960,4,male,722,255,197,1,0,1,0,0,0
1066640,15,2,1998,4,male,649,252,222,1,1,1,1,0,0
1548901,21,2,1992,2,female,372,254,170,1,1,1,1,0,0
1695120,21,6,1992,6,male,495,254,187,1,1,1,1,0,0
1128114,22,1,1991,4,male,317,260,213,1,1,1,1,0,0
1414518,25,1,1988,10,male,847,253,206,1,1,1,1,0,0
2113596,26,19,1987,8,male,612,254,148,1,1,1,1,0,0
2184262,65,27,1948,8,female,1213,260,25,1,1,1,1,0,0
1076230,108,25,1905,6,female,559,251,117,1,1,1,0,0,1
1041964,16,31,1997,7,male,586,252,56,1,10,1,7,0,3
2009036,18,1,1995,1,male,292,256,121,1,14,1,8,0,6
2186668,18,1,1995,11,female,447,254,127,1,38,1,38,0,0
1460993,19,6,1994,7,male,329,251,119,1,12,1,9,0,3
1234999,20,8,1993,7,female,565,254,145,1,8,1,5,0,3
2167008,23,17,1990,12,male,328,254,148,1,23,1,18,0,5
2160088,23,13,1990,4,male,412,259,228,1,38,1,19,0,19
1997872,24,1,1989,11,male,464,251,176,1,7,1,6,0,1
2067816,30,4,1983,4,female,216,258,117,1,10,1,3,0,7
1586000,32,10,1981,10,male,279,258,204,1,3,1,2,0,1
1334753,41,2,1972,3,male,252,255,107,1,7,1,7,0,0
1197986,83,15,1930,9,male,1742,261,173,1,8,1,4,0,4
1990101,18,3,1995,9,female,494,255,130,2,0,0,0,2,0
1368370,31,26,1982,5,male,493,257,146,2,1,0,0,2,1
1565173,20,24,1993,8,female,390,252,215,2,3,0,1,2,2
1311316,26,11,1987,8,female,185,251,153,2,23,0,1,2,22
1315452,52,19,1961,5,male,776,252,207,2,5,0,3,2,2
1872150,94,18,1919,12,female,2437,254,110,2,5,0,5,2,0
1139764,32,16,1981,1,male,1634,255,122,2,1,1,0,1,1
2107508,101,26,1912,6,female,1532,253,65,2,1,1,1,1,0
2051776,30,1,1983,7,female,628,254,194,2,22,1,0,1,22
1845016,65,20,1948,11,male,1570,253,32,2,4,1,4,1,0
1572175,17,15,1996,3,male,281,258,223,2,0,2,0,0,0
1264057,26,1,1987,1,male,187,261,248,2,0,2,0,0,0
1918340,105,3,1908,4,female,359,258,148,2,0,2,0,0,0
1476671,19,19,1994,12,male,418,252,228,2,1,2,1,0,0
1379032,20,8,1993,8,male,263,258,205,2,1,2,1,0,0
1608062,47,13,1966,9,male,1479,258,56,2,1,2,1,0,0
1015551,19,2,1994,2,female,628,257,106,2,2,2,2,0,0
2152079,19,1,1994,7,male,747,261,138,2,2,2,2,0,0
1979396,27,21,1986,4,male,443,259,217,2,2,2,0,0,2
1569459,15,30,1998,4,male,699,253,150,2,37,2,37,0,0
1103660,15,4,1998,4,male,479,252,223,2,12,2,3,0,9
2016505,17,23,1996,8,male,215,260,240,2,11,2,8,0,3
2104682,18,18,1995,5,male,527,256,203,2,9,2,7,0,2
1229898,19,3,1994,8,female,523,252,166,2,9,2,3,0,6
1939113,20,3,1993,3,male,862,258,180,2,4,2,4,0,0
1872847,24,1,1989,2,male,221,253,241,2,20,2,6,0,14
1156297,25,15,1988,3,male,1467,253,95,2,3,2,2,0,1
2142988,27,17,1986,12,male,745,253,237,2,10,2,6,0,4
1879565,30,12,1983,1,female,526,257,27,2,9,2,5,0,4
1198487,48,15,1965,12,male,830,259,81,2,57,2,9,0,48
1869931,95,14,1918,5,male,441,251,109,2,8,2,8,0,0
1697800,19,8,1994,3,male,880,258,93,3,2,0,0,3,2
1535553,48,12,1965,11,male,1114,261,136,3,4,0,0,3,4
1210452,49,28,1964,8,male,1485,260,82,3,0,2,0,1,0
1886061,43,13,1970,11,male,138,253,221,3,1,2,1,1,0
1428190,43,17,1970,7,male,1827,257,159,3,1,2,1,1,0
2146143,48,30,1965,6,male,325,260,93,3,1,2,0,1,1
1295284,15,1,1998,5,male,439,258,195,3,43,2,16,1,27
2111055,17,13,1996,1,male,374,254,100,3,0,3,0,0,0
1648682,17,9,1996,10,female,398,259,226,3,0,3,0,0,0
1453356,25,1,1988,7,male,688,259,219,3,0,3,0,0,0
1078593,68,17,1945,8,male,469,261,236,3,0,3,0,0,0
1318300,21,30,1992,6,female,626,256,79,3,1,3,1,0,0
1105473,23,18,1990,4,male,2332,252,74,3,1,3,1,0,0
1989746,21,12,1992,10,male,439,251,150,3,2,3,2,0,0
1280313,42,26,1971,11,male,1796,261,44,3,2,3,2,0,0
1795678,19,9,1994,12,female,53,261,28,3,123,3,27,0,96
1967869,18,4,1995,4,female,462,260,54,3,59,3,21,0,38
1625534,21,18,1992,11,male,107,255,175,3,13,3,7,0,6
1587675,20,9,1993,10,male,651,254,100,3,16,3,16,0,0
1226354,22,15,1991,10,male,599,256,99,3,47,3,38,0,9
2147387,23,1,1990,1,male,337,260,142,3,8,3,3,0,5
1935595,25,2,1988,11,female,325,252,219,3,106,3,83,0,23
1163071,26,18,1987,5,female,448,255,174,3,35,3,29,0,6
1878115,32,12,1981,11,male,484,260,89,3,13,3,13,0,0
2065952,62,9,1951,9,male,613,257,43,3,8,3,8,0,0
1348754,103,18,1910,12,male,899,256,200,3,34,3,31,0,3
1592178,15,3,1998,7,male,710,255,205,4,1,0,0,4,1
2174628,99,25,1914,6,male,1288,251,28,4,4,0,1,4,3
1874211,17,28,1996,12,male,339,255,135,4,25,0,12,4,13
1271338,18,18,1995,11,male,793,254,62,4,6,0,4,4,2
1472214,28,24,1985,12,male,293,258,255,4,7,0,4,4,3
1070790,82,27,1931,4,female,646,261,103,4,8,0,1,4,7
1452923,19,23,1994,4,male,467,258,117,4,2,1,0,3,2
1777398,23,16,1990,10,male,654,260,138,4,2,2,0,2,2
1991610,68,25,1945,1,male,1324,261,152,4,3,2,1,2,2
2044592,20,26,1993,8,female,378,252,59,4,53,1,21,3,32
1902141,20,3,1993,3,male,909,261,186,4,23,3,18,1,5
1295095,25,12,1988,11,female,205,261,194,4,154,3,53,1,101
2123634,19,7,1994,5,male,608,252,94,4,0,4,0,0,0
2102701,22,7,1991,4,female,526,260,208,4,0,4,0,0,0
2005142,17,21,1996,7,female,827,253,125,4,2,4,2,0,0
1191035,17,7,1996,10,male,441,257,228,4,1,4,1,0,0
1546344,25,22,1988,6,male,1106,261,139,4,1,4,0,0,1
1693572,58,27,1955,3,female,1806,256,100,4,2,4,2,0,0
1024261,27,8,1986,9,male,928,251,181,4,4,4,3,0,1
1517242,103,26,1910,5,male,826,251,155,4,4,4,4,0,0
1258200,108,22,1905,3,male,532,255,158,4,3,4,2,0,1
1987799,17,8,1996,12,female,64,259,56,4,44,4,22,0,22
1964460,16,15,1997,9,female,296,252,61,4,7,4,6,0,1
1930135,18,29,1995,7,male,346,252,60,4,28,4,19,0,9
1259802,22,15,1991,5,female,789,254,107,4,36,4,24,0,12
1910586,26,27,1987,7,male,501,252,79,4,152,4,117,0,35
1947671,103,15,1910,3,female,1139,252,86,4,10,4,10,0,0
1186948,16,24,1997,5,male,762,261,148,5,0,0,0,5,0
1680655,18,2,1995,2,male,318,257,220,5,0,0,0,5,0
1630454,27,29,1986,6,male,865,261,141,5,0,0,0,5,0
1650928,28,17,1985,3,male,498,255,150,5,0,0,0,5,0
1563598,58,28,1955,10,male,1058,254,150,5,4,0,0,5,4
1523339,29,4,1984,8,female,686,257,186,5,20,0,4,5,16
2131771,19,13,1994,5,male,268,255,229,5,6,3,5,2,1
1580557,103,15,1910,10,male,1341,257,96,5,4,3,1,2,3
1312126,21,4,1992,2,male,570,253,118,5,13,2,6,3,7
1862725,25,25,1988,2,female,838,252,37,5,30,4,10,1,20
1495349,37,22,1976,4,male,1209,258,85,5,0,5,0,0,0
1089478,16,4,1997,4,male,508,254,164,5,2,5,2,0,0
1606897,108,1,1905,3,male,834,261,216,5,3,5,1,0,2
1048577,30,22,1983,2,male,208,254,169,5,4,5,4,0,0
1105874,18,10,1995,5,male,94,252,245,5,42,5,20,0,22
1282050,18,14,1995,8,male,679,259,180,5,519,5,404,0,115
1975328,20,11,1993,12,female,41,259,63,5,56,5,42,0,14
1684986,22,29,1991,7,female,140,258,194,5,17,5,10,0,7
1078394,24,10,1989,1,male,853,261,162,5,53,5,41,0,12
1102442,27,27,1986,9,male,387,257,195,5,13,5,10,0,3
1173080,38,26,1975,8,female,627,261,137,5,12,5,2,0,10
1319452,14,9,1999,4,male,215,261,190,6,1,0,0,6,1
1868817,23,23,1990,8,male,1361,261,134,6,7,0,7,6,0
1137688,106,2,1907,6,male,1247,257,114,6,5,1,1,5,4
1785533,15,5,1998,8,male,289,257,170,6,6,3,4,3,2
1563289,19,31,1994,3,male,509,254,92,6,14,4,5,2,9
1227373,28,28,1985,1,female,899,258,52,6,31,3,27,3,4
1877875,21,12,1992,11,male,403,258,210,6,10,5,3,1,7
1496009,22,7,1991,7,male,528,261,116,6,27,5,7,1,20
1617483,29,18,1984,12,female,164,254,221,6,60,5,31,1,29
1862321,26,15,1987,11,male,943,256,117,6,0,6,0,0,0
1594358,27,29,1986,5,female,799,256,140,6,5,6,2,0,3
1309299,16,6,1997,4,female,281,258,76,6,110,6,101,0,9
1459672,19,17,1994,3,male,139,256,224,6,10,6,10,0,0
1681863,22,16,1991,7,male,462,261,201,6,103,6,52,0,51
1066859,25,18,1988,8,female,702,261,95,6,46,6,20,0,26
1221003,37,14,1976,3,female,253,252,215,6,19,6,10,0,9
2032176,44,31,1969,8,male,363,253,112,7,3,0,1,7,2
2095679,103,18,1910,12,male,806,260,140,7,7,0,2,7,5
1903174,14,21,1999,4,male,450,258,151,7,2,6,2,1,0
1792712,19,26,1994,1,female,529,255,122,7,13,6,7,1,6
2098704,14,17,1999,1,male,217,254,180,7,1,7,1,0,0
1077686,14,25,1999,6,male,692,252,206,7,0,7,0,0,0
1207153,16,10,1997,3,male,427,257,201,7,1,7,1,0,0
1114221,19,24,1994,11,male,531,257,126,7,3,7,3,0,0
1917496,18,18,1995,4,male,412,258,183,7,10,7,3,0,7
2013336,32,1,1981,7,female,659,256,197,7,8,7,7,0,1
2108854,40,23,1973,2,female,512,251,178,7,5,7,5,0,0
1124823,14,13,1999,4,female,78,252,45,7,126,7,112,0,14
1356525,56,13,1957,10,male,359,255,54,7,104,7,59,0,45
2051166,29,18,1984,11,male,455,258,98,8,4,1,3,7,1
1199060,20,20,1993,5,male,353,258,169,8,8,0,3,8,5
1836555,103,13,1910,7,male,1812,254,154,8,29,0,14,8,15
1189451,37,22,1976,5,female,462,256,163,8,9,5,5,3,4
2094756,18,17,1995,8,female,414,259,113,8,13,5,5,3,8
2185198,18,1,1995,7,male,666,252,179,8,22,7,15,1,7
1379880,18,28,1995,11,male,181,259,193,8,0,8,0,0,0
1039751,19,20,1994,2,male,472,251,177,8,11,8,9,0,2
1894184,29,25,1984,8,male,251,251,178,8,5,8,5,0,0
1222977,36,4,1977,9,female,487,258,75,8,5,8,4,0,1
1224456,15,8,1998,9,female,293,260,143,8,354,8,295,0,59
2112250,17,23,1996,12,male,513,257,210,8,53,8,36,0,17
1467261,18,9,1995,2,male,244,254,201,8,35,8,33,0,2
2028792,20,30,1993,12,female,301,259,78,8,33,8,18,0,15
1532256,21,23,1992,12,female,93,251,31,8,16,8,6,0,10
1887638,31,15,1982,11,female,970,260,117,8,22,8,22,0,0
2029090,18,29,1995,11,male,682,261,223,9,1,0,0,9,1
1749377,75,5,1938,12,male,2203,256,94,9,1,1,1,8,0
1169636,17,14,1996,5,male,1431,252,109,9,12,0,2,9,10
1368467,113,26,1900,10,male,1830,252,100,9,8,0,7,9,1
1826874,30,17,1983,11,male,672,261,212,9,39,0,13,9,26
2020343,17,3,1996,3,male,647,260,230,9,5,4,3,5,2
1490768,22,17,1991,11,male,548,258,228,9,11,4,2,5,9
1897755,67,2,1946,10,male,1479,259,143,9,217,8,41,1,176
1858374,33,20,1980,4,male,319,252,196,9,0,9,0,0,0
1639413,15,25,1998,4,male,501,256,161,9,3,9,2,0,1
1610209,21,3,1992,8,male,575,255,178,9,4,9,2,0,2
1096177,18,8,1995,5,male,1028,251,96,9,11,9,0,0,11
1817856,19,27,1994,3,male,327,260,205,9,19,9,16,0,3
2019078,29,27,1984,4,male,918,261,103,9,37,9,36,0,1
2061971,15,9,1998,6,male,622,252,224,10,6,0,1,10,5
1871070,25,26,1988,11,male,311,259,244,10,3,0,2,10,1
1660252,30,18,1983,2,male,563,261,237,10,4,0,0,10,4
1116714,73,13,1940,2,male,779,257,117,10,3,0,1,10,2
1525699,16,12,1997,10,female,228,261,84,10,13,0,10,10,3
1035460,21,4,1992,4,female,613,257,52,10,66,7,60,3,6
2156518,18,22,1995,5,male,430,261,69,10,4,9,4,1,0
2099756,18,5,1995,1,male,532,254,216,10,14,9,5,1,9
1781835,16,25,1997,3,female,442,261,210,10,5,10,4,0,1
1002870,17,1,1996,11,male,875,253,177,10,98,10,66,0,32
1216109,24,25,1989,8,male,418,257,164,10,43,10,31,0,12
1361034,20,2,1993,8,male,637,255,65,11,15,3,11,8,4
1323200,20,1,1993,9,male,666,251,200,11,3,11,3,0,0
2123522,31,10,1982,3,male,351,261,94,11,2,11,1,0,1
1358767,60,15,1953,9,male,472,259,147,11,5,11,2,0,3
1112122,103,26,1910,12,male,1277,258,97,11,5,11,5,0,0
1640443,17,4,1996,12,female,158,256,195,11,12,11,12,0,0
1538565,28,25,1985,10,male,568,255,238,11,8,11,7,0,1
1697909,23,15,1990,2,female,639,253,62,11,38,11,34,0,4
1206924,30,31,1983,5,male,795,259,104,11,74,11,26,0,48
1849444,103,17,1910,12,female,782,259,102,11,28,11,27,0,1
1840251,34,19,1979,3,male,478,259,157,12,8,5,2,7,6
1748260,21,22,1992,9,male,388,254,190,12,29,6,27,6,2
1123274,18,9,1995,6,male,628,254,118,12,2,12,2,0,0
1983561,26,28,1987,10,male,523,255,88,12,3,12,3,0,0
1565968,15,28,1998,1,male,390,254,169,12,9,12,2,0,7
1398351,22,19,1991,4,male,912,257,141,12,21,12,18,0,3
1842905,27,28,1986,6,female,934,254,179,12,58,12,45,0,13
1782583,34,5,1979,4,female,137,251,186,12,29,12,20,0,9
1638152,21,6,1992,7,male,356,253,196,13,7,0,1,13,6
1895138,18,12,1995,9,male,356,255,130,13,32,1,16,12,16
1700782,25,26,1988,11,male,1421,252,111,13,5,9,4,4,1
1588096,20,12,1993,1,male,465,256,151,13,53,9,50,4,3
1714636,72,4,1941,5,male,404,260,154,13,2,12,1,1,1
1262185,23,24,1990,8,male,973,258,190,13,1,13,1,0,0
1967716,26,4,1987,4,male,486,252,207,13,11,13,11,0,0
1318394,18,16,1995,9,male,455,252,95,13,33,13,21,0,12
1919150,19,14,1994,6,female,712,253,106,13,53,13,48,0,5
1823472,23,10,1990,8,male,586,251,146,13,34,13,23,0,11
1009757,93,14,1920,11,male,1411,252,145,13,294,13,268,0,26
1139266,18,11,1995,11,female,413,251,162,14,21,0,7,14,14
1116909,21,30,1992,4,male,645,261,197,14,0,14,0,0,0
1278908,18,8,1995,8,male,225,259,132,14,15,14,12,0,3
1725982,21,17,1992,4,male,1290,261,78,14,10,14,8,0,2
1111168,31,25,1982,11,female,522,259,221,14,9,14,4,0,5
1161061,15,20,1998,8,female,332,255,129,14,52,14,26,0,26
1834353,17,9,1996,3,female,33,257,27,14,22,14,19,0,3
1975934,24,28,1989,3,female,469,251,173,14,47,14,17,0,30
1374685,53,27,1960,4,female,377,255,172,14,182,14,144,0,38
1285536,16,1,1997,12,female,249,261,160,15,7,0,7,15,0
2079345,24,7,1989,5,female,375,255,187,15,22,0,9,15,13
1986589,15,22,1998,10,male,773,255,115,15,31,9,20,6,11
1742618,14,4,1999,10,female,280,256,176,15,13,15,12,0,1
1644004,18,8,1995,11,male,898,256,96,15,17,15,4,0,13
1359873,17,29,1996,5,male,922,256,132,15,17,15,11,0,6
1389493,103,13,1910,1,male,726,259,223,16,2,3,0,13,2
1473780,19,3,1994,6,male,498,255,210,16,2,16,2,0,0
1880645,15,9,1998,5,male,458,261,243,16,9,16,9,0,0
1888317,25,7,1988,9,male,562,258,127,16,8,16,8,0,0
2125854,17,27,1996,2,female,509,252,26,16,17,16,13,0,4
1159543,20,12,1993,12,female,102,259,97,16,55,16,31,0,24
1133658,21,15,1992,4,male,661,253,178,16,47,16,32,0,15
1004153,24,22,1989,8,male,29,256,31,16,24,16,15,0,9
1739051,24,25,1989,9,female,29,258,43,16,173,16,150,0,23
1096066,26,11,1987,7,male,423,253,164,17,1,1,0,16,1
1417417,60,11,1953,1,male,1568,256,150,17,12,12,4,5,8
1071123,20,5,1993,11,male,150,253,229,17,0,16,0,1,0
2116342,54,21,1959,10,male,621,254,179,17,47,16,28,1,19
1742963,14,5,1999,7,male,484,259,117,17,11,17,10,0,1
2185782,24,6,1989,8,female,553,254,163,17,136,17,123,0,13
1042650,26,9,1987,6,male,388,256,208,18,18,4,12,14,6
1899342,84,3,1929,7,NA,2214,254,82,18,23,10,4,8,19
1436866,18,4,1995,7,female,187,259,119,18,29,9,15,9,14
1441445,108,24,1905,4,male,2011,256,205,18,40,5,29,13,11
1934656,15,10,1998,6,male,598,255,186,18,11,17,4,1,7
1973345,34,7,1979,2,male,264,259,221,19,1,0,0,19,1
1022105,17,7,1996,10,male,177,252,149,19,12,1,4,18,8
1042032,18,1,1995,1,male,295,257,247,19,0,19,0,0,0
1314120,26,1,1987,1,male,574,259,202,19,1,19,1,0,0
2188558,27,21,1986,3,male,752,252,114,19,1,19,1,0,0
1256174,24,10,1989,8,male,324,258,191,19,12,19,10,0,2
1834286,104,10,1909,4,male,830,257,205,20,2,2,2,18,0
1061533,55,6,1958,9,male,1122,258,176,20,294,8,177,12,117
1526953,93,17,1920,8,male,1635,251,143,20,60,20,58,0,2
1026588,102,25,1911,4,male,848,258,149,21,15,0,7,21,8
1162841,21,15,1992,10,female,498,259,161,21,5,10,4,11,1
1176082,108,28,1905,2,female,950,252,194,21,44,14,34,7,10
1357136,20,20,1993,4,male,447,261,191,21,0,21,0,0,0
1902537,103,8,1910,11,male,412,258,145,21,0,21,0,0,0
1455950,23,8,1990,8,male,150,251,245,21,9,21,7,0,2
2153058,95,4,1918,2,male,1136,252,140,21,6,21,4,0,2
1808939,19,26,1994,1,female,483,252,143,21,211,21,198,0,13
2023767,26,1,1987,1,male,453,260,196,22,23,0,6,22,17
1299849,17,11,1996,12,female,568,260,60,22,36,0,3,22,33
1874107,26,19,1987,5,male,374,251,237,22,3,22,3,0,0
1606672,43,1,1970,3,male,438,257,131,22,17,22,10,0,7
1588731,19,13,1994,11,female,227,260,61,22,101,22,66,0,35
1686767,27,16,1986,1,male,1600,259,103,22,33,22,22,0,11
1376681,100,18,1913,7,female,1873,251,118,23,7,0,6,23,1
1524501,27,28,1986,10,male,517,257,166,23,0,23,0,0,0
1338446,29,8,1984,4,male,167,259,233,23,28,23,25,0,3
1688426,18,9,1995,12,female,312,256,99,23,95,23,21,0,74
1290959,86,11,1927,9,female,2074,251,113,23,67,23,35,0,32
2107893,108,26,1905,3,male,319,258,200,23,85,23,61,0,24
1176923,16,12,1997,4,male,630,258,208,24,8,0,2,24,6
1181771,38,25,1975,10,female,299,254,166,24,66,3,40,21,26
1646496,16,11,1997,6,female,340,257,194,24,5,23,3,1,2
1292833,29,15,1984,12,male,333,252,216,24,6,18,3,6,3
1382747,18,22,1995,10,male,142,257,223,24,17,20,16,4,1
1309400,27,10,1986,8,male,465,253,244,24,9,24,9,0,0
1905575,22,1,1991,6,male,150,251,224,24,16,24,9,0,7
1809382,33,27,1980,6,male,142,257,227,24,58,24,46,0,12
1438449,37,17,1976,9,female,502,258,168,24,58,24,48,0,10
1755725,22,17,1991,4,male,277,261,201,25,11,10,0,15,11
1661745,21,21,1992,11,female,525,257,100,25,0,25,0,0,0
1887282,23,1,1990,11,female,1090,260,180,25,15,25,7,0,8
1801872,16,9,1997,7,male,386,254,156,25,75,25,25,0,50
1044986,22,18,1991,11,female,1998,255,46,25,61,25,45,0,16
1705139,34,1,1979,1,male,312,257,122,25,61,25,36,0,25
1987578,18,27,1995,11,female,210,255,217,26,26,21,5,5,21
1057425,18,8,1995,8,male,325,255,130,26,23,19,15,7,8
1458354,17,4,1996,10,female,222,260,107,26,0,26,0,0,0
2109817,20,20,1993,1,female,555,251,37,26,4,26,3,0,1
1662867,16,16,1997,12,male,240,254,184,26,23,26,22,0,1
1265999,18,21,1995,11,male,412,257,189,26,20,26,16,0,4
1680871,18,5,1995,2,male,726,259,129,26,82,26,69,0,13
2014070,20,2,1993,1,male,289,260,161,26,87,26,84,0,3
1365187,20,22,1993,7,female,179,255,62,26,54,26,28,0,26
1920533,20,17,1993,8,male,461,259,207,26,98,26,77,0,21
1988413,24,22,1989,5,male,419,251,172,26,65,26,56,0,9
1785332,20,12,1993,2,male,317,259,88,27,28,0,9,27,19
1179976,14,17,1999,8,male,68,253,244,27,16,6,10,21,6
1428850,18,1,1995,1,male,279,255,167,27,285,13,102,14,183
1414834,25,24,1988,1,female,202,257,181,27,54,11,38,16,16
1611873,17,14,1996,11,male,141,254,227,27,32,27,32,0,0
1544407,19,28,1994,3,female,219,256,199,27,30,27,23,0,7
2154212,14,29,1999,8,female,100,252,211,27,87,27,76,0,11
1528006,29,22,1984,9,female,341,255,89,27,90,27,67,0,23
1262794,103,9,1910,12,male,1188,260,186,27,101,27,60,0,41
2020591,17,14,1996,11,male,349,257,114,28,3,0,2,28,1
1972204,14,10,1999,2,female,497,259,219,28,0,13,0,15,0
1952740,25,5,1988,1,female,145,260,163,28,130,14,85,14,45
1028224,27,21,1986,8,male,307,256,163,28,103,9,26,19,77
1355790,31,5,1982,3,female,840,260,204,28,111,22,53,6,58
1217739,39,20,1974,2,male,1632,256,63,28,18,28,13,0,5
1195492,64,14,1949,6,male,45,260,78,28,26,28,9,0,17
1696597,68,17,1945,8,male,127,258,183,29,13,0,1,29,12
1121820,22,27,1991,2,male,813,255,109,29,3,26,3,3,0
1571697,30,21,1983,3,female,549,252,105,29,17,28,2,1,15
2127220,108,15,1905,9,female,793,255,99,29,3,29,3,0,0
1822114,16,24,1997,8,female,162,261,81,29,13,29,11,0,2
1996227,19,5,1994,6,male,396,254,195,30,0,0,0,30,0
1463951,70,1,1943,1,male,2034,253,215,31,4,0,2,31,2
1509222,36,21,1977,11,female,1028,259,167,30,7,0,0,30,7
1349023,30,13,1983,7,male,1038,254,128,30,27,5,25,25,2
1268640,41,17,1972,5,female,237,254,178,30,60,0,28,30,32
1848431,13,30,2000,7,male,81,257,146,30,0,10,0,20,0
1619055,22,26,1991,11,male,503,258,187,30,60,15,28,15,32
1048113,28,18,1985,9,female,408,254,66,30,96,16,33,14,63
1249569,24,30,1989,3,male,380,261,219,31,0,27,0,4,0
1445655,20,30,1993,7,female,358,257,124,30,75,27,63,3,12
1011035,21,14,1992,5,female,276,261,110,30,53,22,36,8,17
1667937,35,5,1978,5,female,743,255,145,31,818,30,288,1,530
2172823,18,1,1995,1,female,498,256,63,30,16,30,15,0,1
2149337,19,7,1994,8,male,612,254,222,31,17,31,15,0,2
1761917,19,19,1994,9,male,594,256,77,30,15,30,13,0,2
1796886,21,17,1992,6,male,283,256,105,30,7,30,7,0,0
1846624,26,20,1987,5,male,481,258,228,30,34,30,32,0,2
1773788,108,22,1905,4,male,489,254,241,30,131,30,118,0,13
1908189,88,15,1925,3,male,1863,259,83,32,67,0,21,32,46
1903771,25,17,1988,2,male,1256,255,138,32,3,18,3,14,0
1723558,20,23,1993,7,female,1276,256,102,33,363,3,261,30,102
1095963,16,8,1997,2,male,75,257,238,33,4,19,3,14,1
1568477,19,3,1994,9,female,447,254,161,33,1,29,0,4,1
2079911,25,10,1988,4,male,470,253,179,33,1,27,0,6,1
1453105,24,29,1989,10,male,1147,259,120,33,24,27,9,6,15
1058367,25,16,1988,12,female,198,252,111,33,51,33,49,0,2
1553410,18,2,1995,10,female,236,258,209,34,95,19,18,15,77
1273029,49,16,1964,8,male,1007,259,167,34,0,31,0,3,0
1118140,21,19,1992,8,female,418,256,204,34,50,33,19,1,31
1960624,59,9,1954,2,male,459,257,144,34,16,34,9,0,7
1188817,25,8,1988,11,male,349,256,118,34,37,34,24,0,13
1189765,86,10,1927,8,male,1698,252,180,34,36,34,27,0,9
1941475,16,25,1997,5,male,172,258,136,35,27,0,8,35,19
1130105,62,16,1951,10,female,879,259,148,36,50,0,5,36,45
2025831,18,10,1995,9,female,273,257,170,35,112,5,15,30,97
1844991,26,17,1987,5,female,343,252,207,36,15,16,6,20,9
1589623,16,14,1997,6,male,557,254,188,35,31,32,6,3,25
1237136,19,9,1994,8,male,739,251,194,36,19,36,13,0,6
1916860,52,23,1961,2,male,299,259,97,36,13,36,10,0,3
1447493,103,2,1910,4,male,736,255,97,36,26,36,16,0,10
1843436,25,1,1988,5,female,537,256,29,35,180,35,78,0,102
1539575,14,15,1999,2,female,287,260,224,37,126,37,110,0,16
2044231,27,21,1986,2,male,1349,251,87,37,61,37,44,0,17
2150800,26,9,1987,11,male,743,257,171,39,27,1,17,38,10
2150534,45,24,1968,6,male,579,251,155,38,41,0,18,38,23
1838101,102,10,1911,10,male,1883,260,147,38,20,27,7,11,13
2122126,26,4,1987,10,female,218,261,195,38,76,26,44,12,32
1141068,36,22,1977,12,male,401,258,194,39,5,38,4,1,1
1372028,100,8,1913,7,female,1607,255,144,38,37,32,11,6,26
1176333,20,17,1993,11,male,428,259,243,39,21,39,13,0,8
1024704,21,29,1992,9,female,516,261,153,39,49,39,47,0,2
1162316,22,21,1991,3,male,898,258,123,38,46,38,43,0,3
1968016,32,26,1981,4,male,416,251,145,38,47,38,34,0,13
1198720,31,12,1982,11,female,232,256,199,38,69,38,43,0,26
1146799,103,12,1910,4,female,855,253,79,38,72,38,48,0,24
1398516,20,21,1993,4,female,476,256,161,40,4,0,4,40,0
1885748,60,28,1953,12,female,1737,254,155,40,40,0,22,40,18
1785817,30,1,1983,4,male,338,255,198,40,13,30,7,10,6
1970524,21,19,1992,11,male,710,256,164,40,0,40,0,0,0
1631888,22,10,1991,12,female,826,252,105,40,101,40,94,0,7
1701177,26,17,1987,6,male,666,261,190,40,96,40,77,0,19
1654266,16,1,1997,1,male,202,258,218,41,50,3,17,38,33
1903053,22,30,1991,1,female,195,251,115,42,27,3,5,39,22
1357408,21,29,1992,6,male,929,258,99,42,99,5,92,37,7
1762210,15,15,1998,5,female,351,252,150,41,6,23,3,18,3
1984054,16,29,1997,9,female,428,254,161,42,7,22,4,20,3
1500471,28,3,1985,9,male,497,255,201,42,37,23,25,19,12
1268190,23,3,1990,6,male,402,253,154,41,17,33,10,8,7
1411560,29,14,1984,1,male,733,255,123,41,117,34,48,7,69
1782851,38,20,1975,6,female,414,255,155,42,264,41,241,1,23
1845266,23,10,1990,9,male,197,254,205,41,22,41,14,0,8
1360483,26,12,1987,9,male,434,255,221,42,40,42,29,0,11
1458940,90,30,1923,1,male,394,251,180,43,6,0,1,43,5
1362232,45,23,1968,7,female,654,260,170,44,20,1,9,43,11
1185839,68,1,1945,12,male,48,261,228,43,28,0,19,43,9
2136845,22,11,1991,3,male,403,251,139,43,97,24,24,19,73
1437858,53,22,1960,3,female,858,253,62,43,15,43,11,0,4
1329673,17,7,1996,3,male,666,252,85,44,30,44,13,0,17
1794524,77,13,1936,8,male,2426,253,57,43,33,43,28,0,5
1217433,19,28,1994,7,female,225,260,130,44,76,44,47,0,29
1259929,17,28,1996,2,male,332,256,212,45,17,21,0,24,17
1578103,15,7,1998,11,male,427,259,141,45,80,40,62,5,18
1428999,16,13,1997,3,male,516,251,188,45,13,45,9,0,4
1849659,22,31,1991,8,male,466,257,207,45,15,45,11,0,4
1929752,21,7,1992,9,female,282,254,184,45,57,45,39,0,18
1907116,22,25,1991,5,male,447,257,158,45,41,45,30,0,11
1687668,94,20,1919,3,female,778,254,60,45,31,45,23,0,8
1690045,19,15,1994,1,female,533,253,141,45,97,45,95,0,2
1794539,18,1,1995,1,male,141,257,100,46,3,9,3,37,0
1895262,18,15,1995,10,female,479,256,179,46,17,0,7,46,10
1249696,20,27,1993,9,male,301,260,187,46,57,41,42,5,15
1950148,29,23,1984,4,male,407,254,110,47,21,47,12,0,9
1348000,17,6,1996,6,female,585,255,127,49,52,0,8,49,44
1334909,29,27,1984,8,female,322,255,30,48,114,34,82,14,32
1477549,22,1,1991,7,female,115,252,216,48,237,47,136,1,101
1131255,21,6,1992,7,female,447,257,78,48,209,48,111,0,98
1939737,16,17,1997,4,male,213,257,171,51,53,10,10,41,43
1520667,96,22,1917,3,female,1515,253,95,50,46,0,21,50,25
1720943,108,24,1905,10,male,1363,253,162,50,44,1,19,49,25
1142119,20,1,1993,6,male,298,261,162,51,65,22,34,29,31
1618026,46,11,1967,6,female,516,257,196,50,47,23,27,27,20
1366293,14,1,1999,8,female,213,256,182,50,43,50,37,0,6
1015701,21,1,1992,1,male,529,261,137,50,192,50,159,0,33
2007019,17,15,1996,3,male,1177,251,167,53,13,18,1,35,12
1026957,16,21,1997,9,female,370,251,103,52,10,52,9,0,1
1598018,25,10,1988,6,female,464,254,93,52,40,52,40,0,0
1396212,19,10,1994,8,male,396,251,127,55,6,0,0,55,6
1345931,17,31,1996,5,female,286,251,50,55,25,17,5,38,20
1582779,62,31,1951,3,female,1269,255,203,55,59,39,17,16,42
1106306,54,4,1959,7,female,1767,256,201,55,98,40,64,15,34
1943484,27,31,1986,5,male,65,252,248,55,5,55,5,0,0
1166023,23,21,1990,10,female,354,253,42,54,24,54,23,0,1
2064679,24,18,1989,12,female,187,256,191,55,43,55,42,0,1
1252157,18,8,1995,6,male,512,258,219,57,11,1,0,56,11
1704024,29,8,1984,4,male,605,253,231,58,15,33,14,25,1
1142353,15,11,1998,3,female,22,256,101,57,54,40,49,17,5
2117212,22,20,1991,7,male,1014,253,89,56,10,47,2,9,8
1286033,20,4,1993,9,female,212,255,87,57,118,57,59,0,59
1334834,16,3,1997,6,male,488,258,105,60,19,5,14,55,5
1688671,23,14,1990,7,male,263,257,153,59,89,56,50,3,39
1677972,17,28,1996,8,female,61,255,90,59,13,59,10,0,3
1878342,33,29,1980,5,female,850,260,225,60,15,60,14,0,1
1484940,19,1,1994,1,male,27,259,250,60,194,60,160,0,34
1820553,25,20,1988,10,female,1459,257,87,60,310,60,226,0,84
2182121,99,24,1914,4,male,865,252,162,62,26,1,3,61,23
1594064,23,2,1990,4,female,484,251,182,61,70,43,63,18,7
1122145,19,15,1994,7,male,417,253,145,62,70,46,32,16,38
1273803,16,5,1997,2,female,130,253,69,61,22,61,12,0,10
1183506,18,30,1995,3,male,80,251,194,63,508,63,305,0,203
1149046,27,23,1986,9,female,480,256,169,62,898,62,761,0,137
1386249,35,1,1978,11,male,395,261,246,62,211,62,146,0,65
1509330,100,2,1913,4,male,1485,253,142,65,59,40,46,25,13
1438237,22,17,1991,3,female,800,254,120,65,93,64,80,1,13
1389081,14,20,1999,2,male,76,253,228,65,51,65,26,0,25
1781029,48,14,1965,12,female,429,257,218,66,4,4,1,62,3
1032502,39,23,1974,7,male,909,261,162,67,47,0,14,67,33
1573816,89,18,1924,10,male,949,251,150,66,61,3,4,63,57
1547190,103,10,1910,11,male,1638,255,172,68,57,12,20,56,37
1237360,15,22,1998,2,female,566,254,189,67,4,44,3,23,1
1790723,22,22,1991,9,male,468,255,242,68,6,23,0,45,6
1322133,20,1,1993,1,female,355,259,24,67,46,67,37,0,9
1710778,20,15,1993,7,male,1254,251,122,68,51,68,38,0,13
1683185,108,23,1905,8,male,893,254,107,68,68,68,56,0,12
1165334,108,31,1905,7,male,1155,259,119,71,12,0,7,71,5
2103956,30,25,1983,1,male,126,254,48,69,170,67,161,2,9
1206432,20,28,1993,6,male,457,260,101,71,6,71,6,0,0
1220945,29,18,1984,7,female,1495,261,149,69,17,69,12,0,5
1909362,26,6,1987,3,male,457,257,212,70,285,70,266,0,19
2009801,31,14,1982,10,female,863,255,198,72,66,72,30,0,36
1082066,20,16,1993,10,female,210,256,72,75,77,4,33,71,44
1953269,15,6,1998,11,male,424,253,186,76,92,60,52,16,40
1721375,18,5,1995,6,male,317,257,178,75,7,75,7,0,0
1975699,83,22,1930,11,male,255,261,210,75,23,75,7,0,16
1803724,103,29,1910,6,male,638,260,163,75,25,75,17,0,8
1171043,16,7,1997,7,male,195,260,194,77,53,77,52,0,1
1608491,20,13,1993,10,female,612,256,155,76,61,76,57,0,4
1168826,56,27,1957,6,male,663,259,154,78,66,15,32,63,34
1318076,113,8,1900,4,female,1330,254,96,78,17,24,5,54,12
1763549,23,29,1990,6,male,66,256,231,78,2,71,1,7,1
1701894,28,21,1985,9,female,5,255,158,78,170,70,138,8,32
1187948,19,6,1994,1,female,367,256,141,79,39,79,35,0,4
1580574,21,11,1992,10,male,359,255,214,80,172,80,139,0,33
2061070,16,21,1997,11,female,272,251,165,82,25,59,18,23,7
1168992,15,14,1998,1,female,473,256,236,84,24,34,3,50,21
1691401,108,27,1905,9,female,1885,255,121,84,18,20,7,64,11
1574923,16,9,1997,11,male,116,251,206,84,73,46,10,38,63
1926631,14,16,1999,9,male,35,253,203,83,49,66,41,17,8
1044484,20,12,1993,11,female,651,252,187,84,51,82,40,2,11
1800995,108,25,1905,9,male,560,258,235,82,48,80,38,2,10
1022559,18,2,1995,12,female,675,252,173,83,109,81,43,2,66
1819595,29,9,1984,5,male,748,261,119,83,155,72,121,11,34
1297509,33,13,1980,10,female,845,257,88,82,206,71,71,11,135
1798434,14,9,1999,8,female,226,258,197,84,11,84,6,0,5
1046623,22,5,1991,3,female,429,251,124,84,43,84,41,0,2
2061564,25,18,1988,8,male,396,257,202,82,15,82,10,0,5
1987511,22,14,1991,11,female,380,254,93,83,206,83,198,0,8
2046876,16,1,1997,1,male,96,259,209,86,15,0,0,86,15
1812482,54,1,1959,8,male,873,256,21,87,16,0,9,87,7
1661755,19,25,1994,3,male,172,252,132,87,143,35,54,52,89
1783949,14,8,1999,12,female,119,257,104,87,52,87,48,0,4
2067237,31,31,1982,12,male,349,254,137,87,17,87,17,0,0
1724539,47,23,1966,1,female,442,253,149,86,50,86,44,0,6
1395344,83,14,1930,9,male,772,254,194,87,37,87,24,0,13
1614262,31,6,1982,9,female,251,257,231,87,216,87,97,0,119
1912350,18,29,1995,7,female,463,252,103,88,290,14,91,74,199
1137546,17,11,1996,3,male,398,261,101,89,8,25,3,64,5
1947423,16,23,1997,12,male,411,260,70,90,76,86,58,4,18
1418596,100,22,1913,1,male,2016,254,99,90,106,80,60,10,46
1186130,35,28,1978,9,female,1291,253,123,88,172,75,121,13,51
1956216,22,12,1991,7,male,187,257,248,89,4,89,2,0,2
1288881,113,1,1900,1,female,1529,251,81,89,7,89,7,0,0
1623794,22,21,1991,3,female,475,253,99,88,129,88,93,0,36
1504349,46,15,1967,9,female,1880,256,127,88,72,88,62,0,10
1068128,25,3,1988,2,male,361,260,213,89,157,89,133,0,24
1869216,58,15,1955,8,male,1391,252,112,91,166,91,69,0,97
1799680,18,9,1995,3,male,293,256,235,95,12,0,3,95,9
1056247,21,9,1992,9,male,439,254,156,93,50,46,45,47,5
1189237,18,22,1995,4,female,336,254,224,93,113,46,87,47,26
1371885,72,7,1941,9,male,1759,261,60,93,65,62,52,31,13
1062017,15,19,1998,7,female,614,258,136,92,64,89,44,3,20
1370196,21,31,1992,7,female,408,254,68,95,123,75,95,20,28
2070681,57,5,1956,9,female,1392,251,119,93,75,91,72,2,3
1196901,22,1,1991,2,female,25,255,60,92,91,92,31,0,60
2175153,106,24,1907,2,female,1830,261,210,95,68,95,56,0,12
1612826,21,5,1992,10,female,270,254,81,99,35,99,17,0,18
1506546,108,27,1905,8,female,1744,257,131,101,58,0,41,101,17
1018930,22,2,1991,1,male,378,258,42,100,103,30,29,70,74
1316301,35,12,1978,9,male,348,252,218,101,87,55,52,46,35
1104630,16,14,1997,1,female,434,257,200,100,346,35,255,65,91
1156975,31,21,1982,12,male,919,252,164,102,5,93,1,9,4
1518726,32,21,1981,7,male,428,255,89,102,51,102,13,0,38
1181529,35,17,1978,3,female,505,261,185,101,26,101,9,0,17
1096612,21,28,1992,3,male,229,260,202,101,109,101,107,0,2
1587564,18,4,1995,6,female,422,253,171,100,246,100,136,0,110
1003250,58,8,1955,8,female,1555,260,146,105,238,104,147,1,91
1266327,32,14,1981,6,female,574,251,159,109,20,109,16,0,4
2092921,21,21,1992,4,male,185,256,191,109,97,109,91,0,6
1119262,70,18,1943,5,male,655,251,178,113,4,0,1,113,3
1452965,82,15,1931,7,male,1685,259,173,113,23,16,15,97,8
1644396,33,20,1980,5,female,1304,258,161,110,373,41,242,69,131
1981859,20,29,1993,4,male,741,257,175,112,0,110,0,2,0
1985786,36,7,1977,5,male,401,255,151,113,317,110,229,3,88
1794907,20,5,1993,3,female,341,256,120,110,36,110,34,0,2
1792415,26,19,1987,12,male,59,258,59,111,91,111,59,0,32
2133529,19,29,1994,5,female,712,257,143,115,492,9,159,106,333
1607143,21,28,1992,6,female,430,258,130,116,10,39,6,77,4
2145753,51,7,1962,11,female,386,251,202,115,35,72,21,43,14
1068287,39,29,1974,8,female,393,251,172,114,50,106,37,8,13
2039425,25,5,1988,5,male,280,254,165,119,175,107,114,12,61
1410444,25,27,1988,7,female,568,261,151,114,603,112,421,2,182
1020025,68,26,1945,4,male,1588,253,181,115,2,115,1,0,1
1710309,19,23,1994,4,female,296,251,220,117,105,117,41,0,64
1850051,21,13,1992,12,male,338,258,205,120,41,0,23,120,18
1921179,90,6,1923,12,male,1127,252,211,124,29,0,16,124,13
1104047,28,12,1985,8,female,629,251,140,121,217,87,108,34,109
1055804,17,21,1996,10,male,71,258,251,123,121,90,82,33,39
1800525,24,5,1989,4,male,212,253,179,120,144,93,96,27,48
1062739,21,12,1992,12,female,128,260,24,123,109,123,21,0,88
1614869,77,16,1936,7,female,1588,261,149,121,78,121,73,0,5
1674585,63,9,1950,3,male,552,260,119,130,132,40,26,90,106
1614988,70,25,1943,12,female,2172,252,139,136,69,20,40,116,29
1578751,59,19,1954,11,male,1586,253,40,132,286,0,28,132,258
1279791,57,28,1956,2,male,445,254,51,134,283,38,148,96,135
1467391,15,21,1998,2,male,247,254,206,134,15,129,6,5,9
1834163,47,28,1966,9,male,390,259,54,134,70,132,46,2,24
1140714,22,17,1991,8,female,541,259,107,133,177,127,72,6,105
2072446,23,29,1990,4,male,550,260,178,132,95,132,86,0,9
1168800,108,1,1905,1,male,204,259,169,141,37,14,6,127,31
1692793,103,16,1910,11,female,1088,252,155,137,64,130,58,7,6
1772159,24,4,1989,12,male,463,255,212,140,30,140,15,0,15
2006587,29,20,1984,7,female,740,256,198,139,135,139,103,0,32
1793230,51,25,1962,9,female,1294,253,66,146,291,25,84,121,207
1990225,21,4,1992,5,female,582,251,176,147,62,49,51,98,11
1891559,38,23,1975,4,female,637,258,194,144,101,55,73,89,28
1733726,48,11,1965,11,female,703,252,121,146,450,70,144,76,306
1008817,21,8,1992,5,male,646,257,82,150,11,143,9,7,2
1973759,14,19,1999,7,female,318,252,198,155,189,0,31,155,158
1094014,14,4,1999,7,male,196,253,190,157,48,152,45,5,3
1115811,26,11,1987,11,male,282,254,215,152,32,152,19,0,13
1043596,17,13,1996,10,female,331,258,145,156,172,156,128,0,44
1353508,25,29,1988,12,female,391,251,57,155,197,155,187,0,10
1107515,25,30,1988,8,male,346,253,240,157,116,157,106,0,10
1466866,18,7,1995,1,female,461,261,167,161,205,13,53,148,152
2142608,19,18,1994,9,female,435,254,146,163,130,19,19,144,111
1467574,22,8,1991,3,female,141,252,111,163,118,15,52,148,66
1868753,23,2,1990,5,female,882,259,71,162,403,3,115,159,288
1118487,68,2,1945,2,female,1819,253,152,162,406,5,106,157,300
1971355,108,16,1905,5,male,818,259,145,161,11,97,9,64,2
1079032,18,10,1995,1,female,337,257,200,158,76,46,44,112,32
1293881,57,29,1956,3,female,1406,251,225,160,82,67,48,93,34
1778555,105,8,1908,11,NA,1357,252,163,162,46,136,29,26,17
1859131,17,9,1996,9,female,407,251,140,164,396,158,182,6,214
1250476,18,4,1995,11,male,444,253,193,165,2,5,2,160,0
1779067,53,4,1960,4,male,584,260,169,171,535,33,359,138,176
1859744,21,27,1992,1,male,273,254,146,171,26,97,6,74,20
1645144,16,12,1997,2,male,276,258,106,166,23,166,15,0,8
1062753,25,12,1988,5,female,1976,257,153,166,168,166,145,0,23
2156515,58,1,1955,6,female,1365,260,121,170,137,170,69,0,68
1048416,15,14,1998,9,male,238,252,92,173,139,64,77,109,62
1576355,20,9,1993,9,female,533,260,48,176,296,104,78,72,218
2079474,69,19,1944,10,male,1813,253,151,177,266,39,125,138,141
1047392,24,30,1989,6,female,391,260,201,179,81,149,39,30,42
2104678,18,10,1995,6,female,105,258,237,181,209,176,102,5,107
1072789,108,1,1905,4,female,1628,256,111,188,97,0,25,188,72
1525874,53,3,1960,6,female,917,261,137,182,187,130,106,52,81
1115476,39,14,1974,10,female,1190,261,50,188,184,184,103,4,81
1520674,46,10,1967,5,female,699,255,112,183,17,183,4,0,13
1259767,21,3,1992,7,male,178,253,206,183,73,183,58,0,15
1804935,29,10,1984,3,male,586,253,124,182,105,182,50,0,55
1706302,108,28,1905,7,male,2075,253,142,183,52,183,45,0,7
1756189,19,8,1994,6,female,199,254,238,184,624,184,587,0,37
1755172,22,26,1991,3,male,228,257,189,188,390,188,295,0,95
1798818,18,7,1995,11,male,404,251,178,198,36,15,20,183,16
2038799,44,15,1969,2,female,1921,261,123,200,291,22,57,178,234
1909731,29,20,1984,9,male,303,251,174,193,69,83,22,110,47
2105461,103,1,1910,1,female,1676,253,113,200,125,76,69,124,56
1450498,112,5,1901,5,female,1685,259,75,192,185,107,123,85,62
1015707,32,2,1981,9,female,461,257,192,191,280,191,196,0,84
1045581,23,27,1990,8,female,327,254,192,202,137,13,38,189,99
1629169,15,3,1998,7,female,70,253,95,204,93,122,90,82,3
1744815,14,13,1999,5,female,122,253,91,211,85,184,64,27,21
1445030,17,6,1996,6,female,498,251,104,204,133,196,58,8,75
1835123,36,7,1977,12,male,413,251,184,210,11,210,9,0,2
2097179,29,22,1984,11,male,365,259,181,209,114,209,57,0,57
1656312,55,28,1958,12,male,387,251,193,206,158,206,105,0,53
1745403,50,25,1963,10,female,841,255,194,216,102,0,63,216,39
1928555,49,12,1964,3,female,1618,261,104,215,154,18,34,197,120
1422158,31,12,1982,2,female,282,252,156,215,272,51,66,164,206
1327912,104,13,1909,11,male,55,257,223,220,145,52,55,168,90
1971900,34,28,1979,9,female,268,254,161,212,329,127,132,85,197
2073990,18,26,1995,10,male,369,253,158,219,80,205,51,14,29
1329736,19,20,1994,2,male,131,257,192,216,86,200,13,16,73
1401279,16,4,1997,11,female,84,254,97,218,154,215,73,3,81
2059823,23,16,1990,7,female,476,257,249,215,179,212,105,3,74
1375248,102,11,1911,4,female,716,261,25,216,33,216,29,0,4
1532782,17,8,1996,3,female,353,254,48,212,58,212,42,0,16
1228618,29,18,1984,2,female,1338,252,98,223,327,126,254,97,73
1161481,17,14,1996,2,female,172,254,34,233,356,164,300,69,56
1571760,63,22,1950,12,female,1998,260,117,225,46,196,25,29,21
2087517,26,25,1987,5,male,622,261,205,227,20,227,20,0,0
1869740,25,7,1988,10,female,385,253,174,225,82,225,71,0,11
1726687,47,7,1966,4,female,499,251,100,227,47,227,24,0,23
1376936,32,2,1981,2,male,299,256,86,238,148,36,62,202,86
1257254,27,20,1986,12,male,417,255,84,235,79,116,28,119,51
1815151,55,24,1958,8,female,1746,253,139,244,424,56,176,188,248
1784465,33,4,1980,4,female,590,261,197,246,361,234,222,12,139
1727751,64,10,1949,9,female,1733,252,138,245,182,185,118,60,64
1272854,27,25,1986,7,female,562,258,86,238,348,238,306,0,42
1757580,56,27,1957,3,female,2089,255,46,235,269,235,136,0,133
1823013,15,1,1998,1,female,512,256,171,256,61,99,4,157,57
1656227,36,19,1977,9,female,519,253,116,253,247,78,96,175,151
1058743,103,10,1910,10,male,1204,261,85,259,348,56,60,203,288
1302775,19,18,1994,11,female,347,259,26,248,184,248,160,0,24
1083105,21,25,1992,10,male,367,254,180,252,625,252,426,0,199
1908264,34,3,1979,1,female,467,257,125,270,333,253,223,17,110
2028094,16,22,1997,3,male,79,256,237,272,273,270,241,2,32
1765260,66,5,1947,4,male,701,256,120,261,49,261,41,0,8
2083427,14,20,1999,3,male,403,255,125,269,199,269,149,0,50
1218059,22,16,1991,5,female,550,253,165,266,220,266,198,0,22
1786091,108,27,1905,3,male,1338,256,146,269,269,269,231,0,38
1151543,108,28,1905,9,male,1118,252,89,291,39,277,8,14,31
1865922,37,26,1976,11,male,415,254,209,279,75,271,26,8,49
1091302,27,25,1986,2,female,390,252,172,281,88,281,25,0,63
2163465,31,29,1982,3,male,333,255,184,288,103,288,60,0,43
2149364,56,10,1957,9,male,595,261,160,277,132,277,48,0,84
1115273,24,31,1989,12,female,326,256,103,282,264,282,247,0,17
2012438,67,25,1946,9,male,497,259,120,300,60,23,8,277,52
1685378,93,16,1920,11,female,1098,258,174,303,132,0,28,303,104
2055070,20,24,1993,11,female,410,259,85,301,313,0,49,301,264
1341536,20,10,1993,2,male,345,254,215,303,133,166,120,137,13
2045135,26,1,1987,1,female,872,252,148,304,673,197,278,107,395
1086315,19,4,1994,5,male,279,251,192,295,66,268,61,27,5
1495825,18,20,1995,2,female,529,254,72,300,323,263,202,37,121
1382085,28,23,1985,12,female,719,257,137,307,268,241,128,66,140
1429814,58,6,1955,4,female,739,260,194,302,374,284,216,18,158
1252686,19,1,1994,11,female,212,252,42,295,279,295,211,0,68
1539292,28,23,1985,3,female,360,257,103,308,372,308,368,0,4
1934029,38,25,1975,5,female,243,256,178,294,179,294,123,0,56
1530449,33,27,1980,10,male,417,258,253,324,163,0,129,324,34
1302837,108,5,1905,3,male,2286,260,232,317,263,212,169,105,94
1023344,44,7,1969,4,female,650,252,226,326,348,310,193,16,155
1681961,54,6,1959,1,male,710,258,135,311,503,255,163,56,340
1349775,63,4,1950,5,female,1555,258,213,311,188,308,114,3,74
1090362,68,18,1945,3,female,1190,260,86,312,139,312,124,0,15
2107035,66,19,1947,2,male,611,256,209,338,128,13,20,325,108
1069233,60,22,1953,6,female,1523,261,83,344,391,0,134,344,257
1231943,15,2,1998,10,female,730,256,200,345,40,189,34,156,6
1718648,55,24,1958,6,male,202,257,147,329,197,92,163,237,34
1197014,18,27,1995,1,female,885,261,159,339,270,217,192,122,78
1620792,22,1,1991,1,male,195,256,194,340,424,236,232,104,192
2115141,23,16,1990,10,female,339,258,82,330,288,154,115,176,173
1542247,26,1,1987,8,male,206,261,61,339,400,326,202,13,198
1717499,29,12,1984,9,female,938,258,119,329,290,289,223,40,67
1305130,18,27,1995,4,male,262,257,197,331,14,330,14,1,0
1100960,16,6,1997,8,female,119,261,7,329,10,329,8,0,2
1910970,31,12,1982,11,female,240,257,177,367,224,1,49,366,175
1448884,31,16,1982,6,female,67,253,100,350,254,243,246,107,8
2125495,28,14,1985,11,male,427,260,127,360,13,314,7,46,6
1566823,19,9,1994,9,male,1222,252,149,360,107,306,72,54,35
1853640,27,5,1986,9,female,331,252,120,366,204,366,149,0,55
1209936,35,5,1978,12,female,544,257,173,364,123,364,62,0,61
1987622,15,3,1998,8,female,485,256,193,389,21,25,5,364,16
1441736,32,20,1981,3,female,1388,256,242,383,197,127,161,256,36
1652065,18,30,1995,5,female,235,261,133,382,302,143,213,239,89
2092195,103,12,1910,11,male,1590,256,118,370,43,280,24,90,19
1737652,18,16,1995,6,female,32,252,227,380,210,344,102,36,108
1597109,23,26,1990,4,male,314,252,134,371,65,308,44,63,21
1369963,18,31,1995,12,female,62,253,82,381,749,360,300,21,449
1327053,16,22,1997,4,female,209,255,154,377,56,377,54,0,2
1958079,17,23,1996,6,male,191,257,81,411,16,31,11,380,5
1694274,27,30,1986,8,female,450,254,183,417,502,151,137,266,365
1178505,13,25,2000,8,female,442,251,198,406,217,323,79,83,138
1302179,19,17,1994,3,male,351,253,200,404,227,324,150,80,77
1301371,29,22,1984,4,female,427,258,149,408,145,352,49,56,96
2172151,50,1,1963,8,female,1147,254,164,411,249,322,107,89,142
1160156,62,11,1951,11,female,1564,254,176,410,367,394,185,16,182
1396970,25,27,1988,9,female,174,259,116,395,77,394,43,1,34
1958667,62,18,1951,8,female,798,251,153,444,98,62,36,382,62
1068589,27,10,1986,5,female,327,255,43,446,338,428,263,18,75
1353952,30,4,1983,10,female,182,255,243,433,331,425,258,8,73
1994880,22,30,1991,4,female,203,259,131,434,203,434,178,0,25
1522451,107,6,1906,2,male,1417,253,192,423,346,423,286,0,60
1159952,16,9,1997,11,male,579,259,169,466,280,93,40,373,240
1306618,15,18,1998,9,female,547,260,166,481,253,166,157,315,96
1996009,57,7,1956,9,female,1695,256,119,456,365,328,248,128,117
1214263,15,24,1998,1,female,562,260,160,456,250,418,148,38,102
1738611,16,18,1997,11,female,55,260,58,483,332,469,215,14,117
1037707,14,29,1999,7,male,623,254,152,460,856,354,599,106,257
1256222,28,10,1985,10,female,187,251,67,467,276,467,175,0,101
2007390,36,4,1977,4,male,358,256,86,480,97,480,66,0,31
1403344,111,10,1902,12,female,1576,259,97,482,166,482,127,0,39
1788895,22,18,1991,9,female,169,258,188,482,423,482,366,0,57
1754795,31,21,1982,6,female,322,254,88,477,593,477,438,0,155
1607502,38,14,1975,10,female,1938,252,173,482,695,482,383,0,312
1527586,17,12,1996,1,female,846,252,116,514,450,0,82,514,368
1035688,14,21,1999,2,male,379,261,109,494,2,145,2,349,0
1834969,16,13,1997,12,male,158,253,176,491,278,226,233,265,45
1468606,22,5,1991,7,female,828,252,170,507,297,318,84,189,213
1774812,103,8,1910,9,female,1645,254,149,516,287,215,129,301,158
2155905,108,9,1905,5,female,1588,255,100,510,585,226,317,284,268
1768495,17,26,1996,4,female,380,256,57,505,236,494,192,11,44
1135560,21,2,1992,9,female,261,259,186,498,291,403,282,95,9
1291447,18,28,1995,5,male,302,251,209,492,75,492,74,0,1
1992854,34,4,1979,5,male,337,253,241,513,72,513,69,0,3
1543891,25,4,1988,12,female,72,254,232,497,217,497,198,0,19
1854145,14,8,1999,6,female,585,254,126,544,273,10,66,534,207
1882377,68,27,1945,8,female,1042,259,143,561,96,0,19,561,77
1546819,17,17,1996,4,female,927,254,145,520,715,108,521,412,194
1311574,21,27,1992,11,female,165,259,154,527,418,354,308,173,110
1264081,34,13,1979,11,female,852,259,181,530,409,184,247,346,162
1898754,48,4,1965,5,male,1240,256,65,528,389,361,178,167,211
1923422,103,16,1910,7,female,1293,259,133,553,587,356,265,197,322
1314003,53,12,1960,7,male,559,258,205,556,1483,136,766,420,717
1457961,19,16,1994,12,female,401,256,178,522,285,438,192,84,93
1503314,19,31,1994,3,male,1425,255,109,521,188,509,156,12,32
1449471,22,18,1991,9,female,495,259,163,546,568,530,455,16,113
1011385,14,31,1999,5,female,433,253,148,547,41,547,21,0,20
1522206,58,29,1955,12,female,225,252,201,545,89,545,45,0,44
1634964,32,28,1981,1,female,158,251,86,538,127,538,113,0,14
1026254,57,11,1956,9,female,1398,261,177,541,925,541,654,0,271
2108727,67,7,1946,4,female,521,261,233,597,70,0,9,597,61
1377435,46,6,1967,8,male,343,261,227,589,184,0,43,589,141
1830226,70,25,1943,1,female,1505,260,146,583,170,2,9,581,161
1942590,108,13,1905,11,female,1367,258,123,598,165,92,62,506,103
1766396,22,3,1991,3,female,244,258,167,582,767,37,558,545,209
1450660,62,11,1951,8,female,2301,256,99,578,1030,0,196,578,834
1700926,26,19,1987,12,female,49,256,206,566,96,249,18,317,78
1167748,108,3,1905,2,female,1098,257,172,603,8,584,5,19,3
2136293,25,31,1988,12,female,223,254,120,591,31,591,31,0,0
1652717,52,2,1961,1,female,1153,257,99,589,121,589,56,0,65
1009142,22,23,1991,3,female,349,259,138,576,390,576,351,0,39
1983199,24,1,1989,12,female,349,261,82,562,723,562,653,0,70
1136636,50,25,1963,8,female,1692,256,212,611,753,76,523,535,230
1860544,16,19,1997,3,male,460,254,208,640,100,296,63,344,37
1464555,20,17,1993,8,female,188,251,186,631,654,151,152,480,502
1543595,25,19,1988,8,male,1046,251,203,636,47,478,42,158,5
1342702,53,28,1960,5,female,260,257,199,653,12,652,6,1,6
1150219,19,15,1994,2,female,471,259,160,669,109,36,92,633,17
1601359,38,14,1975,9,female,578,260,199,692,170,692,111,0,59
1102861,39,15,1974,6,male,477,259,196,782,302,11,113,771,189
1471558,16,24,1997,5,male,234,255,149,769,115,244,31,525,84
2142108,15,30,1998,3,female,126,258,217,778,309,403,123,375,186
1698518,52,28,1961,12,female,1455,256,129,758,321,670,174,88,147
1592780,14,15,1999,12,female,304,252,109,750,624,740,321,10,303
1933307,18,4,1995,10,male,108,255,157,794,383,794,323,0,60
1682640,22,24,1991,11,female,602,260,134,808,1026,0,235,808,791
1724341,100,5,1913,10,male,204,253,169,829,91,210,59,619,32
1091304,45,1,1968,11,female,1703,251,126,805,507,427,268,378,239
1423853,31,24,1982,1,female,1294,259,145,874,369,719,214,155,155
1717740,62,14,1951,2,female,1581,251,169,829,219,805,127,24,92
1832381,17,5,1996,12,female,69,261,191,811,635,783,385,28,250
1690944,27,27,1986,8,male,423,255,154,825,544,748,240,77,304
1119690,48,28,1965,8,female,1316,252,82,853,522,741,509,112,13
1061061,23,20,1990,1,male,267,251,202,920,478,221,129,699,349
1365234,37,28,1976,12,male,277,252,161,881,196,872,130,9,66
2012264,22,11,1991,11,male,188,257,194,918,597,805,538,113,59
1375678,34,7,1979,4,female,251,255,166,890,2115,715,1572,175,543
1986895,19,6,1994,7,male,114,259,239,953,99,953,95,0,4
1115137,24,30,1989,6,male,435,254,165,931,111,931,63,0,48
2055558,16,14,1997,6,female,832,254,98,887,271,887,185,0,86
2002751,18,23,1995,5,female,265,261,219,942,1154,942,617,0,537
1753112,68,28,1945,8,male,492,256,155,880,559,880,487,0,72
1894540,31,13,1982,7,female,1090,253,110,1052,296,183,133,869,163
1171863,13,22,2000,9,female,203,260,65,1129,2155,60,450,1069,1705
1525092,19,17,1994,1,female,358,259,144,1104,395,834,279,270,116
1913157,37,10,1976,11,female,367,251,107,1068,926,823,665,245,261
1388235,31,12,1982,10,female,298,252,208,1044,540,1042,362,2,178
1100815,20,24,1993,3,female,158,254,86,1055,321,1055,299,0,22
1738508,36,20,1977,2,female,166,261,202,1027,522,1027,247,0,275
2046810,20,27,1993,9,male,400,258,199,1261,606,579,180,682,426
2063583,59,27,1954,5,female,1296,259,183,1185,1581,842,1130,343,451
1294008,45,28,1968,2,female,508,261,218,1288,687,1288,478,0,209
1677485,71,5,1942,7,female,1378,254,151,1452,38,0,16,1452,22
2079067,21,10,1992,5,female,372,261,219,1336,458,1278,102,58,356
1846540,31,29,1982,3,female,283,261,63,1393,418,1307,305,86,113
1637534,16,8,1997,7,female,288,258,170,1370,1493,1217,893,153,600
1071798,17,21,1996,5,female,134,260,165,1409,1424,1381,1054,28,370
1556707,104,1,1909,2,female,1480,252,168,1499,282,1497,157,2,125
1120290,33,29,1980,1,female,387,258,221,1430,1047,1416,493,14,554
1487472,22,1,1991,1,male,173,258,194,1340,223,1340,165,0,58
1762699,21,9,1992,11,female,419,256,161,1440,819,1440,690,0,129
1771797,22,14,1991,9,female,481,255,39,1332,1322,1332,1117,0,205
1237352,51,22,1962,7,female,1721,256,145,1763,842,545,495,1218,347
1694155,17,28,1996,12,male,196,260,101,1861,846,1418,514,443,332
1380543,42,24,1971,12,female,1290,251,105,1541,1634,1432,1000,109,634
1408211,18,4,1995,6,female,319,253,185,1762,233,1747,149,15,84
1984160,54,2,1959,9,female,1004,255,110,2323,740,0,306,2323,434
1705312,20,26,1993,10,female,302,260,200,1924,2145,105,679,1819,1466
1080547,64,20,1949,9,female,2133,257,166,2327,1145,1175,796,1152,349
1671462,59,19,1954,3,female,1540,257,112,2329,2378,1586,1432,743,946
1382482,15,1,1998,1,female,512,253,103,2083,658,1630,287,453,371
1817539,18,12,1995,4,female,113,258,151,2276,2123,2159,1369,117,754
1138706,21,17,1992,6,male,318,259,69,2004,1296,1656,702,348,594
1696756,17,22,1996,6,female,333,258,117,1936,134,1936,67,0,67
1863743,18,21,1995,7,male,244,261,178,1926,97,1926,59,0,38
1723377,23,10,1990,11,female,354,257,67,2363,828,2363,714,0,114
1218480,23,25,1990,9,female,108,257,158,2207,1302,2207,911,0,391
1972685,59,25,1954,4,female,828,261,161,2841,76,83,46,2758,30
1851054,66,6,1947,6,male,159,256,128,3171,589,1,285,3170,304
1399607,39,7,1974,5,female,1030,258,130,2780,3075,0,1485,2780,1590
1615381,17,16,1996,8,male,384,261,212,2670,545,1122,269,1548,276
1786915,25,1,1988,1,male,232,251,156,2798,352,2798,300,0,52
1563879,17,5,1996,4,male,702,257,121,3888,923,1161,304,2727,619
1037110,33,27,1980,11,female,135,253,125,8213,7213,8175,5643,38,1570
2136457,62,22,1951,6,female,1539,256,71,5458,987,5458,871,0,116
1192100,14,12,1999,12,female,97,267,96,0,0,0,0,0,0
1146632,13,10,2000,2,male,1150,271,160,0,0,0,0,0,0
1369284,15,3,1998,11,female,346,263,193,0,5,0,1,0,4
1841280,15,14,1998,11,male,306,265,245,0,2,0,1,0,1
1250046,14,5,1999,1,female,307,271,203,0,0,0,0,0,0
1575539,14,13,1999,5,male,369,269,205,0,1,0,0,0,1
1273143,14,6,1999,6,male,55,265,236,0,0,0,0,0,0
1634677,14,24,1999,7,male,342,265,115,0,3,0,3,0,0
1561665,14,16,1999,10,male,133,268,176,0,39,0,8,0,31
1356728,16,10,1997,11,male,715,270,212,0,0,0,0,0,0
1116406,16,27,1997,11,male,165,263,252,0,2,0,0,0,2
2156308,16,17,1997,12,female,412,273,207,0,0,0,0,0,0
1178900,16,29,1997,12,male,392,274,271,0,7,0,7,0,0
1445018,15,10,1998,1,male,356,264,159,0,13,0,11,0,2
1652440,15,20,1998,2,male,411,273,236,0,3,0,0,0,3
1424251,15,11,1998,5,female,121,266,249,0,1,0,1,0,0
1743502,15,11,1998,10,female,610,266,113,0,1,0,1,0,0
1883982,17,6,1996,11,male,325,264,214,0,0,0,0,0,0
1708179,17,18,1996,12,male,441,269,208,0,0,0,0,0,0
1601933,17,15,1996,12,male,320,271,170,0,0,0,0,0,0
2103783,16,15,1997,2,male,697,264,166,0,5,0,1,0,4
1961477,16,5,1997,3,male,489,272,143,0,1,0,0,0,1
1067134,16,16,1997,5,male,530,267,218,0,1,0,1,0,0
1775748,18,19,1995,11,male,672,264,103,0,2,0,2,0,0
1536380,18,23,1995,12,male,637,264,154,0,0,0,0,0,0
2098595,17,2,1996,1,female,364,271,27,0,10,0,2,0,8
2067297,17,16,1996,5,male,536,263,157,0,3,0,3,0,0
1187101,17,20,1996,7,male,585,273,187,0,0,0,0,0,0
1755351,17,16,1996,8,male,526,265,183,0,0,0,0,0,0
1093126,17,11,1996,10,male,384,267,59,0,0,0,0,0,0
1122453,19,8,1994,11,female,478,267,240,0,0,0,0,0,0
1797165,19,28,1994,12,female,559,273,108,0,0,0,0,0,0
1193699,19,3,1994,12,female,404,269,193,0,4,0,1,0,3
1138694,19,20,1994,12,male,287,272,20,0,0,0,0,0,0
1328704,18,10,1995,6,male,615,267,232,0,0,0,0,0,0
1753560,18,11,1995,6,male,219,273,180,0,0,0,0,0,0
1198821,18,17,1995,7,male,337,268,227,0,1,0,1,0,0
1930170,18,18,1995,9,male,362,262,164,0,2,0,1,0,1
1855112,18,27,1995,9,male,215,270,202,0,1,0,1,0,0
1878081,18,3,1995,9,female,79,273,51,0,0,0,0,0,0
1903540,18,10,1995,9,male,94,263,253,0,1,0,1,0,0
1685851,18,20,1995,10,male,664,268,200,0,1,0,1,0,0
2127931,20,11,1993,11,female,277,266,79,0,1,0,0,0,1
1973451,19,20,1994,1,female,232,272,86,0,0,0,0,0,0
1272809,19,1,1994,1,male,171,262,215,0,0,0,0,0,0
1089947,19,26,1994,2,female,478,263,140,0,0,0,0,0,0
1429211,19,10,1994,2,male,497,267,218,0,0,0,0,0,0
1097259,19,1,1994,2,male,506,266,130,0,1,0,1,0,0
1224327,19,6,1994,3,male,651,262,190,0,0,0,0,0,0
1707398,19,24,1994,3,female,64,266,243,0,7,0,5,0,2
1157195,19,6,1994,4,male,310,263,120,0,1,0,0,0,1
1585614,19,6,1994,4,male,125,270,266,0,0,0,0,0,0
1743814,19,11,1994,5,male,529,271,157,0,0,0,0,0,0
2020902,19,6,1994,7,male,751,262,207,0,1,0,1,0,0
1348489,20,1,1993,1,male,642,264,16,0,38,0,31,0,7
1200765,20,29,1993,3,male,312,270,177,0,4,0,2,0,2
1631828,20,24,1993,3,female,275,268,86,0,0,0,0,0,0
1878439,20,28,1993,4,male,1033,271,118,0,0,0,0,0,0
1415337,20,18,1993,4,male,635,271,166,0,10,0,3,0,7
1797634,20,16,1993,6,female,955,271,65,0,1,0,0,0,1
1889842,20,14,1993,7,male,1078,271,231,0,1,0,1,0,0
1822764,20,12,1993,8,female,470,268,34,0,4,0,4,0,0
1038463,20,25,1993,8,male,318,267,252,0,1,0,1,0,0
1098695,21,28,1992,1,male,707,270,185,0,3,0,3,0,0
1907345,21,26,1992,1,male,360,272,113,0,2,0,2,0,0
1160703,21,2,1992,2,male,493,263,219,0,4,0,4,0,0
1173674,21,5,1992,7,male,264,274,241,0,4,0,0,0,4
1922435,21,25,1992,8,male,649,268,183,0,1,0,0,0,1
2018674,21,2,1992,10,male,590,268,165,0,0,0,0,0,0
1973783,22,19,1991,1,female,597,271,173,0,15,0,13,0,2
1031222,22,24,1991,2,female,306,269,225,0,0,0,0,0,0
1420554,22,7,1991,4,female,273,274,72,0,0,0,0,0,0
2076394,23,10,1990,1,male,1295,267,184,0,0,0,0,0,0
1685531,23,9,1990,1,male,333,273,232,0,5,0,2,0,3
1425642,23,4,1990,3,male,661,272,237,0,0,0,0,0,0
1457576,23,29,1990,9,male,459,268,144,0,0,0,0,0,0
1848820,24,8,1989,1,male,277,267,109,0,1,0,1,0,0
2103497,24,14,1989,6,male,777,272,137,0,0,0,0,0,0
2004574,24,14,1989,8,female,721,264,179,0,4,0,4,0,0
1884731,25,8,1988,3,female,1617,268,46,0,15,0,11,0,4
1735870,25,5,1988,10,female,712,273,81,0,29,0,6,0,23
1084652,26,11,1987,2,male,1321,274,153,0,0,0,0,0,0
1028770,26,2,1987,6,male,1356,263,179,0,14,0,4,0,10
2134294,26,13,1987,10,male,515,266,193,0,1,0,1,0,0
1342566,27,16,1986,4,male,300,271,256,0,2,0,2,0,0
2115921,27,15,1986,10,male,854,272,163,0,0,0,0,0,0
1663710,28,17,1985,1,female,1252,267,14,0,4,0,1,0,3
1047226,28,30,1985,8,male,618,270,159,0,0,0,0,0,0
1292116,29,10,1984,5,female,1069,265,153,0,48,0,26,0,22
1869335,29,17,1984,5,male,161,267,250,0,0,0,0,0,0
1244495,29,26,1984,6,male,767,269,148,0,2,0,0,0,2
1259531,29,6,1984,6,male,719,274,86,0,1,0,1,0,0
1036684,31,1,1982,3,male,807,272,221,0,6,0,5,0,1
1426664,31,28,1982,7,male,485,274,261,0,0,0,0,0,0
1316503,32,10,1981,2,male,535,263,46,0,49,0,43,0,6
1685879,34,13,1979,5,male,1052,271,94,0,0,0,0,0,0
1557736,34,5,1979,9,female,703,274,111,0,0,0,0,0,0
2190162,37,18,1976,9,male,470,270,201,0,1,0,0,0,1
1247117,42,9,1971,4,male,198,264,221,0,2,0,0,0,2
1889701,50,31,1963,5,male,434,265,178,0,0,0,0,0,0
1650469,51,29,1962,6,male,445,272,105,0,0,0,0,0,0
1477186,52,21,1961,9,male,321,271,212,0,0,0,0,0,0
1839303,53,8,1960,3,male,647,270,189,0,13,0,6,0,7
1834119,53,25,1960,9,male,1533,265,131,0,0,0,0,0,0
1112947,55,21,1958,4,male,546,272,234,0,1,0,0,0,1
1033515,60,14,1953,9,male,990,268,233,0,1,0,0,0,1
1093724,61,17,1952,10,male,1612,265,126,0,0,0,0,0,0
2025640,65,31,1948,7,male,1204,269,121,0,3,0,1,0,2
1157456,68,15,1945,3,female,1190,268,52,0,2,0,2,0,0
1414028,68,2,1945,3,female,256,265,147,0,0,0,0,0,0
1448037,80,1,1933,8,female,794,264,95,0,0,0,0,0,0
1320824,103,3,1910,11,male,296,271,244,0,1,0,1,0,0
1138639,103,15,1910,3,male,1165,263,98,0,1,0,1,0,0
1310598,108,13,1905,12,male,1732,269,16,0,0,0,0,0,0
1252612,15,29,1998,8,female,161,262,147,1,0,0,0,1,0
1033449,17,11,1996,5,male,261,264,164,1,0,0,0,1,0
1506367,66,14,1947,8,male,539,264,152,1,0,0,0,1,0
1813002,17,30,1996,6,female,213,268,68,1,1,0,1,1,0
2191684,19,19,1994,10,male,643,266,174,1,1,0,1,1,0
1075609,68,18,1945,2,male,1751,265,96,1,1,0,0,1,1
2056789,16,25,1997,5,male,414,274,215,1,2,0,2,1,0
1546773,23,20,1990,12,male,639,274,231,1,2,0,1,1,1
1224180,25,1,1988,1,male,181,262,242,1,4,0,0,1,4
1103534,14,13,1999,4,male,328,266,185,1,0,1,0,0,0
1207056,16,18,1997,1,male,439,265,184,1,0,1,0,0,0
1581233,18,28,1995,11,male,686,268,156,1,0,1,0,0,0
1645517,17,10,1996,7,female,426,262,249,1,0,1,0,0,0
2052107,22,25,1991,11,female,471,267,179,1,0,1,0,0,0
2125220,24,19,1989,12,male,374,274,243,1,0,1,0,0,0
1126332,27,15,1986,12,male,258,265,232,1,0,1,0,0,0
1575301,29,11,1984,8,male,436,267,147,1,0,1,0,0,0
1241369,97,30,1916,4,female,532,272,35,1,0,1,0,0,0
1056872,18,17,1995,8,male,280,262,223,1,1,1,0,0,1
1778862,19,13,1994,5,male,391,269,212,1,1,1,1,0,0
1912072,22,6,1991,12,female,586,264,138,1,1,1,1,0,0
1774699,22,19,1991,10,male,345,273,222,1,1,1,0,0,1
1327759,28,11,1985,9,male,1481,262,170,1,1,1,1,0,0
1510357,68,4,1945,11,male,317,264,200,1,1,1,0,0,1
1197993,88,23,1925,6,male,458,272,203,1,1,1,0,0,1
1569187,103,17,1910,12,male,732,265,253,1,1,1,1,0,0
1395043,15,5,1998,9,male,497,265,202,1,6,1,6,0,0
1184682,16,21,1997,2,male,920,273,153,1,3,1,2,0,1
1090260,16,27,1997,7,male,596,262,217,1,18,1,14,0,4
1903193,16,28,1997,7,female,401,274,195,1,3,1,2,0,1
1307700,18,8,1995,6,female,422,267,188,1,41,1,22,0,19
1589663,18,18,1995,10,male,363,274,94,1,2,1,2,0,0
1024476,19,21,1994,3,male,437,262,151,1,4,1,2,0,2
1493339,22,21,1991,7,male,55,272,36,1,11,1,5,0,6
1477064,23,10,1990,10,female,405,270,178,1,140,1,112,0,28
1374634,24,20,1989,10,female,228,263,42,1,3,1,3,0,0
1886855,25,19,1988,5,male,424,263,57,1,3,1,2,0,1
1655339,28,11,1985,1,male,347,274,242,1,16,1,14,0,2
1441502,31,16,1982,1,male,1575,274,98,1,9,1,5,0,4
1572886,48,30,1965,12,male,481,271,224,1,4,1,4,0,0
1325722,49,19,1964,12,male,830,269,168,1,2,1,0,0,2
1465796,66,20,1947,3,female,118,272,16,1,3,1,1,0,2
1342953,68,16,1945,4,male,615,272,203,1,6,1,5,0,1
1250552,37,28,1976,8,male,1328,269,51,2,0,0,0,2,0
1467139,16,2,1997,11,male,358,262,205,2,1,0,1,2,0
1454350,25,8,1988,3,male,279,269,135,2,1,0,1,2,0
1547291,29,10,1984,7,male,628,272,213,2,1,0,0,2,1
1763662,20,10,1993,9,male,522,262,86,2,2,0,0,2,2
1347686,17,2,1996,11,female,223,264,102,2,5,0,0,2,5
1164628,18,1,1995,2,female,197,271,236,2,56,0,36,2,20
1394699,50,16,1963,4,female,649,272,190,2,3,0,1,2,2
1111983,108,2,1905,8,male,1777,266,199,2,41,0,30,2,11
1851724,22,6,1991,2,male,576,263,237,2,1,1,1,1,0
1815350,25,18,1988,9,female,801,271,207,2,1,1,0,1,1
1596123,104,27,1909,12,male,894,267,199,2,4,1,2,1,2
1929643,18,30,1995,9,male,120,262,249,2,0,2,0,0,0
1317712,19,18,1994,2,male,557,265,111,2,0,2,0,0,0
1408027,21,27,1992,12,male,177,267,163,2,0,2,0,0,0
1750405,47,22,1966,8,male,521,272,239,2,0,2,0,0,0
1142136,68,27,1945,4,male,1068,264,186,2,0,2,0,0,0
1942210,17,1,1996,1,female,391,274,29,2,2,2,2,0,0
1874722,18,1,1995,1,male,159,265,242,2,2,2,1,0,1
1995417,13,27,2000,4,female,137,274,79,2,24,2,22,0,2
1128790,16,3,1997,5,male,186,274,247,2,36,2,33,0,3
1646404,17,28,1996,4,female,564,265,141,2,10,2,7,0,3
1970746,18,20,1995,6,female,462,267,45,2,164,2,126,0,38
1239817,18,17,1995,9,female,83,268,250,2,12,2,10,0,2
1053479,19,13,1994,3,male,202,266,187,2,14,2,11,0,3
1475066,19,24,1994,6,female,709,274,79,2,69,2,61,0,8
1022407,23,1,1990,12,female,273,269,26,2,3,2,3,0,0
1149230,23,19,1990,8,female,587,262,95,2,5,2,2,0,3
1897012,24,4,1989,8,male,529,266,164,2,14,2,11,0,3
1618702,24,29,1989,9,male,583,272,161,2,5,2,3,0,2
1472788,26,1,1987,1,male,72,263,244,2,4,2,2,0,2
2111522,26,1,1987,2,female,692,268,150,2,6,2,5,0,1
1235002,28,10,1985,8,female,418,274,173,2,5,2,2,0,3
1598039,29,9,1984,10,male,588,266,153,2,5,2,2,0,3
2080855,39,1,1974,1,male,217,265,246,2,85,2,81,0,4
2192284,52,15,1961,2,male,804,272,29,2,21,2,13,0,8
1509096,108,1,1905,1,male,2333,272,83,2,15,2,3,0,12
1604616,17,30,1996,4,female,319,274,258,3,0,0,0,3,0
1123121,18,19,1995,6,female,648,268,135,3,0,0,0,3,0
1781171,27,18,1986,3,male,495,265,230,3,0,0,0,3,0
1833046,16,25,1997,3,male,2117,267,110,3,2,0,1,3,1
1834063,25,21,1988,2,male,732,271,162,3,37,0,14,3,23
1753380,53,20,1960,5,male,573,270,51,3,167,0,92,3,75
1116538,65,25,1948,11,male,1673,262,161,3,7,0,0,3,7
1901913,18,15,1995,10,female,414,274,113,3,0,3,0,0,0
1775599,35,20,1978,8,male,647,263,70,3,0,3,0,0,0
2103239,20,15,1993,1,male,165,271,246,3,3,3,3,0,0
1217101,21,2,1992,2,male,532,264,109,3,2,3,2,0,0
2152465,24,10,1989,10,male,1007,264,116,3,3,3,2,0,1
1583123,39,23,1974,3,female,1050,271,77,3,3,3,3,0,0
1339877,15,29,1998,11,female,243,262,125,3,15,3,15,0,0
1702206,14,26,1999,7,female,428,267,163,3,30,3,28,0,2
1084781,16,4,1997,8,male,469,270,129,3,5,3,4,0,1
1758196,18,13,1995,11,male,397,267,40,3,45,3,21,0,24
1336476,19,3,1994,12,female,565,268,81,3,32,3,25,0,7
1207526,19,15,1994,8,female,480,267,13,3,38,3,32,0,6
1641061,22,30,1991,8,male,507,263,211,3,17,3,15,0,2
1989856,22,9,1991,10,female,564,268,179,3,24,3,23,0,1
2030038,26,13,1987,6,male,183,264,249,3,23,3,23,0,0
1650143,28,1,1985,7,female,989,269,119,3,54,3,40,0,14
1934759,92,4,1921,1,female,1043,267,94,3,30,3,27,0,3
1543742,16,19,1997,6,male,695,272,176,4,0,0,0,4,0
1159141,19,31,1994,8,male,476,265,219,4,0,0,0,4,0
2191261,15,22,1998,5,male,412,274,217,4,2,0,0,4,2
1298185,19,7,1994,2,female,268,265,153,4,4,0,3,4,1
1231535,19,6,1994,9,male,543,272,144,4,22,0,4,4,18
1542869,68,25,1945,4,female,155,271,190,4,47,0,22,4,25
1882060,19,10,1994,11,male,729,267,180,4,0,3,0,1,0
1241771,18,8,1995,7,male,293,264,165,4,36,3,28,1,8
1363362,15,1,1998,4,male,579,273,113,4,0,4,0,0,0
1004720,17,2,1996,4,male,287,266,239,4,0,4,0,0,0
1766363,20,3,1993,2,male,215,267,240,4,0,4,0,0,0
1806779,27,8,1986,4,male,237,270,217,4,0,4,0,0,0
1992473,18,18,1995,1,female,713,269,67,4,3,4,2,0,1
2163862,19,2,1994,1,male,497,263,204,4,4,4,2,0,2
1253847,29,1,1984,6,male,654,266,169,4,5,4,4,0,1
2033812,19,7,1994,11,male,88,262,243,4,18,4,12,0,6
1125735,18,3,1995,4,female,435,262,99,4,44,4,41,0,3
1379451,25,12,1988,12,female,117,266,157,4,47,4,32,0,15
1801912,24,30,1989,7,male,195,270,168,4,37,4,36,0,1
1864838,29,7,1984,4,female,290,273,89,4,43,4,41,0,2
1810062,32,8,1981,7,female,1025,265,176,4,43,4,39,0,4
1194597,35,18,1978,8,female,1524,262,94,4,6,4,5,0,1
1636272,61,21,1952,10,male,1572,270,124,4,16,4,15,0,1
1264069,103,27,1910,12,female,836,270,36,4,15,4,9,0,6
1696830,44,17,1969,8,male,495,271,220,5,5,0,3,5,2
1473507,64,18,1949,7,male,658,269,147,5,83,0,32,5,51
1562008,67,9,1946,11,male,2100,269,86,5,13,0,9,5,4
1098750,19,22,1994,2,male,275,265,161,5,31,2,30,3,1
1617324,23,31,1990,1,male,563,271,219,5,12,2,4,3,8
1346090,101,21,1912,5,male,900,264,139,5,18,4,12,1,6
1478453,20,15,1993,4,male,166,264,241,5,0,5,0,0,0
1859469,15,1,1998,12,male,404,265,143,5,3,5,3,0,0
1892776,24,1,1989,1,male,664,262,119,5,2,5,1,0,1
1254044,25,6,1988,8,male,508,265,156,5,1,5,0,0,1
1496086,21,20,1992,4,female,542,262,72,5,7,5,6,0,1
2143900,24,8,1989,8,female,266,263,69,5,6,5,6,0,0
1617710,26,16,1987,5,female,458,262,187,5,4,5,3,0,1
1883485,14,21,1999,7,female,57,263,194,5,73,5,67,0,6
1117687,22,31,1991,12,female,182,262,107,5,14,5,11,0,3
2141575,26,1,1987,1,male,242,263,253,5,30,5,30,0,0
1395507,108,21,1905,8,male,923,266,145,5,14,5,3,0,11
2086415,54,20,1959,12,female,188,270,13,6,5,0,0,6,5
1442980,19,28,1994,2,male,300,273,195,6,53,0,35,6,18
1542097,31,8,1982,8,female,1719,262,250,6,54,0,24,6,30
1819563,63,3,1950,6,male,515,272,200,6,35,1,11,5,24
1408386,66,15,1947,7,male,490,265,101,6,203,0,63,6,140
1501145,108,27,1905,1,male,401,262,147,6,15,0,3,6,12
1774767,26,1,1987,2,male,442,271,173,6,12,5,4,1,8
2109238,93,1,1920,11,male,423,272,151,6,3,6,3,0,0
1939190,16,26,1997,3,male,293,268,118,6,4,6,4,0,0
1716329,26,14,1987,10,male,1277,267,166,6,8,6,2,0,6
1517383,15,19,1998,12,male,414,271,204,6,65,6,43,0,22
1707399,15,2,1998,3,female,551,266,174,6,32,6,22,0,10
1688452,21,9,1992,11,male,296,271,150,6,13,6,8,0,5
2051808,21,16,1992,10,male,631,269,173,6,11,6,8,0,3
1352569,23,4,1990,3,male,454,269,156,6,17,6,14,0,3
2061244,23,13,1990,6,male,646,268,160,6,86,6,80,0,6
1294494,59,26,1954,3,male,807,269,209,6,34,6,9,0,25
1965133,103,25,1910,1,male,1223,262,225,6,29,6,22,0,7
1238273,103,2,1910,4,female,685,272,157,6,48,6,33,0,15
2002073,29,22,1984,4,male,273,270,160,7,63,0,11,7,52
1476380,24,10,1989,7,male,1249,273,224,7,2,4,1,3,1
1636391,24,22,1989,10,male,454,265,232,7,21,4,2,3,19
1588159,27,28,1986,2,male,765,273,160,7,5,6,3,1,2
1904790,15,12,1998,11,female,279,271,125,7,44,6,32,1,12
1577013,19,19,1994,5,male,505,262,95,7,0,7,0,0,0
1145257,19,14,1994,10,female,487,263,125,7,0,7,0,0,0
2043893,23,18,1990,5,male,523,263,62,7,0,7,0,0,0
2025518,17,27,1996,12,male,382,274,207,7,2,7,2,0,0
1119333,29,7,1984,10,female,412,269,196,7,2,7,1,0,1
1166974,30,26,1983,1,male,663,263,243,7,11,7,10,0,1
1801249,14,8,1999,2,female,355,263,217,8,0,0,0,8,0
1408407,75,5,1938,5,male,1404,271,138,8,2,0,1,8,1
1152795,27,28,1986,7,male,489,274,217,8,8,0,2,8,6
1996876,25,7,1988,4,male,596,270,40,8,22,0,18,8,4
1839426,57,15,1956,5,male,905,270,106,8,1,2,1,6,0
2174955,22,27,1991,11,male,1006,267,191,8,6,2,1,6,5
1447080,30,8,1983,10,female,483,271,173,8,9,5,0,3,9
1830620,52,3,1961,7,female,676,270,238,8,5,2,1,6,4
1161401,21,18,1992,6,male,743,271,78,8,1,7,1,1,0
1085569,15,10,1998,10,female,503,269,95,8,2,8,2,0,0
1600998,108,5,1905,5,male,297,270,171,8,3,8,3,0,0
1474335,15,18,1998,12,male,306,271,232,8,8,8,7,0,1
1891770,22,31,1991,7,male,1004,273,189,8,8,8,4,0,4
2155738,16,12,1997,2,female,431,266,47,8,14,8,7,0,7
1782536,19,11,1994,9,female,538,274,132,8,20,8,8,0,12
1209587,27,10,1986,12,male,299,268,185,8,100,8,33,0,67
1689697,38,16,1975,10,female,727,262,152,8,88,8,38,0,50
1423872,49,23,1964,6,female,736,262,185,8,32,8,22,0,10
2156451,58,15,1955,8,female,904,274,211,8,47,8,30,0,17
2037425,16,12,1997,12,male,348,266,214,9,0,0,0,9,0
1905633,22,17,1991,3,male,210,268,170,9,8,0,0,9,8
1525060,93,14,1920,12,male,490,268,156,9,2,5,0,4,2
1433609,17,21,1996,7,male,401,265,116,9,7,3,3,6,4
1549360,20,3,1993,10,female,420,273,96,9,12,6,8,3,4
1617467,32,3,1981,10,female,247,264,191,9,47,8,25,1,22
1537486,18,14,1995,12,female,428,262,89,9,0,9,0,0,0
1491350,19,9,1994,9,male,428,264,77,9,1,9,1,0,0
1191484,22,4,1991,9,male,305,271,239,9,1,9,0,0,1
1277609,26,22,1987,11,male,1042,273,180,9,0,9,0,0,0
1917118,27,2,1986,3,male,773,269,134,9,1,9,1,0,0
1001289,62,14,1951,12,female,800,274,221,9,1,9,1,0,0
2042905,89,20,1924,7,male,368,274,206,9,0,9,0,0,0
1812772,16,30,1997,8,male,310,271,265,9,2,9,2,0,0
1084235,24,19,1989,11,male,175,265,235,9,5,9,4,0,1
1427162,25,28,1988,12,male,137,267,260,9,3,9,3,0,0
1954540,27,14,1986,9,female,549,262,153,9,2,9,2,0,0
2060543,23,17,1990,5,male,693,267,108,9,6,9,6,0,0
1890034,18,10,1995,10,male,74,273,199,9,16,9,14,0,2
1799755,26,7,1987,1,male,398,269,194,9,119,9,68,0,51
1084573,98,13,1915,3,female,222,262,201,9,22,9,21,0,1
1622224,103,15,1910,6,female,771,266,141,9,168,9,129,0,39
1883620,18,3,1995,8,male,520,271,218,10,1,0,0,10,1
1565064,23,18,1990,4,male,301,269,231,10,2,1,1,9,1
2186367,51,18,1962,1,male,101,266,259,10,6,0,2,10,4
1752083,16,22,1997,5,male,213,264,253,10,7,0,7,10,0
2067407,23,19,1990,4,female,402,262,154,10,6,4,0,6,6
2138323,13,10,2000,8,female,82,273,190,10,17,7,13,3,4
1352009,21,20,1992,9,male,400,265,107,10,172,7,51,3,121
1508952,33,31,1980,5,male,486,270,122,10,74,6,42,4,32
1592690,21,17,1992,10,male,474,269,197,10,122,9,37,1,85
1894430,24,26,1989,5,male,824,268,78,10,1,10,1,0,0
1415021,17,26,1996,3,male,216,265,114,10,5,10,1,0,4
1429432,18,23,1995,3,male,152,263,214,10,5,10,4,0,1
1610636,20,10,1993,7,male,616,264,211,10,3,10,1,0,2
1798055,14,9,1999,7,female,118,264,222,10,7,10,5,0,2
2045459,21,22,1992,1,female,522,274,208,10,15,10,13,0,2
1452828,24,9,1989,6,female,208,263,144,10,43,10,29,0,14
1898589,36,19,1977,2,female,476,268,164,10,643,10,569,0,74
2118956,42,19,1971,3,male,1710,267,35,10,16,10,8,0,8
1810594,58,1,1955,12,female,489,268,196,10,22,10,22,0,0
1970432,41,23,1972,10,male,720,267,169,11,3,6,0,5,3
1163305,53,3,1960,1,female,1514,273,30,11,0,11,0,0,0
1041427,24,7,1989,6,male,272,270,239,11,4,11,4,0,0
1273030,17,19,1996,11,male,348,263,113,11,8,11,8,0,0
2139996,20,18,1993,8,male,568,265,241,11,8,11,2,0,6
1984068,24,17,1989,7,male,382,264,132,11,7,11,4,0,3
2066959,34,31,1979,8,female,472,265,67,11,8,11,6,0,2
1258428,18,10,1995,10,female,526,266,175,11,114,11,96,0,18
1631523,21,16,1992,6,female,181,262,142,11,104,11,45,0,59
2080446,18,28,1995,7,male,367,264,204,12,1,7,1,5,0
1764354,21,19,1992,8,male,749,264,125,12,13,9,10,3,3
1952660,15,3,1998,6,male,500,262,210,12,5,12,3,0,2
1453607,32,18,1981,3,male,303,270,206,12,7,12,4,0,3
2090827,32,22,1981,4,male,536,268,129,12,4,12,4,0,0
1326797,38,31,1975,5,female,603,272,181,12,12,12,6,0,6
1515943,19,13,1994,10,female,331,273,127,12,139,12,93,0,46
1809644,67,15,1946,4,female,669,264,137,12,22,12,22,0,0
1873133,50,13,1963,9,male,673,263,241,13,6,0,0,13,6
1815217,26,3,1987,12,female,12,266,38,13,64,0,34,13,30
1850313,18,4,1995,7,male,202,270,217,13,1,13,0,0,1
1618540,65,8,1948,11,male,928,270,35,13,0,13,0,0,0
1267441,32,9,1981,12,male,581,266,165,13,7,13,7,0,0
1864721,18,16,1995,11,male,131,270,240,13,59,13,39,0,20
1760672,18,17,1995,11,male,106,274,184,13,21,13,10,0,11
1240895,20,6,1993,2,male,365,267,147,13,195,13,150,0,45
1195031,17,26,1996,1,male,309,265,143,14,7,1,1,13,6
1267891,26,6,1987,11,male,710,274,138,14,44,2,17,12,27
1747445,18,8,1995,3,female,390,270,25,14,14,10,10,4,4
1102016,13,3,2000,5,female,111,271,214,14,2,11,0,3,2
1142056,15,8,1998,10,female,163,271,217,14,2,14,2,0,0
2174389,18,19,1995,6,male,309,272,255,14,8,14,5,0,3
1945208,23,10,1990,2,male,777,264,165,14,10,14,8,0,2
1573838,24,12,1989,1,female,362,272,36,14,76,14,69,0,7
1083915,17,29,1996,5,male,541,272,203,15,0,0,0,15,0
1194575,17,4,1996,11,female,332,264,7,15,219,6,137,9,82
1849966,88,3,1925,7,male,1349,263,168,15,9,14,6,1,3
1698946,14,31,1999,5,female,276,264,21,15,141,13,84,2,57
2129175,18,17,1995,11,male,674,273,165,15,8,15,2,0,6
2161734,18,30,1995,7,male,414,263,175,15,79,15,46,0,33
1587643,21,1,1992,1,male,579,270,120,15,26,15,26,0,0
1434393,63,25,1950,5,male,1841,263,70,15,35,15,8,0,27
1179858,17,24,1996,2,male,342,274,247,16,8,3,8,13,0
1664477,68,3,1945,3,male,1142,271,175,16,10,0,5,16,5
1419264,14,2,1999,6,male,389,262,139,16,0,14,0,2,0
1810125,26,29,1987,7,male,192,266,100,16,22,15,14,1,8
1732658,18,5,1995,9,male,98,267,51,16,47,15,30,1,17
1308087,15,23,1998,9,female,91,273,178,16,0,16,0,0,0
1992396,18,5,1995,9,male,445,269,156,16,5,16,5,0,0
1206209,24,11,1989,8,male,670,273,198,16,3,16,3,0,0
1677885,21,1,1992,9,female,73,264,70,16,72,16,65,0,7
1280743,52,25,1961,7,male,619,273,210,17,44,0,3,17,41
1827006,108,25,1905,4,female,1136,273,148,17,52,0,31,17,21
1591909,19,6,1994,8,male,323,269,199,17,25,5,1,12,24
2137663,30,31,1983,12,male,711,270,200,17,49,4,23,13,26
2091663,49,7,1964,10,male,1513,268,152,17,21,13,15,4,6
1711156,16,27,1997,6,male,291,274,16,17,6,17,6,0,0
1545249,50,1,1963,8,male,959,263,184,17,7,17,3,0,4
1437420,25,14,1988,2,male,615,266,48,17,23,17,23,0,0
1921745,43,15,1970,10,male,1029,272,178,17,11,17,10,0,1
2039751,103,8,1910,4,male,1475,264,198,17,11,17,4,0,7
1933276,16,8,1997,4,male,242,269,177,17,137,17,93,0,44
1122897,20,25,1993,11,male,23,266,40,17,36,17,22,0,14
1125506,19,11,1994,9,female,488,268,195,17,33,17,30,0,3
1510731,25,6,1988,2,female,480,270,119,17,73,17,39,0,34
1475959,58,13,1955,12,female,1603,272,130,17,32,17,16,0,16
1925453,20,18,1993,12,male,358,268,169,18,3,0,1,18,2
1286543,16,28,1997,7,female,437,265,109,18,57,0,12,18,45
1511956,29,3,1984,5,male,489,269,226,18,35,4,6,14,29
1404592,16,21,1997,8,male,295,262,147,18,4,16,2,2,2
1741535,20,8,1993,8,male,306,267,239,18,6,17,3,1,3
1053868,16,12,1997,1,male,580,269,158,18,2,18,1,0,1
1969267,17,11,1996,10,male,242,262,203,18,2,18,2,0,0
1144908,22,5,1991,1,male,108,272,51,18,0,18,0,0,0
1882484,16,30,1997,5,female,268,272,67,18,34,18,21,0,13
1456257,20,22,1993,5,female,364,269,89,18,32,18,22,0,10
2123927,40,22,1973,10,male,542,269,129,18,47,18,39,0,8
2181273,18,5,1995,1,male,467,272,200,19,5,0,4,19,1
2154853,59,9,1954,8,male,171,267,22,19,55,0,32,19,23
1186479,17,20,1996,6,female,750,269,135,19,0,11,0,8,0
1946372,21,11,1992,4,male,720,263,186,19,0,13,0,6,0
2134047,53,21,1960,9,female,1864,271,137,19,26,6,11,13,15
2119757,16,5,1997,3,female,464,266,153,19,2,19,2,0,0
2027488,28,4,1985,3,male,617,274,78,19,1,19,0,0,1
1321476,18,12,1995,4,male,144,262,227,19,37,19,29,0,8
1097668,18,3,1995,5,female,392,266,61,19,68,19,38,0,30
1373178,19,25,1994,6,male,347,274,231,19,47,19,46,0,1
1216797,25,21,1988,7,male,454,270,234,19,57,19,53,0,4
1562842,26,4,1987,9,female,393,263,110,19,50,19,36,0,14
2129031,103,4,1910,2,female,845,271,56,19,345,19,342,0,3
1595934,18,17,1995,5,male,630,268,64,20,0,20,0,0,0
1355965,20,2,1993,11,male,525,274,249,20,3,20,3,0,0
1158220,21,22,1992,5,male,429,263,188,20,10,20,10,0,0
1520359,19,2,1994,7,male,308,263,97,20,16,20,7,0,9
2159870,19,3,1994,7,male,128,272,248,20,15,20,13,0,2
1418004,16,25,1997,10,female,428,271,140,20,86,20,31,0,55
1102465,30,28,1983,1,male,34,265,57,20,449,20,353,0,96
1538996,33,21,1980,6,male,927,265,35,20,50,20,50,0,0
2181793,36,1,1977,1,male,367,268,196,21,3,0,1,21,2
2001922,17,30,1996,7,male,611,262,224,21,8,15,5,6,3
2114437,24,24,1989,3,female,710,272,215,21,4,15,2,6,2
1908712,59,21,1954,3,male,1246,272,120,21,449,14,79,7,370
1214595,25,6,1988,10,male,366,271,147,21,34,18,20,3,14
1945557,17,8,1996,11,male,257,273,228,21,1,21,0,0,1
1417239,17,9,1996,10,male,527,269,188,21,10,21,10,0,0
1321799,16,23,1997,3,female,311,262,193,21,22,21,19,0,3
2022440,103,16,1910,11,female,1180,263,62,21,18,21,12,0,6
1036965,18,3,1995,4,male,391,265,164,21,108,21,88,0,20
1892858,20,27,1993,6,male,403,269,65,21,46,21,39,0,7
1556416,20,7,1993,6,male,497,269,158,22,4,0,1,22,3
1180941,106,7,1907,7,male,1046,262,130,22,24,14,18,8,6
1919724,41,16,1972,5,male,638,265,182,22,16,19,15,3,1
1971537,49,24,1964,10,female,1013,268,178,22,31,16,17,6,14
1407127,25,18,1988,4,female,356,264,199,22,4,22,3,0,1
1286067,22,2,1991,7,male,324,262,251,23,5,0,2,23,3
1658922,15,20,1998,6,female,343,263,140,23,4,23,0,0,4
1292305,15,6,1998,10,female,73,265,76,23,37,23,30,0,7
2108751,100,18,1913,7,male,1755,268,178,23,48,23,17,0,31
1271532,17,28,1996,3,male,545,266,40,24,0,0,0,24,0
1058472,18,10,1995,10,male,387,270,205,24,21,3,10,21,11
1930362,14,24,1999,4,female,265,262,136,24,61,6,41,18,20
2134493,50,29,1963,8,male,204,273,151,24,71,6,37,18,34
1866506,17,4,1996,4,male,396,268,179,24,12,24,10,0,2
1896559,18,10,1995,1,male,231,270,169,24,26,24,21,0,5
1499044,14,6,1999,8,female,88,266,37,24,112,24,97,0,15
1193284,38,2,1975,9,male,476,265,119,25,7,5,5,20,2
1198281,64,29,1949,8,female,565,265,131,25,0,25,0,0,0
1926616,20,5,1993,10,female,1148,263,137,25,7,25,3,0,4
1327794,22,8,1991,8,male,733,265,129,25,25,25,23,0,2
1812584,30,1,1983,6,male,1722,269,95,25,23,25,22,0,1
1516677,22,2,1991,2,male,283,266,178,26,2,3,1,23,1
2123823,37,1,1976,8,female,208,262,171,26,35,16,13,10,22
1256743,16,24,1997,3,male,437,264,153,26,23,24,17,2,6
2036213,28,15,1985,7,male,165,267,138,26,8,26,5,0,3
2181606,18,20,1995,4,male,383,262,218,26,25,26,24,0,1
1425632,21,21,1992,9,male,1077,274,146,26,68,26,11,0,57
2012745,99,25,1914,9,male,1617,269,113,26,42,26,28,0,14
1703196,22,8,1991,1,male,566,268,192,27,2,0,1,27,1
1702476,26,23,1987,2,male,246,272,204,27,36,14,18,13,18
1450212,31,3,1982,7,female,689,269,172,27,10,21,8,6,2
1005203,58,7,1955,9,female,2052,262,146,27,33,26,8,1,25
2029177,16,18,1997,12,female,40,273,169,27,86,23,34,4,52
1177056,16,6,1997,1,male,631,267,168,27,4,27,4,0,0
1670472,20,1,1993,4,female,353,267,164,28,26,2,8,26,18
1125658,21,4,1992,4,male,250,269,244,28,25,25,21,3,4
1998170,26,3,1987,1,male,718,265,178,28,1,28,1,0,0
1399780,15,14,1998,9,male,163,263,220,28,25,28,14,0,11
1774432,23,1,1990,1,male,1417,272,106,28,18,28,14,0,4
2157751,50,13,1963,10,female,1037,266,211,28,24,28,15,0,9
1933702,22,5,1991,5,female,575,274,208,28,85,28,77,0,8
1001153,21,5,1992,5,male,280,263,108,29,0,1,0,28,0
1515775,17,1,1996,2,male,489,270,217,29,13,20,8,9,5
1893947,45,3,1968,11,male,244,273,228,29,44,14,26,15,18
1254645,16,12,1997,9,male,423,268,211,29,7,29,7,0,0
1490428,23,9,1990,3,male,438,263,213,29,25,29,25,0,0
1885614,25,30,1988,12,male,433,265,184,29,28,29,28,0,0
1674103,14,10,1999,2,male,135,274,219,30,15,0,0,30,15
1806244,25,23,1988,8,female,521,269,146,30,88,0,17,30,71
1175049,18,13,1995,2,male,478,263,211,30,2,30,2,0,0
1366670,18,26,1995,9,male,379,269,151,30,29,30,4,0,25
1610656,20,8,1993,9,male,310,269,231,31,31,31,24,0,7
1287199,30,20,1983,8,male,566,273,131,31,23,31,17,0,6
1311139,26,1,1987,1,male,636,266,107,31,83,31,41,0,42
1407260,28,8,1985,4,male,367,262,142,31,54,31,32,0,22
1746326,18,7,1995,2,female,607,268,136,32,35,26,14,6,21
1686735,19,28,1994,11,female,367,265,202,33,32,6,7,27,25
1060094,93,28,1920,11,female,2697,274,184,33,47,3,14,30,33
1930157,30,19,1983,5,female,893,267,204,33,3,33,3,0,0
1083686,101,27,1912,11,male,2328,269,127,34,4,3,2,31,2
1817047,18,27,1995,11,male,810,265,210,34,2,34,1,0,1
2157050,20,1,1993,1,male,452,266,93,34,20,34,16,0,4
1375680,103,20,1910,1,male,1150,265,232,34,8,34,6,0,2
2119663,16,24,1997,6,female,497,262,187,34,22,34,11,0,11
1549023,15,25,1998,1,female,559,273,114,34,89,34,78,0,11
1760304,19,14,1994,2,female,374,263,80,34,56,34,46,0,10
1877564,47,25,1966,10,male,984,270,209,35,3,4,2,31,1
1126108,17,20,1996,9,female,515,265,94,35,1,25,0,10,1
1457049,16,5,1997,9,male,115,266,124,36,288,25,184,11,104
1181597,28,5,1985,5,female,522,263,224,36,148,9,118,27,30
2131934,20,27,1993,6,male,184,265,206,35,8,32,3,3,5
1871994,36,27,1977,7,male,675,266,76,36,12,33,10,3,2
1130694,18,18,1995,5,female,510,273,141,35,17,35,17,0,0
2000815,19,5,1994,10,male,329,262,119,35,10,35,3,0,7
2179546,25,7,1988,8,female,504,264,204,35,10,35,9,0,1
2162625,27,6,1986,4,male,195,265,229,36,21,36,19,0,2
1611450,20,8,1993,6,female,1049,270,160,35,123,35,117,0,6
1868151,95,8,1918,1,female,270,273,158,35,66,35,62,0,4
2051563,17,3,1996,9,male,575,267,223,37,15,5,8,32,7
1154739,25,20,1988,2,female,182,270,199,37,261,37,86,0,175
1930931,63,16,1950,8,male,923,266,201,39,237,6,47,33,190
1755854,23,23,1990,10,male,478,262,241,39,43,33,41,6,2
1683150,15,7,1998,8,male,131,264,126,39,17,39,12,0,5
1791368,103,29,1910,12,male,477,263,181,38,8,38,8,0,0
1494276,19,5,1994,5,female,1119,269,93,38,52,38,51,0,1
1727736,22,25,1991,10,female,963,264,87,38,54,38,49,0,5
1031654,30,5,1983,7,male,108,273,221,39,33,39,32,0,1
1410453,20,2,1993,9,male,176,267,158,38,101,38,85,0,16
1367094,63,23,1950,10,male,1625,263,155,40,22,0,2,40,20
2116998,21,1,1992,6,male,367,270,99,40,10,30,4,10,6
1493545,108,19,1905,3,male,1741,273,139,40,148,39,134,1,14
1432883,49,11,1964,5,male,68,273,153,40,31,40,19,0,12
1877617,21,2,1992,1,male,713,269,100,40,112,40,86,0,26
2169199,20,16,1993,5,female,273,264,89,42,66,41,51,1,15
2163779,19,1,1994,2,female,696,269,139,41,24,41,23,0,1
2145642,24,22,1989,1,male,453,266,203,41,44,41,31,0,13
1446504,14,20,1999,7,male,367,269,112,42,90,42,45,0,45
1908923,18,1,1995,1,female,475,262,118,41,70,41,22,0,48
1940987,108,25,1905,9,female,1592,262,40,44,5,0,0,44,5
1871532,35,9,1978,3,male,502,263,156,44,11,3,7,41,4
2175302,18,12,1995,6,male,197,262,155,44,43,22,19,22,24
1360632,14,30,1999,12,male,221,264,156,44,73,11,29,33,44
1370634,15,14,1998,7,female,346,271,62,44,164,38,100,6,64
2119201,17,21,1996,10,male,642,273,133,43,78,41,33,2,45
1814546,103,1,1910,1,male,1559,267,127,44,69,43,57,1,12
1548665,29,20,1984,2,male,140,270,254,44,3,44,3,0,0
2112364,19,9,1994,4,female,559,263,129,44,9,44,9,0,0
1786097,54,8,1959,12,male,644,264,181,44,83,44,54,0,29
2109646,16,24,1997,2,male,263,270,226,45,0,0,0,45,0
1786572,21,3,1992,3,female,372,265,205,45,165,27,83,18,82
1127421,15,28,1998,2,female,261,269,152,47,81,32,31,15,50
1228122,18,11,1995,8,female,537,264,137,47,55,45,52,2,3
1275592,18,16,1995,9,female,176,270,79,46,4,46,2,0,2
1595175,26,19,1987,5,male,691,265,113,46,11,46,11,0,0
1331149,63,14,1950,7,female,639,263,116,46,8,46,7,0,1
1827407,20,12,1993,10,male,327,265,220,47,72,47,63,0,9
2149637,23,30,1990,5,male,391,274,206,47,142,47,136,0,6
1694002,14,9,1999,3,female,634,269,164,48,26,1,20,47,6
1642652,13,3,2000,3,female,491,268,152,48,32,1,1,47,31
1721978,21,15,1992,10,male,463,274,127,49,38,4,19,45,19
1764121,62,19,1951,2,male,752,266,150,49,255,5,126,44,129
1090500,21,9,1992,1,male,435,264,178,49,2,13,0,36,2
1137035,23,24,1990,8,male,405,267,218,49,14,21,3,28,11
1221686,19,28,1994,5,male,1085,263,105,48,25,47,12,1,13
1261954,27,2,1986,2,female,538,263,103,48,281,45,94,3,187
1742388,19,20,1994,3,male,481,265,240,49,4,49,0,0,4
1813100,68,30,1945,9,female,539,263,200,48,14,48,10,0,4
1954913,108,12,1905,8,male,1403,264,74,49,14,49,10,0,4
1671922,20,30,1993,10,female,540,262,95,50,172,4,42,46,130
1190775,17,19,1996,1,male,480,273,232,50,37,25,16,25,21
1782279,15,17,1998,2,male,496,266,173,50,43,47,34,3,9
2117724,18,21,1995,3,female,371,267,249,50,0,50,0,0,0
2156650,73,23,1940,7,male,784,266,148,53,35,0,30,53,5
1186165,24,15,1989,10,male,515,269,178,52,100,4,32,48,68
1411018,28,16,1985,6,female,555,270,158,53,66,50,27,3,39
1164821,43,12,1970,12,male,1188,272,197,53,277,50,80,3,197
1349262,85,5,1928,8,female,1405,264,232,54,138,0,52,54,86
1262957,52,2,1961,3,female,483,274,205,54,22,19,6,35,16
2005322,25,22,1988,5,female,295,271,202,54,63,54,54,0,9
1218337,108,29,1905,11,female,1191,268,102,54,64,54,48,0,16
1933884,28,25,1985,10,female,351,274,174,55,256,55,191,0,65
1169889,108,18,1905,12,NA,1860,265,119,58,14,0,3,58,11
1100541,20,13,1993,8,female,713,263,226,57,8,51,8,6,0
1242996,21,27,1992,10,male,440,262,183,58,62,54,47,4,15
1673807,22,27,1991,5,male,677,264,203,58,146,45,99,13,47
1845352,41,2,1972,1,female,527,272,78,57,96,42,72,15,24
2012829,41,28,1972,8,female,212,264,158,57,272,44,100,13,172
1540240,30,8,1983,4,female,1127,264,89,56,109,56,63,0,46
1943081,47,14,1966,6,female,1079,263,107,60,47,0,17,60,30
1925975,18,16,1995,11,female,502,262,226,59,47,59,46,0,1
1253917,18,14,1995,9,female,272,262,113,61,14,9,4,52,10
1820361,32,26,1981,11,male,511,269,181,61,14,0,2,61,12
1771528,108,13,1905,5,female,2063,263,72,63,55,6,16,57,39
1456921,26,14,1987,2,male,538,268,126,62,101,3,69,59,32
1505975,18,15,1995,8,male,388,266,216,62,72,29,46,33,26
1752815,23,24,1990,1,male,710,269,202,62,9,47,4,15,5
1904532,19,4,1994,3,male,358,271,209,62,41,58,38,4,3
1246960,21,1,1992,12,female,540,262,202,63,44,62,34,1,10
1299582,20,13,1993,9,male,524,271,191,63,20,63,4,0,16
1091678,46,4,1967,3,male,307,272,145,62,55,62,18,0,37
1248558,27,20,1986,4,male,340,270,189,63,102,63,44,0,58
1619590,46,16,1967,8,female,448,265,127,61,133,61,101,0,32
1365250,21,9,1992,3,female,383,270,129,65,24,60,20,5,4
1925245,16,10,1997,5,male,438,270,168,65,83,54,58,11,25
1847062,18,5,1995,3,male,585,268,127,65,42,57,36,8,6
2070879,35,3,1978,6,female,1817,268,215,65,77,64,36,1,41
1880990,25,21,1988,8,male,544,266,236,65,35,65,35,0,0
1344932,23,16,1990,10,male,341,273,214,64,44,64,42,0,2
1425281,18,24,1995,7,female,658,271,126,67,30,9,15,58,15
2004804,60,9,1953,7,female,574,274,199,66,158,0,21,66,137
1105251,16,6,1997,5,female,203,264,49,68,142,65,75,3,67
1152904,37,12,1976,1,female,1711,268,195,68,268,60,212,8,56
2038028,18,2,1995,4,female,310,265,177,66,0,66,0,0,0
2030017,15,9,1998,7,male,306,263,199,66,34,66,28,0,6
1304968,24,21,1989,4,male,974,273,177,66,21,66,9,0,12
1385889,15,5,1998,2,female,36,269,179,68,59,68,40,0,19
1746918,21,25,1992,2,female,533,271,179,68,215,68,146,0,69
2003491,48,14,1965,10,female,1446,274,182,70,15,0,1,70,14
1184500,16,3,1997,9,male,177,273,256,69,10,44,7,25,3
1317993,22,11,1991,4,female,800,267,179,71,49,68,45,3,4
1456306,20,15,1993,9,female,811,268,170,71,93,71,68,0,25
1288947,24,22,1989,12,male,217,262,154,69,92,69,63,0,29
1337760,53,8,1960,10,female,1813,268,126,71,93,71,60,0,33
1302693,108,27,1905,5,male,2366,263,127,71,100,71,81,0,19
1047501,28,11,1985,7,female,296,269,69,69,220,69,189,0,31
1473670,19,1,1994,12,female,537,268,79,73,9,2,5,71,4
1625074,19,27,1994,3,male,422,268,101,73,14,12,6,61,8
1769114,93,23,1920,2,male,955,268,185,72,393,0,162,72,231
1010389,18,7,1995,12,female,477,267,215,74,22,21,5,53,17
1443455,20,8,1993,1,male,468,271,133,72,83,27,50,45,33
1845394,50,31,1963,3,female,736,264,55,72,10,66,8,6,2
1493556,18,5,1995,1,male,649,272,201,72,48,58,30,14,18
1214525,54,10,1959,12,female,1454,264,133,72,216,69,116,3,100
1516908,34,12,1979,2,female,491,273,239,77,0,0,0,77,0
1734681,21,30,1992,8,male,280,274,231,75,22,4,11,71,11
1045539,64,17,1949,3,male,37,273,269,77,2,40,1,37,1
1248266,29,15,1984,2,female,687,269,121,75,109,33,45,42,64
1693021,15,24,1998,11,female,254,263,197,77,67,72,53,5,14
1268924,17,4,1996,8,male,437,264,9,76,21,76,19,0,2
1007130,21,20,1992,9,male,562,272,182,77,42,77,38,0,4
1789053,37,4,1976,8,female,140,267,214,76,59,76,35,0,24
1034022,20,13,1993,6,female,335,269,127,75,216,75,122,0,94
2153769,14,13,1999,8,female,573,262,109,79,150,24,57,55,93
1581510,19,1,1994,12,male,674,269,160,80,43,63,33,17,10
1687136,20,28,1993,5,male,924,271,204,78,53,58,7,20,46
1204601,19,30,1994,4,male,243,271,235,78,39,78,38,0,1
1219710,16,12,1997,7,female,679,273,161,79,104,79,100,0,4
1502083,21,31,1992,10,female,573,263,110,80,119,80,95,0,24
1757691,19,3,1994,8,female,502,267,183,80,254,80,252,0,2
1909283,30,19,1983,11,male,144,271,198,83,12,10,3,73,9
1100566,17,21,1996,11,male,630,269,115,84,27,0,24,84,3
1434891,19,20,1994,1,female,563,274,131,81,288,51,96,30,192
1367691,21,25,1992,8,female,711,265,148,81,84,72,81,9,3
1992417,108,3,1905,12,male,1053,274,109,82,68,66,60,16,8
1924535,18,30,1995,12,female,792,269,121,82,8,82,8,0,0
1596689,24,9,1989,3,female,315,266,37,81,15,81,13,0,2
1578916,16,19,1997,6,male,636,273,101,83,93,83,48,0,45
1942513,23,10,1990,11,female,646,271,115,84,113,84,82,0,31
1348305,30,14,1983,5,female,242,271,131,83,98,83,95,0,3
1957344,53,19,1960,3,male,1101,262,94,83,102,83,76,0,26
1252499,16,19,1997,8,male,307,265,168,87,0,2,0,85,0
2160619,15,15,1998,8,female,333,274,133,86,108,55,51,31,57
1460016,18,19,1995,11,male,609,266,116,85,65,48,14,37,51
1455015,18,6,1995,9,female,257,263,164,87,72,62,32,25,40
1622559,26,22,1987,10,female,96,262,91,85,170,40,103,45,67
1824192,21,10,1992,6,female,299,265,82,85,51,72,25,13,26
1304027,20,22,1993,8,female,330,271,169,87,182,87,102,0,80
1489458,17,5,1996,12,female,373,266,188,91,21,7,13,84,8
1511452,18,5,1995,5,male,187,265,217,89,15,0,4,89,11
1817197,15,30,1998,1,male,342,271,113,89,64,43,9,46,55
1261889,15,6,1998,1,male,187,269,231,89,355,89,336,0,19
1045699,48,30,1965,1,female,569,263,198,92,27,3,2,89,25
2033248,59,9,1954,3,male,567,265,161,93,38,0,16,93,22
1732020,21,8,1992,5,female,587,272,194,93,22,85,20,8,2
1839098,64,10,1949,6,male,1942,267,171,94,97,93,61,1,36
1101215,23,1,1990,9,female,1257,266,141,94,147,81,88,13,59
2094738,34,2,1979,10,female,586,266,148,98,92,13,7,85,85
1042990,50,5,1963,6,female,190,266,214,97,287,0,37,97,250
1008635,16,17,1997,12,female,593,271,209,99,23,26,9,73,14
1193560,28,9,1985,4,male,744,273,231,97,97,29,34,68,63
1403630,51,25,1962,7,male,771,272,143,97,106,35,70,62,36
1495319,32,14,1981,1,female,352,268,137,99,223,63,73,36,150
2111204,18,17,1995,7,male,109,270,172,98,140,75,63,23,77
1315138,19,8,1994,1,female,644,271,129,99,17,99,17,0,0
2171681,44,18,1969,11,male,572,273,238,96,43,96,34,0,9
2001479,25,21,1988,10,female,333,263,134,99,139,99,90,0,49
1658255,16,24,1997,5,female,67,274,132,103,558,19,123,84,435
2126095,29,25,1984,2,male,281,269,234,102,36,95,33,7,3
1985385,21,17,1992,12,male,548,264,94,100,68,98,48,2,20
2123145,22,23,1991,10,female,487,266,49,101,262,95,178,6,84
1034458,65,11,1948,4,male,1584,269,189,104,169,102,122,2,47
1203269,14,30,1999,12,male,216,272,215,102,22,102,15,0,7
1844543,17,9,1996,10,male,379,266,141,103,118,103,87,0,31
1512479,51,25,1962,1,female,477,270,229,102,79,102,78,0,1
1774382,18,22,1995,8,female,640,269,140,101,270,101,250,0,20
2105169,95,20,1918,5,male,375,271,169,102,237,102,233,0,4
1363510,15,11,1998,12,male,429,264,193,107,15,1,1,106,14
1196914,58,25,1955,9,female,620,265,162,107,29,0,22,107,7
1464303,61,11,1952,6,male,379,271,249,108,33,0,2,108,31
1647150,14,4,1999,5,male,98,268,202,109,70,35,25,74,45
1755385,20,9,1993,7,male,926,269,160,108,100,43,30,65,70
1961393,14,25,1999,8,male,252,263,179,105,14,86,12,19,2
2153305,20,1,1993,9,male,280,273,112,108,71,83,44,25,27
1581189,59,17,1954,5,male,1689,273,86,109,114,98,71,11,43
2009992,22,25,1991,5,male,121,268,243,108,40,108,32,0,8
2083116,35,6,1978,5,female,1264,268,84,107,284,107,190,0,94
1902124,94,15,1919,8,NA,2411,262,113,111,42,4,21,107,21
1742153,75,15,1938,2,male,1802,267,154,110,26,30,12,80,14
2132647,113,17,1900,1,male,1295,274,70,110,71,33,36,77,35
1983756,21,9,1992,12,male,501,264,164,112,170,53,70,59,100
1037425,94,9,1919,9,female,1912,266,154,112,138,99,93,13,45
1566933,14,6,1999,9,female,167,268,104,110,114,110,41,0,73
2117451,25,1,1988,7,female,377,262,102,110,125,110,123,0,2
1913241,19,3,1994,9,male,307,262,169,116,66,15,11,101,55
1331122,108,17,1905,1,female,1899,269,37,118,76,13,30,105,46
1697357,15,14,1998,6,male,183,263,234,117,112,29,19,88,93
1471105,30,14,1983,11,female,1777,263,79,116,161,73,114,43,47
1726639,39,28,1974,3,male,600,267,223,116,17,113,13,3,4
1257968,20,2,1993,4,female,642,274,71,114,115,97,94,17,21
1425265,25,6,1988,1,female,296,269,167,115,54,115,47,0,7
2074245,23,10,1990,4,male,635,270,178,120,67,40,30,80,37
1680862,29,14,1984,7,male,522,272,206,121,136,42,74,79,62
1099185,31,14,1982,5,male,261,263,86,120,13,116,7,4,6
1328368,29,28,1984,1,male,381,266,184,124,127,98,61,26,66
1314469,17,26,1996,6,male,237,274,180,124,18,124,14,0,4
1580608,56,19,1957,6,female,251,264,69,125,30,0,0,125,30
1439916,14,26,1999,7,female,503,271,228,127,89,85,38,42,51
1490632,17,2,1996,6,male,473,273,236,128,12,115,6,13,6
1117284,14,26,1999,9,female,110,263,138,127,46,127,27,0,19
1107117,29,12,1984,1,male,936,263,186,127,157,127,59,0,98
1477114,14,13,1999,2,male,276,266,196,133,48,5,1,128,47
1536284,20,20,1993,4,female,156,263,235,135,77,27,11,108,66
1450419,27,10,1986,3,female,111,273,217,133,804,35,364,98,440
1421020,31,2,1982,7,female,338,263,149,132,158,121,97,11,61
2052851,35,24,1978,8,female,1181,262,74,131,179,126,76,5,103
2108089,15,18,1998,2,male,487,267,197,134,50,133,28,1,22
1556451,108,1,1905,2,male,1522,269,129,138,71,0,24,138,47
1737913,26,10,1987,11,female,864,267,100,139,186,2,60,137,126
1096128,19,8,1994,8,female,247,271,142,140,79,134,53,6,26
1079637,103,1,1910,6,male,681,274,178,140,173,105,71,35,102
1052837,19,31,1994,3,male,592,267,157,139,72,139,68,0,4
1943134,23,17,1990,5,male,305,262,200,141,310,141,104,0,206
2144859,33,19,1980,10,male,364,273,194,141,557,141,319,0,238
1809887,29,18,1984,6,female,717,264,76,148,155,27,23,121,132
1364121,57,13,1956,7,female,1506,265,199,146,76,67,40,79,36
2095975,22,21,1991,7,female,274,267,233,149,215,99,190,50,25
1092787,16,18,1997,1,male,397,262,237,145,15,115,15,30,0
1172279,30,10,1983,8,male,612,262,234,149,24,149,21,0,3
1681600,24,26,1989,4,male,960,264,125,145,151,145,134,0,17
1602910,15,12,1998,7,female,841,274,161,153,33,7,2,146,31
1958976,20,19,1993,12,male,558,269,93,157,42,10,26,147,16
1814383,57,12,1956,5,male,468,270,245,155,51,12,14,143,37
1072823,50,10,1963,4,male,840,262,186,152,154,64,89,88,65
1763847,66,5,1947,3,female,1053,262,90,156,28,132,19,24,9
2015988,15,25,1998,3,female,854,267,36,157,194,139,134,18,60
1447059,23,31,1990,12,male,286,273,219,151,59,151,55,0,4
1208828,18,23,1995,11,male,174,273,147,151,97,151,87,0,10
1854836,29,16,1984,5,female,739,269,180,157,276,157,62,0,214
1894818,13,12,2000,2,female,316,273,149,159,119,2,40,157,79
1381538,25,14,1988,1,male,229,271,168,161,224,44,75,117,149
2115833,29,10,1984,2,male,518,272,169,158,18,152,3,6,15
1422026,19,6,1994,5,female,274,263,186,163,145,136,54,27,91
1841559,23,24,1990,12,female,703,268,192,158,109,126,78,32,31
1566196,19,10,1994,4,male,274,272,225,164,12,164,9,0,3
1717229,19,6,1994,11,male,604,268,166,159,97,159,43,0,54
1093455,16,10,1997,2,male,245,264,146,170,2,0,1,170,1
2093074,58,20,1955,3,male,486,265,248,167,132,0,20,167,112
2072064,23,3,1990,9,female,112,272,127,170,394,19,155,151,239
1869869,24,19,1989,11,female,225,270,133,165,37,113,35,52,2
2055927,13,4,2000,4,male,273,268,99,165,134,60,63,105,71
1602628,14,27,1999,8,male,89,262,217,172,74,169,66,3,8
2061700,17,29,1996,7,female,182,266,185,170,53,170,51,0,2
1704416,18,2,1995,6,male,573,263,122,165,157,165,128,0,29
1395209,20,27,1993,8,female,144,270,113,169,281,169,254,0,27
1131812,49,24,1964,1,female,343,271,80,179,65,0,13,179,52
2188131,18,24,1995,12,male,392,267,195,180,22,51,7,129,15
1985144,31,4,1982,2,female,621,274,121,176,125,118,65,58,60
1634852,14,25,1999,4,female,358,265,110,178,133,172,87,6,46
1502223,26,11,1987,12,female,243,268,241,174,741,172,398,2,343
2081567,18,9,1995,11,female,803,269,158,180,74,180,43,0,31
1143012,16,18,1997,1,male,52,265,137,177,315,177,278,0,37
1697665,24,7,1989,5,female,551,270,140,175,315,175,233,0,82
1680957,51,24,1962,11,female,731,263,159,180,512,180,412,0,100
2090302,95,12,1918,4,male,525,271,240,182,113,50,53,132,60
1728943,45,27,1968,7,female,560,272,247,189,380,187,284,2,96
1693136,49,3,1964,9,male,820,272,196,182,126,182,98,0,28
1263424,94,1,1919,12,male,878,262,97,187,124,187,97,0,27
2004639,20,19,1993,10,female,477,266,182,197,244,180,146,17,98
1846918,20,12,1993,8,female,248,262,182,193,310,149,243,44,67
1631155,22,11,1991,1,male,33,264,241,193,17,193,8,0,9
1172745,18,20,1995,3,male,517,272,101,197,297,197,185,0,112
1858263,51,10,1962,1,female,1718,266,218,206,167,0,69,206,98
2181609,19,9,1994,10,female,497,262,145,202,143,105,47,97,96
1251724,67,22,1946,12,female,1565,270,130,209,169,58,57,151,112
1542518,30,24,1983,7,female,660,273,177,204,196,180,80,24,116
1542329,49,5,1964,1,female,1465,265,135,208,902,186,301,22,601
1320343,57,6,1956,8,male,294,267,104,204,293,203,149,1,144
1885186,41,16,1972,12,female,580,269,132,211,76,211,60,0,16
1540374,25,1,1988,1,female,71,262,203,203,184,203,182,0,2
2063230,18,6,1995,6,female,209,266,175,221,179,103,157,118,22
1882220,24,12,1989,9,male,118,272,253,214,115,211,98,3,17
1119443,53,21,1960,11,female,2328,269,186,220,284,209,148,11,136
2122239,63,27,1950,3,female,1690,273,122,224,256,2,191,222,65
1675479,93,1,1920,5,female,239,269,222,233,433,91,114,142,319
1850943,106,13,1907,9,female,1488,264,185,225,126,212,92,13,34
1461533,46,27,1967,5,female,2312,262,162,223,261,214,160,9,101
1769927,46,3,1967,4,female,1156,270,135,227,78,227,52,0,26
2031281,18,25,1995,7,female,620,269,155,229,333,229,292,0,41
1788611,18,16,1995,9,female,481,262,27,223,148,223,47,0,101
1058661,18,2,1995,9,female,391,262,174,237,33,236,33,1,0
1800143,14,20,1999,10,female,244,274,188,238,73,238,53,0,20
1316477,24,29,1989,6,female,183,273,26,244,109,244,103,0,6
1634228,93,7,1920,5,female,771,267,140,243,127,243,110,0,17
1780832,94,29,1919,4,female,959,271,131,241,81,241,65,0,16
2001392,25,19,1988,6,female,570,268,215,251,302,19,216,232,86
1471343,43,27,1970,2,male,956,263,190,251,183,1,34,250,149
1559566,24,3,1989,7,female,448,272,169,250,54,137,28,113,26
1146294,103,13,1910,5,female,687,266,157,257,154,92,50,165,104
2171420,21,24,1992,12,female,765,270,191,255,198,249,184,6,14
2167372,15,2,1998,12,male,290,267,209,253,806,185,659,68,147
1581428,16,2,1997,4,male,175,266,170,253,137,253,88,0,49
1466878,18,29,1995,12,female,420,270,146,257,77,257,31,0,46
1614052,21,28,1992,7,male,213,273,100,260,60,260,45,0,15
1776026,32,31,1981,7,female,389,264,223,254,117,254,90,0,27
1947754,20,17,1993,1,male,583,268,126,247,174,247,126,0,48
1452281,63,7,1950,7,female,377,262,174,265,142,0,45,265,97
1525688,47,27,1966,8,female,1370,263,162,266,251,264,211,2,40
1871795,19,23,1994,11,female,182,268,92,268,103,268,70,0,33
1008130,16,25,1997,9,female,354,271,233,262,214,262,152,0,62
1479308,108,7,1905,8,female,816,263,153,292,41,0,15,292,26
2190940,51,16,1962,5,female,805,263,135,277,69,0,5,277,64
1505971,57,17,1956,3,female,246,269,100,287,84,87,31,200,53
1506470,15,3,1998,7,female,471,271,199,279,357,99,186,180,171
1976492,26,9,1987,9,female,864,265,135,288,124,241,51,47,73
1997945,25,11,1988,9,female,240,270,94,282,417,281,325,1,92
1110477,14,15,1999,8,male,217,273,185,279,46,279,42,0,4
1506759,28,18,1985,9,male,1291,264,142,283,36,283,36,0,0
1372323,108,21,1905,7,male,1142,270,169,290,47,290,12,0,35
1794749,61,20,1952,8,female,2049,262,151,288,96,288,61,0,35
2169504,51,8,1962,6,female,1620,265,147,305,125,31,32,274,93
1250646,61,9,1952,3,female,1138,268,133,307,271,0,45,307,226
1238701,28,15,1985,10,female,935,265,94,293,349,289,175,4,174
1218606,18,30,1995,9,male,364,270,194,295,312,295,305,0,7
2157924,19,24,1994,12,male,294,269,62,315,45,24,40,291,5
2172915,18,12,1995,3,male,491,269,142,324,33,2,23,322,10
1361670,66,8,1947,1,female,743,270,181,327,299,3,57,324,242
2050664,19,5,1994,4,male,366,272,130,309,270,205,226,104,44
1591516,24,28,1989,11,female,275,272,203,309,353,188,204,121,149
1032521,31,30,1982,1,male,2374,264,96,316,209,109,34,207,175
1513040,31,17,1982,1,female,653,266,90,312,350,285,91,27,259
1048675,20,17,1993,11,male,518,263,114,322,126,322,79,0,47
1184677,22,8,1991,10,female,134,263,128,313,129,313,54,0,75
1080694,41,19,1972,8,female,78,271,137,311,447,311,271,0,176
1281752,18,28,1995,10,female,311,262,111,317,507,317,244,0,263
1832115,17,3,1996,10,male,355,262,189,339,145,242,113,97,32
1151223,108,10,1905,5,female,238,274,196,337,281,292,157,45,124
1504304,18,8,1995,11,female,78,264,126,328,668,287,260,41,408
1507970,19,1,1994,10,male,142,266,216,332,57,330,47,2,10
2156557,100,29,1913,11,female,444,268,192,337,546,334,496,3,50
1368735,22,26,1991,9,male,190,270,121,335,76,335,71,0,5
1487345,29,27,1984,1,male,580,268,203,330,89,330,51,0,38
1969848,55,12,1958,8,female,1602,268,58,334,451,334,322,0,129
1613715,100,29,1913,10,male,2042,269,170,339,221,339,203,0,18
2105911,55,7,1958,2,female,1296,270,163,363,222,44,132,319,90
1202601,105,9,1908,1,male,157,265,184,355,383,50,122,305,261
1577694,23,1,1990,12,male,294,269,140,360,161,188,115,172,46
2015390,17,7,1996,9,male,125,263,189,362,912,159,598,203,314
1331597,18,1,1995,8,female,425,274,198,350,156,282,106,68,50
1188686,23,8,1990,10,female,360,266,194,354,176,265,118,89,58
1820191,15,30,1998,11,female,687,264,115,357,570,333,450,24,120
1775441,26,5,1987,5,female,564,273,150,358,1678,323,1069,35,609
1769969,13,9,2000,5,female,411,266,125,378,192,156,48,222,144
1126482,24,9,1989,8,female,1728,263,137,391,310,382,211,9,99
1874022,44,17,1969,3,male,1013,264,232,405,127,241,97,164,30
1937195,61,20,1952,12,female,888,272,186,419,167,419,112,0,55
1115523,100,13,1913,9,male,1711,264,115,395,159,395,114,0,45
1244293,14,18,1999,3,female,175,272,158,414,396,414,359,0,37
1349880,20,1,1993,6,female,203,270,61,416,619,416,572,0,47
1727316,16,9,1997,9,male,582,266,176,424,507,82,310,342,197
1695126,17,14,1996,4,male,336,269,168,424,376,402,243,22,133
1062999,18,6,1995,5,male,345,270,205,432,42,431,32,1,10
1278744,45,17,1968,12,female,1101,266,117,430,968,426,675,4,293
1417334,26,6,1987,4,female,340,272,157,426,205,426,164,0,41
1904901,63,29,1950,1,female,2256,262,183,435,89,435,61,0,28
1464471,23,22,1990,10,male,960,265,115,422,474,422,399,0,75
1792567,36,11,1977,10,female,890,263,130,464,355,17,187,447,168
2014458,25,16,1988,7,female,788,274,190,477,292,122,61,355,231
1446376,24,31,1989,3,male,430,268,137,476,982,278,605,198,377
2181587,45,7,1968,8,female,1670,262,111,458,1875,314,361,144,1514
1547506,28,12,1985,6,male,278,269,252,466,77,464,32,2,45
2016000,25,17,1988,4,female,612,264,185,453,678,453,662,0,16
1953454,64,13,1949,1,female,1705,267,137,490,860,90,260,400,600
2137140,23,29,1990,1,female,371,270,226,503,263,263,118,240,145
2159497,38,7,1975,4,female,1332,265,132,517,190,354,109,163,81
1351577,15,10,1998,3,female,28,269,144,502,1064,274,691,228,373
1370285,20,18,1993,4,female,572,272,171,486,177,388,124,98,53
1745457,33,17,1980,8,female,1253,273,130,489,1044,355,640,134,404
2105295,16,27,1997,3,male,241,271,215,510,664,510,444,0,220
2102891,14,4,1999,5,female,13,262,126,539,238,16,128,523,110
1668051,23,23,1990,2,male,20,271,254,531,299,239,285,292,14
2089431,16,19,1997,2,female,183,270,202,524,355,523,226,1,129
1224340,25,14,1988,1,female,623,265,202,523,677,521,642,2,35
1610583,20,20,1993,1,female,361,274,213,556,435,556,315,0,120
1327789,21,8,1992,9,female,729,264,172,587,301,326,168,261,133
1665105,19,20,1994,5,female,440,265,174,600,572,303,431,297,141
1892811,19,2,1994,9,female,251,272,163,600,585,211,285,389,300
1135519,16,20,1997,7,male,409,263,97,579,915,362,339,217,576
2026138,19,1,1994,10,male,280,262,249,595,177,584,144,11,33
1483221,59,6,1954,8,female,2206,274,96,566,146,556,95,10,51
1407759,23,23,1990,12,female,1528,265,53,590,542,572,307,18,235
1204969,30,6,1983,6,female,1820,266,133,583,358,577,317,6,41
1478962,62,6,1951,11,female,1489,268,29,572,72,570,41,2,31
1896441,20,23,1993,12,female,599,266,150,596,241,596,227,0,14
1519968,19,25,1994,9,female,143,269,237,636,49,450,8,186,41
1426763,34,27,1979,5,female,300,271,228,622,297,365,88,257,209
1983587,19,2,1994,10,female,179,272,79,625,300,482,246,143,54
1096438,29,8,1984,7,male,360,263,189,660,326,649,194,11,132
1524996,18,21,1995,4,male,364,262,186,634,578,560,372,74,206
1337205,24,20,1989,11,female,461,267,188,659,1109,628,400,31,709
1669088,25,14,1988,9,female,638,263,172,624,2396,589,2324,35,72
1901529,68,29,1945,8,male,564,273,185,630,1262,574,669,56,593
2189512,54,14,1959,2,female,493,263,185,636,90,636,38,0,52
1039989,20,20,1993,1,female,113,271,76,628,165,628,157,0,8
1676948,20,13,1993,2,male,281,266,229,725,2143,294,1015,431,1128
1918618,19,8,1994,5,male,514,266,181,690,58,666,22,24,36
1503150,23,4,1990,11,male,175,267,195,674,62,512,61,162,1
2006494,60,10,1953,10,female,1103,263,106,719,237,571,138,148,99
1339676,39,4,1974,7,female,639,274,225,677,182,677,111,0,71
2064878,49,25,1964,3,male,634,270,188,689,305,689,146,0,159
1881248,34,14,1979,9,female,222,273,193,688,549,688,451,0,98
1168299,93,18,1920,9,female,361,262,176,681,825,681,732,0,93
1674784,22,4,1991,2,female,349,270,186,756,288,126,156,630,132
1951410,49,22,1964,3,male,1752,264,175,758,261,26,59,732,202
1260744,18,15,1995,12,male,338,267,161,762,539,394,275,368,264
1754310,38,20,1975,4,female,2314,266,156,760,861,709,688,51,173
1585274,56,19,1957,4,female,1231,274,114,728,791,723,516,5,275
1891364,16,9,1997,3,female,359,265,213,733,72,733,50,0,22
2063056,17,27,1996,11,female,198,266,110,731,424,731,179,0,245
1372267,36,19,1977,2,female,557,267,118,730,316,730,208,0,108
2106173,21,28,1992,8,female,185,262,117,789,1298,789,1146,0,152
2111500,16,12,1997,1,male,122,267,224,827,131,65,97,762,34
2181992,62,25,1951,6,female,211,271,188,825,1270,0,165,825,1105
2148822,22,23,1991,4,female,1987,265,125,838,1142,201,574,637,568
1340905,17,6,1996,11,male,648,274,163,836,745,627,280,209,465
1367322,28,10,1985,5,female,724,267,156,853,601,620,435,233,166
1172314,17,12,1996,7,female,609,274,120,833,316,832,230,1,86
1594680,20,24,1993,5,male,871,269,85,836,323,836,200,0,123
1828181,52,2,1961,10,male,890,262,209,832,1240,832,925,0,315
1837894,74,20,1939,10,female,557,266,102,942,254,0,18,942,236
2190361,47,27,1966,12,female,1598,263,175,977,504,339,210,638,294
1495774,15,20,1998,10,female,568,265,187,903,712,501,258,402,454
1590040,23,2,1990,1,female,716,272,130,985,362,886,196,99,166
1337679,14,29,1999,5,male,133,274,46,937,1072,819,630,118,442
1018501,24,1,1989,4,female,368,267,197,910,551,910,344,0,207
2050973,24,1,1989,11,male,450,263,240,950,646,950,547,0,99
1765587,25,28,1988,4,female,478,263,93,991,305,491,223,500,82
1463961,57,3,1956,1,female,2092,274,109,1087,407,387,159,700,248
2149860,13,3,2000,9,female,119,272,159,1047,1366,460,821,587,545
1560296,19,1,1994,5,female,392,262,179,1073,238,1000,124,73,114
1146740,33,28,1980,5,female,504,273,236,1082,799,788,510,294,289
1066630,21,9,1992,11,male,156,266,243,1028,520,1028,498,0,22
1865156,50,27,1963,7,female,911,270,74,999,1291,999,634,0,657
1345565,81,22,1932,8,female,1416,271,185,1186,467,0,187,1186,280
1990750,44,8,1969,11,male,13,266,82,1188,1342,376,901,812,441
1905170,50,8,1963,12,female,1173,272,213,1236,900,845,238,391,662
1637600,23,17,1990,5,female,248,271,66,1178,328,1178,236,0,92
1461229,61,31,1952,3,female,222,271,251,1315,263,0,43,1315,220
1412810,20,5,1993,11,male,640,270,119,1405,1144,259,171,1146,973
1737445,26,31,1987,1,female,680,266,159,1368,1331,244,519,1124,812
2056787,18,7,1995,7,female,75,274,158,1466,1541,833,777,633,764
1071516,50,16,1963,6,female,1318,274,120,1419,465,1340,177,79,288
2130182,20,2,1993,10,female,383,262,152,1513,1171,1398,446,115,725
1927639,33,20,1980,11,female,945,268,197,1446,735,1446,562,0,173
1128294,43,21,1970,12,male,351,264,184,1471,440,1471,388,0,52
1802021,18,16,1995,2,male,252,266,186,1801,406,15,117,1786,289
1176141,26,23,1987,4,female,725,265,143,1664,611,994,290,670,321
1861236,18,30,1995,9,female,156,272,36,1680,331,1680,312,0,19
1052502,48,14,1965,7,female,508,274,192,1842,1033,1842,433,0,600
1649001,57,20,1956,10,female,1412,271,194,2051,259,0,112,2051,147
1004479,18,26,1995,7,female,267,265,192,2357,1125,59,144,2298,981
1233637,44,28,1969,7,male,513,269,164,2091,568,109,354,1982,214
1639110,52,18,1961,12,male,1354,262,187,2276,34,1598,20,678,14
1605928,19,9,1994,5,female,300,262,236,2085,618,1890,366,195,252
1983388,24,10,1989,1,male,470,262,146,2329,514,2329,503,0,11
2061073,45,15,1968,12,female,815,272,192,2010,1819,2010,1485,0,334
1782685,31,27,1982,8,male,1754,263,202,2881,1341,0,371,2881,970
1747017,57,22,1956,11,female,874,269,91,3229,996,19,256,3210,740
2187709,23,6,1990,3,male,1096,264,133,2877,3021,59,629,2818,2392
1827256,49,12,1964,5,female,960,262,90,2515,904,1003,683,1512,221
1752119,54,18,1959,10,female,773,262,142,3103,3749,1691,2871,1412,878
1929464,32,2,1981,11,female,1111,272,197,2714,2609,2637,2137,77,472
1385168,30,28,1983,2,male,391,264,234,2461,313,2440,229,21,84
1359999,38,17,1975,3,female,369,273,112,3422,1318,3418,821,4,497
1505555,107,8,1906,2,male,131,262,220,2463,229,2463,194,0,35
1229821,36,7,1977,1,female,340,265,116,2690,5290,2690,5045,0,245
1670646,14,21,1999,1,male,651,288,174,0,2,0,2,0,0
1715812,14,1,1999,2,male,378,278,74,0,15,0,12,0,3
1383058,14,24,1999,4,male,653,279,129,0,8,0,3,0,5
1529875,14,10,1999,8,male,327,276,195,0,0,0,0,0,0
1023914,16,31,1997,12,female,359,281,177,0,0,0,0,0,0
1333543,15,8,1998,1,female,504,278,154,0,9,0,1,0,8
1681508,17,27,1996,12,female,506,278,203,0,0,0,0,0,0
2057531,17,1,1996,12,male,698,280,245,0,0,0,0,0,0
1367301,16,12,1997,1,female,581,286,222,0,0,0,0,0,0
2000648,16,19,1997,4,male,476,286,254,0,2,0,2,0,0
1410902,16,8,1997,4,male,251,281,210,0,9,0,1,0,8
1575189,17,5,1996,1,male,262,277,186,0,38,0,18,0,20
2176115,17,5,1996,2,male,339,286,270,0,7,0,6,0,1
1502195,17,13,1996,7,male,276,280,236,0,0,0,0,0,0
1943503,19,19,1994,11,male,448,282,247,0,2,0,1,0,1
1523737,19,17,1994,12,male,955,285,196,0,0,0,0,0,0
2006170,18,24,1995,1,male,209,287,134,0,10,0,5,0,5
2160531,18,1,1995,1,male,33,285,281,0,1,0,0,0,1
1990965,18,19,1995,2,female,284,278,200,0,4,0,4,0,0
1480082,18,5,1995,4,male,1233,279,147,0,6,0,1,0,5
2060432,18,18,1995,7,female,286,287,36,0,57,0,55,0,2
1893026,20,22,1993,11,male,612,280,200,0,0,0,0,0,0
1083967,20,28,1993,11,male,567,282,235,0,0,0,0,0,0
1182560,20,24,1993,12,male,547,276,80,0,0,0,0,0,0
1535876,20,2,1993,12,female,24,286,16,0,0,0,0,0,0
1836645,19,1,1994,1,male,353,276,242,0,0,0,0,0,0
1627062,19,1,1994,1,male,328,280,255,0,0,0,0,0,0
1884349,19,24,1994,2,male,238,275,199,0,1,0,1,0,0
2139213,19,17,1994,7,male,506,279,191,0,0,0,0,0,0
1089471,19,17,1994,8,male,504,286,155,0,2,0,1,0,1
2189884,21,7,1992,11,male,630,277,204,0,21,0,3,0,18
2127215,20,4,1993,1,female,553,285,180,0,1,0,1,0,0
1230189,20,18,1993,3,female,493,280,96,0,32,0,26,0,6
1926305,20,3,1993,3,male,315,276,253,0,30,0,11,0,19
1553677,20,24,1993,7,male,905,280,236,0,1,0,1,0,0
1903556,22,1,1991,12,female,344,275,207,0,5,0,1,0,4
1605772,21,26,1992,5,male,324,282,256,0,0,0,0,0,0
1765841,21,26,1992,5,male,323,283,215,0,3,0,3,0,0
1309316,21,17,1992,6,female,391,284,237,0,10,0,3,0,7
1317989,21,24,1992,7,female,493,279,122,0,1,0,1,0,0
1273584,21,9,1992,8,male,327,282,68,0,0,0,0,0,0
1739869,22,22,1991,2,male,687,285,244,0,0,0,0,0,0
1882984,22,21,1991,5,female,681,278,119,0,0,0,0,0,0
1572324,22,12,1991,9,male,1163,279,103,0,0,0,0,0,0
1161875,23,27,1990,1,male,1159,280,172,0,0,0,0,0,0
2036206,23,11,1990,1,male,688,282,143,0,2,0,2,0,0
1684225,23,20,1990,3,female,521,285,33,0,36,0,12,0,24
1376024,23,20,1990,4,male,417,277,35,0,0,0,0,0,0
1678663,23,6,1990,6,male,228,288,165,0,4,0,4,0,0
1355813,23,19,1990,7,male,941,285,91,0,0,0,0,0,0
1550706,24,21,1989,1,male,293,287,247,0,16,0,4,0,12
1470301,24,5,1989,3,male,945,284,164,0,0,0,0,0,0
1421350,24,21,1989,7,male,1132,277,88,0,0,0,0,0,0
2176965,24,4,1989,8,female,384,277,88,0,5,0,5,0,0
1451994,25,6,1988,2,male,492,287,234,0,56,0,50,0,6
1831669,25,14,1988,5,male,462,284,247,0,0,0,0,0,0
1774826,25,27,1988,5,male,449,285,235,0,4,0,4,0,0
1380051,25,5,1988,8,male,781,283,217,0,0,0,0,0,0
1853045,25,23,1988,8,male,700,281,143,0,3,0,0,0,3
1210033,27,25,1986,11,female,454,276,180,0,0,0,0,0,0
2029073,27,29,1986,12,male,518,279,7,0,0,0,0,0,0
2140839,26,25,1987,7,male,657,275,92,0,1,0,0,0,1
1220323,27,26,1986,5,female,228,282,93,0,0,0,0,0,0
1805371,28,28,1985,1,female,343,279,247,0,4,0,2,0,2
1324078,28,24,1985,6,male,397,277,96,0,30,0,17,0,13
1961450,28,13,1985,8,male,979,288,15,0,3,0,1,0,2
2148388,29,19,1984,5,male,1524,278,81,0,13,0,3,0,10
1288548,30,21,1983,4,male,412,285,228,0,12,0,12,0,0
1865351,31,3,1982,1,male,474,278,8,0,0,0,0,0,0
1239966,31,20,1982,4,female,440,283,249,0,2,0,1,0,1
1147065,32,10,1981,2,male,1106,275,185,0,3,0,2,0,1
1148527,33,1,1980,1,male,444,282,234,0,4,0,4,0,0
1160103,35,4,1978,5,female,437,288,178,0,0,0,0,0,0
1704658,36,4,1977,4,male,196,277,80,0,0,0,0,0,0
1185595,36,3,1977,6,male,191,287,270,0,1,0,0,0,1
1987379,36,7,1977,7,male,651,283,279,0,2,0,0,0,2
1106723,37,1,1976,1,male,1300,286,111,0,48,0,9,0,39
1000125,48,1,1965,3,female,583,277,178,0,9,0,8,0,1
2097223,61,23,1952,11,male,996,279,214,0,0,0,0,0,0
1904293,61,1,1952,11,male,1949,277,221,0,11,0,11,0,0
1505201,63,13,1950,3,male,485,276,156,0,4,0,4,0,0
1641456,66,5,1947,1,male,1113,276,86,0,1,0,1,0,0
1861226,68,28,1945,1,male,46,275,254,0,5,0,5,0,0
1643377,74,4,1939,2,male,1716,281,33,0,3,0,0,0,3
1716631,75,3,1938,1,male,1742,278,41,0,26,0,17,0,9
2015855,77,26,1936,8,male,1658,284,82,0,18,0,3,0,15
2120076,83,15,1930,9,male,695,288,142,0,4,0,4,0,0
1027780,90,2,1923,11,female,1943,281,149,0,2,0,2,0,0
2076897,97,11,1916,8,male,1617,275,217,0,0,0,0,0,0
1081653,100,20,1913,5,male,863,284,135,0,0,0,0,0,0
1946858,101,12,1912,1,male,1336,288,241,0,1,0,1,0,0
1804646,103,3,1910,3,male,742,282,166,0,1,0,1,0,0
2172062,107,25,1906,6,male,1363,288,127,0,2,0,2,0,0
1662676,108,5,1905,1,male,1966,279,111,0,0,0,0,0,0
1099282,19,25,1994,12,male,622,281,180,1,0,0,0,1,0
1893422,18,3,1995,6,male,309,275,235,1,0,0,0,1,0
2175670,21,10,1992,9,male,228,276,192,1,0,0,0,1,0
1372407,52,7,1961,7,male,967,284,184,1,0,0,0,1,0
1013269,65,17,1948,3,female,1448,282,214,1,0,0,0,1,0
1472889,14,27,1999,3,male,362,275,198,1,6,0,3,1,3
2184934,14,16,1999,4,male,263,285,172,1,5,0,2,1,3
1383400,15,7,1998,8,female,203,288,76,1,11,0,8,1,3
1676411,16,15,1997,6,male,170,287,192,1,3,0,1,1,2
2153640,20,16,1993,3,male,277,275,172,1,6,0,4,1,2
1964280,56,2,1957,5,female,1619,280,147,1,2,0,0,1,2
1259360,58,22,1955,1,male,1989,287,164,1,16,0,14,1,2
1170724,73,30,1940,9,female,1437,278,144,1,91,0,0,1,91
2121038,93,13,1920,10,male,508,280,258,1,4,0,0,1,4
1404483,15,29,1998,9,female,280,276,81,1,0,1,0,0,0
2030131,17,17,1996,11,female,366,276,92,1,0,1,0,0,0
1307580,16,14,1997,7,male,518,282,76,1,0,1,0,0,0
1517646,16,17,1997,8,male,302,288,258,1,0,1,0,0,0
1038189,17,24,1996,4,male,1476,276,120,1,0,1,0,0,0
1931172,18,13,1995,4,male,187,286,273,1,0,1,0,0,0
1547719,18,18,1995,9,male,750,279,221,1,0,1,0,0,0
1388702,19,3,1994,5,male,318,277,201,1,0,1,0,0,0
1863375,19,20,1994,8,male,408,287,126,1,0,1,0,0,0
1094926,22,7,1991,6,male,426,286,275,1,0,1,0,0,0
1485246,23,7,1990,4,male,662,275,178,1,0,1,0,0,0
1540770,26,10,1987,8,female,368,285,105,1,0,1,0,0,0
1762283,32,15,1981,12,male,170,279,235,1,0,1,0,0,0
2022911,46,22,1967,5,male,792,275,216,1,0,1,0,0,0
1980760,18,14,1995,5,female,269,285,253,1,1,1,1,0,0
2182750,15,18,1998,12,female,383,285,187,1,14,1,7,0,7
2114716,15,1,1998,7,male,148,276,249,1,19,1,13,0,6
1535640,18,18,1995,11,male,391,283,204,1,5,1,3,0,2
2046845,18,17,1995,11,male,255,287,238,1,2,1,2,0,0
1199749,17,26,1996,1,female,31,275,204,1,34,1,31,0,3
1365666,17,16,1996,2,male,850,277,226,1,2,1,0,0,2
2156456,18,10,1995,6,female,408,276,137,1,2,1,0,0,2
2165456,20,24,1993,10,male,425,285,111,1,31,1,30,0,1
2017284,23,12,1990,12,male,319,275,270,1,9,1,2,0,7
1432357,22,4,1991,2,male,580,282,206,1,4,1,4,0,0
1789874,22,25,1991,4,female,1392,285,79,1,2,1,0,0,2
1266238,22,17,1991,8,male,575,278,213,1,3,1,2,0,1
1516001,22,5,1991,10,male,722,276,197,1,46,1,22,0,24
1253880,23,28,1990,10,female,620,286,118,1,5,1,5,0,0
1759452,24,24,1989,7,male,355,286,95,1,8,1,7,0,1
2136290,24,17,1989,8,female,952,286,150,1,39,1,30,0,9
1287067,25,28,1988,5,male,496,283,240,1,4,1,4,0,0
1347457,27,16,1986,7,female,220,285,188,1,19,1,11,0,8
1268930,27,19,1986,8,male,309,279,141,1,43,1,43,0,0
2167507,28,17,1985,5,female,1307,277,31,1,2,1,2,0,0
1261999,30,3,1983,3,female,412,285,262,1,2,1,2,0,0
1762824,103,1,1910,7,male,1513,277,217,1,4,1,2,0,2
1073719,108,21,1905,1,female,1375,276,179,1,21,1,21,0,0
2175445,17,13,1996,12,male,450,288,255,2,0,0,0,2,0
1790696,21,1,1992,4,male,425,286,171,2,0,0,0,2,0
1320919,100,17,1913,5,female,458,286,222,2,1,0,0,2,1
1516998,17,7,1996,11,female,274,284,110,2,19,0,7,2,12
1897453,103,6,1910,10,male,1341,275,24,2,14,0,5,2,9
1234390,108,18,1905,4,male,1617,277,161,2,41,0,17,2,24
2006082,24,13,1989,6,male,332,280,224,2,1,1,0,1,1
1364498,28,25,1985,3,male,658,279,75,2,4,1,3,1,1
1339312,81,24,1932,10,female,974,278,65,2,8,1,6,1,2
2132069,16,7,1997,6,female,322,275,146,2,0,2,0,0,0
2133860,24,11,1989,5,male,319,285,58,2,0,2,0,0,0
1754810,14,31,1999,5,male,434,286,204,2,1,2,0,0,1
2055944,64,19,1949,9,male,791,286,191,2,1,2,1,0,0
1002945,103,15,1910,3,male,1018,279,90,2,1,2,1,0,0
1471040,15,8,1998,1,female,548,281,203,2,4,2,3,0,1
1823948,16,27,1997,10,female,210,286,102,2,92,2,43,0,49
1025239,17,25,1996,1,female,539,287,202,2,5,2,1,0,4
1081531,18,30,1995,8,male,492,285,153,2,11,2,5,0,6
1939471,18,21,1995,9,female,858,284,107,2,56,2,50,0,6
2153358,21,11,1992,11,female,442,286,22,2,35,2,35,0,0
1249287,22,29,1991,12,male,1102,285,72,2,4,2,1,0,3
1053054,21,27,1992,5,male,176,285,256,2,62,2,46,0,16
1556757,24,20,1989,11,female,575,280,135,2,3,2,3,0,0
1023272,23,16,1990,8,female,599,276,136,2,96,2,70,0,26
1040194,24,6,1989,7,female,298,286,31,2,5,2,5,0,0
1747697,29,6,1984,3,male,272,275,149,2,49,2,26,0,23
1058967,38,24,1975,8,female,641,286,142,2,8,2,8,0,0
1992029,42,25,1971,12,male,626,282,198,2,5,2,2,0,3
1105238,46,6,1967,2,female,533,283,42,2,12,2,6,0,6
1906974,72,17,1941,3,male,968,280,203,2,9,2,9,0,0
2143039,108,26,1905,6,male,206,278,211,2,3,2,2,0,1
1477532,28,13,1985,4,male,199,276,263,3,0,0,0,3,0
2182942,31,23,1982,9,male,311,280,207,3,2,0,2,3,0
2099952,20,30,1993,5,male,362,275,145,3,16,0,8,3,8
1443796,23,17,1990,9,male,296,278,178,3,22,0,2,3,20
1662141,62,20,1951,5,female,1175,278,130,3,201,0,18,3,183
2140105,16,4,1997,4,male,452,277,191,3,0,3,0,0,0
1799874,53,1,1960,6,female,421,284,82,3,1,3,1,0,0
1554509,18,25,1995,12,female,486,285,111,3,3,3,3,0,0
1479048,19,5,1994,3,male,473,285,158,3,4,3,4,0,0
1159727,27,17,1986,12,male,219,284,269,3,3,3,2,0,1
1874904,14,6,1999,4,female,165,275,73,3,176,3,151,0,25
1632397,15,6,1998,6,male,275,281,181,3,26,3,16,0,10
1483210,19,27,1994,10,female,146,285,181,3,9,3,9,0,0
1549764,20,8,1993,7,male,1006,275,150,3,8,3,5,0,3
1074417,22,26,1991,11,female,377,283,175,3,48,3,36,0,12
2054925,21,12,1992,4,male,436,278,103,3,88,3,50,0,38
1616076,21,18,1992,9,male,172,286,210,3,14,3,13,0,1
2033681,26,24,1987,2,male,440,282,233,3,31,3,17,0,14
1239519,30,6,1983,5,male,662,283,71,3,34,3,13,0,21
1912069,45,29,1968,12,female,820,286,154,3,16,3,9,0,7
1185871,58,13,1955,12,male,1559,286,167,3,18,3,18,0,0
1220896,21,13,1992,6,male,543,287,162,4,0,0,0,4,0
2094223,62,26,1951,9,male,1282,283,188,4,11,0,7,4,4
1539193,20,2,1993,8,female,566,275,84,4,0,4,0,0,0
1813481,19,11,1994,8,male,692,277,166,4,2,4,2,0,0
1443135,24,19,1989,9,female,506,286,251,4,1,4,1,0,0
2142193,26,20,1987,6,male,493,283,238,4,1,4,1,0,0
1885198,26,23,1987,7,male,423,281,174,4,1,4,1,0,0
1998592,53,28,1960,2,male,1177,283,185,4,2,4,1,0,1
1645474,27,14,1986,8,male,422,283,250,4,4,4,2,0,2
1916325,17,30,1996,4,female,312,286,94,4,12,4,12,0,0
2035211,19,10,1994,11,male,509,288,248,4,15,4,1,0,14
1744704,19,4,1994,11,male,406,276,147,4,12,4,12,0,0
2130377,21,16,1992,7,male,871,288,115,4,50,4,48,0,2
2071959,28,18,1985,11,male,233,286,125,4,334,4,79,0,255
1818195,27,10,1986,10,male,693,288,192,4,46,4,40,0,6
2162705,28,23,1985,6,male,483,281,162,4,14,4,10,0,4
1750671,38,15,1975,3,male,333,280,212,4,53,4,46,0,7
1872302,42,9,1971,5,female,315,278,212,4,47,4,14,0,33
1615200,59,26,1954,10,female,632,288,240,4,13,4,10,0,3
1966485,23,27,1990,9,male,718,287,193,5,2,0,0,5,2
2011053,19,16,1994,2,male,784,276,231,5,7,3,3,2,4
2021324,53,10,1960,1,male,203,277,46,5,14,3,8,2,6
1089250,45,4,1968,12,male,1485,287,223,5,0,4,0,1,0
1947171,16,15,1997,7,female,849,276,56,5,1,4,0,1,1
1937307,18,10,1995,4,male,272,280,50,5,11,4,3,1,8
1818937,21,18,1992,7,male,692,276,136,5,8,4,3,1,5
2031398,60,17,1953,10,male,1600,277,106,5,10,4,6,1,4
1155343,15,28,1998,9,female,378,288,121,5,0,5,0,0,0
1880365,20,20,1993,10,male,330,281,144,5,0,5,0,0,0
1013443,29,18,1984,4,male,528,285,247,5,0,5,0,0,0
1660849,39,31,1974,8,male,443,276,237,5,0,5,0,0,0
2133492,14,8,1999,3,female,368,275,114,5,1,5,1,0,0
1675756,14,21,1999,4,male,224,275,205,5,3,5,0,0,3
1594264,14,9,1999,2,female,466,277,200,5,4,5,3,0,1
1276248,21,7,1992,1,male,859,281,105,5,18,5,16,0,2
2063672,29,8,1984,7,male,441,284,232,5,12,5,8,0,4
1162581,33,27,1980,5,male,450,285,150,5,28,5,14,0,14
2091698,39,9,1974,6,male,56,288,216,5,8,5,6,0,2
1355464,94,14,1919,10,female,583,276,226,5,14,5,14,0,0
1826150,37,14,1976,8,male,360,281,115,6,8,0,0,6,8
1914476,19,19,1994,8,male,152,281,275,6,23,1,16,5,7
1970875,26,8,1987,12,male,251,278,121,6,0,3,0,3,0
1018051,107,22,1906,5,male,1146,275,219,6,79,5,73,1,6
1098625,17,19,1996,1,female,710,284,63,6,0,6,0,0,0
1770337,26,23,1987,8,male,495,285,133,6,3,6,1,0,2
1186106,33,30,1980,9,male,193,287,79,6,3,6,2,0,1
1707872,81,9,1932,4,female,1239,285,68,6,7,6,7,0,0
2073421,108,9,1905,4,male,878,286,158,6,5,6,4,0,1
1928830,108,2,1905,5,male,1260,286,240,6,6,6,6,0,0
1010256,15,22,1998,12,male,799,277,96,6,24,6,10,0,14
1452884,15,3,1998,5,female,145,282,153,6,17,6,12,0,5
1441562,16,4,1997,6,male,614,286,237,6,53,6,31,0,22
1781172,24,22,1989,7,female,1305,284,184,6,62,6,46,0,16
1361208,28,30,1985,11,male,434,276,179,6,33,6,20,0,13
1842612,28,16,1985,1,male,733,277,180,6,9,6,3,0,6
1891199,95,26,1918,8,male,1361,278,59,6,22,6,11,0,11
2015432,15,21,1998,1,male,640,282,147,7,0,0,0,7,0
1909917,17,12,1996,1,male,730,287,200,7,25,1,12,6,13
1472927,18,13,1995,2,male,608,279,58,7,5,2,2,5,3
1326919,62,3,1951,4,female,1290,279,100,7,0,6,0,1,0
1607161,15,19,1998,8,male,710,276,182,7,0,7,0,0,0
2070689,16,9,1997,10,male,323,279,236,7,1,7,0,0,1
1704518,29,1,1984,8,male,596,277,177,7,1,7,1,0,0
1995749,36,1,1977,10,male,412,275,153,7,1,7,1,0,0
1681707,44,11,1969,9,male,599,287,81,7,1,7,1,0,0
1611993,20,7,1993,1,male,319,281,241,7,94,7,74,0,20
1515467,21,16,1992,4,female,65,286,100,7,33,7,28,0,5
1307868,23,30,1990,12,female,263,283,169,7,15,7,12,0,3
1943167,24,22,1989,12,male,612,285,171,7,53,7,45,0,8
2004461,105,30,1908,4,female,597,281,62,7,40,7,20,0,20
1691170,21,22,1992,12,male,361,285,120,8,4,0,0,8,4
1117038,30,22,1983,8,female,377,277,172,8,60,0,37,8,23
1598264,74,6,1939,6,female,73,278,76,8,28,0,17,8,11
1823645,21,24,1992,5,male,658,286,57,8,96,2,72,6,24
1402962,47,24,1966,2,male,422,280,268,8,31,3,26,5,5
1701255,16,8,1997,7,male,239,284,175,8,4,6,0,2,4
1279097,23,20,1990,9,male,553,287,201,8,4,8,3,0,1
1127676,51,15,1962,2,male,564,286,261,8,6,8,6,0,0
1848459,96,15,1917,2,male,1540,280,141,8,5,8,5,0,0
1233289,16,2,1997,6,male,435,277,72,8,95,8,51,0,44
1123827,22,29,1991,7,male,123,276,42,8,27,8,23,0,4
1890301,24,24,1989,7,female,183,278,29,8,64,8,54,0,10
1041993,63,16,1950,9,male,492,288,155,8,16,8,5,0,11
1622052,25,10,1988,6,female,658,286,177,9,35,1,18,8,17
1829297,58,11,1955,11,male,1573,282,144,9,1,2,1,7,0
1949709,16,3,1997,11,female,149,281,57,9,13,5,10,4,3
1448785,28,29,1985,9,male,763,279,171,9,1,9,1,0,0
1741928,23,31,1990,10,male,172,283,224,9,5,9,5,0,0
1541673,15,20,1998,9,female,327,287,129,9,13,9,9,0,4
1924951,22,12,1991,9,male,137,284,269,9,13,9,4,0,9
1971210,26,16,1987,6,male,874,278,224,9,29,9,29,0,0
1004019,21,30,1992,11,male,430,276,211,10,0,0,0,10,0
1429635,64,14,1949,10,male,1325,287,213,10,3,0,0,10,3
1153581,20,22,1993,7,male,705,280,146,10,9,0,1,10,8
1645526,83,24,1930,3,male,801,287,153,10,46,0,21,10,25
1088062,78,11,1935,10,male,2217,286,58,10,6,3,2,7,4
1771191,18,19,1995,8,male,458,278,169,10,33,3,25,7,8
1609799,14,20,1999,7,male,433,279,236,10,12,9,11,1,1
2093810,20,10,1993,8,male,530,286,135,10,41,9,20,1,21
1742421,19,25,1994,8,male,373,281,223,10,1,10,0,0,1
1847257,55,2,1958,1,male,700,287,106,10,0,10,0,0,0
1561777,15,4,1998,3,female,220,281,108,10,56,10,20,0,36
1476952,23,26,1990,6,male,381,283,244,10,74,10,59,0,15
1388940,31,21,1982,9,male,515,285,194,10,232,10,220,0,12
1966478,15,27,1998,7,female,468,288,173,11,14,0,6,11,8
1058230,32,10,1981,2,male,1670,276,79,11,19,5,4,6,15
1320761,25,1,1988,1,male,303,287,280,11,0,11,0,0,0
1250889,13,12,2000,2,male,152,284,250,11,8,11,8,0,0
1348746,20,15,1993,5,female,207,282,75,11,11,11,11,0,0
1796700,24,25,1989,6,male,688,282,213,11,7,11,3,0,4
1340852,21,12,1992,8,male,241,284,115,11,82,11,47,0,35
2015408,23,22,1990,2,male,707,275,229,11,33,11,26,0,7
2130588,68,29,1945,10,male,1453,283,157,11,70,11,60,0,10
1737496,15,6,1998,11,male,462,286,215,12,8,0,5,12,3
2008218,20,8,1993,10,male,355,279,146,12,18,0,15,12,3
1271665,17,30,1996,12,female,167,283,237,12,26,4,18,8,8
1831762,19,7,1994,5,male,1325,275,174,12,33,7,11,5,22
1656838,17,4,1996,6,male,556,285,214,12,1,12,1,0,0
1837501,57,10,1956,3,male,434,279,270,12,3,12,3,0,0
1644055,16,13,1997,1,male,389,281,210,12,9,12,6,0,3
1916804,18,25,1995,9,male,94,281,67,12,13,12,10,0,3
2046593,21,9,1992,5,female,353,285,208,12,15,12,9,0,6
1501689,29,6,1984,6,male,509,283,181,12,8,12,4,0,4
1027193,42,29,1971,6,male,1371,288,148,12,14,12,12,0,2
1178286,18,21,1995,6,male,325,286,179,12,41,12,41,0,0
2111328,16,23,1997,3,male,444,275,229,13,32,0,5,13,27
1476166,108,5,1905,6,female,1598,288,112,13,43,0,18,13,25
1033916,23,14,1990,6,male,585,278,178,13,4,12,3,1,1
1177162,18,15,1995,7,female,124,283,253,13,15,13,7,0,8
2039101,19,2,1994,7,male,415,278,179,13,9,13,9,0,0
1552534,18,16,1995,7,female,334,275,108,13,166,13,96,0,70
1431830,22,10,1991,11,female,222,285,115,13,39,13,29,0,10
2061619,15,1,1998,4,male,221,275,165,14,0,12,0,2,0
1258888,87,1,1926,5,male,63,286,163,14,35,13,20,1,15
1048055,19,20,1994,6,male,125,285,231,14,2,14,1,0,1
1722740,21,19,1992,1,male,388,287,169,14,2,14,2,0,0
1349263,29,4,1984,10,male,526,281,103,14,8,14,1,0,7
1721833,108,24,1905,9,male,1365,275,93,14,5,14,3,0,2
1212592,23,15,1990,8,male,181,283,88,14,24,14,20,0,4
1890378,25,28,1988,9,male,711,280,215,14,34,14,34,0,0
1501214,26,15,1987,10,male,320,276,170,15,80,4,15,11,65
1680116,15,23,1998,6,female,348,276,139,15,0,13,0,2,0
2063598,108,9,1905,7,male,880,276,109,15,450,14,138,1,312
1740401,98,18,1915,7,female,993,279,130,15,9,15,7,0,2
1619979,21,4,1992,10,male,1364,282,153,15,21,15,16,0,5
1976493,16,31,1997,5,male,390,280,211,16,2,4,1,12,1
1755167,34,1,1979,1,male,195,278,240,16,11,8,6,8,5
1109667,67,16,1946,10,male,1406,283,197,16,95,4,21,12,74
1664075,30,4,1983,9,male,353,280,103,16,8,16,6,0,2
1972363,14,1,1999,1,male,477,288,213,17,4,17,2,0,2
1280184,19,13,1994,11,male,397,277,114,17,22,17,7,0,15
1027523,94,16,1919,6,male,2132,278,154,18,4,1,1,17,3
2098533,49,21,1964,10,male,1372,283,119,18,25,13,14,5,11
2010119,18,28,1995,9,male,354,278,211,18,0,18,0,0,0
1008734,19,10,1994,7,male,590,278,228,18,3,18,3,0,0
1291242,21,20,1992,6,male,521,280,209,18,5,18,4,0,1
1799486,20,27,1993,3,male,505,283,238,18,14,18,14,0,0
1349233,18,8,1995,8,male,101,285,276,18,67,18,15,0,52
1648984,23,19,1990,7,male,544,275,243,18,31,18,30,0,1
1688738,53,22,1960,12,female,207,281,77,18,79,18,75,0,4
1271587,20,26,1993,3,male,219,283,254,19,97,3,32,16,65
1910011,15,1,1998,3,male,715,282,120,19,18,15,16,4,2
1287106,23,28,1990,10,male,257,284,123,19,45,16,26,3,19
1109407,16,16,1997,7,female,385,286,115,19,16,19,11,0,5
1499253,15,19,1998,11,female,47,283,42,19,34,19,26,0,8
1402494,23,1,1990,11,male,369,284,186,20,0,0,0,20,0
2045969,34,25,1979,4,female,311,283,211,20,7,0,1,20,6
2111369,23,15,1990,12,male,799,287,151,20,13,4,4,16,9
1384653,16,21,1997,8,female,349,280,157,20,7,20,5,0,2
1777994,24,11,1989,4,male,735,276,165,20,5,20,1,0,4
1097238,17,18,1996,5,female,451,288,146,20,13,20,9,0,4
1603002,21,25,1992,12,male,258,277,231,20,17,20,14,0,3
1159224,108,25,1905,1,male,980,281,213,20,13,20,10,0,3
1705480,15,8,1998,2,male,672,283,109,20,32,20,28,0,4
2014352,19,6,1994,1,male,725,282,97,20,102,20,51,0,51
1838983,19,26,1994,8,female,477,284,149,20,40,20,12,0,28
1882325,25,12,1988,7,male,47,281,276,21,20,19,13,2,7
1901752,51,14,1962,1,female,1259,284,118,21,25,21,17,0,8
1836293,108,21,1905,2,male,772,282,186,22,11,0,3,22,8
2178460,20,12,1993,12,male,343,284,241,22,35,5,25,17,10
1795742,18,28,1995,12,male,352,284,191,22,14,22,14,0,0
1871044,15,1,1998,12,male,736,288,127,22,36,22,33,0,3
1760071,25,1,1988,9,female,419,280,132,22,200,22,58,0,142
1134802,16,10,1997,4,male,402,285,231,23,18,0,5,23,13
1930808,23,28,1990,11,male,790,276,151,23,30,0,8,23,22
1189233,23,11,1990,11,male,660,287,136,23,14,5,6,18,8
1713620,20,20,1993,6,male,648,285,209,23,7,22,0,1,7
1959707,50,30,1963,5,female,723,280,179,23,288,20,132,3,156
2193209,17,31,1996,1,male,376,284,218,23,19,23,19,0,0
2012509,17,16,1996,9,male,430,286,223,24,2,1,1,23,1
1064407,108,9,1905,9,male,1567,275,139,24,15,16,13,8,2
1826472,15,25,1998,10,male,426,275,64,24,61,22,13,2,48
1373170,108,13,1905,1,NA,2322,280,182,24,51,18,23,6,28
1043700,19,6,1994,7,male,173,280,178,24,23,24,11,0,12
1086076,103,15,1910,3,male,1117,285,114,24,21,24,20,0,1
2189673,27,20,1986,5,female,476,277,206,24,59,24,17,0,42
2017712,27,6,1986,6,male,290,288,143,25,84,1,69,24,15
1066269,49,19,1964,12,male,1761,285,198,25,8,24,5,1,3
1355739,35,5,1978,12,male,638,280,170,25,24,24,14,1,10
2114677,103,12,1910,7,male,843,277,195,25,33,25,32,0,1
1002016,15,18,1998,6,male,127,283,131,26,6,22,1,4,5
1009746,108,25,1905,6,male,1558,285,99,26,47,22,23,4,24
1293834,18,20,1995,10,female,556,276,98,26,10,26,7,0,3
1598826,15,4,1998,6,female,517,278,150,27,3,9,1,18,2
1690488,17,15,1996,6,female,189,279,238,27,3,17,3,10,0
1259864,24,24,1989,7,female,253,280,158,27,86,17,41,10,45
1805320,22,30,1991,1,female,271,285,44,27,54,27,30,0,24
1973943,41,24,1972,5,male,889,275,193,27,156,27,131,0,25
1623935,36,2,1977,10,male,344,283,152,28,6,0,1,28,5
1770037,103,28,1910,4,female,605,285,108,28,46,0,22,28,24
1346227,20,11,1993,10,female,778,284,63,28,36,28,34,0,2
1973403,19,24,1994,1,female,412,288,184,28,93,28,83,0,10
1235738,21,26,1992,12,female,350,277,101,28,186,28,172,0,14
1960881,21,26,1992,2,male,532,277,222,28,106,28,53,0,53
1555567,15,16,1998,4,male,475,288,220,29,2,0,2,29,0
1161871,18,17,1995,11,female,294,286,237,29,1,29,1,0,0
1143366,21,14,1992,7,male,430,282,239,29,4,29,4,0,0
1959599,25,30,1988,4,male,785,278,164,29,2,29,2,0,0
1365943,15,5,1998,8,female,234,280,201,29,74,29,72,0,2
1422160,70,28,1943,2,male,161,285,187,30,6,0,2,30,4
1727095,18,5,1995,5,female,471,280,62,31,139,0,41,31,98
1153973,17,31,1996,8,male,1090,275,73,30,26,13,15,17,11
1041318,108,29,1905,4,male,1097,284,159,30,29,7,6,23,23
1127962,18,18,1995,9,female,578,275,221,30,7,29,2,1,5
2057814,16,8,1997,3,male,446,286,115,30,0,30,0,0,0
2073717,18,25,1995,12,male,73,276,229,31,191,31,185,0,6
1092705,23,22,1990,5,male,152,288,267,31,67,31,42,0,25
2087383,36,14,1977,3,male,1018,276,216,31,143,31,127,0,16
1825245,25,1,1988,1,male,133,279,268,32,72,32,60,0,12
1601395,46,13,1967,3,female,562,275,195,33,28,32,18,1,10
2082040,27,3,1986,7,male,328,279,205,33,14,33,11,0,3
1253529,23,25,1990,7,male,645,282,143,33,30,33,26,0,4
1679321,64,14,1949,12,male,443,278,167,33,21,33,4,0,17
2189517,113,14,1900,5,female,1425,279,107,34,145,0,83,34,62
1843967,22,8,1991,9,male,162,276,180,34,80,31,68,3,12
2192729,16,6,1997,2,male,324,279,144,34,610,34,477,0,133
1248458,21,28,1992,1,female,228,278,131,34,73,34,44,0,29
2071017,15,24,1998,3,female,567,283,187,35,3,0,0,35,3
1939702,15,5,1998,6,male,554,285,224,35,52,0,15,35,37
2080003,68,31,1945,10,male,52,282,117,35,25,2,15,33,10
1066271,101,7,1912,6,female,652,284,80,35,42,4,3,31,39
1252315,33,12,1980,12,male,422,282,221,35,16,19,9,16,7
1936418,68,17,1945,8,female,36,282,123,35,45,10,33,25,12
1602494,22,25,1991,4,male,717,280,143,36,7,34,7,2,0
1577722,65,21,1948,5,male,572,275,158,36,292,33,81,3,211
1378293,73,1,1940,1,male,1222,277,144,36,73,34,57,2,16
1074986,26,1,1987,1,male,126,281,272,35,46,35,42,0,4
1429087,103,19,1910,1,male,1735,288,151,35,40,35,16,0,24
1508035,18,2,1995,2,male,397,284,208,35,109,35,68,0,41
1183640,24,26,1989,5,male,745,275,191,36,69,36,56,0,13
1912225,28,17,1985,10,male,1079,287,126,37,55,15,24,22,31
1466883,13,14,2000,1,female,247,275,175,37,17,37,14,0,3
1739078,22,1,1991,7,male,1014,275,123,37,13,37,13,0,0
1142427,27,1,1986,1,male,687,281,155,37,9,37,6,0,3
1948124,23,16,1990,9,female,218,280,206,39,11,0,1,39,10
1001347,25,7,1988,9,male,1119,288,213,38,42,37,30,1,12
1287634,18,19,1995,9,female,463,288,121,39,2,39,2,0,0
1057806,15,14,1998,3,female,477,286,153,39,23,39,20,0,3
1285865,20,15,1993,11,female,556,282,82,38,26,38,16,0,10
1499051,103,30,1910,12,male,661,279,208,38,26,38,20,0,6
1435263,23,21,1990,10,female,708,286,196,38,459,38,349,0,110
1316271,29,10,1984,8,female,376,285,65,39,72,39,48,0,24
1889717,36,20,1977,12,male,513,280,205,39,144,39,143,0,1
1368173,108,25,1905,3,male,1509,278,145,40,45,1,17,39,28
1710514,24,6,1989,8,male,555,284,100,40,207,34,88,6,119
1504689,19,23,1994,7,female,432,283,106,40,46,40,38,0,8
1899942,65,9,1948,9,female,102,276,107,40,127,40,105,0,22
1327180,103,9,1910,6,male,1363,276,172,42,3,3,1,39,2
1344735,17,25,1996,1,female,372,279,188,42,13,0,0,42,13
1839555,17,26,1996,5,male,81,288,98,41,29,0,4,41,25
1531578,15,7,1998,5,male,34,283,74,41,81,40,39,1,42
1040404,21,6,1992,4,female,504,275,51,41,217,41,166,0,51
2077227,26,17,1987,1,female,290,287,187,42,78,42,62,0,16
1290855,32,11,1981,4,female,319,286,51,42,96,42,88,0,8
1294808,36,4,1977,7,female,884,282,76,42,94,42,25,0,69
1508469,19,18,1994,3,male,550,288,241,44,25,3,5,41,20
1807478,24,30,1989,3,male,695,281,127,43,20,28,14,15,6
1943064,105,26,1908,11,male,1788,278,146,44,45,13,24,31,21
1004844,21,4,1992,10,male,562,281,159,43,30,41,23,2,7
1564678,91,21,1922,11,male,189,276,170,44,35,42,32,2,3
1081837,21,27,1992,7,female,538,285,211,43,6,43,6,0,0
1452670,19,10,1994,4,female,373,278,59,44,24,44,14,0,10
1181963,16,7,1997,10,female,329,277,129,44,43,44,10,0,33
1517178,19,2,1994,3,female,212,287,93,44,55,44,33,0,22
1902426,108,30,1905,9,male,1592,275,147,45,16,0,8,45,8
1026186,46,1,1967,4,female,472,282,174,45,34,1,4,44,30
2062360,108,27,1905,12,female,1777,280,73,45,62,1,42,44,20
1509812,20,13,1993,3,female,205,279,78,45,314,44,283,1,31
1902613,30,11,1983,8,male,581,284,156,45,67,45,54,0,13
1774761,16,12,1997,7,male,770,278,103,46,18,2,3,44,15
1483777,16,21,1997,6,male,743,286,217,46,0,23,0,23,0
1712300,17,2,1996,2,female,67,279,63,46,23,46,18,0,5
1822701,26,17,1987,11,male,238,282,144,47,140,47,75,0,65
1670707,44,3,1969,10,male,950,275,203,46,75,46,46,0,29
1424566,14,29,1999,1,female,405,282,190,49,29,0,9,49,20
2047962,26,10,1987,3,male,499,277,229,48,8,1,6,47,2
1760050,50,5,1963,12,female,749,277,194,49,16,0,1,49,15
2024652,20,28,1993,9,male,761,282,154,49,72,17,52,32,20
1477640,24,2,1989,5,female,732,288,200,49,42,15,36,34,6
1720363,22,3,1991,10,female,330,278,94,48,57,47,48,1,9
2112833,26,9,1987,5,female,144,284,136,49,250,47,119,2,131
1504193,15,23,1998,4,male,324,281,22,49,10,49,10,0,0
1149808,21,20,1992,7,male,145,276,252,49,30,49,16,0,14
2046477,21,18,1992,9,male,169,288,237,48,33,48,20,0,13
2129214,35,2,1978,10,female,128,276,257,49,55,49,33,0,22
1285980,108,5,1905,8,male,1224,278,191,49,48,49,37,0,11
1028038,47,24,1966,6,female,1996,287,113,48,294,48,201,0,93
1156715,15,3,1998,2,female,120,276,153,51,320,4,49,47,271
2021597,21,30,1992,1,female,656,281,153,50,102,0,51,50,51
1681396,23,10,1990,10,male,486,284,151,51,110,3,18,48,92
1003456,97,30,1916,12,male,575,288,235,53,125,0,24,53,101
1733386,113,22,1900,3,female,2184,279,141,52,145,32,105,20,40
1083677,18,18,1995,7,female,501,279,149,53,66,53,51,0,15
2181329,70,8,1943,5,male,2399,277,129,53,75,53,46,0,29
2030947,108,19,1905,3,male,1338,284,154,55,1,0,1,55,0
1196144,20,19,1993,12,female,590,286,203,55,55,1,9,54,46
1119149,27,26,1986,7,male,212,277,236,55,3,39,3,16,0
1497735,15,4,1998,2,male,589,281,232,54,137,22,114,32,23
1855593,18,18,1995,2,male,451,281,154,55,10,48,9,7,1
1753496,35,5,1978,1,female,914,281,161,54,157,51,63,3,94
1064713,20,11,1993,2,female,1045,279,87,54,36,54,6,0,30
1908858,32,18,1981,9,male,561,288,239,54,203,54,200,0,3
1784677,16,23,1997,4,female,469,275,115,58,23,0,17,58,6
2064313,52,24,1961,7,male,831,277,187,56,78,0,61,56,17
1120877,19,30,1994,1,female,371,282,217,57,90,34,33,23,57
1124357,23,22,1990,6,female,623,288,165,58,126,35,94,23,32
1102322,25,11,1988,11,female,584,283,167,56,196,37,114,19,82
1258773,29,6,1984,11,female,87,285,278,58,104,34,91,24,13
1172175,95,15,1918,10,male,1841,280,245,56,16,46,12,10,4
1789748,104,16,1909,12,female,180,281,165,56,32,52,11,4,21
1833623,24,19,1989,7,male,280,288,260,57,122,45,49,12,73
1144748,18,4,1995,6,male,402,279,169,58,34,58,28,0,6
1753712,24,20,1989,9,male,406,278,168,57,51,57,41,0,10
1090943,29,10,1984,6,male,471,281,195,58,39,58,28,0,11
1917438,50,11,1963,1,female,1590,282,199,56,81,56,29,0,52
2065967,21,20,1992,7,female,786,284,155,56,150,56,135,0,15
1201916,23,14,1990,5,female,156,275,182,58,179,58,120,0,59
2052785,26,1,1987,1,male,297,288,250,57,90,57,86,0,4
1973869,58,10,1955,8,male,242,277,12,57,231,57,192,0,39
1460700,38,22,1975,5,female,258,284,232,59,3,0,3,59,0
1047902,17,4,1996,7,female,432,283,97,60,13,0,4,60,9
1798913,15,8,1998,11,male,395,279,125,60,69,43,29,17,40
1593990,27,14,1986,6,male,1086,277,94,60,65,60,51,0,14
1769639,17,23,1996,7,male,635,287,231,61,7,1,2,60,5
1550730,21,3,1992,3,male,257,284,209,63,0,7,0,56,0
1861392,76,9,1937,6,male,716,281,179,62,9,0,8,62,1
1481149,18,1,1995,6,female,445,287,65,63,4,63,0,0,4
1325536,56,28,1957,8,female,279,282,168,63,37,63,11,0,26
1984209,25,3,1988,12,female,228,277,194,65,89,5,58,60,31
1555214,23,23,1990,3,female,200,282,137,65,69,64,27,1,42
2057184,68,15,1945,5,male,1134,286,265,65,11,65,8,0,3
1826888,17,9,1996,2,female,71,283,83,64,96,64,72,0,24
2083375,21,12,1992,10,female,655,283,164,64,134,64,114,0,20
2014599,22,21,1991,1,male,116,285,139,65,103,65,100,0,3
2018434,47,19,1966,1,female,1610,278,106,66,81,0,17,66,64
1870949,67,20,1946,9,male,1189,285,172,67,22,48,13,19,9
1500397,15,6,1998,12,male,572,278,222,68,41,59,25,9,16
1899833,30,9,1983,7,male,1289,285,226,68,40,63,33,5,7
1108874,27,9,1986,4,male,733,280,204,66,41,64,35,2,6
1632807,23,26,1990,12,male,1024,277,130,67,11,67,2,0,9
1086066,15,14,1998,9,male,719,284,137,67,15,67,15,0,0
1297452,19,12,1994,2,male,494,275,209,68,63,68,61,0,2
1303257,23,2,1990,5,female,556,279,233,67,61,67,61,0,0
1299297,14,3,1999,5,male,454,281,101,67,261,67,260,0,1
1535737,28,28,1985,2,male,542,286,195,67,117,67,104,0,13
2191587,19,12,1994,5,female,477,285,97,71,14,24,12,47,2
2007379,32,1,1981,9,male,393,284,253,71,31,45,24,26,7
1173261,35,31,1978,3,female,850,286,141,70,121,32,97,38,24
1475425,22,28,1991,2,male,455,284,189,70,7,58,2,12,5
1645019,103,1,1910,1,female,616,277,133,69,33,69,29,0,4
1952719,26,18,1987,12,female,762,275,207,69,46,69,29,0,17
1204120,21,2,1992,9,female,423,282,91,71,160,71,63,0,97
1274440,35,11,1978,8,male,284,288,217,73,58,2,20,71,38
1396461,18,30,1995,3,male,787,279,154,73,63,17,35,56,28
1736491,18,3,1995,4,female,487,281,118,72,76,42,70,30,6
2159814,25,20,1988,5,female,611,284,93,73,84,28,51,45,33
1959718,67,22,1946,10,male,152,278,147,72,17,53,12,19,5
1881081,40,1,1973,3,female,662,288,130,73,107,71,56,2,51
1004793,68,23,1945,7,female,1884,280,137,73,105,68,45,5,60
1790663,14,3,1999,12,male,77,284,274,73,597,69,506,4,91
1632467,18,14,1995,4,female,474,277,183,72,120,67,110,5,10
2106798,18,22,1995,5,female,102,282,200,72,16,72,16,0,0
1112072,23,1,1990,5,male,860,286,223,74,111,74,87,0,24
1567392,93,1,1920,1,female,1978,285,204,75,15,13,4,62,11
1275863,25,19,1988,5,female,758,277,193,75,66,66,53,9,13
1817793,23,15,1990,9,male,387,285,246,77,33,77,30,0,3
1900199,102,28,1911,11,male,1505,285,180,75,36,75,23,0,13
1725803,17,21,1996,12,female,443,277,202,76,49,76,49,0,0
1408828,22,21,1991,8,female,343,275,160,75,53,75,47,0,6
1798294,19,8,1994,10,female,387,276,156,77,198,77,147,0,51
2152810,43,1,1970,9,male,281,275,234,75,143,75,63,0,80
1707224,18,1,1995,7,male,652,279,209,80,32,3,28,77,4
1052819,20,9,1993,1,female,456,283,209,79,10,79,8,0,2
2167158,25,16,1988,4,male,559,288,187,79,13,79,11,0,2
1381793,21,20,1992,10,female,257,282,134,79,21,79,6,0,15
1985817,49,2,1964,9,female,614,281,189,84,10,0,7,84,3
1693341,65,7,1948,8,male,593,275,180,83,51,20,27,63,24
1376192,17,18,1996,11,female,466,277,156,82,70,77,50,5,20
1522898,59,18,1954,12,male,1461,277,198,84,57,82,48,2,9
1575765,58,14,1955,11,female,1149,283,100,84,4,84,1,0,3
1004001,17,5,1996,10,male,54,283,269,83,31,83,30,0,1
1002087,35,4,1978,7,female,135,279,36,83,22,83,13,0,9
1288389,37,2,1976,11,female,409,282,176,81,30,81,19,0,11
1440377,18,25,1995,11,female,344,278,51,81,174,81,116,0,58
1307176,26,2,1987,5,male,289,286,220,85,37,69,26,16,11
1329306,18,13,1995,9,male,646,285,226,86,1,86,1,0,0
1006822,23,8,1990,6,male,737,281,91,86,5,86,4,0,1
1596990,18,27,1995,8,female,156,276,194,90,25,0,3,90,22
2162241,58,17,1955,10,male,549,285,47,89,54,0,12,89,42
1838417,15,23,1998,2,female,410,281,193,88,117,3,18,85,99
1981520,47,24,1966,12,female,411,279,174,90,400,37,104,53,296
1661186,21,3,1992,3,male,462,281,215,88,34,87,18,1,16
1005664,27,27,1986,2,female,806,279,212,89,82,68,39,21,43
1606111,57,2,1956,10,female,1816,279,50,88,240,87,160,1,80
1471489,18,17,1995,11,female,622,282,248,90,0,90,0,0,0
2110717,23,4,1990,12,male,355,276,158,88,13,88,10,0,3
1967495,23,21,1990,2,female,768,281,170,90,109,90,79,0,30
1847864,25,15,1988,5,male,241,287,265,88,84,88,75,0,9
1540417,21,7,1992,12,female,597,281,75,91,140,91,110,0,30
1996481,18,25,1995,3,male,288,275,241,95,48,0,2,95,46
1555271,15,18,1998,9,female,330,283,212,92,14,58,11,34,3
2080241,19,6,1994,11,male,511,287,186,94,112,86,96,8,16
1217455,19,7,1994,8,male,654,284,248,94,81,88,13,6,68
2107145,24,28,1989,8,female,196,285,30,92,16,92,10,0,6
1760927,29,26,1984,7,male,208,278,275,94,43,94,40,0,3
1076884,75,23,1938,8,male,1175,280,169,95,54,95,50,0,4
1957041,22,29,1991,5,female,1385,280,108,92,99,92,89,0,10
2010512,27,1,1986,10,female,72,280,251,95,77,95,72,0,5
1567598,83,30,1930,11,male,674,277,112,97,84,8,25,89,59
1305835,56,21,1957,6,female,773,286,78,99,380,0,72,99,308
1378783,28,19,1985,5,male,561,284,199,99,42,54,33,45,9
1244823,16,27,1997,2,female,212,278,114,96,134,51,32,45,102
1301015,58,29,1955,7,female,1768,286,111,98,81,67,68,31,13
1346436,20,7,1993,10,male,105,276,255,99,240,91,201,8,39
1480819,54,16,1959,9,female,959,287,207,99,12,99,12,0,0
1994392,50,19,1963,12,male,762,288,172,98,40,98,27,0,13
1840460,101,1,1912,1,male,155,284,15,96,356,96,328,0,28
1977986,22,15,1991,3,female,399,286,177,101,34,49,6,52,28
1957012,94,18,1919,10,male,1857,278,101,102,54,63,25,39,29
1087437,23,11,1990,4,female,313,276,227,104,58,97,20,7,38
1508288,31,6,1982,10,male,50,284,104,103,231,98,121,5,110
1637139,20,20,1993,9,female,634,281,161,101,17,101,6,0,11
1720746,21,29,1992,7,female,374,281,113,100,31,100,14,0,17
1054143,23,11,1990,12,male,642,281,184,103,46,103,44,0,2
1571206,14,18,1999,9,male,379,276,155,104,99,104,67,0,32
2119220,20,5,1993,8,female,292,278,121,100,86,100,60,0,26
1945116,24,27,1989,8,female,427,282,218,100,96,100,88,0,8
1988113,16,28,1997,6,male,258,281,178,109,16,39,7,70,9
1460270,32,16,1981,2,female,496,283,190,105,76,28,26,77,50
1767759,25,24,1988,7,female,766,281,116,109,44,97,29,12,15
2145532,37,19,1976,11,female,314,285,195,105,336,80,131,25,205
2102541,19,10,1994,7,male,750,286,147,109,32,109,29,0,3
1655347,19,15,1994,8,male,496,283,248,107,55,107,51,0,4
1131951,23,1,1990,1,male,504,277,160,113,40,0,18,113,22
1168786,108,1,1905,1,male,1246,282,111,113,89,16,63,97,26
1471989,19,22,1994,12,male,570,287,190,112,108,41,49,71,59
1721579,19,28,1994,11,female,653,285,187,110,243,34,168,76,75
1712137,19,16,1994,12,female,1142,284,134,110,37,107,11,3,26
1527240,23,20,1990,11,female,601,278,168,111,79,85,33,26,46
1676092,31,10,1982,9,female,394,275,174,112,22,112,19,0,3
1453752,24,21,1989,11,female,1338,288,214,118,74,76,14,42,60
1448771,57,16,1956,10,male,1036,278,190,118,149,49,87,69,62
1631316,21,11,1992,1,female,316,276,174,117,272,59,62,58,210
1842454,17,7,1996,6,female,212,281,158,118,153,115,135,3,18
1098494,22,18,1991,9,male,1674,282,132,116,294,106,243,10,51
1284765,33,24,1980,12,female,325,279,177,118,156,118,108,0,48
1437407,28,5,1985,9,female,1057,283,186,117,307,117,93,0,214
2012001,36,20,1977,11,female,2091,280,184,118,311,118,292,0,19
1603943,42,17,1971,7,male,554,287,136,121,251,6,68,115,183
1687753,23,29,1990,6,female,165,276,59,120,119,111,52,9,67
1680887,108,12,1905,9,male,1302,277,112,122,63,122,45,0,18
2192932,28,12,1985,1,female,542,281,148,129,67,13,17,116,50
1684483,28,3,1985,9,female,243,284,154,128,31,9,17,119,14
1643819,93,2,1920,3,female,1162,277,109,129,149,5,28,124,121
1504116,20,23,1993,6,female,707,280,169,130,16,88,10,42,6
1230028,26,13,1987,6,female,1694,283,187,127,248,99,197,28,51
1296505,33,16,1980,8,male,1099,280,251,129,17,129,17,0,0
1644058,92,14,1921,2,male,1079,284,196,127,18,127,16,0,2
1407350,28,15,1985,8,male,574,281,231,128,22,128,22,0,0
1960262,113,30,1900,11,female,1314,286,114,126,49,126,37,0,12
1295024,94,30,1919,3,male,1086,276,194,133,142,0,16,133,126
1503233,54,15,1959,7,male,255,280,182,131,736,0,370,131,366
2091772,17,12,1996,9,female,828,288,211,136,33,93,23,43,10
2097474,18,17,1995,2,male,160,286,192,132,169,39,27,93,142
1016718,23,10,1990,10,female,632,281,163,131,124,127,112,4,12
1152664,21,15,1992,2,male,314,285,66,135,2,135,2,0,0
1937930,57,17,1956,10,male,854,278,246,132,13,132,7,0,6
1147750,28,5,1985,9,male,524,277,204,133,190,133,121,0,69
1193119,83,30,1930,11,female,710,280,121,131,180,131,126,0,54
1135072,14,30,1999,5,male,196,288,166,142,3,0,0,142,3
1451816,17,17,1996,8,male,274,275,142,141,1,14,0,127,1
1018940,68,23,1945,9,female,1847,277,124,143,188,41,121,102,67
1480838,108,9,1905,10,female,1729,284,134,139,289,73,138,66,151
2041957,17,30,1996,3,male,630,284,90,141,166,137,100,4,66
1755499,21,21,1992,6,female,375,280,125,139,319,137,223,2,96
2136595,21,19,1992,9,male,310,279,170,138,32,138,28,0,4
1955474,38,22,1975,9,female,508,278,79,146,102,2,24,144,78
1207024,66,9,1947,7,female,1783,288,151,146,94,5,84,141,10
1654071,53,10,1960,2,male,616,286,216,150,513,12,90,138,423
1749362,103,7,1910,8,male,1664,287,173,146,17,99,14,47,3
1161654,20,16,1993,7,male,479,280,155,149,88,88,44,61,44
1332692,54,27,1959,9,female,1814,276,159,150,135,83,58,67,77
1790577,19,6,1994,8,male,431,278,161,146,457,127,282,19,175
1822871,28,10,1985,1,male,430,278,231,148,24,148,13,0,11
1326227,52,12,1961,12,male,359,286,200,148,17,148,11,0,6
1788232,17,26,1996,1,male,241,288,236,149,29,149,22,0,7
2077463,31,7,1982,5,male,399,287,220,145,44,145,33,0,11
2037947,21,6,1992,11,female,457,278,163,150,130,150,89,0,41
1584781,18,25,1995,7,female,296,275,58,144,294,144,253,0,41
1098498,30,10,1983,8,female,31,287,236,154,613,12,96,142,517
1923536,51,30,1962,4,female,1089,280,204,155,238,1,18,154,220
1769451,18,13,1995,1,male,215,277,234,151,43,89,31,62,12
1625968,23,5,1990,2,male,630,280,219,151,222,146,149,5,73
1352763,102,19,1911,3,male,1374,279,153,156,143,138,94,18,49
1716946,22,27,1991,6,female,561,284,51,154,256,138,81,16,175
1373283,108,3,1905,6,male,1106,280,186,154,159,153,135,1,24
1511933,33,1,1980,5,male,485,275,222,157,43,157,32,0,11
1970175,20,17,1993,7,male,56,286,278,156,242,156,193,0,49
1295973,30,12,1983,12,male,534,277,207,161,235,53,95,108,140
1020887,61,31,1952,10,female,2136,283,218,162,159,114,32,48,127
1506879,15,1,1998,1,male,313,280,160,164,98,153,54,11,44
1309348,16,8,1997,10,male,226,287,194,158,75,157,62,1,13
1755491,53,8,1960,2,female,1085,288,65,163,406,162,236,1,170
1665888,74,20,1939,10,female,729,286,44,162,223,162,103,0,120
2090068,21,27,1992,3,female,240,280,124,159,309,159,230,0,79
1172400,21,23,1992,9,male,49,286,271,168,114,118,51,50,63
1036323,35,31,1978,12,female,1885,284,102,168,556,168,482,0,74
1879383,103,29,1910,7,male,690,276,194,166,4601,166,3340,0,1261
1735086,45,16,1968,12,female,316,280,147,174,355,5,163,169,192
1874559,15,13,1998,3,male,155,287,97,175,288,73,183,102,105
1748704,25,18,1988,3,female,523,281,187,179,594,49,142,130,452
1878886,24,27,1989,3,female,326,277,170,179,29,172,4,7,25
1211388,19,9,1994,8,female,407,276,210,177,66,139,40,38,26
1480748,18,27,1995,11,female,379,285,147,177,119,174,98,3,21
1954968,103,25,1910,7,male,303,280,212,174,229,170,187,4,42
1269617,19,10,1994,9,male,155,275,199,175,33,174,25,1,8
1680794,22,14,1991,9,female,412,279,178,174,29,174,18,0,11
1844912,26,7,1987,3,male,564,276,177,175,38,175,21,0,17
1293660,70,14,1943,1,female,1705,287,191,179,61,179,46,0,15
2040167,28,9,1985,6,female,553,287,136,174,144,174,57,0,87
1686047,21,29,1992,9,male,570,282,195,189,61,181,41,8,20
1047336,29,14,1984,8,female,356,278,198,188,207,156,84,32,123
1277476,21,29,1992,11,male,869,286,163,188,313,139,162,49,151
1187623,14,19,1999,2,male,473,285,161,186,69,186,18,0,51
1056895,32,10,1981,10,male,383,280,252,186,45,186,44,0,1
1305595,50,22,1963,9,female,1334,283,94,189,124,189,98,0,26
1705421,108,8,1905,11,male,1587,278,179,185,245,185,217,0,28
2065367,18,10,1995,3,male,353,285,238,193,11,23,7,170,4
1710418,19,17,1994,12,female,521,279,108,200,111,25,18,175,93
1350665,27,26,1986,5,female,454,284,226,192,69,1,48,191,21
1787464,19,14,1994,7,female,414,287,148,191,85,75,39,116,46
1551591,20,18,1993,9,female,677,283,185,193,130,189,80,4,50
1343759,21,18,1992,3,male,833,283,212,193,208,185,135,8,73
1709464,27,4,1986,9,male,1392,286,227,194,215,166,95,28,120
2142809,18,24,1995,1,female,327,286,208,195,506,194,360,1,146
1121688,34,3,1979,9,female,1415,278,47,200,62,200,46,0,16
2086809,19,10,1994,1,female,298,276,124,200,295,200,150,0,145
1517434,20,12,1993,1,male,302,278,110,209,84,206,71,3,13
1796357,29,26,1984,7,female,616,286,221,204,282,192,189,12,93
1841082,30,29,1983,1,female,304,276,239,207,248,195,106,12,142
1182062,104,23,1909,11,male,1817,275,91,205,685,204,352,1,333
1725965,19,2,1994,12,male,182,288,97,202,30,202,30,0,0
2096702,43,20,1970,9,male,798,280,166,210,100,210,63,0,37
2175067,18,31,1995,1,female,230,281,147,207,236,207,158,0,78
1776108,19,4,1994,2,female,270,281,34,207,283,207,271,0,12
1002868,52,14,1961,4,female,864,275,204,202,140,202,130,0,10
1499569,23,24,1990,8,female,466,285,112,213,115,118,20,95,95
1769965,52,11,1961,5,female,721,279,189,213,115,179,50,34,65
1770903,103,4,1910,9,male,1384,276,172,217,244,204,135,13,109
1621209,48,24,1965,12,female,553,286,162,217,99,217,54,0,45
1169606,21,19,1992,2,male,1185,277,132,230,102,37,63,193,39
1595812,74,10,1939,4,female,2342,282,76,233,156,0,94,233,62
1635225,28,18,1985,7,male,522,282,152,229,146,150,128,79,18
1921483,108,16,1905,3,female,2192,287,103,224,189,222,156,2,33
1060630,24,10,1989,9,female,461,286,176,230,262,230,207,0,55
1522237,66,14,1947,12,male,694,287,143,230,206,230,165,0,41
2050626,19,10,1994,5,female,290,280,102,233,389,233,246,0,143
1633975,63,13,1950,9,female,1903,280,126,245,153,0,3,245,150
1756545,54,26,1959,2,female,526,278,61,246,491,0,112,246,379
1917114,30,21,1983,7,female,453,276,205,242,288,142,102,100,186
2027778,14,6,1999,2,female,271,280,179,236,45,235,44,1,1
1294637,103,28,1910,1,male,585,275,175,242,79,242,57,0,22
2024668,23,8,1990,7,male,739,283,171,239,284,239,215,0,69
1863873,25,21,1988,7,female,739,278,151,245,165,245,64,0,101
1019310,52,11,1961,6,female,1723,278,200,240,231,240,79,0,152
1165987,20,7,1993,4,male,511,280,37,236,378,236,321,0,57
1504639,58,10,1955,10,male,503,281,49,253,22,0,1,253,21
2114641,20,10,1993,11,male,317,276,136,248,91,29,33,219,58
1226805,29,13,1984,4,male,572,275,134,259,387,1,115,258,272
1964570,26,3,1987,12,male,230,278,239,250,490,13,142,237,348
1669944,64,30,1949,6,female,1385,286,169,259,156,148,63,111,93
1997277,32,11,1981,6,female,983,279,94,248,643,171,500,77,143
2173329,21,14,1992,1,female,199,279,162,251,44,238,32,13,12
1888452,51,11,1962,8,female,1487,276,158,255,206,236,71,19,135
1648200,108,13,1905,4,NA,2278,279,199,250,145,248,104,2,41
1353626,18,14,1995,3,male,332,280,247,249,8,249,5,0,3
1911619,25,8,1988,8,male,622,279,146,260,184,260,107,0,77
2046409,46,19,1967,5,female,1906,278,136,248,170,248,163,0,7
1490605,63,17,1950,1,female,448,281,218,249,315,249,237,0,78
2039213,61,6,1952,2,female,1862,284,208,271,259,2,35,269,224
1691915,15,3,1998,11,male,77,278,247,270,266,90,145,180,121
1672841,21,4,1992,10,male,208,288,255,269,143,243,105,26,38
1263335,17,9,1996,4,male,490,282,70,264,89,264,72,0,17
1963361,18,27,1995,9,female,273,286,109,275,93,275,93,0,0
2007917,34,24,1979,2,male,424,277,137,266,250,266,214,0,36
1099265,21,22,1992,5,male,310,276,221,285,201,205,127,80,74
1935865,21,28,1992,1,female,1786,275,96,291,891,109,262,182,629
1915967,13,15,2000,8,female,110,283,207,284,338,278,125,6,213
1047054,16,15,1997,8,female,473,288,184,279,327,225,100,54,227
1603701,27,21,1986,11,female,635,276,161,288,454,225,161,63,293
1600377,19,17,1994,11,male,323,288,225,291,45,291,40,0,5
2019226,40,14,1973,9,female,668,286,208,289,361,289,161,0,200
1188640,46,12,1967,10,female,768,278,138,292,305,292,289,0,16
1588374,20,14,1993,12,female,494,281,100,301,242,36,156,265,86
1972775,22,13,1991,6,male,362,276,208,306,235,173,143,133,92
1151780,22,8,1991,3,female,230,279,228,299,420,270,318,29,102
1588045,56,25,1957,10,female,1422,284,198,307,223,294,166,13,57
1607930,19,6,1994,5,male,801,278,193,306,67,306,46,0,21
1070368,24,11,1989,3,female,110,279,101,308,427,308,332,0,95
1039645,32,31,1981,1,female,205,279,217,308,286,308,168,0,118
1048842,48,12,1965,10,male,2054,281,233,296,260,296,227,0,33
2123696,92,4,1921,6,male,969,285,225,313,58,0,23,313,35
1707253,30,1,1983,3,female,858,276,192,315,234,12,143,303,91
1243459,88,21,1925,2,male,137,286,219,326,661,16,445,310,216
2120314,21,9,1992,6,female,243,277,156,316,419,177,200,139,219
1025093,25,27,1988,11,female,729,283,207,316,168,296,155,20,13
1423234,20,12,1993,8,female,290,288,243,327,414,314,343,13,71
2080151,48,27,1965,2,female,333,278,253,324,384,313,257,11,127
1142314,56,8,1957,10,female,1314,280,84,322,532,316,291,6,241
1236723,22,11,1991,5,male,257,278,269,322,28,322,26,0,2
1650465,47,29,1966,4,male,483,280,161,325,46,325,34,0,12
1460578,14,31,1999,1,female,331,277,200,334,107,45,74,289,33
1897795,56,27,1957,11,female,997,286,200,330,83,220,70,110,13
1424189,18,1,1995,9,male,280,286,221,330,28,243,22,87,6
1719780,20,15,1993,8,male,176,277,105,328,444,263,187,65,257
1500762,96,13,1917,8,female,1590,277,179,330,372,326,296,4,76
1276399,19,2,1994,2,male,413,279,215,345,176,343,141,2,35
1037825,27,24,1986,4,female,276,288,86,331,222,331,121,0,101
1860409,65,10,1948,9,female,507,277,86,356,245,11,14,345,231
1015129,93,9,1920,11,male,1577,285,169,358,233,0,173,358,60
1867415,16,6,1997,5,female,278,281,193,361,385,73,131,288,254
1930250,23,18,1990,4,male,305,275,214,349,324,79,146,270,178
2076779,19,7,1994,6,female,209,276,59,358,921,251,434,107,487
1895541,17,1,1996,7,male,451,282,160,361,162,331,158,30,4
1329876,23,27,1990,6,female,485,278,157,351,313,346,255,5,58
1199780,35,3,1978,11,female,2286,278,94,365,619,290,470,75,149
2070838,18,25,1995,3,female,425,282,238,368,44,368,32,0,12
1081571,21,7,1992,3,female,18,288,280,350,217,350,129,0,88
1641079,22,24,1991,4,female,421,278,112,352,388,352,232,0,156
2127110,26,29,1987,9,female,276,285,216,352,395,352,351,0,44
2130797,14,7,1999,6,female,323,288,224,375,83,223,55,152,28
1529732,15,14,1998,1,female,592,285,130,370,142,132,107,238,35
1846237,30,25,1983,3,female,467,284,173,371,336,338,212,33,124
1888308,17,27,1996,7,female,477,286,117,381,416,381,217,0,199
1683163,46,21,1967,1,male,248,284,180,383,545,383,435,0,110
1156617,22,9,1991,4,female,485,275,138,414,280,281,200,133,80
1537129,33,29,1980,9,female,1971,282,136,414,637,205,377,209,260
1604812,28,3,1985,9,female,297,277,253,404,239,295,102,109,137
1778201,18,25,1995,4,male,294,288,276,402,42,402,34,0,8
1225839,46,8,1967,8,male,350,277,52,421,21,421,18,0,3
1213554,47,16,1966,5,female,1177,276,102,407,174,407,132,0,42
1659428,25,1,1988,1,female,218,276,27,402,626,402,577,0,49
1549297,52,29,1961,1,female,1493,280,140,451,234,13,26,438,208
1330554,108,6,1905,4,female,1451,279,178,438,205,0,116,438,89
1804772,113,6,1900,12,male,1553,287,187,442,122,0,63,442,59
1009543,39,9,1974,6,female,751,287,227,433,156,167,42,266,114
1753613,19,17,1994,7,male,103,287,262,449,378,245,135,204,243
1366938,20,28,1993,9,female,686,280,147,449,617,219,417,230,200
1703086,33,29,1980,6,female,483,282,166,448,379,443,210,5,169
1397383,54,12,1959,8,female,1356,280,160,424,630,324,350,100,280
1024093,58,23,1955,1,female,1673,275,179,434,378,396,163,38,215
1214715,32,30,1981,4,female,535,283,161,432,119,428,44,4,75
1363234,18,13,1995,2,female,471,283,147,442,340,438,270,4,70
1136777,32,8,1981,5,male,368,284,184,451,75,451,59,0,16
2036349,19,28,1994,6,male,611,276,158,451,251,451,196,0,55
1864923,28,8,1985,4,female,894,279,183,439,146,439,62,0,84
1488177,34,30,1979,3,male,595,285,114,448,87,448,59,0,28
1775074,96,28,1917,7,male,1809,282,164,436,143,436,127,0,16
1235628,65,4,1948,7,female,1809,285,126,462,1905,0,322,462,1583
1735271,52,26,1961,12,female,2454,287,114,467,296,193,120,274,176
1857845,24,11,1989,2,female,468,285,147,460,237,411,161,49,76
1313488,20,27,1993,9,female,694,288,152,460,434,391,264,69,170
1661579,22,27,1991,8,female,59,281,198,470,361,459,103,11,258
1723882,24,12,1989,10,female,571,288,151,460,373,432,223,28,150
2178802,18,30,1995,3,female,888,287,173,456,124,456,73,0,51
2048445,18,3,1995,1,male,144,286,199,455,402,455,235,0,167
1279588,33,12,1980,1,female,242,277,197,464,693,464,533,0,160
1342056,113,7,1900,4,male,1246,288,219,495,223,44,127,451,96
1442991,37,28,1976,7,female,301,281,167,486,238,357,127,129,111
1754547,26,6,1987,5,male,353,280,188,506,100,506,65,0,35
1969126,17,15,1996,12,female,280,279,129,515,501,515,264,0,237
1972446,13,20,2000,5,female,123,284,71,518,1208,518,681,0,527
2076188,17,25,1996,4,male,373,276,181,545,46,104,25,441,21
1495236,113,27,1900,7,female,1755,281,181,536,186,0,12,536,174
1404191,21,18,1992,10,male,529,276,74,527,210,347,105,180,105
1021402,30,26,1983,9,female,297,279,213,539,275,178,99,361,176
1152311,23,13,1990,2,female,298,284,156,528,568,340,221,188,347
1746704,45,4,1968,10,female,788,283,74,548,7,538,6,10,1
1487424,33,13,1980,12,female,1487,288,178,520,251,502,143,18,108
2042243,47,26,1966,2,female,774,281,94,530,239,521,106,9,133
2069606,28,20,1985,1,female,778,279,168,541,501,530,188,11,313
1865059,58,26,1955,11,female,1830,282,185,557,698,422,113,135,585
1378848,15,11,1998,9,male,431,282,118,534,28,534,20,0,8
2042877,57,14,1956,5,female,987,286,195,541,3,541,3,0,0
1526131,16,24,1997,1,male,346,282,118,556,264,556,192,0,72
1698023,46,30,1967,4,male,633,275,177,521,363,521,271,0,92
1570716,58,9,1955,12,female,1396,284,245,583,314,166,272,417,42
1211468,68,12,1945,2,female,1388,278,214,573,304,299,130,274,174
1426103,85,25,1928,8,male,1750,288,94,609,99,593,62,16,37
1437880,22,20,1991,12,female,438,279,135,581,108,482,52,99,56
2129351,25,2,1988,1,female,84,275,225,581,233,540,84,41,149
2043629,56,17,1957,4,male,1366,278,180,574,534,521,302,53,232
2037168,25,9,1988,5,male,1166,287,170,597,95,592,53,5,42
1330593,24,21,1989,1,female,25,285,223,567,755,562,487,5,268
1375197,16,10,1997,5,female,503,284,162,663,501,24,85,639,416
1516015,31,11,1982,6,female,655,283,137,650,185,431,65,219,120
2138303,35,10,1978,4,male,1283,286,251,639,861,249,378,390,483
1079951,38,18,1975,2,female,1220,278,155,612,435,564,275,48,160
1843354,69,30,1944,3,female,2313,288,197,617,560,501,338,116,222
1869062,64,16,1949,11,male,254,282,244,612,8,612,4,0,4
2002734,48,20,1965,5,female,498,282,257,610,139,610,105,0,34
1891420,25,5,1988,6,female,290,287,176,665,718,107,414,558,304
1132553,22,14,1991,10,male,368,275,204,723,89,484,43,239,46
1853227,28,19,1985,9,female,11,284,130,667,575,440,260,227,315
1063815,17,22,1996,7,male,651,277,172,699,218,555,90,144,128
1119564,27,13,1986,3,male,572,285,160,667,125,644,70,23,55
1466661,27,3,1986,10,female,882,283,224,708,329,676,245,32,84
1936262,29,7,1984,3,female,1304,281,73,668,543,578,281,90,262
1619564,35,29,1978,6,female,263,283,180,666,51,666,19,0,32
1508491,50,9,1963,12,male,357,281,234,694,58,694,33,0,25
1961372,25,20,1988,9,female,172,280,97,700,368,700,194,0,174
1326168,56,9,1957,9,female,1786,276,169,667,281,667,232,0,49
2064580,103,28,1910,6,male,982,281,92,691,479,691,222,0,257
1802067,56,28,1957,1,female,809,282,151,729,407,118,167,611,240
1249574,74,7,1939,12,female,1727,288,230,732,350,0,83,732,267
1935970,43,28,1970,11,female,457,282,192,768,290,171,34,597,256
1629014,18,8,1995,11,female,440,283,120,780,571,355,250,425,321
1689281,44,2,1969,7,female,1040,280,211,737,572,213,446,524,126
1343990,31,18,1982,5,male,1016,282,171,764,648,759,198,5,450
1631715,22,27,1991,9,male,264,277,202,788,115,788,79,0,36
1444387,14,21,1999,2,female,166,281,203,768,428,768,237,0,191
2039348,18,9,1995,10,female,366,280,65,769,362,769,228,0,134
2151867,24,7,1989,7,female,396,284,240,777,423,777,382,0,41
1629583,18,10,1995,2,female,457,275,110,856,179,114,74,742,105
1361641,61,21,1952,11,male,1336,283,227,875,739,71,33,804,706
1365214,19,24,1994,12,male,162,277,249,820,350,736,250,84,100
1420071,31,21,1982,1,male,519,287,213,816,300,772,277,44,23
2068605,22,8,1991,11,female,702,277,106,815,1042,631,388,184,654
1949289,36,12,1977,3,female,368,284,54,847,17,847,15,0,2
1975299,48,26,1965,12,female,1241,279,171,965,1513,94,199,871,1314
1534773,15,22,1998,7,female,545,283,207,919,144,329,67,590,77
1857908,21,25,1992,12,male,396,286,106,930,307,660,191,270,116
1381215,29,2,1984,1,female,199,277,180,981,587,634,419,347,168
1761126,19,11,1994,10,female,748,276,205,961,235,748,123,213,112
1542755,42,6,1971,6,female,1454,283,164,956,317,804,191,152,126
1262365,43,11,1970,2,female,810,279,147,910,374,857,151,53,223
1612347,18,24,1995,11,male,74,287,244,918,1004,861,441,57,563
2025122,47,11,1966,4,female,306,276,195,981,623,827,346,154,277
1150263,49,11,1964,6,female,312,286,127,922,583,899,543,23,40
1321585,68,13,1945,8,male,821,288,197,925,392,922,293,3,99
1406407,32,9,1981,5,female,487,276,159,938,946,938,856,0,90
2109729,23,24,1990,10,female,347,278,161,1070,416,24,61,1046,355
1698127,22,31,1991,1,female,847,277,126,1006,1112,167,320,839,792
1823158,31,7,1982,7,female,1170,283,206,1069,821,531,554,538,267
1033109,26,27,1987,11,male,561,281,137,1031,326,988,189,43,137
1259584,16,29,1997,10,female,536,288,234,997,205,996,172,1,33
2107324,14,8,1999,2,female,198,279,221,995,556,995,511,0,45
1254492,23,23,1990,11,female,423,281,104,1121,390,1121,292,0,98
1492871,22,19,1991,9,male,115,278,192,1096,398,1096,301,0,97
2165015,39,22,1974,7,female,380,282,199,1033,313,1033,268,0,45
1264331,22,4,1991,5,female,273,279,110,1092,742,1092,594,0,148
1898687,62,17,1951,4,female,2114,276,167,1230,461,167,383,1063,78
1821904,21,28,1992,12,male,41,275,35,1219,2134,773,536,446,1598
1182282,44,23,1969,6,female,1430,288,119,1193,465,944,193,249,272
1959384,73,18,1940,12,female,299,285,268,1207,363,882,190,325,173
1640623,50,7,1963,2,female,1272,283,159,1244,912,1161,407,83,505
1369246,28,31,1985,1,female,380,284,191,1245,247,1241,183,4,64
1059943,51,12,1962,6,female,739,280,176,1173,190,1173,139,0,51
1406839,16,19,1997,6,male,106,276,263,1214,583,1214,441,0,142
1304695,16,13,1997,10,female,67,279,235,1183,239,1183,206,0,33
1054033,23,19,1990,3,male,529,279,201,1198,476,1198,380,0,96
1703058,35,3,1978,2,female,271,280,169,1159,446,1159,439,0,7
1033857,18,6,1995,9,male,125,277,217,1473,591,0,183,1473,408
1607593,31,23,1982,3,female,220,284,179,1426,666,190,117,1236,549
1314501,19,3,1994,3,female,541,288,180,1381,314,930,86,451,228
1689768,45,7,1968,8,female,1517,276,221,1498,376,496,152,1002,224
1781643,17,30,1996,5,male,1131,279,202,1326,1453,945,952,381,501
1391649,23,2,1990,2,male,343,277,211,1449,1174,305,378,1144,796
1992997,36,10,1977,12,female,2079,276,130,1307,1400,1186,439,121,961
1841006,22,28,1991,3,male,545,275,182,1352,726,1352,141,0,585
1654039,108,19,1905,7,female,655,283,98,1620,817,940,160,680,657
1124078,49,21,1964,3,female,1713,285,119,1804,916,1776,594,28,322
1990622,18,14,1995,12,female,858,278,91,1717,3785,1502,2218,215,1567
1351485,25,13,1988,7,female,40,279,32,1823,678,1823,587,0,91
1947767,24,11,1989,2,female,361,285,115,2073,1394,247,852,1826,542
1480774,68,21,1945,6,female,1861,279,178,2191,1348,0,449,2191,899
1774710,25,19,1988,3,female,1683,287,97,2004,1125,1251,701,753,424
1226443,31,20,1982,11,female,635,285,200,2134,884,1409,589,725,295
1189445,49,7,1964,12,female,291,286,211,2263,919,1910,257,353,662
1550631,17,14,1996,5,male,406,278,131,2205,279,2196,133,9,146
1836470,56,4,1957,1,female,860,287,164,1992,538,1992,206,0,332
1363308,29,1,1984,6,female,569,288,58,3290,518,3288,426,2,92
1491906,45,22,1968,10,female,756,276,237,2852,424,2831,338,21,86
1637313,16,21,1997,11,female,96,288,247,2933,226,2933,163,0,63
1683012,62,29,1951,8,female,305,280,214,2733,253,2733,252,0,1
1126452,37,20,1976,12,female,470,275,194,2435,440,2435,293,0,147
1941647,67,20,1946,11,male,1314,276,202,6915,910,0,308,6915,602
1260155,57,8,1956,7,female,1589,280,170,5921,2830,27,580,5894,2250
1280998,33,31,1980,12,female,859,279,199,3668,2444,499,1259,3169,1185
1882588,19,26,1994,7,female,993,277,114,5393,2792,2523,1067,2870,1725
1252177,14,6,1999,4,female,135,283,130,6514,5721,3289,3075,3225,2646
1671065,55,6,1958,7,male,226,282,230,4783,3794,3098,2466,1685,1328
1581720,15,14,1998,8,female,48,286,179,4060,4109,3402,2990,658,1119
1173289,33,17,1980,9,female,511,277,241,9020,1235,9020,980,0,255
1775035,28,3,1985,7,female,531,284,54,4642,6943,4642,6618,0,325
1887620,13,19,2000,5,male,123,299,256,0,1,0,1,0,0
1281438,15,17,1998,11,female,485,302,160,0,6,0,2,0,4
1506220,16,19,1997,12,female,323,301,73,0,22,0,12,0,10
1456995,16,12,1997,12,female,186,300,201,0,7,0,7,0,0
1249507,15,15,1998,4,female,255,301,96,0,4,0,3,0,1
1321712,15,15,1998,5,female,718,296,186,0,0,0,0,0,0
2007245,15,6,1998,5,male,246,289,32,0,10,0,1,0,9
1268884,16,16,1997,1,male,484,291,234,0,0,0,0,0,0
1246758,16,1,1997,3,female,236,296,80,0,22,0,1,0,21
1441258,16,28,1997,7,male,165,300,282,0,1,0,1,0,0
1959021,16,26,1997,9,male,240,300,134,0,0,0,0,0,0
1752691,18,17,1995,11,male,514,296,245,0,0,0,0,0,0
1583103,18,11,1995,11,female,301,295,216,0,1,0,1,0,0
1876399,17,24,1996,1,male,304,300,204,0,3,0,3,0,0
1796352,17,11,1996,3,male,1027,294,84,0,150,0,74,0,76
1915086,17,28,1996,5,female,515,290,173,0,6,0,1,0,5
1743788,17,14,1996,8,male,628,299,252,0,1,0,1,0,0
1872014,17,10,1996,8,male,538,297,212,0,4,0,4,0,0
1200306,17,4,1996,9,female,497,300,152,0,2,0,1,0,1
1339104,19,23,1994,11,male,654,299,244,0,2,0,2,0,0
1869906,19,21,1994,11,female,207,303,162,0,0,0,0,0,0
1097333,18,13,1995,1,male,177,303,140,0,9,0,8,0,1
1923515,18,6,1995,6,male,1000,295,224,0,0,0,0,0,0
1801252,18,11,1995,6,male,779,289,107,0,1,0,0,0,1
1053440,18,21,1995,6,female,163,291,49,0,7,0,6,0,1
1216100,18,26,1995,8,male,451,303,232,0,48,0,24,0,24
1763592,18,25,1995,9,male,592,298,200,0,1,0,1,0,0
2043810,18,27,1995,9,male,452,292,265,0,10,0,7,0,3
1063703,18,29,1995,10,male,596,289,186,0,0,0,0,0,0
1353881,20,28,1993,12,male,267,291,272,0,4,0,4,0,0
1106765,19,8,1994,1,male,329,301,110,0,0,0,0,0,0
1183688,19,16,1994,2,female,577,300,138,0,3,0,2,0,1
1622951,19,15,1994,2,female,426,301,202,0,0,0,0,0,0
1766570,19,22,1994,4,female,343,295,133,0,0,0,0,0,0
1311899,19,5,1994,5,male,104,294,61,0,3,0,2,0,1
1794917,19,31,1994,7,female,507,291,232,0,0,0,0,0,0
1336447,19,12,1994,10,male,454,291,151,0,28,0,20,0,8
1361424,20,24,1993,1,male,146,294,287,0,7,0,2,0,5
1675735,20,3,1993,4,male,876,301,238,0,0,0,0,0,0
1532224,20,24,1993,4,male,758,303,225,0,1,0,0,0,1
1230443,20,18,1993,8,female,669,289,140,0,8,0,1,0,7
1212394,20,7,1993,9,male,568,299,177,0,0,0,0,0,0
1060002,22,7,1991,11,male,123,290,277,0,0,0,0,0,0
1393987,21,8,1992,3,male,690,292,200,0,4,0,4,0,0
1880771,21,4,1992,5,male,531,300,232,0,0,0,0,0,0
1251630,21,3,1992,8,female,753,296,191,0,0,0,0,0,0
2019888,21,12,1992,8,male,356,301,258,0,3,0,3,0,0
1904812,21,28,1992,10,female,308,298,85,0,27,0,23,0,4
1524224,23,20,1990,12,male,528,300,254,0,1,0,0,0,1
1699951,22,1,1991,1,female,496,290,240,0,0,0,0,0,0
2126482,22,25,1991,5,male,1086,292,194,0,1,0,1,0,0
2179342,22,7,1991,5,male,556,298,195,0,1,0,1,0,0
1214867,22,19,1991,9,male,341,302,261,0,1,0,1,0,0
1938632,23,28,1990,4,male,818,296,127,0,5,0,2,0,3
1377733,23,19,1990,5,male,499,303,268,0,49,0,41,0,8
2182616,23,28,1990,7,male,769,289,272,0,3,0,3,0,0
1744676,23,9,1990,8,male,472,294,257,0,0,0,0,0,0
1218077,24,5,1989,2,male,320,293,210,0,1,0,1,0,0
1504429,24,12,1989,3,male,718,302,261,0,6,0,0,0,6
1434739,24,11,1989,4,male,841,293,188,0,15,0,14,0,1
1692143,24,3,1989,8,female,654,292,115,0,0,0,0,0,0
1013759,24,6,1989,9,male,477,298,244,0,0,0,0,0,0
1085063,24,26,1989,10,male,1024,301,190,0,0,0,0,0,0
1288186,25,27,1988,10,male,562,296,238,0,16,0,14,0,2
2184239,26,29,1987,5,male,895,297,200,0,5,0,2,0,3
1074354,26,28,1987,6,male,1276,292,56,0,3,0,2,0,1
1622975,26,16,1987,6,male,549,303,283,0,0,0,0,0,0
1879062,26,23,1987,8,female,506,297,270,0,0,0,0,0,0
1880954,26,9,1987,8,male,302,302,190,0,36,0,23,0,13
2177292,27,21,1986,8,male,197,293,275,0,1,0,0,0,1
1755947,28,20,1985,4,male,623,300,178,0,0,0,0,0,0
1086324,28,15,1985,5,male,237,300,236,0,0,0,0,0,0
1877819,28,23,1985,10,male,451,289,226,0,0,0,0,0,0
1810458,29,9,1984,5,male,582,292,247,0,0,0,0,0,0
1669928,29,30,1984,9,male,510,289,182,0,0,0,0,0,0
1436096,29,26,1984,10,male,797,289,97,0,2,0,2,0,0
1181902,31,22,1982,11,male,457,297,268,0,0,0,0,0,0
1785378,31,1,1982,2,male,1389,299,165,0,5,0,4,0,1
2129594,33,20,1980,11,female,348,290,107,0,10,0,10,0,0
1869325,35,28,1978,5,male,478,293,272,0,1,0,1,0,0
1939510,35,1,1978,9,male,800,289,256,0,0,0,0,0,0
1496002,36,9,1977,10,male,622,293,256,0,6,0,1,0,5
1564685,38,1,1975,8,male,581,294,211,0,14,0,9,0,5
2015477,39,14,1974,2,male,528,301,177,0,0,0,0,0,0
1428613,46,17,1967,8,female,1850,302,241,0,0,0,0,0,0
2009825,50,26,1963,11,male,277,302,172,0,2,0,1,0,1
1507462,61,12,1952,3,male,1442,291,106,0,0,0,0,0,0
1480492,62,9,1951,3,male,635,294,279,0,0,0,0,0,0
2178248,62,10,1951,3,female,450,300,228,0,0,0,0,0,0
1622426,68,17,1945,12,male,221,295,255,0,0,0,0,0,0
1391223,68,13,1945,9,male,1214,290,255,0,0,0,0,0,0
2099070,88,8,1925,9,male,2285,303,181,0,0,0,0,0,0
1537816,91,23,1922,10,male,832,293,232,0,0,0,0,0,0
1801943,101,21,1912,12,male,829,301,237,0,4,0,2,0,2
1987884,103,21,1910,5,male,1183,290,208,0,4,0,0,0,4
1571864,103,12,1910,6,male,517,301,223,0,0,0,0,0,0
1664294,104,1,1909,4,male,933,303,273,0,0,0,0,0,0
1198683,107,30,1906,12,male,1807,294,76,0,36,0,20,0,16
1255818,108,1,1905,1,male,2331,303,32,0,8,0,4,0,4
1152067,108,27,1905,6,male,860,298,152,0,8,0,8,0,0
1683986,113,25,1900,9,female,1396,297,104,0,0,0,0,0,0
1103186,17,14,1996,2,male,808,297,188,1,0,0,0,1,0
1555831,23,9,1990,1,female,360,299,274,1,0,0,0,1,0
1396710,15,26,1998,3,male,229,293,56,1,1,0,0,1,1
1044143,34,26,1979,12,male,978,292,147,1,1,0,0,1,1
1767624,16,7,1997,2,female,425,301,25,1,2,0,1,1,1
1890183,23,7,1990,7,male,147,295,262,1,16,0,11,1,5
1675711,26,5,1987,9,female,451,298,135,1,31,0,24,1,7
1639570,29,11,1984,11,male,460,295,272,1,3,0,1,1,2
1833819,29,3,1984,5,male,442,298,216,1,107,0,44,1,63
1425397,48,14,1965,1,male,581,293,216,1,17,0,16,1,1
1188027,16,28,1997,1,female,721,303,204,1,0,1,0,0,0
1038247,18,25,1995,1,female,254,298,238,1,0,1,0,0,0
2120505,20,18,1993,11,male,1112,290,165,1,0,1,0,0,0
2121554,19,2,1994,6,male,388,289,191,1,0,1,0,0,0
1327074,21,23,1992,7,male,680,297,115,1,0,1,0,0,0
1892588,21,6,1992,8,male,408,297,161,1,0,1,0,0,0
1692319,23,28,1990,12,female,444,294,196,1,0,1,0,0,0
1161585,23,21,1990,7,male,138,289,259,1,1,1,0,0,1
2192231,25,10,1988,2,male,304,298,277,1,1,1,0,0,1
1489634,26,15,1987,8,male,1120,299,244,1,1,1,1,0,0
1749265,29,3,1984,2,male,1538,295,218,1,1,1,1,0,0
1132520,18,7,1995,11,female,445,303,102,1,5,1,5,0,0
1067887,17,9,1996,4,male,224,294,235,1,3,1,3,0,0
1658231,18,8,1995,8,male,684,295,79,1,27,1,26,0,1
1521623,20,12,1993,8,female,453,297,165,1,10,1,10,0,0
1325494,20,13,1993,9,male,393,294,207,1,65,1,61,0,4
1439379,21,24,1992,1,male,651,300,226,1,13,1,6,0,7
1918795,21,5,1992,1,male,473,300,221,1,3,1,2,0,1
1740532,23,13,1990,12,male,835,296,158,1,4,1,4,0,0
1878693,22,18,1991,4,male,486,289,174,1,71,1,63,0,8
1365354,22,1,1991,9,male,1394,291,126,1,10,1,6,0,4
1324877,22,8,1991,10,male,562,303,187,1,5,1,4,0,1
2069360,23,16,1990,8,male,1088,302,228,1,18,1,14,0,4
1467031,23,16,1990,10,male,248,298,226,1,3,1,0,0,3
1635931,25,11,1988,5,male,139,290,277,1,11,1,8,0,3
1040384,26,5,1987,10,male,1038,295,247,1,3,1,3,0,0
1941868,36,21,1977,7,male,351,290,237,1,8,1,0,0,8
1360720,37,15,1976,5,female,623,298,184,1,15,1,10,0,5
1664650,43,31,1970,7,male,616,291,211,1,40,1,32,0,8
1803949,71,1,1942,3,male,196,301,236,1,3,1,0,0,3
1434107,100,17,1913,8,male,2077,303,122,1,4,1,4,0,0
1349183,103,14,1910,9,male,808,290,128,1,32,1,23,0,9
1639292,103,28,1910,9,female,709,291,156,1,25,1,25,0,0
1907669,16,7,1997,6,male,297,290,93,2,1,0,0,2,1
1819147,16,7,1997,9,female,469,291,193,2,1,0,0,2,1
1502608,28,18,1985,7,male,852,290,22,2,1,0,1,2,0
1418889,14,13,1999,7,male,65,301,254,2,3,0,0,2,3
1913113,15,12,1998,3,male,762,291,127,2,4,0,2,2,2
1312690,17,10,1996,1,male,153,291,238,2,7,0,2,2,5
2148733,18,1,1995,6,male,338,292,180,2,7,0,5,2,2
1717561,26,12,1987,1,male,1300,303,104,2,453,1,249,1,204
1693084,16,26,1997,3,male,620,293,252,2,0,2,0,0,0
1060077,19,14,1994,1,male,502,293,93,2,0,2,0,0,0
1859179,19,11,1994,2,male,288,298,196,2,0,2,0,0,0
1556267,23,14,1990,2,male,263,290,208,2,0,2,0,0,0
2027054,34,4,1979,1,female,437,294,195,2,1,2,1,0,0
1525288,18,26,1995,5,female,353,299,24,2,2,2,1,0,1
1171066,18,14,1995,5,male,241,297,281,2,2,2,1,0,1
2001347,57,2,1956,6,male,270,292,133,2,2,2,2,0,0
1983045,98,18,1915,3,male,2178,300,229,2,2,2,1,0,1
1244619,19,17,1994,12,female,247,295,83,2,6,2,5,0,1
1679437,19,20,1994,2,female,196,292,30,2,50,2,42,0,8
1721081,20,30,1993,8,male,730,293,168,2,29,2,13,0,16
1879314,21,15,1992,3,male,507,293,100,2,5,2,5,0,0
1792228,21,26,1992,5,female,281,289,140,2,25,2,21,0,4
1193980,22,1,1991,1,female,386,296,89,2,39,2,31,0,8
1773356,26,26,1987,11,male,462,294,251,2,11,2,2,0,9
2155984,26,15,1987,1,male,458,299,192,2,5,2,5,0,0
2190547,26,1,1987,1,male,345,289,219,2,3,2,3,0,0
1435646,27,30,1986,1,female,311,295,41,2,3,2,3,0,0
1268052,27,17,1986,6,male,141,289,216,2,27,2,21,0,6
1524112,28,19,1985,10,male,420,303,170,2,3,2,2,0,1
2095396,18,11,1995,1,male,97,289,243,3,1,0,0,3,1
1505959,17,25,1996,11,male,511,290,225,3,4,0,2,3,2
1216805,18,6,1995,1,male,236,303,263,3,6,0,3,3,3
2118895,29,29,1984,12,male,664,292,155,3,97,0,62,3,35
1988557,57,23,1956,11,female,824,290,205,3,8,0,7,3,1
1870554,24,5,1989,4,female,264,292,75,3,11,1,3,2,8
1091063,108,31,1905,7,male,1222,299,207,3,21,1,18,2,3
2002048,18,13,1995,4,male,568,296,119,3,0,3,0,0,0
1262112,18,1,1995,11,male,381,289,227,3,0,3,0,0,0
1733006,31,9,1982,11,male,597,295,130,3,0,3,0,0,0
1860028,113,5,1900,2,female,1529,302,84,3,0,3,0,0,0
1096164,18,15,1995,9,male,453,291,270,3,1,3,0,0,1
2058921,26,21,1987,3,male,1144,294,81,3,1,3,0,0,1
1991142,20,19,1993,2,male,276,292,136,3,4,3,3,0,1
1477484,22,30,1991,12,male,566,290,252,3,2,3,1,0,1
1611120,24,7,1989,10,male,951,293,175,3,3,3,2,0,1
1373439,68,17,1945,8,male,949,298,241,3,2,3,1,0,1
1801690,13,24,2000,4,female,185,294,228,3,87,3,56,0,31
1282486,14,16,1999,4,female,193,290,109,3,14,3,13,0,1
1113273,19,27,1994,3,male,195,298,69,3,43,3,31,0,12
1771262,19,4,1994,8,male,434,290,245,3,77,3,77,0,0
1006533,19,19,1994,10,male,595,294,181,3,20,3,13,0,7
1195428,26,13,1987,5,male,338,290,268,3,12,3,11,0,1
2095198,29,6,1984,10,male,594,295,164,3,5,3,2,0,3
1959926,39,1,1974,4,male,390,292,206,3,33,3,28,0,5
1556368,49,14,1964,9,female,1433,291,182,3,13,3,7,0,6
1087819,108,3,1905,3,male,1822,296,133,3,6,3,3,0,3
1935277,18,27,1995,12,male,274,295,245,4,0,0,0,4,0
1375408,19,13,1994,11,female,295,297,255,4,0,0,0,4,0
1242197,19,24,1994,2,male,548,292,171,4,0,0,0,4,0
1776694,23,1,1990,1,male,960,289,191,4,0,0,0,4,0
1979601,19,18,1994,8,male,492,300,163,4,6,0,0,4,6
1485986,23,1,1990,10,male,413,302,196,4,1,1,0,3,1
2123558,23,29,1990,3,male,428,295,197,4,26,2,6,2,20
1961852,44,1,1969,1,male,452,296,88,4,17,2,3,2,14
1787287,49,31,1964,10,male,1220,289,128,4,5,3,4,1,1
1882850,19,27,1994,12,male,614,298,188,4,9,3,7,1,2
1659676,16,9,1997,6,male,171,292,51,4,0,4,0,0,0
1472855,18,4,1995,10,female,137,292,29,4,0,4,0,0,0
1202280,19,10,1994,1,male,560,290,235,4,1,4,1,0,0
1192440,19,24,1994,7,female,539,300,129,4,1,4,1,0,0
1426478,103,27,1910,9,male,725,295,273,4,1,4,1,0,0
1596996,16,14,1997,8,male,755,300,216,4,4,4,4,0,0
1976194,73,7,1940,11,female,2197,299,193,4,4,4,4,0,0
1518555,103,4,1910,12,female,781,291,55,4,5,4,5,0,0
2029526,18,5,1995,4,female,179,300,41,4,16,4,14,0,2
2034152,24,15,1989,5,female,639,296,66,4,12,4,10,0,2
1348002,108,14,1905,2,male,582,296,99,4,12,4,7,0,5
2012117,108,6,1905,8,female,591,289,145,4,10,4,9,0,1
2041210,17,18,1996,12,male,291,295,221,5,0,0,0,5,0
1614586,103,20,1910,6,female,1820,289,44,5,5,0,1,5,4
2063306,16,9,1997,4,male,336,295,176,5,24,3,4,2,20
2014326,16,9,1997,5,male,588,296,160,5,0,5,0,0,0
1971227,24,4,1989,4,male,277,298,189,5,0,5,0,0,0
1056059,19,18,1994,12,male,71,302,78,5,3,5,3,0,0
1290059,21,12,1992,3,female,385,294,146,5,1,5,0,0,1
2022933,39,18,1974,10,male,602,291,249,5,2,5,1,0,1
1679654,27,1,1986,1,male,816,302,185,5,4,5,4,0,0
1418550,36,15,1977,11,male,275,294,151,5,4,5,3,0,1
2167404,17,1,1996,2,male,222,297,224,5,31,5,23,0,8
1294517,19,22,1994,7,male,889,291,223,5,20,5,15,0,5
1393686,20,6,1993,2,male,861,293,99,5,41,5,22,0,19
1555308,22,22,1991,11,male,557,303,230,5,11,5,5,0,6
1170019,27,1,1986,1,female,752,296,37,5,27,5,18,0,9
1242624,28,14,1985,1,male,577,289,137,5,18,5,16,0,2
1257520,47,7,1966,7,female,936,292,159,5,38,5,29,0,9
1603632,108,22,1905,7,female,1015,300,186,5,47,5,22,0,25
1101938,14,15,1999,12,male,220,289,258,6,0,0,0,6,0
1390245,20,30,1993,8,male,581,293,213,6,0,0,0,6,0
1722576,20,25,1993,7,male,400,301,232,6,8,0,1,6,7
1347699,34,9,1979,1,male,872,294,117,6,4,0,4,6,0
1779976,21,2,1992,4,female,635,289,131,6,102,5,76,1,26
1043288,25,1,1988,1,male,272,294,244,6,4,6,1,0,3
1041285,61,2,1952,1,female,1171,298,14,6,4,6,4,0,0
1005917,108,9,1905,4,male,1421,298,72,6,8,6,5,0,3
1522478,15,2,1998,6,female,152,303,46,6,14,6,13,0,1
1243802,17,31,1996,7,male,632,296,138,6,158,6,121,0,37
1773450,18,5,1995,6,female,110,300,246,6,157,6,117,0,40
2053179,20,11,1993,11,male,1117,296,186,6,63,6,56,0,7
2192996,19,1,1994,10,male,966,290,135,6,252,6,218,0,34
1860515,24,6,1989,3,female,81,292,37,6,12,6,10,0,2
1797872,25,14,1988,3,male,260,289,117,6,114,6,58,0,56
1275532,55,2,1958,7,male,1647,297,116,6,12,6,11,0,1
1289491,24,18,1989,5,male,436,301,271,7,0,0,0,7,0
1504980,68,13,1945,2,female,538,298,214,7,8,1,3,6,5
1198178,108,8,1905,9,female,1740,292,234,7,5,0,3,7,2
1075119,52,26,1961,3,male,1405,293,189,7,69,0,18,7,51
1452385,24,16,1989,8,female,631,295,149,7,17,2,7,5,10
1288754,17,6,1996,8,female,217,290,30,7,14,6,10,1,4
1076438,24,3,1989,10,male,364,293,258,7,8,7,7,0,1
1901275,25,8,1988,9,female,423,291,31,7,5,7,5,0,0
1789213,108,6,1905,3,female,687,294,99,7,8,7,7,0,1
1959506,19,1,1994,1,male,686,299,232,7,20,7,19,0,1
1917992,24,30,1989,5,female,1390,302,115,7,77,7,67,0,10
1704086,27,10,1986,10,female,253,302,288,7,12,7,8,0,4
1190772,29,28,1984,5,male,1360,291,211,7,28,7,21,0,7
1902018,14,18,1999,3,male,19,295,256,8,8,3,4,5,4
1010656,25,15,1988,8,male,298,296,205,8,10,5,5,3,5
2055883,17,9,1996,10,male,635,300,190,8,0,8,0,0,0
1462691,22,4,1991,3,female,837,291,58,8,0,8,0,0,0
1861996,18,9,1995,2,female,547,290,75,8,7,8,6,0,1
1591461,14,21,1999,4,female,536,291,102,8,30,8,6,0,24
1233599,22,19,1991,12,female,776,302,212,8,22,8,7,0,15
1810850,21,16,1992,5,male,1493,294,117,8,47,8,27,0,20
1363543,24,17,1989,12,male,153,296,187,8,38,8,3,0,35
1899121,27,22,1986,5,male,479,301,143,8,47,8,24,0,23
1165444,13,16,2000,7,male,48,300,283,9,0,0,0,9,0
1314241,54,12,1959,4,male,536,295,237,9,11,0,5,9,6
1833953,103,1,1910,1,male,782,295,105,9,19,0,2,9,17
1716632,75,29,1938,10,female,2303,302,39,9,9,2,8,7,1
2158123,19,28,1994,3,female,337,301,177,9,1,8,0,1,1
1040369,29,4,1984,2,male,560,301,207,9,2,9,1,0,1
1063218,68,16,1945,6,female,803,290,110,9,5,9,3,0,2
1223739,21,23,1992,3,male,299,293,169,9,55,9,38,0,17
1410943,34,9,1979,8,male,1274,289,144,9,85,9,54,0,31
1737116,16,30,1997,4,female,327,302,181,10,41,0,30,10,11
1131656,18,5,1995,4,female,620,293,163,10,17,5,9,5,8
1671218,21,7,1992,7,female,327,297,243,10,59,2,32,8,27
1547987,22,17,1991,10,male,583,289,243,10,57,5,46,5,11
2095365,16,11,1997,11,female,491,300,106,10,15,9,11,1,4
1340407,18,4,1995,6,male,229,302,211,10,29,9,12,1,17
1052968,17,16,1996,11,male,1147,300,107,10,1,10,1,0,0
2015615,17,5,1996,1,male,423,300,219,10,2,10,1,0,1
1245910,95,4,1918,11,male,1221,303,118,10,3,10,2,0,1
1207663,108,21,1905,10,male,553,294,125,10,4,10,0,0,4
1476954,20,21,1993,3,female,97,291,125,10,89,10,88,0,1
1220556,23,25,1990,8,female,415,294,146,10,23,10,18,0,5
1156677,24,16,1989,9,female,198,295,63,10,19,10,18,0,1
1873708,32,13,1981,4,male,518,303,214,10,54,10,49,0,5
2047241,68,11,1945,5,male,696,294,237,10,84,10,64,0,20
1402414,23,24,1990,1,male,736,302,84,11,0,11,0,0,0
1460365,13,2,2000,3,female,133,296,153,11,5,11,3,0,2
2187134,22,18,1991,6,male,394,300,205,11,2,11,1,0,1
1368102,25,19,1988,8,male,334,295,159,11,5,11,2,0,3
1257987,26,7,1987,8,male,767,292,104,11,8,11,8,0,0
1459764,16,28,1997,1,male,121,291,236,11,49,11,49,0,0
2058402,19,18,1994,8,female,546,294,114,11,28,11,17,0,11
2119739,19,23,1994,10,male,590,301,249,11,82,11,56,0,26
1856283,29,19,1984,12,female,100,303,201,11,34,11,30,0,4
1274973,32,1,1981,1,male,729,296,203,11,25,11,22,0,3
1198528,84,8,1929,3,male,2595,292,196,11,24,11,4,0,20
1137639,103,5,1910,12,female,1218,299,56,11,117,11,101,0,16
1274155,21,27,1992,11,male,473,290,193,12,0,1,0,11,0
1079626,22,24,1991,4,female,1660,289,130,12,9,5,7,7,2
2116759,18,15,1995,8,female,444,290,239,12,42,8,35,4,7
1859645,25,27,1988,8,male,842,290,219,12,6,10,6,2,0
1751535,94,11,1919,1,male,1281,303,146,12,0,12,0,0,0
2118652,15,28,1998,7,female,512,290,188,12,9,12,6,0,3
1699251,26,23,1987,9,female,166,291,61,12,22,12,21,0,1
2053666,20,1,1993,4,female,181,293,46,13,8,13,6,0,2
1480833,15,8,1998,2,female,449,298,93,13,84,13,40,0,44
1307522,27,19,1986,3,male,1267,291,214,14,11,0,4,14,7
1455022,16,17,1997,7,female,546,294,137,14,1,14,0,0,1
1364423,18,4,1995,4,male,348,300,274,14,0,14,0,0,0
1218744,22,19,1991,6,female,341,299,171,14,2,14,2,0,0
1957963,24,28,1989,1,male,346,303,178,14,7,14,5,0,2
1631449,98,15,1915,9,male,1200,296,109,14,8,14,3,0,5
1697243,13,1,2000,1,female,229,295,110,14,18,14,18,0,0
1894071,17,30,1996,11,female,218,292,80,14,17,14,15,0,2
2028904,15,2,1998,6,female,306,296,153,14,52,14,38,0,14
1611641,19,11,1994,5,male,840,298,170,14,37,14,28,0,9
1994319,108,31,1905,12,male,1203,303,97,14,54,14,50,0,4
1625625,18,7,1995,4,male,297,294,235,15,0,0,0,15,0
2079396,16,28,1997,12,male,640,292,124,15,16,0,5,15,11
1409553,26,3,1987,6,male,991,299,184,15,3,3,2,12,1
1235442,18,24,1995,8,female,248,290,144,15,1,14,1,1,0
1818301,14,18,1999,12,female,219,291,217,15,1,15,1,0,0
1765077,17,6,1996,1,male,150,295,256,15,23,15,23,0,0
1811495,18,22,1995,5,male,1470,302,142,16,2,1,1,15,1
1431473,19,27,1994,2,male,611,295,277,16,10,8,8,8,2
1555553,108,28,1905,3,male,2126,300,96,16,36,7,13,9,23
1932725,13,8,2000,2,male,250,296,186,16,79,16,49,0,30
1452405,46,29,1967,8,male,361,300,242,16,29,16,11,0,18
1290171,103,8,1910,12,male,948,292,185,17,6,2,3,15,3
1390079,55,26,1958,8,male,1976,293,90,17,14,0,0,17,14
1733924,13,11,2000,7,male,365,301,259,17,0,8,0,9,0
1662313,19,14,1994,12,male,372,291,94,17,7,9,0,8,7
1201215,20,16,1993,4,male,563,297,187,17,23,12,17,5,6
1789179,18,14,1995,8,male,631,289,159,17,2,17,1,0,1
1253151,19,9,1994,10,female,365,298,206,17,16,17,15,0,1
1698786,53,23,1960,3,female,403,302,262,17,23,17,11,0,12
1906719,19,28,1994,10,female,547,295,71,17,26,17,23,0,3
1637826,14,22,1999,4,male,608,296,232,18,4,0,1,18,3
2010660,23,18,1990,4,female,814,295,158,18,138,3,91,15,47
1471858,18,13,1995,8,male,275,299,270,18,15,13,11,5,4
1503960,20,9,1993,5,male,243,293,172,18,259,8,50,10,209
1198348,20,22,1993,11,female,138,292,257,18,2,18,0,0,2
1152022,15,16,1998,4,female,349,294,148,18,14,18,12,0,2
1884024,21,21,1992,5,male,488,290,139,18,13,18,11,0,2
1417347,19,28,1994,10,female,466,298,202,18,75,18,74,0,1
2091255,24,3,1989,12,male,192,297,216,19,2,0,2,19,0
1148807,16,24,1997,6,male,1436,302,46,19,18,3,9,16,9
1053960,20,26,1993,10,male,613,303,262,19,1,11,1,8,0
1087598,55,30,1958,11,male,1152,289,233,19,6,8,3,11,3
1429139,18,7,1995,5,male,440,293,268,19,3,18,0,1,3
1210370,18,19,1995,2,male,728,295,194,19,5,15,2,4,3
1921582,19,13,1994,3,female,199,302,83,19,38,17,13,2,25
1055539,14,25,1999,9,female,77,300,53,19,8,19,8,0,0
2046899,24,21,1989,6,female,141,295,96,19,28,19,18,0,10
1147997,29,2,1984,10,male,748,295,184,19,12,19,12,0,0
2179896,16,5,1997,1,female,490,300,188,19,58,19,52,0,6
1456089,22,17,1991,1,female,595,291,47,19,78,19,64,0,14
1795101,28,15,1985,2,male,528,290,203,19,146,19,125,0,21
1363642,16,23,1997,12,male,516,300,103,20,0,2,0,18,0
1658544,23,29,1990,6,male,1304,291,186,20,8,2,5,18,3
1343996,92,9,1921,3,male,2196,300,192,20,42,0,4,20,38
1575984,23,15,1990,12,male,332,299,197,20,28,16,19,4,9
1203082,20,13,1993,7,female,317,290,248,20,12,20,1,0,11
1220035,26,12,1987,3,male,374,299,228,20,28,20,17,0,11
1975704,17,5,1996,4,female,147,289,85,20,32,20,31,0,1
1719944,18,17,1995,3,male,242,291,239,20,179,20,31,0,148
2181171,21,13,1992,1,male,256,296,151,21,72,14,52,7,20
2120332,33,16,1980,9,male,122,291,261,21,15,19,10,2,5
1167251,21,24,1992,1,female,739,293,173,21,62,16,12,5,50
1081539,33,1,1980,1,male,619,294,118,21,14,21,14,0,0
1181599,21,28,1992,7,male,688,299,222,22,13,15,9,7,4
1431078,20,14,1993,11,male,487,294,177,22,32,22,31,0,1
1165526,28,6,1985,10,male,426,297,268,22,193,22,33,0,160
2004831,34,12,1979,3,female,422,296,226,23,5,0,0,23,5
2014684,27,5,1986,4,female,354,298,262,23,19,19,12,4,7
1090485,14,12,1999,8,female,36,289,160,23,54,19,35,4,19
1576579,14,10,1999,10,male,350,300,98,23,9,23,6,0,3
1984406,15,19,1998,1,female,1168,300,160,23,37,23,10,0,27
1523041,18,8,1995,8,female,312,303,94,23,58,23,5,0,53
1460779,51,13,1962,11,male,375,289,217,24,18,0,8,24,10
1512853,25,19,1988,12,male,664,302,88,24,494,9,424,15,70
2112887,23,8,1990,11,male,421,296,270,24,11,24,10,0,1
1633208,30,4,1983,7,female,880,295,171,24,67,24,62,0,5
1001853,32,30,1981,11,male,205,295,267,25,2,0,2,25,0
1511904,59,2,1954,2,female,1507,289,211,25,57,0,29,25,28
1807382,52,21,1961,10,male,104,291,268,25,3,18,2,7,1
1906641,31,28,1982,10,male,453,294,283,25,8,13,3,12,5
1269911,19,10,1994,10,male,352,290,215,25,14,25,11,0,3
1824679,35,25,1978,2,male,698,289,153,25,14,25,12,0,2
1908091,41,28,1972,3,male,1895,292,64,25,33,25,24,0,9
1409469,18,28,1995,11,female,87,295,82,25,107,25,91,0,16
1581834,19,18,1994,7,female,424,299,89,25,59,25,55,0,4
2123995,25,16,1988,6,male,685,293,132,26,12,8,5,18,7
1430175,28,20,1985,5,female,738,303,187,26,1,26,0,0,1
1781958,18,15,1995,6,male,437,303,252,26,28,26,13,0,15
1726373,24,19,1989,10,male,787,292,215,27,2,11,1,16,1
1843833,20,27,1993,5,female,224,302,123,27,24,24,10,3,14
1747722,17,3,1996,10,male,112,302,251,27,19,27,8,0,11
2004568,18,27,1995,7,male,444,294,208,27,78,27,77,0,1
1947278,14,9,1999,5,female,291,302,111,28,44,0,21,28,23
1484351,22,1,1991,9,female,597,297,170,28,74,4,33,24,41
2045090,51,22,1962,8,female,1961,293,101,28,17,27,11,1,6
1362193,23,17,1990,11,female,445,296,220,28,90,28,31,0,59
1926706,23,10,1990,12,female,743,303,93,28,171,28,160,0,11
1082351,33,13,1980,5,female,406,295,239,28,44,28,16,0,28
1932157,108,5,1905,6,male,145,289,257,29,28,0,6,29,22
1903617,27,15,1986,11,female,295,292,175,29,26,21,20,8,6
1736468,108,10,1905,11,male,698,299,246,29,24,21,3,8,21
1645521,27,8,1986,4,female,59,290,31,29,6,29,4,0,2
1705640,26,5,1987,2,male,129,301,256,29,38,29,31,0,7
1447125,68,10,1945,3,male,309,299,202,30,7,0,2,30,5
1579131,19,12,1994,8,male,412,292,148,31,61,17,55,14,6
1491123,15,22,1998,5,female,180,294,199,30,29,29,21,1,8
2185213,56,18,1957,3,male,1009,295,171,31,20,30,15,1,5
1568823,18,17,1995,9,male,277,292,267,30,149,29,98,1,51
2093706,19,26,1994,11,male,421,289,178,30,21,30,9,0,12
2099681,28,5,1985,12,female,307,303,227,31,25,31,11,0,14
1838008,50,24,1963,2,female,1063,303,124,30,38,30,16,0,22
1747291,100,27,1913,2,male,1399,295,216,30,44,30,42,0,2
2106455,31,3,1982,4,male,534,289,173,31,76,31,63,0,13
1454040,27,24,1986,4,female,1241,292,148,32,2,2,0,30,2
1197099,55,6,1958,9,female,435,293,129,32,86,0,23,32,63
1865879,13,9,2000,2,female,200,294,262,32,22,8,3,24,19
2076976,19,20,1994,3,male,331,291,121,32,14,31,12,1,2
2038150,33,22,1980,5,male,701,289,145,32,5,32,2,0,3
1800027,14,19,1999,5,male,378,295,252,32,8,32,7,0,1
1644041,21,25,1992,6,female,234,297,46,32,42,32,37,0,5
1893342,21,27,1992,8,male,640,301,226,33,5,1,3,32,2
1781840,25,5,1988,12,male,609,296,202,33,87,32,28,1,59
1452587,30,11,1983,4,male,1487,299,102,33,1,33,1,0,0
1384385,17,22,1996,9,female,391,297,173,33,13,33,11,0,2
1151900,27,30,1986,12,male,285,301,257,33,24,33,24,0,0
1307276,23,13,1990,1,male,445,292,172,34,55,1,6,33,49
1042439,14,31,1999,7,female,761,289,194,34,7,15,0,19,7
1696392,18,7,1995,8,female,249,298,95,34,11,33,10,1,1
1355997,84,19,1929,6,male,144,296,221,34,16,31,3,3,13
1093081,14,14,1999,4,female,465,296,171,34,57,31,51,3,6
1809869,15,6,1998,2,female,300,290,116,34,108,31,74,3,34
2097712,18,12,1995,9,male,282,299,96,34,71,29,64,5,7
2087611,27,11,1986,10,male,395,294,256,34,18,34,16,0,2
1614322,108,21,1905,3,male,1520,299,24,36,65,0,24,36,41
1171224,18,13,1995,1,female,264,301,151,36,18,17,10,19,8
2062259,66,10,1947,4,female,986,292,57,36,45,28,24,8,21
1632703,23,5,1990,6,male,212,296,188,35,87,26,36,9,51
1979331,43,25,1970,11,male,97,289,284,36,1,36,1,0,0
1084348,21,19,1992,10,male,420,294,245,35,23,35,20,0,3
1128801,103,1,1910,12,male,1086,289,238,36,43,36,16,0,27
1144804,32,28,1981,5,male,381,292,270,35,53,35,37,0,16
1479013,102,11,1911,5,female,849,296,217,35,66,35,34,0,32
1950544,83,30,1930,9,male,1357,302,157,37,114,0,14,37,100
1329729,19,11,1994,5,female,267,299,213,37,3,20,2,17,1
1850855,108,5,1905,8,male,756,292,98,37,54,16,30,21,24
1443897,27,3,1986,9,male,345,289,219,37,27,34,4,3,23
2122693,16,9,1997,1,male,759,296,206,38,1,5,0,33,1
1541328,18,3,1995,1,male,459,296,96,39,60,2,31,37,29
1015432,20,10,1993,4,male,11,290,267,38,156,37,90,1,66
1747676,59,25,1954,3,male,250,301,291,38,61,37,51,1,10
1925561,19,3,1994,7,female,357,292,193,38,1,38,1,0,0
1801154,23,26,1990,6,female,251,291,66,38,2,38,2,0,0
1851191,23,10,1990,7,male,435,298,233,39,12,39,5,0,7
1074314,52,29,1961,4,female,354,300,158,39,19,39,5,0,14
1335338,56,24,1957,1,female,1258,301,153,39,15,39,5,0,10
1454032,26,10,1987,5,female,229,299,154,39,43,39,37,0,6
1881738,17,16,1996,10,female,213,302,38,38,66,38,9,0,57
2151638,16,14,1997,7,male,235,293,178,40,27,1,16,39,11
1865329,14,20,1999,9,male,477,294,115,40,38,37,23,3,15
1709128,20,13,1993,7,male,756,298,112,40,166,40,136,0,30
1169195,52,1,1961,1,male,40,291,269,42,1,0,1,42,0
1327108,94,25,1919,12,male,1743,295,186,41,5,19,1,22,4
1034331,18,3,1995,5,female,437,295,0,41,66,23,37,18,29
1822670,14,2,1999,2,female,1082,300,154,42,17,40,13,2,4
1376864,28,20,1985,1,male,1396,296,168,42,26,41,7,1,19
1187755,17,29,1996,4,male,321,303,91,42,9,42,9,0,0
2187892,17,17,1996,2,female,615,299,152,41,37,41,33,0,4
1519625,21,5,1992,10,male,108,302,252,42,42,42,41,0,1
1466493,36,11,1977,2,male,451,299,192,41,26,41,25,0,1
2134801,54,6,1959,10,female,230,291,225,43,26,0,2,43,24
2191160,15,19,1998,8,female,151,291,106,44,16,30,5,14,11
2150812,56,28,1957,9,female,1011,290,184,43,82,42,20,1,62
1808767,30,22,1983,9,male,704,296,133,44,2,44,1,0,1
1948605,23,26,1990,1,male,729,303,206,44,9,44,6,0,3
2163558,42,5,1971,12,male,143,290,252,43,17,43,16,0,1
1914862,18,12,1995,7,female,628,294,26,44,45,44,23,0,22
1216160,103,4,1910,8,male,1109,303,71,43,27,43,24,0,3
1511280,54,2,1959,5,female,1405,291,99,44,331,44,216,0,115
1446462,108,4,1905,6,female,562,290,152,44,66,44,60,0,6
2118926,52,13,1961,3,male,1545,289,109,45,66,1,22,44,44
1802819,34,16,1979,5,male,1138,300,129,45,197,14,55,31,142
1050703,25,5,1988,9,female,371,298,274,45,302,38,202,7,100
1718844,19,15,1994,3,male,671,294,221,45,15,45,14,0,1
1913406,103,27,1910,1,female,1782,289,202,45,25,45,15,0,10
1882573,21,10,1992,12,female,363,300,124,47,1,3,0,44,1
1158920,19,10,1994,2,female,413,291,219,47,68,18,51,29,17
1567955,19,24,1994,12,female,232,297,153,47,152,32,134,15,18
1805184,17,31,1996,3,male,555,294,165,46,3,44,0,2,3
1455850,33,15,1980,1,male,402,302,167,47,11,45,8,2,3
1849583,20,20,1993,8,female,641,293,204,47,231,40,159,7,72
1748760,15,8,1998,11,female,359,290,136,46,44,46,29,0,15
1972601,37,22,1976,11,female,637,298,213,46,33,46,17,0,16
2161770,58,15,1955,12,female,278,303,259,47,37,47,27,0,10
1923459,33,25,1980,3,female,221,291,169,46,72,46,30,0,42
1192336,14,15,1999,4,female,440,295,40,49,8,4,0,45,8
2048610,15,11,1998,2,male,386,296,261,49,87,35,78,14,9
1787154,20,5,1993,1,male,397,294,176,49,73,37,30,12,43
1016805,43,25,1970,2,female,695,303,233,48,64,38,36,10,28
1146020,28,1,1985,11,female,425,298,148,49,143,39,117,10,26
1890704,63,15,1950,9,male,1962,291,200,48,3,48,2,0,1
1402978,14,14,1999,2,male,143,295,272,49,14,49,8,0,6
1583897,42,20,1971,4,male,586,294,36,48,29,48,29,0,0
1560758,13,29,2000,4,female,210,302,270,50,4,47,3,3,1
1459200,14,2,1999,6,female,472,302,151,50,409,49,163,1,246
1412746,20,4,1993,9,female,135,294,136,51,242,50,171,1,71
1855588,28,20,1985,1,male,160,297,165,50,8,50,6,0,2
1269296,39,1,1974,5,male,440,292,261,51,38,51,28,0,10
1317295,108,29,1905,1,female,1858,289,84,50,31,50,15,0,16
1093226,21,16,1992,2,male,544,302,241,52,49,7,20,45,29
1654162,54,27,1959,7,male,474,289,188,53,21,53,21,0,0
1685314,68,18,1945,9,male,925,291,184,52,28,52,23,0,5
1320615,16,16,1997,1,female,415,300,100,55,14,0,8,55,6
1280588,19,3,1994,3,male,420,290,222,54,7,54,1,0,6
1862682,20,23,1993,8,male,370,302,281,55,5,55,5,0,0
1914715,22,16,1991,11,male,508,301,245,54,4,54,4,0,0
1155325,23,27,1990,5,male,589,301,139,58,24,0,10,58,14
1454744,16,23,1997,4,female,71,301,149,57,63,56,29,1,34
1960689,20,14,1993,4,female,422,292,195,56,239,46,124,10,115
2104287,100,13,1913,6,male,81,297,77,57,11,57,8,0,3
2000205,20,27,1993,9,male,337,293,203,56,56,56,14,0,42
1146030,24,20,1989,11,male,564,301,221,56,54,56,44,0,10
1038694,18,12,1995,10,male,281,300,72,59,86,41,72,18,14
1868249,18,3,1995,12,female,295,296,81,60,56,44,19,16,37
1163081,103,23,1910,5,male,676,296,191,59,46,55,17,4,29
1134114,102,23,1911,4,female,798,298,165,59,29,59,23,0,6
1856478,33,23,1980,5,female,745,295,155,59,67,59,51,0,16
1055811,21,5,1992,10,female,245,303,153,59,97,59,63,0,34
1873768,25,8,1988,1,female,742,292,165,60,94,60,36,0,58
1213601,15,20,1998,10,male,877,290,167,63,1,0,0,63,1
1162613,18,20,1995,6,male,370,289,83,61,14,0,4,61,10
1225219,107,20,1906,10,female,1286,295,63,63,55,0,19,63,36
1756486,19,24,1994,12,male,1112,294,196,62,49,20,38,42,11
1421390,22,20,1991,7,male,1615,296,140,63,26,54,3,9,23
1581583,31,19,1982,11,male,351,293,256,63,81,63,63,0,18
1845587,18,10,1995,5,male,659,303,209,63,146,63,130,0,16
1107851,44,25,1969,9,female,420,297,259,65,336,42,262,23,74
1052198,19,14,1994,8,male,422,297,254,65,32,53,5,12,27
1456199,23,11,1990,12,female,495,299,192,64,25,61,19,3,6
1419338,15,3,1998,8,female,212,297,185,64,247,58,163,6,84
2083778,18,27,1995,6,male,288,290,265,65,4,65,2,0,2
1552380,34,17,1979,10,male,229,290,224,65,30,65,28,0,2
1273342,23,11,1990,9,male,407,294,198,64,44,64,25,0,19
1929176,86,9,1927,11,male,1480,296,103,65,96,65,75,0,21
1716533,55,19,1958,8,male,1293,295,169,64,186,64,140,0,46
1387346,60,14,1953,2,female,884,302,206,67,320,0,130,67,190
1751691,93,1,1920,1,male,1686,301,216,67,4,48,1,19,3
1729940,20,8,1993,3,male,684,292,198,66,125,65,83,1,42
1331338,60,17,1953,12,female,2148,291,142,66,196,59,163,7,33
1374161,14,18,1999,4,male,279,298,145,66,39,66,22,0,17
2096914,23,25,1990,7,male,585,290,162,66,11,66,8,0,3
1634106,20,14,1993,4,female,625,291,153,67,53,67,47,0,6
1910415,26,6,1987,7,male,409,302,126,68,71,68,71,0,0
1314134,23,8,1990,2,male,604,300,217,69,63,27,41,42,22
1210197,25,9,1988,4,male,418,289,226,70,32,70,28,0,4
2147080,20,22,1993,12,female,206,293,119,70,85,70,72,0,13
1528795,25,1,1988,1,male,130,290,153,70,52,70,43,0,9
1654949,20,19,1993,9,female,407,292,234,69,295,69,224,0,71
1645170,104,9,1909,5,female,1634,295,228,72,108,0,15,72,93
1676109,19,26,1994,6,male,1089,299,67,73,39,50,31,23,8
2113845,19,17,1994,10,male,193,297,254,73,25,48,7,25,18
1200837,72,17,1941,7,female,573,299,143,72,51,35,35,37,16
1542594,18,5,1995,9,male,215,302,251,74,311,25,237,49,74
1196621,33,11,1980,9,male,1557,302,175,73,121,40,109,33,12
1591602,19,10,1994,3,male,1131,300,241,73,79,65,72,8,7
2060790,68,1,1945,1,male,371,294,268,74,10,74,10,0,0
1496159,18,14,1995,8,female,151,299,273,74,62,74,49,0,13
1544316,29,31,1984,7,male,487,301,215,72,87,72,73,0,14
2078805,31,31,1982,3,male,184,298,283,72,45,72,19,0,26
1458307,73,25,1940,2,female,2205,302,122,72,77,72,68,0,9
1990119,100,15,1913,12,female,1714,294,178,72,79,72,76,0,3
1131080,15,19,1998,5,female,354,293,186,77,24,73,16,4,8
1249898,39,12,1974,6,female,2259,294,207,76,87,74,70,2,17
2102357,19,7,1994,6,female,467,295,172,77,16,77,15,0,1
1385055,102,29,1911,4,female,1712,291,169,78,31,4,15,74,16
2093215,57,21,1956,4,female,880,289,207,79,15,50,5,29,10
1737657,26,17,1987,5,female,98,300,243,79,209,29,82,50,127
1041679,103,18,1910,1,male,1136,300,136,78,93,77,71,1,22
1853784,48,16,1965,9,female,734,296,105,79,285,79,252,0,33
1423688,31,23,1982,6,male,243,289,179,83,3,2,1,81,2
1200048,52,24,1961,12,female,770,293,241,84,70,14,34,70,36
1805646,52,9,1961,8,male,668,289,261,82,86,6,34,76,52
1216761,20,10,1993,11,female,673,296,165,81,264,15,143,66,121
1105556,25,9,1988,4,female,438,293,222,81,71,30,14,51,57
1842156,15,8,1998,12,female,450,302,118,82,92,66,57,16,35
2030175,19,11,1994,8,male,270,292,267,82,26,82,19,0,7
1856496,32,11,1981,5,female,741,297,152,82,45,82,26,0,19
1162771,83,27,1930,1,female,2194,300,114,85,191,10,96,75,95
1040946,28,16,1985,4,female,866,289,59,85,9,25,6,60,3
2075011,40,8,1973,8,male,432,294,234,85,210,32,72,53,138
1987209,17,19,1996,2,female,595,298,192,85,118,72,66,13,52
1526241,17,10,1996,9,male,848,296,198,86,128,85,95,1,33
1963694,31,28,1982,11,female,573,299,180,86,77,64,51,22,26
1693091,47,10,1966,1,male,59,296,218,86,43,86,36,0,7
1245761,108,26,1905,11,female,1658,300,98,86,28,86,17,0,11
1060431,108,1,1905,1,male,394,301,272,91,44,0,5,91,39
2133037,21,30,1992,9,female,512,292,195,89,131,44,58,45,73
1775153,53,14,1960,1,female,1858,299,144,91,122,39,74,52,48
1685350,38,10,1975,10,female,714,289,226,88,63,86,35,2,28
1486493,21,3,1992,7,female,641,295,170,90,53,90,49,0,4
1135008,25,17,1988,1,male,599,299,183,89,52,89,46,0,6
1259963,103,4,1910,11,male,975,299,263,89,27,89,25,0,2
1096545,113,15,1900,7,female,1360,296,189,91,275,91,136,0,139
1062157,19,29,1994,4,female,320,299,245,93,26,18,13,75,13
1419097,28,3,1985,5,female,589,294,181,94,256,1,122,93,134
1537610,21,29,1992,4,male,219,291,250,92,80,86,46,6,34
1378816,52,5,1961,5,male,426,295,140,92,123,92,93,0,30
1329754,22,2,1991,10,female,395,303,159,94,166,94,137,0,29
1504755,30,10,1983,8,male,350,302,249,98,37,31,25,67,12
2077890,51,20,1962,8,male,475,300,242,97,100,25,11,72,89
1985613,18,12,1995,1,female,619,301,199,99,54,97,53,2,1
1699053,29,1,1984,2,female,229,291,187,98,96,93,42,5,54
1345317,24,16,1989,6,female,1091,291,140,98,157,97,131,1,26
1741107,108,18,1905,10,male,248,291,238,96,20,96,11,0,9
2001674,49,5,1964,2,male,462,294,158,102,58,5,24,97,34
1952045,18,14,1995,8,female,373,296,205,104,719,60,461,44,258
1180624,47,4,1966,12,male,317,293,236,100,156,57,31,43,125
1787916,15,26,1998,11,male,856,296,138,101,30,101,16,0,14
1043316,21,14,1992,8,female,385,290,138,106,29,6,17,100,12
2068711,14,8,1999,1,male,393,299,199,107,41,35,20,72,21
1315103,17,29,1996,8,male,752,293,159,107,29,103,5,4,24
2138963,19,24,1994,10,male,573,290,233,109,78,99,47,10,31
1060088,24,25,1989,4,female,462,299,230,108,326,105,324,3,2
1420792,83,1,1930,1,male,2333,295,214,109,66,109,47,0,19
1674423,18,10,1995,10,female,706,295,45,105,347,105,65,0,282
1063490,14,6,1999,1,male,472,293,225,110,40,0,16,110,24
1405637,19,2,1994,12,male,369,291,158,113,97,9,17,104,80
1996293,56,12,1957,8,male,361,297,134,113,69,0,32,113,37
1781485,87,3,1926,10,male,164,297,135,111,137,0,18,111,119
2030320,104,9,1909,11,male,1272,297,211,110,68,0,31,110,37
2168092,16,3,1997,10,male,626,297,180,112,0,90,0,22,0
1177943,18,3,1995,11,female,579,301,167,113,101,107,64,6,37
1653643,15,25,1998,3,female,405,299,234,113,24,113,10,0,14
1251319,33,1,1980,1,male,440,294,265,111,95,111,73,0,22
1949090,28,26,1985,12,male,463,301,255,112,189,112,186,0,3
1382522,108,24,1905,6,female,1844,295,159,117,54,6,13,111,41
2015962,36,27,1977,1,female,1338,298,115,115,157,22,118,93,39
1240933,25,6,1988,2,female,610,301,263,114,4,82,1,32,3
2107044,17,2,1996,2,male,372,289,163,114,46,97,24,17,22
2090432,22,14,1991,11,female,472,291,140,119,96,117,33,2,63
2192092,99,14,1914,10,male,1497,299,248,122,51,0,21,122,30
1733855,103,17,1910,12,female,993,299,141,121,58,11,35,110,23
1184097,57,7,1956,7,female,490,289,234,120,132,0,14,120,118
1255839,13,3,2000,5,female,138,303,75,124,26,116,9,8,17
1653198,14,21,1999,6,female,390,293,176,121,136,115,69,6,67
1219951,44,17,1969,3,female,1527,298,138,122,137,93,56,29,81
1137199,15,18,1998,10,female,293,289,140,123,14,123,8,0,6
1972209,25,9,1988,1,female,281,289,162,122,8,122,6,0,2
2139755,19,2,1994,11,female,196,295,50,124,55,124,46,0,9
1395562,27,12,1986,8,female,406,303,158,124,83,124,75,0,8
1029090,22,12,1991,3,male,160,289,235,120,196,120,97,0,99
1090554,25,4,1988,2,male,295,291,206,128,34,87,13,41,21
1483961,18,15,1995,7,male,587,293,191,126,179,109,92,17,87
1509011,21,29,1992,6,female,204,299,262,126,110,94,96,32,14
1559778,26,28,1987,10,female,671,303,226,128,374,93,202,35,172
1899891,19,11,1994,5,male,446,299,203,131,97,26,75,105,22
1525316,24,1,1989,7,female,269,302,83,131,379,20,145,111,234
1829387,22,4,1991,11,female,896,301,246,134,135,88,61,46,74
1699544,22,17,1991,7,male,571,289,136,135,42,117,27,18,15
1538665,16,6,1997,3,male,226,294,143,138,27,0,13,138,14
2020835,17,5,1996,2,male,403,300,260,137,91,131,69,6,22
1490315,31,4,1982,9,female,246,293,280,140,195,135,110,5,85
1839190,18,17,1995,7,male,496,299,252,139,59,139,48,0,11
1437043,19,2,1994,9,male,156,298,278,138,28,138,27,0,1
1853211,17,21,1996,2,male,526,299,185,148,42,26,19,122,23
1502820,13,9,2000,1,female,333,293,204,144,128,8,37,136,91
1805208,23,3,1990,3,male,716,296,160,148,567,0,119,148,448
2090751,22,1,1991,5,female,419,294,242,145,84,64,28,81,56
1917991,19,21,1994,11,male,173,295,262,149,2,137,2,12,0
1783496,17,25,1996,3,female,199,293,237,147,97,124,53,23,44
1701854,21,16,1992,6,female,588,301,167,148,244,144,206,4,38
1435938,19,2,1994,10,female,363,296,49,149,93,148,59,1,34
1941632,45,5,1968,10,female,613,294,227,145,29,145,22,0,7
1159665,19,14,1994,9,male,387,290,131,148,146,148,92,0,54
1871397,56,23,1957,6,female,2131,299,64,149,103,149,71,0,32
1669211,16,30,1997,3,female,267,300,77,156,124,60,90,96,34
2029944,19,16,1994,7,female,702,302,178,156,205,156,194,0,11
1044764,27,1,1986,10,male,261,294,214,157,144,157,71,0,73
1942756,113,14,1900,6,female,1179,301,138,158,900,0,156,158,744
2162479,20,14,1993,6,male,278,297,258,164,58,70,20,94,38
1336278,27,14,1986,12,female,382,297,216,161,390,96,60,65,330
1247277,17,14,1996,6,male,404,299,223,161,25,137,15,24,10
1092535,108,22,1905,6,female,2192,302,124,163,323,124,268,39,55
1572090,18,14,1995,9,female,305,299,265,158,65,158,59,0,6
2044903,94,8,1919,12,male,2000,299,117,166,240,1,169,165,71
1407204,22,16,1991,8,male,686,290,173,166,85,84,37,82,48
1006603,23,5,1990,6,female,81,300,133,172,305,120,123,52,182
1692917,56,31,1957,10,female,1717,301,211,169,68,156,35,13,33
1541507,19,12,1994,2,male,776,297,103,165,78,165,55,0,23
1998699,56,4,1957,7,female,1546,291,136,167,52,167,47,0,5
1031119,18,8,1995,5,male,243,291,223,166,155,166,141,0,14
1986611,23,30,1990,5,female,113,300,150,166,131,166,91,0,40
1966603,15,30,1998,11,female,469,292,199,171,262,171,213,0,49
2131776,16,22,1997,5,male,565,302,239,179,13,0,1,179,12
1150628,56,15,1957,11,female,2074,297,202,179,91,0,50,179,41
1189090,108,7,1905,3,male,1307,290,164,175,30,9,8,166,22
1223681,16,1,1997,6,female,366,289,206,178,170,144,97,34,73
1961172,16,12,1997,3,male,616,289,179,176,89,176,73,0,16
1027913,19,23,1994,10,male,245,294,270,178,86,178,50,0,36
2152302,23,25,1990,3,female,231,298,67,178,205,178,125,0,80
1789468,50,11,1963,8,male,355,301,186,187,247,0,15,187,232
1711649,97,3,1916,4,male,903,296,68,183,362,0,175,183,187
1194755,21,27,1992,7,male,688,302,185,188,310,53,77,135,233
2108070,24,1,1989,1,female,658,298,110,184,485,79,156,105,329
1613364,24,20,1989,5,female,731,303,113,184,53,184,53,0,0
2032817,19,20,1994,12,male,403,303,229,187,303,187,240,0,63
1236036,40,6,1973,1,male,645,298,254,195,45,8,33,187,12
1833291,39,22,1974,10,female,1381,294,132,197,145,15,62,182,83
1353622,15,2,1998,6,male,398,292,117,199,27,58,15,141,12
1080304,17,1,1996,9,male,445,290,205,199,144,52,86,147,58
1293379,42,7,1971,7,male,982,299,135,197,47,173,7,24,40
2041710,18,18,1995,4,male,197,299,169,195,108,195,75,0,33
1379294,23,12,1990,6,female,1345,303,104,210,111,104,53,106,58
1287865,19,1,1994,5,female,821,289,113,204,291,74,137,130,154
1265826,29,17,1984,2,female,567,302,196,205,149,118,72,87,77
2158392,29,8,1984,11,male,554,290,161,207,55,202,20,5,35
2105375,53,24,1960,9,male,492,292,261,208,45,172,9,36,36
1782632,18,5,1995,11,female,511,293,190,211,312,189,243,22,69
1625510,17,15,1996,3,female,512,298,145,210,72,210,30,0,42
1325767,103,11,1910,5,male,480,297,208,204,233,204,172,0,61
1061057,92,19,1921,4,male,59,289,232,221,46,0,25,221,21
1114648,19,8,1994,1,female,631,294,189,214,156,34,8,180,148
1954336,28,12,1985,9,male,435,289,248,213,134,8,132,205,2
1324435,17,17,1996,9,male,328,300,207,215,62,51,11,164,51
1779530,23,26,1990,10,female,679,291,82,215,129,133,81,82,48
1795056,53,6,1960,12,female,1063,294,262,216,54,70,11,146,43
1051620,26,29,1987,10,female,167,299,241,221,203,133,110,88,93
1125820,19,9,1994,12,male,317,302,237,214,407,105,334,109,73
1715257,25,10,1988,2,female,239,296,77,219,380,88,329,131,51
1530224,27,5,1986,2,female,383,296,34,212,368,122,297,90,71
1893266,20,22,1993,1,female,255,303,179,218,162,188,84,30,78
1422093,25,11,1988,3,female,249,299,265,220,285,194,179,26,106
1375353,17,21,1996,11,female,825,291,196,218,416,198,317,20,99
1072174,27,7,1986,1,female,707,293,199,221,346,165,137,56,209
1945610,17,1,1996,1,female,260,290,146,213,106,213,54,0,52
1920811,42,26,1971,2,female,483,291,248,212,39,212,24,0,15
1685060,25,1,1988,1,female,232,289,266,220,304,220,294,0,10
1352525,24,26,1989,5,female,564,293,230,217,538,217,493,0,45
1260511,67,5,1946,10,female,1327,298,59,212,937,212,465,0,472
1636245,18,22,1995,12,male,187,293,221,224,153,184,122,40,31
1145588,25,9,1988,7,female,508,301,198,229,933,207,501,22,432
1035295,108,5,1905,3,female,1522,289,172,226,454,222,294,4,160
1914984,27,29,1986,9,female,659,302,219,233,192,232,84,1,108
1803019,27,13,1986,7,male,442,290,253,229,46,229,39,0,7
1265786,45,6,1968,7,female,1729,290,166,223,255,223,129,0,126
1423337,20,25,1993,2,female,389,298,163,223,348,223,346,0,2
1218644,108,22,1905,4,male,356,297,257,243,33,1,29,242,4
1119119,15,8,1998,4,male,217,293,153,236,78,28,32,208,46
1566931,48,27,1965,9,female,504,289,104,243,127,0,15,243,112
1368843,16,11,1997,10,female,885,296,158,239,60,147,12,92,48
1231040,13,3,2000,3,female,507,294,203,239,309,172,160,67,149
1350529,24,26,1989,1,female,855,298,116,240,282,59,41,181,241
1939772,27,13,1986,3,female,842,290,109,246,252,172,151,74,101
2142157,19,19,1994,12,female,519,295,120,243,127,205,122,38,5
2039908,19,22,1994,9,female,437,294,201,234,153,199,118,35,35
1990530,21,16,1992,5,female,399,291,176,246,311,188,112,58,199
1969540,16,7,1997,5,female,261,296,206,246,401,208,265,38,136
1968219,113,2,1900,9,female,1913,290,225,237,252,236,144,1,108
2161779,15,5,1998,4,female,388,300,99,257,349,0,70,257,279
1006116,67,30,1946,8,male,1414,296,192,250,204,97,112,153,92
2066863,53,26,1960,10,female,564,303,241,260,471,88,180,172,291
2144536,22,21,1991,3,male,571,300,249,273,22,45,13,228,9
1707028,95,15,1918,8,male,1834,297,148,265,57,52,42,213,15
1714042,18,25,1995,7,female,148,298,218,267,195,164,156,103,39
1653113,16,2,1997,12,female,289,297,177,266,427,74,126,192,301
1015608,18,9,1995,8,male,79,298,207,274,3,252,3,22,0
2026207,64,16,1949,12,female,699,297,190,270,78,218,39,52,39
1298559,17,19,1996,6,female,149,292,168,269,345,228,169,41,176
1417157,45,10,1968,11,male,396,300,216,262,209,262,133,0,76
1274024,17,10,1996,3,female,192,299,169,285,436,11,147,274,289
1790438,20,18,1993,9,female,296,299,292,289,25,144,6,145,19
1349513,20,28,1993,5,female,417,290,187,292,292,201,178,91,114
1045859,27,19,1986,11,female,1927,291,187,285,244,57,146,228,98
1479692,17,19,1996,5,male,779,292,186,280,427,57,302,223,125
1470577,16,12,1997,5,female,395,303,155,280,55,277,18,3,37
2012091,19,26,1994,3,female,276,296,107,286,211,237,95,49,116
1472234,55,21,1958,12,female,1696,296,147,287,177,250,147,37,30
1210013,25,30,1988,10,male,312,297,246,279,61,278,53,1,8
1511885,14,25,1999,11,female,340,297,108,282,95,282,81,0,14
2025548,35,21,1978,10,female,805,303,238,281,355,281,316,0,39
2133402,16,15,1997,1,female,1000,302,154,306,249,39,103,267,146
1002484,21,14,1992,7,female,411,296,201,294,250,293,181,1,69
1030671,18,23,1995,9,male,497,303,149,302,28,302,16,0,12
1880596,18,10,1995,6,male,381,299,204,296,271,296,186,0,85
1813978,53,21,1960,7,female,1712,294,177,305,438,305,300,0,138
1493577,52,3,1961,12,female,1335,289,85,294,566,294,353,0,213
1098791,23,23,1990,6,female,257,302,66,315,282,0,210,315,72
1584322,28,30,1985,1,male,466,289,229,310,928,50,460,260,468
2075049,24,25,1989,2,female,1286,303,90,317,395,66,89,251,306
1897148,52,30,1961,5,male,1601,300,164,327,1070,283,774,44,296
1724185,46,3,1967,2,female,450,302,172,314,337,314,127,0,210
2154903,28,27,1985,7,female,1173,302,74,341,2665,97,1490,244,1175
2003680,25,18,1988,3,male,303,297,225,334,212,251,156,83,56
1280981,43,16,1970,1,female,520,296,140,343,205,343,123,0,82
1413940,50,5,1963,2,female,1753,289,129,337,110,337,100,0,10
1432395,28,2,1985,10,female,263,290,156,343,423,343,336,0,87
2059471,15,5,1998,2,female,220,297,179,360,129,0,36,360,93
1532534,86,4,1927,5,female,739,291,222,361,103,0,10,361,93
1445507,21,16,1992,6,male,327,296,227,349,102,144,84,205,18
1245976,21,11,1992,11,male,513,290,125,368,572,91,110,277,462
1439002,35,25,1978,10,female,1988,300,187,368,642,367,480,1,162
1173084,18,25,1995,7,female,315,292,203,359,177,359,164,0,13
1422048,18,28,1995,10,male,82,294,277,366,74,366,54,0,20
1586135,36,15,1977,4,female,328,299,168,358,495,358,334,0,161
1158450,14,2,1999,5,male,337,298,215,381,4,20,0,361,4
1933767,68,27,1945,3,female,1717,294,202,387,627,1,209,386,418
1748210,17,14,1996,5,female,404,291,202,390,347,107,157,283,190
1778082,18,13,1995,3,female,460,300,57,389,285,222,195,167,90
1982299,21,24,1992,10,female,222,291,136,386,923,131,376,255,547
1692584,101,26,1912,2,male,1837,299,173,389,138,322,87,67,51
2111824,20,27,1993,7,female,909,290,132,390,274,323,222,67,52
1426329,17,9,1996,9,female,281,299,176,388,48,388,33,0,15
2069439,50,9,1963,6,female,1564,295,149,391,278,391,188,0,90
2051037,19,19,1994,7,female,26,291,104,388,666,388,354,0,312
1651616,30,26,1983,5,female,631,299,222,397,357,59,114,338,243
2035251,100,27,1913,6,female,1763,299,172,411,66,402,46,9,20
1759247,23,10,1990,9,male,179,303,194,408,605,337,334,71,271
1795204,53,4,1960,5,female,1560,296,146,418,437,382,193,36,244
1073667,103,28,1910,4,female,1139,298,178,413,218,413,177,0,41
1144625,51,28,1962,9,female,258,289,164,422,134,0,32,422,102
2139443,20,8,1993,1,female,657,297,200,446,396,80,84,366,312
1080873,113,27,1900,8,female,1139,293,155,432,605,0,115,432,490
2020526,14,15,1999,9,female,301,292,176,432,202,300,98,132,104
1251035,18,4,1995,8,female,104,290,30,436,211,332,145,104,66
2116574,18,4,1995,4,male,355,297,199,435,277,333,125,102,152
1354209,23,15,1990,12,male,754,298,150,434,190,431,117,3,73
1057271,26,1,1987,11,male,884,300,206,442,84,441,76,1,8
1591618,20,7,1993,6,male,798,296,200,439,32,439,24,0,8
1542583,62,5,1951,9,male,1603,292,171,444,60,444,57,0,3
1094734,20,24,1993,8,female,327,293,80,433,153,433,151,0,2
1338472,16,2,1997,6,female,365,291,119,468,224,0,130,468,94
2090433,59,17,1954,4,female,871,299,204,472,80,0,5,472,75
1586001,25,6,1988,4,female,793,289,209,458,125,320,56,138,69
1914978,24,4,1989,3,male,152,291,141,457,1022,130,309,327,713
1880951,21,3,1992,3,female,283,299,256,454,264,358,168,96,96
1558984,22,14,1991,7,male,667,299,215,460,129,460,116,0,13
1845282,31,26,1982,12,female,400,298,125,469,690,469,485,0,205
1343762,40,21,1973,12,female,211,296,115,459,455,459,172,0,283
1253889,20,18,1993,3,male,205,292,197,487,55,6,26,481,29
1868828,30,28,1983,1,female,377,296,144,503,69,1,6,502,63
2132140,14,20,1999,9,female,453,297,158,517,213,33,91,484,122
1943615,26,14,1987,10,female,457,298,147,500,166,21,101,479,65
1579262,51,29,1962,3,female,711,292,209,503,141,4,51,499,90
1462602,14,21,1999,1,female,446,301,111,513,476,125,293,388,183
1582095,31,12,1982,10,male,168,293,257,486,358,299,80,187,278
1718507,32,8,1981,10,female,485,302,179,495,350,282,219,213,131
2097476,44,29,1969,6,female,1497,295,203,497,404,288,183,209,221
1580444,29,30,1984,1,female,1432,292,179,506,791,363,651,143,140
2027086,27,5,1986,7,male,306,302,261,515,313,436,99,79,214
1582427,43,14,1970,8,female,863,299,203,514,435,372,237,142,198
1676439,18,10,1995,2,male,483,294,131,485,5,485,1,0,4
1633908,14,20,1999,6,female,410,289,226,504,184,504,149,0,35
1354821,31,13,1982,5,male,653,293,152,492,224,492,209,0,15
1249284,40,2,1973,7,female,376,301,253,517,358,517,119,0,239
1356856,55,31,1958,8,female,656,297,215,524,627,64,83,460,544
1359693,52,23,1961,8,female,1777,292,163,531,407,253,268,278,139
1000489,18,25,1995,12,female,129,302,277,543,275,515,163,28,112
1245118,22,17,1991,10,male,312,300,217,548,643,500,486,48,157
2083916,20,23,1993,10,female,93,298,191,557,149,557,130,0,19
2096390,108,23,1905,9,female,126,303,91,529,145,529,138,0,7
1783886,56,9,1957,5,female,254,295,73,602,133,0,11,602,122
1804841,94,13,1919,6,female,1191,293,149,604,700,58,281,546,419
1636826,23,7,1990,7,male,767,293,85,576,1128,18,226,558,902
1848960,48,24,1965,7,female,1151,300,139,584,1026,69,589,515,437
1291183,23,7,1990,10,male,73,300,272,591,280,375,137,216,143
1156487,15,28,1998,10,female,206,296,156,563,582,347,324,216,258
1042103,24,5,1989,9,female,747,303,153,577,457,127,137,450,320
1203468,51,22,1962,2,male,370,297,243,563,74,407,37,156,37
1507270,21,2,1992,5,female,76,292,122,605,292,551,128,54,164
1262761,52,2,1961,10,male,391,301,211,603,230,569,167,34,63
2157218,20,8,1993,9,female,371,300,251,604,375,569,121,35,254
1911765,29,1,1984,1,female,324,301,191,574,487,567,296,7,191
1801972,67,24,1946,12,female,2373,301,223,605,346,604,134,1,212
1390314,28,8,1985,4,female,603,299,253,573,576,570,354,3,222
1286741,45,18,1968,10,male,293,298,292,564,301,564,281,0,20
2151776,94,21,1919,4,male,315,300,232,602,259,602,220,0,39
1608999,33,23,1980,4,female,436,300,216,608,613,608,476,0,137
1759430,103,7,1910,8,female,1319,299,146,575,702,575,531,0,171
2007212,19,4,1994,10,female,191,294,179,598,990,598,849,0,141
1846548,18,9,1995,12,male,407,298,155,626,378,0,56,626,322
1638433,64,3,1949,9,female,1497,301,134,615,352,115,142,500,210
1452451,83,11,1930,11,male,679,302,159,617,374,122,139,495,235
1859579,56,3,1957,1,female,1032,292,154,636,420,5,161,631,259
1939729,15,18,1998,4,male,597,303,133,640,19,316,15,324,4
1385362,47,7,1966,12,female,797,299,182,655,369,413,160,242,209
1028992,19,10,1994,8,female,376,290,99,649,324,528,162,121,162
1854122,58,6,1955,6,female,1755,301,159,634,363,483,136,151,227
1317027,17,22,1996,10,female,558,303,226,621,848,592,481,29,367
1545799,21,11,1992,7,female,70,298,252,619,500,603,451,16,49
1338676,28,12,1985,10,female,492,295,222,617,586,594,353,23,233
1225116,49,10,1964,7,female,85,298,209,653,967,628,857,25,110
1282085,54,9,1959,7,male,414,297,197,658,628,657,372,1,256
1072775,16,14,1997,10,female,160,289,253,661,192,661,173,0,19
1369079,65,18,1948,10,female,627,299,146,634,677,634,265,0,412
1538968,108,6,1905,10,female,814,293,132,682,129,91,32,591,97
2151024,18,9,1995,1,male,349,295,110,700,2409,355,1373,345,1036
1386770,16,9,1997,5,female,393,301,230,674,159,664,125,10,34
1720282,17,19,1996,4,female,860,303,202,704,187,683,150,21,37
1679817,19,25,1994,3,male,291,292,162,722,228,706,123,16,105
1157693,90,1,1923,4,female,2550,295,147,724,190,683,179,41,11
2187895,21,4,1992,4,female,296,301,102,692,647,691,376,1,271
1416755,52,27,1961,10,female,1100,289,58,678,198,678,153,0,45
2190249,34,22,1979,3,female,1593,299,139,725,564,725,355,0,209
1790676,55,23,1958,9,female,1636,294,178,762,340,42,214,720,126
1152244,62,6,1951,5,female,1648,290,172,749,566,53,197,696,369
1463915,54,17,1959,2,male,1506,292,73,796,116,387,45,409,71
1542388,23,19,1990,8,female,645,299,204,763,443,531,269,232,174
1038069,18,10,1995,11,female,337,299,211,736,631,500,511,236,120
1785784,20,20,1993,11,female,220,298,233,764,1072,248,591,516,481
1747729,19,5,1994,8,female,940,295,209,736,864,386,341,350,523
1979751,18,4,1995,10,female,234,302,172,753,447,753,340,0,107
1911959,30,4,1983,6,female,379,301,227,740,306,740,104,0,202
1898818,48,6,1965,3,female,533,292,220,852,303,0,66,852,237
1761700,17,3,1996,7,female,439,298,93,863,1497,2,190,861,1307
1235870,14,30,1999,6,female,391,293,194,873,361,407,222,466,139
1074847,48,13,1965,7,female,1032,303,89,829,463,489,141,340,322
1787589,18,5,1995,6,female,1224,303,102,832,1022,599,500,233,522
1974721,55,8,1958,10,female,2010,301,197,856,458,815,291,41,167
1845809,23,16,1990,8,female,468,289,193,824,546,771,303,53,243
1497882,16,21,1997,11,male,396,294,173,871,26,871,24,0,2
1666179,17,8,1996,7,female,296,296,95,844,12,844,6,0,6
1143931,34,6,1979,10,male,154,296,275,825,198,825,185,0,13
1302598,68,21,1945,5,female,319,303,154,846,1669,846,1496,0,173
1728020,18,8,1995,8,male,293,298,204,921,284,504,153,417,131
1092244,53,21,1960,8,female,1794,296,169,918,165,632,75,286,90
1618865,50,20,1963,5,female,2395,294,160,966,618,684,383,282,235
1325957,50,21,1963,9,female,2169,294,174,974,1015,238,436,736,579
1628337,18,1,1995,12,female,351,294,107,883,2326,241,565,642,1761
2128105,20,18,1993,8,female,603,297,169,904,1668,265,551,639,1117
1291794,20,29,1993,9,female,514,303,128,903,4,751,2,152,2
1838048,20,10,1993,12,female,39,289,278,928,236,817,124,111,112
1019795,23,5,1990,3,female,312,292,188,935,353,919,279,16,74
1479623,39,30,1974,11,female,250,297,250,893,342,883,192,10,150
1190799,53,19,1960,9,female,1399,295,170,882,878,873,629,9,249
1803106,46,16,1967,7,female,233,303,226,926,1178,926,405,0,773
1639994,66,29,1947,12,male,511,291,266,1046,473,9,67,1037,406
1965881,93,25,1920,1,male,1435,298,96,1035,418,368,241,667,177
1305401,28,25,1985,4,female,257,302,139,1070,1301,1070,1184,0,117
1349841,33,29,1980,10,female,499,299,148,1063,1205,1063,1076,0,129
2149947,18,5,1995,8,female,287,303,167,1263,1206,535,454,728,752
1437236,23,26,1990,11,female,1937,290,156,1196,905,440,461,756,444
2068887,18,6,1995,11,female,81,290,127,1208,1003,1133,674,75,329
1908573,89,19,1924,2,female,1440,298,131,1144,1015,1127,904,17,111
1379795,23,24,1990,9,male,966,301,139,1272,2015,1120,1496,152,519
1793353,43,10,1970,4,female,571,289,197,1157,626,1152,420,5,206
1875768,47,1,1966,3,male,836,298,200,1180,188,1180,112,0,76
2082289,58,25,1955,10,female,553,289,157,1136,663,1136,331,0,332
1352682,72,10,1941,6,female,2310,292,126,1268,693,1268,465,0,228
1082623,14,7,1999,7,female,425,292,186,1160,1420,1160,1260,0,160
1599956,22,14,1991,12,female,389,294,110,1447,351,762,197,685,154
2101632,19,23,1994,3,male,1386,299,192,1415,1527,926,458,489,1069
1752778,21,2,1992,9,female,41,303,84,1399,367,1157,134,242,233
1085808,32,17,1981,4,female,181,301,207,1431,756,1272,374,159,382
1287982,30,31,1983,7,male,247,295,238,1459,207,1459,164,0,43
1753807,30,14,1983,7,male,507,294,166,1320,350,1320,331,0,19
1406952,50,20,1963,4,female,118,303,238,1521,1206,1521,1122,0,84
1490623,57,23,1956,10,female,418,295,184,1657,125,0,29,1657,96
1950800,49,13,1964,4,female,580,299,160,1753,450,0,174,1753,276
1537668,60,30,1953,11,female,536,299,188,1541,754,0,141,1541,613
1272707,64,26,1949,10,female,1721,297,167,1585,2018,208,777,1377,1241
1462074,22,23,1991,5,female,585,292,157,1578,838,899,428,679,410
1302581,46,11,1967,3,female,1764,294,107,1586,610,374,224,1212,386
1458551,22,5,1991,10,female,425,291,148,1728,437,1612,286,116,151
1103488,57,30,1956,1,female,1695,289,168,1770,655,1280,253,490,402
1346505,40,19,1973,7,female,1265,297,143,1713,3167,1369,839,344,2328
1487335,35,20,1978,7,female,771,296,147,1632,837,1631,570,1,267
1157575,20,28,1993,2,male,397,297,148,1870,815,1870,751,0,64
2029176,27,10,1986,2,male,103,295,236,1528,432,1528,211,0,221
1194251,39,9,1974,2,female,934,299,153,2238,773,1092,550,1146,223
1165390,50,1,1963,4,female,2056,297,224,2211,1906,746,1029,1465,877
1816147,15,9,1998,9,female,48,300,144,2119,1837,1630,951,489,886
1848904,43,10,1970,9,female,1899,297,202,2195,1649,1607,1325,588,324
1607253,36,22,1977,1,female,415,290,246,2092,157,2092,100,0,57
1834674,58,18,1955,7,female,1983,292,94,2836,1258,70,739,2766,519
1893579,15,30,1998,10,female,319,294,177,3466,3341,105,969,3361,2372
1031889,16,12,1997,12,female,116,303,182,3283,4024,1292,1983,1991,2041
1670016,14,23,1999,5,female,32,293,174,3423,2222,2581,1847,842,374
2027140,36,28,1977,3,female,311,297,170,3515,1461,3515,1201,0,260
1048712,17,8,1996,1,male,90,298,248,4438,1947,2574,888,1864,1059
1725383,38,9,1975,5,male,470,295,177,4932,1,4920,1,12,0
2077803,48,19,1965,9,male,506,302,161,8936,4133,8934,3279,2,854
1540330,53,9,1960,12,male,460,297,215,8432,450,8432,266,0,184
2037044,14,1,1999,1,male,200,312,224,0,10,0,6,0,4
1553826,14,13,1999,8,male,259,318,151,0,0,0,0,0,0
2000918,16,16,1997,12,male,379,312,242,0,0,0,0,0,0
1596931,15,12,1998,2,female,280,306,113,0,0,0,0,0,0
1390285,15,16,1998,3,male,861,304,131,0,6,0,6,0,0
2108838,15,17,1998,6,male,399,308,242,0,1,0,1,0,0
1893826,15,18,1998,8,male,816,318,184,0,2,0,2,0,0
1169365,15,15,1998,9,female,292,311,168,0,0,0,0,0,0
2142736,17,24,1996,12,male,571,304,170,0,5,0,5,0,0
1233483,16,27,1997,7,male,273,308,67,0,0,0,0,0,0
1352509,16,16,1997,9,female,174,304,268,0,1,0,0,0,1
1442463,16,20,1997,10,female,98,304,146,0,0,0,0,0,0
1656371,18,24,1995,11,male,404,307,271,0,0,0,0,0,0
1761117,17,1,1996,1,male,340,307,184,0,2,0,2,0,0
1108417,17,19,1996,2,male,311,309,89,0,0,0,0,0,0
1229097,17,2,1996,4,male,646,314,292,0,0,0,0,0,0
2089679,17,22,1996,4,male,128,304,299,0,5,0,5,0,0
2085250,17,7,1996,6,male,479,315,258,0,0,0,0,0,0
1031854,17,1,1996,6,male,252,306,257,0,10,0,2,0,8
2035759,19,25,1994,11,female,505,317,85,0,1,0,1,0,0
1164988,19,6,1994,12,male,575,315,224,0,1,0,1,0,0
1815148,19,29,1994,12,male,402,314,227,0,1,0,1,0,0
1650163,18,6,1995,1,male,499,311,272,0,0,0,0,0,0
1004925,18,26,1995,1,male,397,316,273,0,4,0,1,0,3
1553707,18,1,1995,1,male,400,310,253,0,8,0,8,0,0
1631294,18,9,1995,2,female,451,307,183,0,0,0,0,0,0
2138756,18,1,1995,2,male,520,314,247,0,0,0,0,0,0
2109074,18,13,1995,5,male,445,317,228,0,1,0,1,0,0
1454390,18,22,1995,7,male,842,310,257,0,4,0,2,0,2
1562275,18,4,1995,7,male,524,315,214,0,42,0,26,0,16
1102233,18,24,1995,7,male,206,306,275,0,0,0,0,0,0
1370988,18,17,1995,8,female,652,318,28,0,8,0,3,0,5
1110122,18,25,1995,9,female,273,306,40,0,0,0,0,0,0
1264660,18,15,1995,10,male,184,308,243,0,5,0,5,0,0
1892739,20,22,1993,12,male,659,307,133,0,2,0,0,0,2
1188716,19,12,1994,1,male,601,310,232,0,1,0,0,0,1
1600902,19,27,1994,3,male,459,317,165,0,3,0,3,0,0
1862275,19,11,1994,4,male,589,317,141,0,0,0,0,0,0
1970792,19,5,1994,4,male,235,307,263,0,0,0,0,0,0
1551024,19,24,1994,5,male,726,305,236,0,1,0,1,0,0
1521328,19,4,1994,9,male,831,306,49,0,0,0,0,0,0
1723979,19,10,1994,10,male,568,307,143,0,5,0,5,0,0
1199706,19,18,1994,10,male,220,304,240,0,0,0,0,0,0
1009516,20,10,1993,1,female,232,312,67,0,1,0,1,0,0
1784082,20,10,1993,2,male,297,315,276,0,0,0,0,0,0
1482289,20,3,1993,3,male,1067,305,227,0,4,0,4,0,0
1820536,20,16,1993,3,male,479,304,161,0,2,0,1,0,1
1578691,20,20,1993,3,male,426,315,238,0,0,0,0,0,0
1838754,20,26,1993,4,male,742,312,247,0,1,0,1,0,0
2057242,20,28,1993,5,male,644,306,111,0,0,0,0,0,0
1610539,20,27,1993,5,female,570,308,139,0,3,0,1,0,2
1641570,20,25,1993,6,male,567,315,269,0,0,0,0,0,0
1097190,22,24,1991,12,female,384,316,30,0,7,0,6,0,1
1356134,21,15,1992,4,female,1046,313,236,0,0,0,0,0,0
1515540,21,29,1992,4,female,396,316,254,0,0,0,0,0,0
1022274,21,10,1992,5,female,325,312,200,0,3,0,1,0,2
1794811,21,20,1992,6,male,257,313,287,0,0,0,0,0,0
1575813,21,20,1992,10,male,382,312,187,0,0,0,0,0,0
1182201,22,18,1991,1,female,528,306,145,0,1,0,0,0,1
1931794,22,5,1991,8,male,142,308,269,0,2,0,0,0,2
2120845,24,26,1989,11,male,1250,313,189,0,0,0,0,0,0
1318567,23,4,1990,2,male,1399,317,144,0,1,0,1,0,0
1758581,23,9,1990,3,male,1070,307,156,0,0,0,0,0,0
1403261,23,5,1990,3,male,607,304,177,0,1,0,0,0,1
2003299,23,18,1990,4,female,354,319,89,0,0,0,0,0,0
1866403,23,21,1990,5,male,335,309,185,0,0,0,0,0,0
1375688,23,12,1990,6,male,333,314,110,0,1,0,1,0,0
1046783,23,18,1990,10,male,549,315,275,0,0,0,0,0,0
1210683,24,1,1989,1,male,205,316,292,0,0,0,0,0,0
2103828,24,18,1989,3,female,1319,315,83,0,7,0,7,0,0
2075816,24,24,1989,4,male,131,309,309,0,0,0,0,0,0
1015691,24,10,1989,5,male,496,306,256,0,0,0,0,0,0
1368947,24,13,1989,10,male,484,311,240,0,0,0,0,0,0
1147254,25,24,1988,2,male,443,310,265,0,1,0,1,0,0
1794106,25,18,1988,8,male,794,311,82,0,8,0,4,0,4
1865311,25,20,1988,10,male,96,319,313,0,0,0,0,0,0
2075221,26,15,1987,2,male,1269,318,223,0,0,0,0,0,0
1960521,26,6,1987,3,male,727,306,240,0,0,0,0,0,0
1369151,27,20,1986,4,male,676,315,185,0,0,0,0,0,0
1960728,28,4,1985,2,male,369,306,217,0,2,0,1,0,1
1344068,28,27,1985,5,male,1536,309,203,0,0,0,0,0,0
1919491,29,17,1984,8,male,637,312,242,0,1,0,1,0,0
1547681,31,4,1982,2,male,858,316,202,0,0,0,0,0,0
1223731,31,6,1982,7,male,1347,309,247,0,0,0,0,0,0
2078725,32,30,1981,3,male,616,315,252,0,0,0,0,0,0
1863156,33,23,1980,1,male,342,308,213,0,0,0,0,0,0
1712637,34,2,1979,9,male,1003,307,165,0,9,0,6,0,3
1914458,42,22,1971,11,male,819,317,190,0,14,0,10,0,4
1117273,45,26,1968,2,male,1342,304,280,0,14,0,8,0,6
1404453,47,30,1966,11,female,362,304,238,0,0,0,0,0,0
1779596,53,3,1960,11,male,493,319,168,0,0,0,0,0,0
1164604,61,27,1952,7,female,228,305,236,0,18,0,9,0,9
2098722,62,15,1951,4,male,527,305,180,0,2,0,2,0,0
1181699,68,14,1945,2,male,854,318,285,0,0,0,0,0,0
1252230,99,27,1914,2,male,1000,318,248,0,1,0,1,0,0
2001464,99,30,1914,9,male,1470,311,157,0,11,0,4,0,7
1974028,103,20,1910,6,male,689,309,220,0,0,0,0,0,0
1966682,103,1,1910,11,male,1264,313,231,0,2,0,2,0,0
1277706,108,8,1905,2,male,1029,313,161,0,0,0,0,0,0
1954628,17,16,1996,11,male,461,312,270,1,0,0,0,1,0
1921695,18,25,1995,9,male,853,307,174,1,0,0,0,1,0
1398246,25,20,1988,12,male,666,314,237,1,1,0,0,1,1
1630156,21,22,1992,8,male,332,317,233,1,5,0,1,1,4
1003335,21,2,1992,9,female,458,309,77,1,4,0,0,1,4
1197167,25,5,1988,4,male,1132,318,67,1,8,0,1,1,7
1669061,65,16,1948,2,male,1011,314,111,1,7,0,6,1,1
1140804,68,26,1945,4,male,562,307,176,1,47,0,33,1,14
1163553,14,2,1999,5,female,247,312,269,1,0,1,0,0,0
1494016,16,11,1997,4,male,502,304,239,1,0,1,0,0,0
1910151,19,6,1994,6,male,394,314,252,1,0,1,0,0,0
2072632,19,6,1994,7,male,280,314,55,1,0,1,0,0,0
1385240,19,18,1994,8,male,364,304,119,1,0,1,0,0,0
1612573,20,23,1993,1,male,856,314,170,1,0,1,0,0,0
1713485,20,28,1993,3,male,286,317,129,1,0,1,0,0,0
2082015,21,25,1992,6,male,334,306,189,1,0,1,0,0,0
1269288,22,21,1991,1,male,820,317,173,1,0,1,0,0,0
2105584,22,19,1991,1,male,251,307,252,1,0,1,0,0,0
1711832,32,9,1981,8,female,558,308,164,1,0,1,0,0,0
1578473,68,1,1945,1,male,271,314,295,1,0,1,0,0,0
1114985,19,12,1994,6,male,207,317,260,1,1,1,0,0,1
1789579,19,17,1994,10,male,711,314,114,1,1,1,1,0,0
1517598,25,5,1988,11,male,679,314,195,1,1,1,1,0,0
1822807,28,21,1985,9,male,494,307,205,1,1,1,1,0,0
1610897,57,9,1956,12,male,1030,306,70,1,1,1,0,0,1
1031886,14,27,1999,2,male,128,319,43,1,2,1,0,0,2
2107776,15,19,1998,4,female,577,317,155,1,2,1,2,0,0
1478299,17,6,1996,5,male,504,318,150,1,51,1,42,0,9
1200711,17,20,1996,7,male,251,305,252,1,10,1,9,0,1
1873842,18,17,1995,8,male,403,308,47,1,13,1,11,0,2
1756967,19,19,1994,5,male,560,307,268,1,16,1,16,0,0
1999226,20,29,1993,3,female,860,304,104,1,25,1,15,0,10
1390128,21,26,1992,3,male,192,308,272,1,11,1,8,0,3
1547063,24,17,1989,11,male,818,308,235,1,2,1,0,0,2
2084049,23,23,1990,10,male,449,310,274,1,2,1,0,0,2
1481987,24,22,1989,5,female,582,309,72,1,2,1,2,0,0
1634199,25,9,1988,1,male,535,306,252,1,12,1,10,0,2
1882500,27,10,1986,12,female,376,318,265,1,6,1,5,0,1
1095832,68,8,1945,9,male,1488,311,113,1,21,1,18,0,3
1471922,94,8,1919,4,male,259,309,149,1,17,1,4,0,13
1339115,103,2,1910,2,female,327,314,63,1,3,1,1,0,2
1875359,19,1,1994,1,male,190,309,57,2,0,0,0,2,0
1270454,49,21,1964,12,male,963,316,226,2,2,0,1,2,1
1167116,24,13,1989,11,male,650,306,71,2,9,0,5,2,4
1683890,69,29,1944,7,male,1681,315,181,2,33,0,12,2,21
1846672,108,31,1905,1,male,1709,308,91,2,17,0,13,2,4
1321373,24,23,1989,5,male,1435,312,52,2,57,1,41,1,16
1167618,26,1,1987,1,male,443,319,240,2,5,1,4,1,1
1077751,17,11,1996,10,male,420,314,218,2,0,2,0,0,0
1388336,18,22,1995,10,male,214,309,210,2,0,2,0,0,0
1307025,32,20,1981,8,male,491,306,277,2,0,2,0,0,0
1607227,18,24,1995,12,male,144,312,288,2,1,2,1,0,0
1045666,20,8,1993,6,female,546,315,62,2,1,2,1,0,0
1565419,20,13,1993,8,male,625,306,246,2,1,2,1,0,0
1642631,26,30,1987,9,male,1456,317,171,2,1,2,1,0,0
1818543,18,27,1995,7,female,213,319,59,2,2,2,2,0,0
1128285,103,3,1910,8,male,1282,312,125,2,2,2,2,0,0
1830030,14,22,1999,5,female,189,309,66,2,6,2,4,0,2
1163167,16,4,1997,3,male,204,304,106,2,30,2,16,0,14
1414861,17,20,1996,1,male,338,304,138,2,3,2,3,0,0
1669154,18,10,1995,7,female,127,306,228,2,6,2,3,0,3
1426631,19,31,1994,8,male,191,309,258,2,8,2,4,0,4
1269136,19,26,1994,9,male,275,316,221,2,8,2,7,0,1
1897709,21,31,1992,5,male,421,315,289,2,4,2,4,0,0
1494368,22,4,1991,2,male,689,311,171,2,10,2,6,0,4
1356430,22,8,1991,10,male,532,310,179,2,5,2,5,0,0
1780454,35,21,1978,3,male,1148,317,121,2,3,2,3,0,0
2093591,44,1,1969,5,male,612,318,10,2,7,2,4,0,3
1313928,93,3,1920,1,male,1460,304,88,2,5,2,5,0,0
1283576,103,18,1910,11,male,542,317,198,2,18,2,15,0,3
1079357,103,23,1910,10,female,1373,308,100,2,20,2,16,0,4
1709658,21,23,1992,11,male,732,318,264,3,2,0,2,3,0
1101982,48,18,1965,9,male,397,305,288,3,3,0,1,3,2
1001311,108,15,1905,12,male,1307,308,162,3,4,0,2,3,2
2100201,17,15,1996,11,female,547,310,68,3,20,0,16,3,4
2157282,41,30,1972,9,male,569,316,169,3,5,2,2,1,3
1453666,58,30,1955,1,female,2004,306,172,3,8,1,6,2,2
1612704,94,3,1919,9,male,1147,313,128,3,29,2,10,1,19
1306155,14,26,1999,7,male,148,311,284,3,0,3,0,0,0
1512893,16,12,1997,12,male,684,318,151,3,0,3,0,0,0
1222303,16,2,1997,8,male,442,304,267,3,0,3,0,0,0
1672222,95,29,1918,6,female,316,313,210,3,0,3,0,0,0
1114822,21,6,1992,8,female,278,309,161,3,1,3,1,0,0
1826650,24,24,1989,1,male,900,315,133,3,1,3,1,0,0
1285082,16,17,1997,12,male,285,314,152,3,3,3,2,0,1
1046464,18,2,1995,1,male,341,305,195,3,4,3,3,0,1
2086711,36,1,1977,10,male,1326,313,98,3,4,3,3,0,1
1334453,16,2,1997,12,female,510,315,218,3,5,3,3,0,2
1979268,19,2,1994,2,male,513,313,183,3,36,3,22,0,14
1397041,20,27,1993,9,male,1164,318,160,3,37,3,29,0,8
1587000,20,7,1993,9,female,569,304,33,3,22,3,17,0,5
1861974,21,18,1992,4,female,609,315,102,3,9,3,6,0,3
2180560,23,3,1990,4,male,291,316,232,3,25,3,22,0,3
1413282,23,15,1990,6,male,524,319,239,3,5,3,5,0,0
1324535,25,5,1988,4,male,362,304,283,3,7,3,6,0,1
1702005,27,18,1986,4,male,558,319,294,3,5,3,0,0,5
1867239,27,9,1986,6,male,1082,309,213,3,8,3,7,0,1
1257963,94,23,1919,2,male,811,313,143,3,31,3,26,0,5
2133340,103,16,1910,4,male,547,312,269,3,12,3,10,0,2
1300788,16,28,1997,4,male,237,307,216,4,0,0,0,4,0
1987534,21,2,1992,2,male,541,311,288,4,0,0,0,4,0
1224842,16,12,1997,9,female,302,311,99,4,5,0,1,4,4
1603931,17,31,1996,1,male,378,305,153,4,3,0,0,4,3
1105912,22,21,1991,5,female,314,305,275,4,4,0,0,4,4
2048347,21,17,1992,12,female,713,307,207,4,6,0,1,4,5
1442845,43,28,1970,9,male,556,313,146,4,4,1,3,3,1
2181576,20,8,1993,8,male,609,306,276,4,0,4,0,0,0
1252283,15,26,1998,5,male,307,308,289,4,1,4,0,0,1
1535077,108,15,1905,9,male,1078,316,200,4,1,4,0,0,1
1318065,20,4,1993,2,male,670,311,255,4,4,4,4,0,0
1476782,15,27,1998,6,female,514,315,171,4,55,4,33,0,22
1202073,15,30,1998,8,female,108,312,96,4,82,4,80,0,2
1829735,20,29,1993,6,male,453,312,183,4,10,4,7,0,3
1352490,25,16,1988,7,male,500,310,149,4,10,4,9,0,1
1959803,94,30,1919,5,female,234,314,92,4,6,4,4,0,2
1100239,53,29,1960,12,male,493,311,231,5,6,0,6,5,0
1253985,29,6,1984,3,male,367,317,174,5,25,0,8,5,17
2121150,34,18,1979,2,male,478,309,273,5,15,1,4,4,11
1241133,16,4,1997,4,male,247,314,238,5,0,5,0,0,0
1161664,103,12,1910,2,male,1223,306,197,5,2,5,1,0,1
1772171,16,16,1997,8,male,266,316,281,5,5,5,4,0,1
1013541,18,23,1995,11,male,391,304,159,5,6,5,6,0,0
1361958,25,1,1988,6,male,222,316,250,5,4,5,4,0,0
1038342,16,14,1997,1,male,398,307,190,5,15,5,14,0,1
1327689,17,6,1996,6,female,363,307,63,5,18,5,11,0,7
2084308,19,6,1994,11,male,643,317,120,5,19,5,18,0,1
1803326,19,19,1994,11,female,153,314,81,5,16,5,10,0,6
2192048,18,15,1995,4,male,636,316,238,5,71,5,53,0,18
1583807,21,10,1992,11,male,421,312,289,5,63,5,57,0,6
1945161,24,9,1989,6,male,350,319,204,5,10,5,6,0,4
1923982,25,9,1988,4,male,714,306,252,5,9,5,9,0,0
1368193,29,15,1984,11,female,503,306,93,5,37,5,19,0,18
1433765,38,12,1975,11,male,1610,311,129,5,9,5,8,0,1
1628224,95,7,1918,10,female,1143,315,107,5,35,5,26,0,9
1575767,98,12,1915,5,female,2489,308,69,5,11,5,11,0,0
1777131,22,22,1991,10,male,653,317,194,6,3,0,1,6,2
1129458,13,14,2000,2,male,250,305,254,6,5,0,1,6,4
2031451,16,19,1997,12,male,524,304,154,6,30,0,21,6,9
1073651,16,31,1997,10,female,406,310,198,6,11,0,3,6,8
1337295,67,26,1946,9,male,1415,308,192,6,96,0,18,6,78
2014299,19,13,1994,5,female,263,307,150,6,0,2,0,4,0
1766348,44,16,1969,5,male,414,309,210,6,10,4,5,2,5
1967800,20,9,1993,6,male,178,310,211,6,47,5,41,1,6
1224516,63,30,1950,6,male,1703,313,76,6,24,5,17,1,7
1515220,21,23,1992,11,male,302,309,181,6,0,6,0,0,0
1842555,21,2,1992,9,male,737,317,191,6,0,6,0,0,0
1708124,18,9,1995,2,male,658,309,154,6,3,6,1,0,2
1841670,21,5,1992,11,male,382,309,263,6,5,6,3,0,2
1925464,21,15,1992,1,female,487,319,45,6,6,6,6,0,0
1795912,25,1,1988,1,female,474,318,110,6,17,6,11,0,6
1405938,26,12,1987,5,male,201,317,158,6,62,6,50,0,12
2083040,48,24,1965,12,male,1063,309,55,6,34,6,22,0,12
2091041,108,7,1905,10,male,852,315,119,6,12,6,9,0,3
1859806,15,1,1998,4,female,358,314,218,7,5,0,2,7,3
1014209,63,11,1950,12,male,647,307,184,7,19,0,6,7,13
1060251,18,20,1995,7,male,417,318,295,7,12,4,7,3,5
1430458,17,3,1996,1,male,537,317,271,7,2,6,1,1,1
1517018,15,14,1998,6,female,511,309,173,7,1,7,1,0,0
2188440,16,10,1997,7,male,470,306,272,7,0,7,0,0,0
1882374,20,16,1993,9,male,677,305,290,7,0,7,0,0,0
1668551,31,15,1982,12,male,675,319,237,7,0,7,0,0,0
1848399,17,5,1996,3,male,442,313,89,7,4,7,4,0,0
1577618,21,31,1992,8,female,463,314,105,7,5,7,4,0,1
1570711,28,4,1985,3,male,266,315,224,7,6,7,6,0,0
2108619,103,25,1910,11,male,1304,305,90,7,6,7,4,0,2
1596310,22,2,1991,8,male,120,318,283,7,25,7,20,0,5
1304207,26,2,1987,11,female,442,310,214,7,130,7,127,0,3
2149247,30,6,1983,5,female,277,317,271,7,12,7,8,0,4
1263926,53,29,1960,2,male,966,312,106,8,5,2,5,6,0
1218002,18,25,1995,9,male,97,319,318,8,4,8,4,0,0
1961129,26,18,1987,2,male,664,317,192,8,2,8,2,0,0
1807987,16,18,1997,3,male,301,305,279,8,7,8,2,0,5
1977855,42,27,1971,9,male,389,310,276,8,6,8,6,0,0
1041274,20,1,1993,4,female,511,314,192,8,92,8,66,0,26
2136826,22,19,1991,2,female,792,316,222,8,13,8,5,0,8
1166938,26,1,1987,1,female,487,304,129,8,34,8,26,0,8
1865688,108,31,1905,12,female,346,304,60,8,61,8,47,0,14
1242064,18,17,1995,3,female,424,308,160,9,0,0,0,9,0
2165896,17,30,1996,11,male,586,305,145,9,3,0,0,9,3
2154065,15,24,1998,5,female,377,305,229,9,6,0,2,9,4
1150439,19,13,1994,6,male,565,312,224,9,10,0,1,9,9
1310404,14,16,1999,4,female,142,319,193,9,20,0,1,9,19
1206493,13,26,2000,1,female,126,306,101,9,29,5,4,4,25
2186959,54,29,1959,11,female,1739,314,65,9,2,7,1,2,1
1922325,21,19,1992,3,female,648,306,239,9,4,9,2,0,2
1720920,108,30,1905,10,male,1613,304,207,9,8,9,7,0,1
2047492,16,28,1997,6,male,540,305,179,9,24,9,20,0,4
1055847,25,13,1988,2,male,450,314,163,9,60,9,32,0,28
1787804,33,6,1980,12,male,279,307,78,9,21,9,15,0,6
1601249,34,25,1979,4,female,1010,304,198,9,40,9,37,0,3
1239959,26,21,1987,9,female,440,312,188,10,4,0,0,10,4
1489066,14,12,1999,7,female,119,315,144,10,36,1,25,9,11
1232703,21,11,1992,9,male,615,319,139,10,0,4,0,6,0
2135889,18,1,1995,1,female,367,306,154,10,9,7,7,3,2
1030695,21,28,1992,9,male,793,317,206,10,1,10,0,0,1
1608484,18,17,1995,12,male,241,308,142,10,2,10,1,0,1
1566206,40,8,1973,10,female,1459,313,118,10,9,10,7,0,2
1926544,16,12,1997,9,female,110,306,271,10,48,10,30,0,18
1018113,18,15,1995,3,female,231,319,115,10,80,10,51,0,29
2058706,21,8,1992,12,female,425,317,86,10,194,10,146,0,48
1983752,33,10,1980,5,female,954,311,189,10,30,10,21,0,9
1368054,50,24,1963,1,female,367,315,275,11,1,0,1,11,0
2158184,15,22,1998,6,female,465,314,185,11,2,0,0,11,2
1843744,50,29,1963,5,female,741,305,166,11,150,0,61,11,89
1140328,103,9,1910,3,female,506,315,72,11,128,6,109,5,19
1479036,108,31,1905,8,male,1515,304,132,11,35,5,24,6,11
1836147,20,3,1993,3,male,536,311,277,11,5,11,5,0,0
1585506,103,11,1910,1,female,766,313,202,11,5,11,3,0,2
1208929,108,8,1905,8,female,1076,309,209,11,4,11,4,0,0
2103465,23,1,1990,1,male,218,312,279,11,40,11,37,0,3
1239331,25,28,1988,10,male,1010,306,165,11,249,11,217,0,32
1745353,68,17,1945,8,male,1760,319,44,11,49,11,25,0,24
1764255,17,28,1996,3,male,504,316,261,12,15,10,9,2,6
1064417,19,3,1994,10,male,410,319,256,12,15,11,14,1,1
1446278,18,18,1995,2,male,156,311,225,12,0,12,0,0,0
1522204,24,4,1989,3,male,252,308,76,12,0,12,0,0,0
1284907,21,5,1992,5,male,325,310,275,12,14,12,13,0,1
1622006,19,14,1994,11,female,243,310,48,12,23,12,22,0,1
1191410,33,15,1980,5,male,367,319,45,12,36,12,35,0,1
1021113,108,5,1905,2,female,1283,316,196,12,71,12,48,0,23
1957379,112,28,1901,1,male,1497,312,75,13,4,0,4,13,0
1409518,21,18,1992,9,male,717,315,237,13,7,6,5,7,2
1256189,27,10,1986,11,male,1019,308,174,13,28,4,24,9,4
1742600,25,18,1988,5,male,324,311,102,13,33,10,23,3,10
1144837,21,13,1992,11,female,260,311,241,13,1,13,1,0,0
1128707,103,10,1910,11,male,1407,309,172,13,2,13,0,0,2
1214360,99,7,1914,4,female,745,307,142,13,6,13,6,0,0
1044010,21,10,1992,3,female,419,319,110,13,12,13,12,0,0
1073392,30,22,1983,3,male,536,318,220,13,24,13,20,0,4
1022800,30,24,1983,4,female,991,312,95,13,25,13,7,0,18
1191048,15,3,1998,8,male,465,312,210,14,17,0,4,14,13
1295779,53,22,1960,5,male,633,319,262,14,26,1,17,13,9
1675955,17,10,1996,10,male,748,317,237,14,4,14,4,0,0
1898383,87,14,1926,11,male,1007,309,120,15,13,3,8,12,5
1281112,33,1,1980,9,male,1682,315,31,15,67,12,47,3,20
2154029,14,16,1999,7,female,454,307,255,15,9,15,6,0,3
1347226,18,10,1995,9,male,556,308,83,15,9,15,9,0,0
1641583,22,12,1991,9,male,264,305,275,15,8,15,8,0,0
1654810,26,28,1987,3,female,495,318,126,15,7,15,7,0,0
1141305,94,12,1919,9,male,980,310,206,15,5,15,5,0,0
1586132,21,6,1992,9,female,177,312,215,15,49,15,23,0,26
2122677,33,9,1980,7,female,331,316,183,15,40,15,34,0,6
1299253,45,6,1968,10,female,284,317,107,15,145,15,116,0,29
1953649,14,24,1999,4,male,50,306,116,16,17,11,3,5,14
1269912,24,13,1989,7,female,361,309,245,16,4,14,4,2,0
1987289,113,1,1900,1,male,1391,315,168,16,18,16,14,0,4
1965476,17,7,1996,1,male,725,304,281,17,2,11,2,6,0
1227705,20,30,1993,12,male,624,305,234,17,59,8,46,9,13
1397363,15,1,1998,5,male,377,313,241,17,2,17,2,0,0
1749228,19,30,1994,6,male,353,314,202,17,5,17,4,0,1
2110827,34,30,1979,11,male,542,310,230,18,50,2,16,16,34
1683191,15,18,1998,8,female,340,308,145,18,21,11,13,7,8
1064677,26,6,1987,11,male,580,308,239,18,1,18,1,0,0
1785955,29,10,1984,2,male,1466,318,136,18,3,18,2,0,1
1833142,21,25,1992,8,female,533,310,17,18,16,18,12,0,4
1195584,93,6,1920,1,male,1662,317,55,18,95,18,61,0,34
1812472,15,6,1998,5,male,491,307,250,19,24,3,8,16,16
1192736,18,11,1995,10,female,303,304,178,19,29,17,14,2,15
1585896,18,6,1995,10,male,543,304,206,19,1,19,1,0,0
1910229,25,24,1988,4,female,774,309,230,19,0,19,0,0,0
1294546,21,5,1992,11,female,754,308,194,19,4,19,4,0,0
1988753,17,1,1996,1,male,232,318,138,19,36,19,28,0,8
1674872,20,30,1993,6,female,630,310,114,19,139,19,104,0,35
2164768,21,13,1992,10,female,29,304,132,19,96,19,74,0,22
1159194,18,8,1995,6,male,342,309,151,20,4,20,4,0,0
1225429,50,12,1963,10,female,905,315,142,21,69,20,42,1,27
1655175,107,23,1906,10,male,1495,304,101,21,24,21,20,0,4
1004373,28,10,1985,12,male,251,309,287,21,41,21,27,0,14
1996549,35,12,1978,3,female,46,318,148,21,440,21,328,0,112
1302544,14,26,1999,10,male,303,304,206,22,2,0,1,22,1
2125026,33,1,1980,1,male,50,313,52,22,141,21,112,1,29
1238262,20,5,1993,5,male,537,304,281,22,1,22,0,0,1
1558029,21,24,1992,9,male,268,304,270,22,27,22,20,0,7
1976102,20,21,1993,9,female,374,310,98,22,430,22,360,0,70
1246451,24,17,1989,6,male,248,312,259,22,128,22,108,0,20
1249833,24,7,1989,9,female,60,316,130,22,43,22,41,0,2
1714032,22,10,1991,6,female,500,318,112,23,9,0,5,23,4
2149517,52,9,1961,8,female,697,305,92,23,52,0,2,23,50
1945994,20,29,1993,6,female,967,318,61,23,31,21,24,2,7
1975419,17,8,1996,1,male,495,311,233,23,11,23,9,0,2
1400495,24,21,1989,4,female,527,307,252,23,74,23,47,0,27
1831490,99,9,1914,1,male,2247,315,205,24,15,3,9,21,6
2018869,21,6,1992,10,male,203,310,211,24,0,24,0,0,0
2175653,18,10,1995,8,male,653,319,208,24,12,24,8,0,4
1673753,98,31,1915,12,female,743,318,208,24,7,24,6,0,1
1523189,16,18,1997,2,male,217,316,253,24,34,24,18,0,16
1357513,17,10,1996,10,male,609,318,237,25,10,25,3,0,7
1063866,36,14,1977,7,female,615,317,204,25,5,25,5,0,0
2174289,108,13,1905,4,female,66,311,64,25,16,25,15,0,1
1115266,24,1,1989,4,male,554,312,236,25,166,25,70,0,96
1889815,34,26,1979,4,female,261,304,175,25,38,25,18,0,20
1060806,16,5,1997,7,male,238,307,276,26,1,0,0,26,1
1173284,32,10,1981,2,male,572,315,207,26,15,0,3,26,12
1531609,103,12,1910,6,male,827,308,186,26,15,1,2,25,13
1792248,25,5,1988,9,male,1392,309,171,26,788,0,601,26,187
1733113,84,4,1929,8,female,798,305,3,26,56,1,14,25,42
1254198,27,19,1986,8,male,1682,311,117,26,78,19,54,7,24
1494236,15,8,1998,8,male,522,312,184,26,22,26,17,0,5
1315446,18,15,1995,2,male,452,307,225,26,30,26,18,0,12
1236108,38,23,1975,3,male,1198,312,162,26,25,26,18,0,7
1799418,40,2,1973,12,male,484,313,116,26,109,26,62,0,47
1453944,91,31,1922,10,female,1080,304,135,27,160,3,36,24,124
1762198,108,7,1905,3,male,983,307,175,27,15,27,11,0,4
1281574,21,30,1992,6,female,804,311,242,27,17,27,13,0,4
1562336,18,15,1995,7,female,684,305,159,27,65,27,54,0,11
2139538,51,2,1962,5,male,685,306,195,28,3,28,3,0,0
1880117,17,22,1996,6,male,1384,305,221,28,12,28,12,0,0
2061576,20,28,1993,2,female,305,314,127,28,331,28,209,0,122
1145837,29,29,1984,12,female,514,315,237,29,161,6,90,23,71
2011259,22,1,1991,12,male,504,311,292,29,26,29,25,0,1
1809640,17,26,1996,10,female,19,313,304,29,86,29,78,0,8
1319011,25,5,1988,1,male,554,309,95,29,116,29,110,0,6
1631059,29,10,1984,8,male,689,309,19,29,244,29,139,0,105
1498068,15,23,1998,5,male,167,306,289,30,35,0,22,30,13
2017740,18,30,1995,9,male,164,307,174,31,19,0,0,31,19
1023667,22,6,1991,11,female,250,307,49,30,15,20,13,10,2
1423536,15,2,1998,10,female,324,306,235,31,0,27,0,4,0
1456861,108,15,1905,5,male,1734,314,70,31,0,29,0,2,0
1723616,22,20,1991,11,male,401,318,269,30,37,27,24,3,13
1821415,17,6,1996,6,male,419,312,151,31,18,31,15,0,3
1552821,24,25,1989,8,male,634,318,257,30,12,30,12,0,0
2102490,108,31,1905,7,male,960,319,182,30,7,30,6,0,1
1332168,24,4,1989,8,male,1492,306,227,31,43,31,34,0,9
1975714,58,1,1955,11,female,1358,307,56,30,34,30,16,0,18
1295838,17,1,1996,12,female,521,311,179,31,52,31,43,0,9
1625467,18,29,1995,7,male,123,313,224,31,117,31,92,0,25
1297781,22,15,1991,2,female,389,308,110,30,70,30,60,0,10
1589528,34,6,1979,12,female,538,314,192,33,59,14,38,19,21
2016802,18,7,1995,7,male,737,317,261,33,14,33,8,0,6
1359416,14,4,1999,2,male,142,304,271,33,34,33,34,0,0
1151424,68,3,1945,4,male,912,314,226,34,18,0,15,34,3
1803361,89,11,1924,12,male,1923,312,155,34,57,24,15,10,42
2039234,22,16,1991,7,male,1095,309,165,34,4,28,2,6,2
1313318,19,26,1994,7,male,263,308,147,34,45,34,11,0,34
1988281,25,31,1988,8,male,321,309,221,34,44,34,32,0,12
1761864,33,25,1980,6,male,599,316,268,34,47,34,34,0,13
1681847,21,2,1992,2,male,357,314,269,34,148,34,65,0,83
1141456,16,24,1997,5,male,373,317,88,36,3,0,1,36,2
1817937,69,29,1944,5,male,316,312,19,35,75,0,33,35,42
1156260,18,2,1995,12,female,288,308,231,35,113,17,56,18,57
1471339,35,30,1978,11,female,661,308,199,36,318,11,122,25,196
1036908,55,13,1958,8,male,882,315,133,36,93,11,27,25,66
1136702,58,31,1955,1,female,1295,315,236,36,26,28,15,8,11
1558900,16,22,1997,9,female,151,311,118,35,9,35,8,0,1
1968421,18,11,1995,12,male,583,314,208,35,18,35,14,0,4
1008799,25,8,1988,5,male,723,314,170,36,17,36,16,0,1
1302527,26,11,1987,11,male,575,314,263,36,26,36,22,0,4
1956997,31,5,1982,10,male,1488,316,140,36,39,36,33,0,6
1459444,20,30,1993,1,male,1583,315,82,36,110,36,92,0,18
1463038,20,11,1993,3,male,965,312,164,37,152,3,76,34,76
1243241,25,1,1988,1,male,354,306,143,37,20,37,13,0,7
1286218,18,8,1995,2,male,311,317,189,37,44,37,39,0,5
1331769,15,8,1998,1,female,554,309,227,38,0,3,0,35,0
1115008,16,19,1997,8,male,549,308,156,39,29,5,11,34,18
1127456,21,16,1992,2,male,636,306,188,39,42,37,23,2,19
1903484,19,29,1994,7,male,427,306,259,38,59,36,46,2,13
1607825,22,11,1991,8,male,1061,309,205,39,4,39,3,0,1
1687213,27,28,1986,12,male,1726,308,134,38,32,38,25,0,7
1420710,30,15,1983,9,female,389,308,183,38,81,38,77,0,4
1025500,40,8,1973,7,female,350,305,93,38,98,38,49,0,49
1004428,103,12,1910,1,male,972,305,226,38,142,38,134,0,8
1087416,35,18,1978,1,male,240,317,242,40,122,1,41,39,81
1434117,27,15,1986,12,male,358,314,177,40,59,39,30,1,29
1911808,20,8,1993,6,male,519,305,222,40,17,40,16,0,1
1580663,22,26,1991,4,female,495,316,204,40,71,40,28,0,43
2108398,16,29,1997,3,male,643,309,216,41,4,0,1,41,3
1222439,41,22,1972,9,male,466,311,303,41,8,11,5,30,3
1161651,27,4,1986,3,male,533,310,205,41,50,15,12,26,38
1473982,20,10,1993,5,female,389,309,227,42,199,20,130,22,69
2193522,22,29,1991,9,male,407,313,278,42,27,42,16,0,11
1611712,23,8,1990,4,female,305,305,62,42,44,42,20,0,24
1518619,34,30,1979,12,male,1003,318,155,42,40,42,33,0,7
1478129,25,17,1988,1,male,77,319,303,41,121,41,117,0,4
1813330,15,22,1998,7,female,381,307,182,44,74,23,63,21,11
1626774,20,2,1993,6,male,1485,316,148,43,23,43,12,0,11
1060770,43,15,1970,1,female,1347,308,119,43,26,43,22,0,4
2144366,103,3,1910,7,male,1539,317,227,44,34,44,18,0,16
1560765,68,3,1945,10,male,1446,316,100,43,66,43,64,0,2
1509262,102,21,1911,10,male,770,309,111,45,35,45,33,0,2
1520941,20,7,1993,1,female,236,306,259,45,122,45,93,0,29
2193059,14,21,1999,9,male,433,316,205,47,57,1,12,46,45
1363093,35,9,1978,1,male,528,309,265,47,94,0,35,47,59
1232041,17,23,1996,6,male,176,315,179,46,42,17,20,29,22
1833612,16,14,1997,12,male,55,318,296,46,43,44,43,2,0
1956443,27,8,1986,7,male,174,314,208,46,15,46,7,0,8
1979622,23,24,1990,6,female,659,305,101,47,44,47,22,0,22
1028853,25,23,1988,3,male,302,306,263,46,74,46,52,0,22
1388232,50,11,1963,3,female,683,304,225,49,351,5,42,44,309
1509203,29,20,1984,8,male,244,315,210,48,33,32,16,16,17
1786601,56,8,1957,1,female,1858,306,107,48,107,16,84,32,23
2180569,17,10,1996,10,male,157,308,287,49,2,49,0,0,2
1509145,97,4,1916,1,male,1906,311,137,49,10,49,10,0,0
1807158,19,4,1994,3,female,1423,306,58,48,134,48,125,0,9
1942883,31,25,1982,12,male,634,308,166,50,3,30,0,20,3
1458346,19,7,1994,3,male,123,308,272,50,64,28,53,22,11
1028309,21,12,1992,7,male,176,310,198,50,57,28,35,22,22
1253943,105,15,1908,4,female,1809,307,138,51,47,18,39,33,8
1147040,13,2,2000,6,male,99,315,255,51,38,50,19,1,19
2027610,20,24,1993,8,female,321,305,60,51,57,49,34,2,23
1762484,18,20,1995,12,female,335,308,41,51,78,50,60,1,18
1507605,113,31,1900,12,female,2225,305,212,50,77,50,41,0,36
1693017,20,24,1993,1,male,380,308,132,53,51,9,25,44,26
1581232,106,5,1907,7,male,1878,316,204,53,133,18,42,35,91
2140069,19,28,1994,3,female,481,310,80,53,32,50,17,3,15
1572590,80,29,1933,7,male,157,308,251,52,71,40,12,12,59
1237335,17,28,1996,5,male,428,312,18,53,61,53,40,0,21
1633799,21,15,1992,1,female,597,315,30,52,60,52,54,0,6
1841526,38,12,1975,12,female,908,311,205,53,92,53,56,0,36
1933609,17,28,1996,2,female,159,304,213,54,10,0,2,54,8
1645891,18,1,1995,1,female,416,316,109,55,334,0,18,55,316
1362101,106,2,1907,3,male,1989,315,171,55,3,49,1,6,2
1322395,20,19,1993,2,female,235,311,257,55,71,40,51,15,20
1015851,96,15,1917,6,male,1429,317,125,54,43,53,29,1,14
2151859,108,16,1905,12,male,1854,314,119,54,4,54,2,0,2
1388453,17,29,1996,9,female,536,307,197,54,134,54,67,0,67
1867743,16,29,1997,7,male,372,315,253,58,32,13,9,45,23
1080970,19,7,1994,3,male,674,305,180,59,0,8,0,51,0
1196565,17,21,1996,5,female,486,310,63,59,67,6,19,53,48
1923016,18,12,1995,9,female,607,319,174,60,104,3,31,57,73
1760663,17,15,1996,11,male,718,308,192,60,10,15,1,45,9
1185677,15,20,1998,8,female,117,305,98,59,172,57,141,2,31
1359012,20,5,1993,8,male,581,314,195,60,3,60,3,0,0
2021531,27,1,1986,7,female,405,310,81,60,25,60,18,0,7
1510059,33,18,1980,6,male,858,309,262,60,163,60,156,0,7
1163613,26,17,1987,12,female,253,312,160,63,116,3,62,60,54
1688736,20,16,1993,12,female,404,304,177,62,17,16,9,46,8
1381448,33,2,1980,10,male,520,306,103,62,67,60,30,2,37
1854549,45,11,1968,4,male,419,318,251,62,50,62,35,0,15
2116087,55,17,1958,9,female,627,313,217,63,87,63,56,0,31
1492695,24,19,1989,7,female,554,305,252,62,133,62,108,0,25
1394438,108,12,1905,3,male,1139,315,86,64,9,0,4,64,5
1828031,38,21,1975,8,female,529,304,143,65,206,63,61,2,145
1164884,29,16,1984,11,female,566,305,162,65,4,65,4,0,0
2042966,26,12,1987,5,male,1101,315,139,64,19,64,10,0,9
2037699,19,31,1994,5,male,583,316,240,64,79,64,57,0,22
1656714,23,6,1990,4,male,296,304,249,67,178,33,104,34,74
1542858,16,21,1997,4,female,227,309,189,66,57,65,40,1,17
1232129,18,8,1995,3,female,266,318,46,68,72,67,28,1,44
1665699,28,9,1985,3,female,1170,312,158,67,70,67,45,0,25
1088141,93,13,1920,11,female,254,314,87,67,51,67,49,0,2
2181574,17,28,1996,6,female,276,307,239,68,320,68,281,0,39
2051600,16,26,1997,11,female,368,319,266,69,101,11,45,58,56
1317841,17,15,1996,7,male,789,304,196,71,3,41,1,30,2
1582329,18,8,1995,4,female,52,310,34,70,354,65,125,5,229
1929245,23,22,1990,9,female,279,316,62,70,53,70,52,0,1
1748662,16,29,1997,5,male,346,313,260,69,139,69,119,0,20
1699671,71,2,1942,2,female,659,314,156,74,44,0,9,74,35
1096951,17,13,1996,1,male,432,307,148,74,57,10,5,64,52
1790432,108,30,1905,5,female,1413,305,173,73,96,2,17,71,79
2187641,39,18,1974,11,female,1597,315,42,74,39,74,24,0,15
1625003,50,7,1963,6,female,1846,317,95,73,63,73,31,0,32
1056327,53,28,1960,12,female,1798,315,125,74,166,74,73,0,93
1018269,108,20,1905,8,female,992,318,81,76,73,0,30,76,43
1079370,20,22,1993,11,male,637,315,187,76,35,53,21,23,14
1510992,46,22,1967,3,male,180,312,289,77,8,72,8,5,0
1079472,14,12,1999,6,male,493,305,215,75,36,73,14,2,22
1739583,34,15,1979,6,male,775,318,94,75,211,59,40,16,171
2066718,23,9,1990,12,female,248,306,108,80,6,49,2,31,4
1865553,108,22,1905,11,male,1258,312,211,79,27,61,13,18,14
2163037,16,13,1997,10,female,472,308,101,78,163,66,40,12,123
1988689,18,16,1995,6,male,708,304,196,79,48,79,38,0,10
1087325,104,20,1909,1,male,149,304,237,79,15,79,13,0,2
1076324,22,14,1991,9,male,924,315,139,78,67,78,34,0,33
1354307,108,12,1905,3,female,1040,305,161,78,49,78,43,0,6
1388561,17,1,1996,1,female,31,312,56,79,210,79,170,0,40
2112016,30,3,1983,9,female,936,312,222,84,48,22,12,62,36
1337122,16,26,1997,9,female,146,309,286,84,10,72,5,12,5
1016423,27,18,1986,2,male,125,307,290,82,49,61,38,21,11
1959841,26,15,1987,10,female,1003,307,159,82,76,82,48,0,28
1672595,51,26,1962,12,female,2182,318,154,83,58,83,45,0,13
1731398,108,13,1905,1,female,1705,308,180,86,39,21,19,65,20
1126120,19,10,1994,9,female,1684,316,129,85,73,61,38,24,35
1399389,18,28,1995,11,female,368,312,161,85,132,50,98,35,34
1043283,23,15,1990,11,female,391,315,272,86,147,82,92,4,55
2126252,47,10,1966,8,male,918,314,123,86,145,74,82,12,63
1455378,15,28,1998,2,female,243,306,58,87,146,87,138,0,8
1834854,23,27,1990,8,female,710,312,224,86,581,86,517,0,64
1739671,14,28,1999,1,male,410,309,189,91,12,1,9,90,3
1774597,15,25,1998,3,male,704,316,227,88,22,28,3,60,19
1122921,19,3,1994,8,male,492,312,260,88,98,26,54,62,44
1637823,49,17,1964,6,male,553,319,192,89,303,29,103,60,200
1827009,77,1,1936,8,male,753,304,158,90,191,51,109,39,82
1816055,16,10,1997,3,male,326,311,136,88,13,88,12,0,1
1816226,23,4,1990,10,male,150,318,293,91,60,91,41,0,19
2014619,44,11,1969,5,male,604,305,252,91,133,91,130,0,3
1987785,46,16,1967,12,female,686,311,190,89,190,89,145,0,45
1415117,21,2,1992,2,female,490,319,166,95,23,1,3,94,20
2070262,22,2,1991,7,male,788,310,107,94,82,64,34,30,48
1265810,90,29,1923,10,female,794,314,29,93,361,82,145,11,216
2184503,14,8,1999,2,female,447,308,197,94,38,94,34,0,4
1434690,108,30,1905,9,male,906,305,134,95,18,95,17,0,1
1771751,21,23,1992,3,male,1575,319,179,94,77,94,31,0,46
1844835,50,5,1963,9,female,1920,312,120,93,179,93,128,0,51
1764242,51,26,1962,9,female,1370,306,119,96,27,0,7,96,20
1470800,74,16,1939,10,female,537,317,222,98,36,0,6,98,30
1423943,107,6,1906,5,female,2251,315,129,96,35,18,13,78,22
1489495,23,18,1990,7,male,268,314,268,96,150,43,94,53,56
1006982,24,8,1989,8,male,877,315,263,98,42,97,33,1,9
1286568,65,20,1948,8,male,912,319,164,96,9,96,4,0,5
1629356,25,22,1988,4,female,483,317,176,99,110,99,94,0,16
1571916,100,31,1913,3,female,169,315,197,97,409,97,356,0,53
2047095,25,21,1988,4,female,1130,319,54,103,56,89,8,14,48
1400749,113,16,1900,12,female,1667,307,60,100,111,100,86,0,25
2170268,18,18,1995,12,female,172,310,117,100,191,100,136,0,55
1812884,83,17,1930,6,female,1954,314,245,107,133,0,24,107,109
2142486,16,30,1997,1,female,174,307,233,107,74,42,49,65,25
1904404,17,5,1996,7,male,420,317,150,105,142,105,129,0,13
2128303,18,30,1995,3,male,317,313,227,109,145,109,83,0,62
1782066,21,2,1992,2,male,617,307,132,106,73,106,70,0,3
2108930,18,29,1995,12,male,174,305,237,107,339,107,269,0,70
1553429,21,4,1992,6,female,372,314,95,107,300,107,155,0,145
2071797,24,2,1989,5,female,67,314,290,107,457,107,431,0,26
1477208,22,5,1991,4,male,367,305,247,111,8,34,0,77,8
1351664,23,14,1990,11,male,570,311,203,112,61,33,28,79,33
1157163,24,17,1989,8,male,910,315,225,111,100,80,45,31,55
1244389,33,12,1980,1,female,1534,304,78,113,397,69,254,44,143
2131499,22,13,1991,8,male,527,309,163,113,64,104,18,9,46
1234018,16,17,1997,6,male,521,312,80,111,185,85,146,26,39
1744728,20,20,1993,8,male,353,318,249,111,169,96,75,15,94
1702959,18,28,1995,6,female,498,311,150,112,582,112,256,0,326
1540080,55,1,1958,12,female,1710,315,111,111,419,111,158,0,261
2139328,81,16,1932,11,male,730,316,229,114,4,0,0,114,4
1586730,108,26,1905,8,male,1752,308,212,114,24,10,9,104,15
1384313,23,9,1990,7,male,1551,308,178,115,85,2,39,113,46
1666347,108,2,1905,3,female,1010,305,170,116,64,55,38,61,26
1391506,18,17,1995,8,male,226,310,246,117,153,54,36,63,117
2152960,22,19,1991,3,male,293,317,251,118,96,118,67,0,29
1976208,23,3,1990,10,female,655,317,220,115,115,115,100,0,15
1740865,17,5,1996,6,female,438,317,176,120,42,27,21,93,21
1452093,19,20,1994,4,male,113,318,276,123,72,70,36,53,36
1968631,43,28,1970,8,female,1380,310,229,122,36,120,20,2,16
1481642,19,10,1994,11,male,245,305,247,124,3,124,3,0,0
1534831,22,19,1991,8,male,201,310,225,124,63,124,23,0,40
2073979,19,21,1994,5,female,423,311,162,121,117,121,59,0,58
1651042,17,15,1996,4,male,882,305,76,130,463,25,265,105,198
2127552,25,20,1988,2,female,91,306,267,129,156,71,101,58,55
1683493,21,19,1992,6,female,370,306,129,128,264,90,129,38,135
1145411,28,24,1985,10,female,178,311,196,125,513,54,210,71,303
1838065,22,1,1991,11,female,241,311,106,125,90,106,77,19,13
1980301,103,18,1910,1,female,89,317,289,127,33,127,28,0,5
1281068,19,1,1994,1,male,42,310,110,125,160,125,145,0,15
1614896,46,10,1967,5,female,459,310,154,134,66,0,15,134,51
2186019,23,7,1990,9,male,193,310,274,134,129,0,105,134,24
1396431,73,16,1940,9,female,1539,310,177,133,90,0,65,133,25
1319191,21,25,1992,12,male,549,312,258,135,34,112,18,23,16
1975195,26,1,1987,5,male,365,306,181,131,58,120,57,11,1
2091885,17,1,1996,12,female,246,307,223,136,253,130,154,6,99
1271674,17,14,1996,12,male,631,316,168,134,131,133,51,1,80
1069631,25,15,1988,10,male,1011,310,168,134,72,134,70,0,2
1567558,14,19,1999,9,male,326,312,104,139,65,70,45,69,20
1640086,93,3,1920,11,female,2211,312,181,138,77,94,33,44,44
2173581,14,7,1999,11,female,357,317,109,137,16,126,8,11,8
1837681,26,21,1987,11,female,217,304,258,138,17,138,9,0,8
2179743,19,9,1994,7,female,552,315,186,143,67,143,66,0,1
1869149,37,6,1976,11,female,428,311,108,139,700,139,442,0,258
1573277,49,25,1964,6,male,1607,305,201,140,282,140,206,0,76
1398448,19,21,1994,9,female,390,310,228,146,63,53,18,93,45
1103303,17,11,1996,10,female,162,313,227,150,154,91,85,59,69
1593814,17,17,1996,4,female,54,307,114,144,258,82,209,62,49
1713215,43,12,1970,1,female,530,317,254,147,114,112,70,35,44
1751614,55,24,1958,8,female,2315,310,150,147,115,145,85,2,30
2098981,26,1,1987,1,male,440,307,256,145,10,145,10,0,0
2060328,18,8,1995,6,male,102,313,280,149,25,149,21,0,4
1604397,19,4,1994,10,male,308,310,206,145,111,145,78,0,33
2084320,29,6,1984,1,female,201,319,73,147,204,147,161,0,43
1098035,36,19,1977,3,female,984,308,241,146,193,146,171,0,22
2120106,58,19,1955,11,male,937,311,210,147,151,147,112,0,39
1215809,32,17,1981,2,male,231,308,211,150,288,150,285,0,3
1163226,20,30,1993,4,female,384,317,251,153,64,23,10,130,54
1720962,55,20,1958,12,female,666,307,153,152,514,1,175,151,339
1150393,108,28,1905,4,female,1838,310,170,154,74,44,21,110,53
1769840,26,18,1987,5,male,112,319,204,157,353,65,188,92,165
1252733,48,14,1965,7,male,803,311,209,156,94,143,61,13,33
1992236,21,30,1992,1,female,658,310,128,157,169,120,83,37,86
2151390,23,2,1990,1,female,723,317,195,154,233,121,104,33,129
1268247,30,5,1983,10,female,428,307,137,157,269,155,96,2,173
1169669,37,20,1976,4,male,273,311,177,155,275,152,236,3,39
1767707,75,24,1938,1,female,2009,316,125,157,13,156,4,1,9
1185843,22,23,1991,12,female,381,310,159,157,203,157,167,0,36
1073061,21,6,1992,10,female,527,316,177,156,285,156,269,0,16
1105965,30,21,1983,8,female,1448,307,92,153,279,153,160,0,119
1738834,32,28,1981,1,female,235,307,204,162,67,3,5,159,62
1600391,13,8,2000,7,female,94,316,249,158,105,23,75,135,30
1087056,21,25,1992,10,male,239,316,254,162,113,5,40,157,73
2064822,66,21,1947,10,male,1746,318,111,159,112,110,55,49,57
2001066,17,18,1996,10,female,776,310,98,163,104,149,41,14,63
1855155,108,26,1905,3,female,1403,318,106,161,139,152,92,9,47
1922973,15,10,1998,12,female,110,317,187,164,28,164,23,0,5
1118841,20,21,1993,8,female,503,304,129,162,218,162,89,0,129
1085540,18,14,1995,12,male,1092,308,249,171,21,28,13,143,8
1690114,20,20,1993,9,male,440,309,144,169,87,147,43,22,44
1239112,22,1,1991,1,male,686,315,219,169,81,169,59,0,22
1624123,23,27,1990,2,female,556,315,126,172,30,172,19,0,11
1330854,26,4,1987,5,male,408,318,255,170,230,170,165,0,65
1101207,29,10,1984,6,female,139,312,132,169,121,169,79,0,42
1578368,90,12,1923,8,female,1733,313,97,171,309,171,276,0,33
1064490,20,15,1993,7,male,506,311,79,181,16,61,8,120,8
1375148,55,12,1958,7,male,2211,311,179,177,86,49,50,128,36
1820872,21,15,1992,10,male,749,309,96,178,193,160,134,18,59
1492489,17,4,1996,11,male,752,314,120,178,39,177,27,1,12
1540869,26,17,1987,1,male,592,311,241,175,0,175,0,0,0
1013244,25,10,1988,12,female,303,312,256,176,67,176,58,0,9
2026295,100,30,1913,3,male,233,316,283,174,42,174,38,0,4
2012013,17,22,1996,8,female,266,308,77,180,228,180,113,0,115
2176268,20,21,1993,4,female,204,305,43,176,195,176,151,0,44
1350407,102,21,1911,9,female,1762,312,85,186,561,117,335,69,226
1959267,15,24,1998,1,female,596,306,172,186,163,178,111,8,52
1507065,48,5,1965,12,male,493,315,210,184,259,154,125,30,134
1190531,49,8,1964,6,female,757,318,89,185,5,185,3,0,2
1783441,43,10,1970,11,male,46,309,232,183,54,183,41,0,13
1230062,50,9,1963,8,female,626,319,269,182,31,182,16,0,15
1522323,18,5,1995,9,male,475,315,234,186,115,186,102,0,13
1807268,19,7,1994,5,male,102,312,282,189,137,189,88,0,49
1674176,23,3,1990,12,male,193,312,161,186,145,186,70,0,75
1261583,36,21,1977,3,female,416,309,218,190,239,190,141,0,98
1058740,41,28,1972,4,female,614,306,221,185,140,185,113,0,27
1067019,75,1,1938,1,female,1399,318,43,192,125,14,67,178,58
2020183,108,10,1905,11,male,1935,306,129,192,175,0,96,192,79
1643968,94,4,1919,5,male,1074,310,232,194,19,109,18,85,1
1453705,20,6,1993,9,female,14,316,246,191,394,74,250,117,144
1352157,107,13,1906,1,male,2269,314,213,196,560,74,271,122,289
1228738,19,7,1994,7,male,178,318,267,196,116,196,108,0,8
1483831,21,18,1992,11,male,163,311,257,194,44,194,28,0,16
1041971,16,30,1997,6,male,92,304,236,191,140,191,114,0,26
1735619,21,21,1992,3,male,507,319,102,211,167,12,117,199,50
2065956,24,7,1989,7,female,408,314,165,208,75,150,15,58,60
1836993,18,4,1995,8,female,392,314,159,202,349,131,144,71,205
1477427,18,22,1995,7,male,163,309,236,203,22,177,9,26,13
1852337,46,18,1967,10,female,1663,312,62,212,569,86,274,126,295
1319980,15,6,1998,7,female,205,309,285,214,55,159,22,55,33
2186830,18,14,1995,8,female,437,306,103,217,205,183,117,34,88
1194430,20,11,1993,7,male,1026,314,243,214,135,213,112,1,23
2086919,44,29,1969,12,female,592,312,227,215,17,215,13,0,4
1770247,24,11,1989,10,male,98,314,297,212,72,212,64,0,8
1244798,21,30,1992,3,female,666,318,213,225,162,5,33,220,129
1647820,106,21,1907,9,male,1884,310,203,225,78,112,38,113,40
1352600,58,19,1955,3,male,1080,313,195,233,209,89,126,144,83
1300343,48,15,1965,7,male,376,305,203,231,2,178,1,53,1
1731691,20,29,1993,8,male,580,313,229,232,292,171,97,61,195
1863754,31,1,1982,10,female,319,304,258,225,72,225,38,0,34
2109229,100,7,1913,2,female,1561,310,119,233,203,233,180,0,23
2152391,18,23,1995,3,female,241,312,203,225,434,225,197,0,237
2147381,103,1,1910,1,male,1154,317,238,242,91,5,17,237,74
2000880,28,13,1985,2,female,185,317,165,236,70,72,51,164,19
1829558,25,30,1988,7,female,550,306,190,238,194,94,22,144,172
1666915,48,21,1965,9,female,208,315,254,245,202,85,155,160,47
1280220,15,9,1998,3,female,648,307,108,243,102,238,53,5,49
2038768,26,1,1987,1,male,262,306,295,244,99,210,87,34,12
1248237,55,16,1958,8,female,1270,305,155,234,351,219,159,15,192
1841554,20,17,1993,7,female,206,312,124,234,94,234,65,0,29
1511297,18,1,1995,1,male,658,307,232,244,267,244,158,0,109
1005676,20,18,1993,8,male,42,319,215,245,281,245,262,0,19
1226814,26,12,1987,8,male,885,305,181,234,483,234,453,0,30
1152600,30,12,1983,10,female,140,314,143,243,708,243,498,0,210
1142768,19,10,1994,7,female,323,304,115,257,87,0,38,257,49
1249814,14,25,1999,12,female,142,315,190,259,88,65,67,194,21
1323862,17,25,1996,11,female,78,312,220,260,429,92,358,168,71
1128283,21,20,1992,9,male,984,311,216,257,4,249,0,8,4
1740469,18,28,1995,9,female,197,312,54,256,96,251,55,5,41
2134665,19,23,1994,6,female,339,312,171,257,54,246,31,11,23
2060068,21,11,1992,5,male,550,308,176,256,150,220,89,36,61
1702977,19,7,1994,5,female,584,319,205,258,359,258,270,0,89
1019531,22,30,1991,5,male,334,312,225,256,290,256,154,0,136
2169936,25,27,1988,11,male,566,314,180,258,165,258,155,0,10
1617376,41,23,1972,2,female,365,309,202,260,168,260,166,0,2
2132355,44,22,1969,4,female,411,317,120,256,177,256,147,0,30
1577216,20,22,1993,10,female,257,312,289,269,303,27,64,242,239
2160842,31,4,1982,6,female,1750,304,173,264,283,117,170,147,113
1651731,25,8,1988,7,female,501,309,219,263,394,257,344,6,50
1147125,15,26,1998,9,female,131,311,98,264,446,254,186,10,260
1595530,47,1,1966,4,female,1825,310,212,271,572,252,522,19,50
1470196,19,29,1994,9,male,365,318,55,276,79,276,61,0,18
1916772,47,7,1966,12,female,2065,319,191,261,48,261,23,0,25
1243313,22,8,1991,3,female,178,313,249,283,171,1,58,282,113
1950692,25,2,1988,6,male,506,315,249,283,172,53,127,230,45
1158386,69,13,1944,3,male,1155,315,131,279,56,0,26,279,30
1799828,18,15,1995,6,female,66,312,112,281,268,41,150,240,118
1738474,96,11,1917,10,female,2063,311,201,278,61,213,38,65,23
1404740,21,25,1992,5,female,598,316,145,285,299,258,206,27,93
1943531,45,28,1968,9,female,1684,317,233,289,125,288,38,1,87
1034904,28,9,1985,4,male,256,318,248,283,284,283,243,0,41
1573479,37,21,1976,8,female,504,305,253,282,246,282,212,0,34
1083107,17,1,1996,8,male,343,316,169,294,73,0,40,294,33
1335142,53,11,1960,2,female,1298,312,156,303,72,0,41,303,31
1837784,51,30,1962,8,female,1839,314,245,308,198,51,64,257,134
2020847,17,26,1996,7,female,642,317,174,294,525,210,243,84,282
1946194,31,1,1982,7,male,95,310,225,306,722,219,401,87,321
1406289,30,25,1983,2,female,1253,314,197,306,801,285,357,21,444
1241875,24,12,1989,2,male,762,308,248,307,213,307,167,0,46
2084845,35,21,1978,12,male,527,313,217,312,18,100,11,212,7
1928998,21,4,1992,7,female,1067,312,94,315,414,113,128,202,286
1799822,16,27,1997,12,female,586,311,122,323,578,265,432,58,146
2055360,16,1,1997,1,male,497,305,249,317,29,316,24,1,5
1303850,108,6,1905,8,female,2238,317,160,317,125,316,107,1,18
1994428,66,16,1947,10,female,1785,313,210,317,377,315,255,2,122
2039723,52,30,1961,3,female,573,312,273,320,175,320,127,0,48
1916024,52,1,1961,1,male,51,313,272,324,256,324,245,0,11
1164589,19,5,1994,4,male,366,315,177,338,36,0,13,338,23
2039227,18,11,1995,6,male,378,306,153,334,129,231,78,103,51
1581700,56,27,1957,9,male,1475,304,229,340,201,171,115,169,86
1357449,22,9,1991,10,female,426,314,238,343,259,105,189,238,70
1952942,17,4,1996,4,male,423,308,245,334,995,73,323,261,672
2070325,60,11,1953,2,male,1442,309,141,343,203,290,82,53,121
1687892,13,26,2000,7,female,96,310,212,329,244,324,149,5,95
1318683,16,1,1997,10,male,236,305,266,334,210,295,147,39,63
1273900,27,2,1986,7,female,143,318,291,346,508,278,267,68,241
1890527,31,19,1982,9,male,710,318,212,345,441,320,197,25,244
1620983,33,11,1980,12,female,553,314,97,342,301,260,197,82,104
1760932,22,13,1991,7,male,488,319,207,337,173,337,112,0,61
1717791,16,27,1997,7,female,316,317,173,328,487,328,238,0,249
1311540,25,28,1988,7,male,271,315,254,335,286,335,228,0,58
1089316,27,22,1986,11,female,1686,319,192,340,520,340,509,0,11
2169295,51,20,1962,2,female,1831,316,106,358,213,153,101,205,112
1044962,19,10,1994,5,female,468,310,219,364,230,214,119,150,111
1401744,19,23,1994,9,male,753,317,210,350,292,75,200,275,92
1246605,55,1,1958,10,male,1747,313,111,360,523,225,249,135,274
2061791,60,18,1953,2,NA,1825,308,214,363,505,186,56,177,449
1603674,15,26,1998,1,female,365,318,151,350,144,341,88,9,56
1412382,30,18,1983,12,female,764,319,100,353,193,353,100,0,93
1304402,13,26,2000,6,male,94,308,178,366,239,366,196,0,43
1845621,18,29,1995,3,female,227,314,104,355,410,355,249,0,161
2141567,34,27,1979,5,female,1520,312,219,359,420,359,175,0,245
1934213,57,3,1956,9,male,211,312,162,373,189,0,60,373,129
1810567,25,2,1988,6,female,1887,306,167,389,238,71,117,318,121
1121975,32,11,1981,10,female,630,316,76,375,587,183,227,192,360
2050443,21,18,1992,3,male,656,319,216,392,1,387,1,5,0
1630690,22,30,1991,3,male,672,316,155,393,123,326,70,67,53
2056515,16,13,1997,3,female,514,318,155,386,342,328,145,58,197
1290102,54,19,1959,3,female,335,304,111,389,6,389,3,0,3
1357785,26,13,1987,8,female,418,315,73,383,294,383,181,0,113
1901132,18,26,1995,11,female,84,319,141,421,254,0,50,421,204
1525301,104,2,1909,7,female,1916,310,102,409,77,0,59,409,18
2046321,17,30,1996,1,male,423,317,249,415,25,386,18,29,7
1196686,16,4,1997,3,female,91,316,130,406,157,304,137,102,20
1732187,20,3,1993,4,male,215,306,275,413,99,363,69,50,30
1513277,102,28,1911,5,female,1908,317,209,421,133,386,107,35,26
1651513,19,11,1994,12,female,498,317,134,398,337,391,193,7,144
2154612,23,31,1990,12,female,328,309,147,399,462,333,337,66,125
1494748,38,18,1975,7,female,663,307,170,409,528,403,412,6,116
1332487,58,24,1955,4,female,1558,304,173,402,479,387,252,15,227
1669698,17,21,1996,7,female,85,313,212,419,806,403,319,16,487
1153192,28,15,1985,4,male,889,311,228,398,123,397,73,1,50
1832152,16,31,1997,12,male,860,319,209,395,3,395,2,0,1
1017530,22,1,1991,1,female,381,316,126,396,97,396,81,0,16
1243116,49,1,1964,6,female,438,310,259,410,196,410,61,0,135
1324222,108,16,1905,5,male,1892,306,146,398,74,398,40,0,34
1311573,16,9,1997,4,female,112,310,186,417,337,417,142,0,195
1319556,16,18,1997,2,female,570,304,207,447,260,49,138,398,122
1622598,108,20,1905,5,female,1435,308,166,432,326,0,65,432,261
1062666,15,20,1998,6,female,421,318,166,451,45,295,22,156,23
1892135,26,15,1987,6,female,1392,314,193,422,351,135,189,287,162
1958803,40,25,1973,8,female,876,313,145,423,388,249,102,174,286
1713036,25,8,1988,4,female,1105,307,153,447,911,191,517,256,394
2000362,42,8,1971,10,female,1154,305,183,430,1396,139,1087,291,309
1235662,18,13,1995,7,male,263,315,263,425,67,320,57,105,10
1294935,17,9,1996,11,female,500,308,220,446,232,371,153,75,79
1487923,13,23,2000,3,female,70,314,131,430,364,422,260,8,104
1081051,14,15,1999,2,female,355,312,147,449,561,405,373,44,188
1801629,17,9,1996,8,female,265,315,196,426,164,426,92,0,72
1879039,108,28,1905,9,female,1156,304,41,448,214,448,101,0,113
1501877,16,15,1997,6,female,414,307,139,445,381,445,327,0,54
1413221,26,12,1987,6,male,328,308,206,431,472,431,392,0,80
1196203,19,27,1994,7,female,232,310,89,459,238,243,173,216,65
1238807,21,21,1992,12,female,1462,304,136,478,130,295,51,183,79
2015534,53,8,1960,2,female,2216,306,156,480,432,313,166,167,266
1764415,101,9,1912,6,female,2020,307,256,479,486,319,278,160,208
1356188,19,4,1994,9,male,168,318,168,479,792,318,509,161,283
1854105,27,10,1986,6,female,419,304,161,467,121,352,41,115,80
2094140,16,24,1997,4,female,480,316,129,475,700,460,509,15,191
1068271,39,28,1974,3,male,1014,308,230,458,248,458,198,0,50
1676680,41,10,1972,9,female,692,307,256,456,270,456,81,0,189
1073033,66,22,1947,8,female,555,317,144,472,303,472,290,0,13
1849892,27,16,1986,7,female,1747,310,153,495,492,78,358,417,134
2111489,18,4,1995,6,male,459,315,254,491,152,122,90,369,62
1140237,16,2,1997,10,female,264,312,185,494,403,294,109,200,294
1107545,19,19,1994,1,female,191,308,234,517,348,153,106,364,242
2070041,17,23,1996,7,female,294,306,251,488,147,481,86,7,61
2065513,21,3,1992,5,female,721,318,238,484,234,476,176,8,58
1909074,23,24,1990,6,female,474,316,278,487,151,418,97,69,54
1630095,25,16,1988,9,female,1218,314,129,517,507,498,419,19,88
1593539,46,9,1967,8,female,1760,315,110,495,850,388,600,107,250
1725083,25,29,1988,4,male,482,317,250,486,219,486,186,0,33
1315170,27,6,1986,3,male,1511,312,200,514,332,514,252,0,80
2089174,34,13,1979,5,female,98,307,63,511,533,511,451,0,82
1557358,17,2,1996,11,female,274,306,261,524,506,0,238,524,268
1542782,20,22,1993,1,female,259,309,190,543,391,73,226,470,165
2158506,18,17,1995,1,female,507,318,220,551,324,151,98,400,226
1406750,51,29,1962,6,female,113,316,53,526,306,142,195,384,111
1633117,18,25,1995,8,male,523,317,171,560,428,182,203,378,225
1314252,33,6,1980,1,female,1793,319,136,552,634,115,474,437,160
1935785,37,20,1976,3,male,890,317,220,549,464,300,74,249,390
2090838,21,17,1992,8,male,295,318,239,561,54,548,50,13,4
2055480,14,12,1999,8,female,327,307,120,536,457,427,289,109,168
1313764,43,6,1970,7,female,1804,309,139,529,918,511,490,18,428
1532389,61,1,1952,8,female,516,304,280,538,315,538,221,0,94
1072045,26,5,1987,9,female,120,312,83,559,402,559,301,0,101
2072696,31,22,1982,4,female,746,309,183,536,574,536,453,0,121
2087253,37,22,1976,8,female,1111,318,132,560,1164,560,685,0,479
1404531,54,29,1959,10,NA,2030,306,156,593,633,27,397,566,236
1949174,62,3,1951,1,female,1190,310,163,572,924,0,96,572,828
1248224,62,14,1951,9,female,1817,304,91,609,98,154,39,455,59
1746941,14,8,1999,4,female,131,310,212,572,386,392,174,180,212
1367937,28,13,1985,9,female,2170,311,167,597,514,327,375,270,139
1074242,42,5,1971,8,female,1281,307,223,605,565,353,475,252,90
1156207,50,1,1963,7,female,1360,319,168,603,405,226,139,377,266
1541397,14,11,1999,8,female,115,319,216,567,788,548,390,19,398
1111923,46,10,1967,1,male,172,313,53,593,361,542,201,51,160
1828421,49,28,1964,9,female,1960,310,216,584,730,571,550,13,180
2008733,67,7,1946,1,male,733,304,66,571,71,571,55,0,16
1389279,18,17,1995,8,female,249,304,54,603,293,603,194,0,99
1829475,23,2,1990,10,female,188,304,267,585,275,585,227,0,48
2074113,29,16,1984,3,female,398,306,162,578,262,578,89,0,173
1362882,30,13,1983,2,male,178,306,281,619,367,229,142,390,225
1478165,27,5,1986,4,female,1763,311,98,662,835,455,567,207,268
2132274,86,28,1927,8,female,638,319,243,622,7,516,5,106,2
1921010,17,6,1996,7,male,321,305,94,650,800,519,605,131,195
1326140,103,29,1910,10,female,1883,305,142,622,389,455,338,167,51
1846636,108,20,1905,5,male,880,318,211,627,47,627,39,0,8
1181917,18,16,1995,10,male,191,319,221,613,642,613,558,0,84
1851940,58,24,1955,2,male,653,314,228,690,162,0,62,690,100
1974326,16,26,1997,2,female,856,309,158,684,917,173,348,511,569
1536318,26,28,1987,6,female,347,311,181,719,764,345,141,374,623
1646016,49,28,1964,1,male,122,319,226,671,598,186,153,485,445
1708048,62,27,1951,1,male,1498,305,172,694,557,407,336,287,221
1920000,20,6,1993,5,female,773,305,154,707,1210,162,309,545,901
1162762,15,30,1998,6,female,602,316,74,717,111,689,46,28,65
1517661,80,29,1933,10,female,1053,315,147,705,193,629,116,76,77
1374145,15,4,1998,12,female,471,306,211,747,455,0,34,747,421
1090633,44,29,1969,8,female,1872,316,186,759,263,389,163,370,100
1586478,56,30,1957,12,female,1752,317,177,794,365,304,270,490,95
1716503,53,13,1960,10,female,1513,318,195,737,591,343,270,394,321
1381438,14,25,1999,2,female,279,316,180,783,284,754,129,29,155
1049779,31,25,1982,6,female,1155,307,130,744,766,637,345,107,421
2146194,103,29,1910,6,male,585,310,212,732,314,731,215,1,99
1877595,25,27,1988,6,male,499,314,233,780,762,780,610,0,152
2072689,28,10,1985,11,female,542,306,238,821,544,99,214,722,330
1133023,20,1,1993,11,female,468,319,244,863,287,174,118,689,169
1011880,15,8,1998,7,female,155,309,136,834,603,602,242,232,361
1583032,66,20,1947,8,female,564,311,153,872,114,830,62,42,52
1254087,17,23,1996,10,female,248,305,104,879,338,816,271,63,67
1786236,15,20,1998,5,male,304,306,110,842,130,842,88,0,42
1318365,21,10,1992,3,male,475,308,156,805,397,805,151,0,246
1367574,20,22,1993,3,female,314,311,241,906,315,224,116,682,199
1804116,15,4,1998,10,female,226,317,275,980,552,709,395,271,157
1760367,18,1,1995,9,female,475,315,244,884,356,727,272,157,84
1788668,19,12,1994,11,female,249,311,143,964,1260,954,994,10,266
1744138,25,3,1988,9,female,102,306,285,905,724,876,620,29,104
2108199,28,17,1985,1,female,1873,311,173,949,986,711,662,238,324
1376591,41,6,1972,9,female,1497,315,203,891,710,674,443,217,267
1171646,23,11,1990,9,female,983,315,175,986,733,986,652,0,81
2046788,30,27,1983,8,male,506,315,221,954,603,954,196,0,407
1675920,15,19,1998,10,female,365,315,211,992,128,87,56,905,72
1683677,64,8,1949,4,female,2098,307,123,1071,160,127,57,944,103
1984872,19,4,1994,9,female,580,306,79,1088,1115,638,406,450,709
1519442,13,21,2000,5,female,284,318,101,1040,600,944,264,96,336
1261526,57,29,1956,6,female,1635,317,164,1118,214,1091,96,27,118
1455349,34,17,1979,6,female,312,304,228,988,1076,833,441,155,635
2140275,53,11,1960,7,female,2208,319,121,1006,1392,972,983,34,409
1206808,57,3,1956,4,female,1629,319,117,1125,46,1125,37,0,9
1779977,100,7,1913,9,female,1439,305,203,1031,381,1031,270,0,111
1910448,25,16,1988,9,male,224,316,140,1048,1004,1048,656,0,348
1087068,43,16,1970,8,female,804,314,99,1121,847,1121,746,0,101
1035092,20,1,1993,9,female,326,306,167,1050,2397,1050,2281,0,116
1347641,29,27,1984,5,female,370,318,144,1179,498,281,262,898,236
1074222,14,4,1999,1,male,35,319,243,1275,1072,559,751,716,321
1900692,53,12,1960,6,female,2096,317,190,1160,1717,475,792,685,925
1889051,21,1,1992,1,female,464,312,96,1186,1983,569,1399,617,584
1683680,87,2,1926,1,female,1596,319,139,1146,1141,1140,790,6,351
1653690,41,24,1972,9,female,552,317,227,1268,958,1268,646,0,312
1635090,67,4,1946,10,female,689,314,180,1414,208,0,75,1414,133
1479812,15,4,1998,6,female,676,317,208,1360,697,119,235,1241,462
1012615,56,21,1957,8,male,1885,305,174,1387,1236,190,718,1197,518
1012443,19,23,1994,4,female,342,316,219,1378,810,1193,601,185,209
1786691,24,8,1989,2,female,138,315,269,1340,473,1340,399,0,74
1860501,54,7,1959,9,female,1352,315,216,1608,377,0,178,1608,199
1749276,58,6,1955,7,female,1320,305,150,1657,260,1548,187,109,73
2127880,108,8,1905,10,male,980,314,145,1694,230,1450,114,244,116
1032323,15,5,1998,3,female,687,311,228,1747,890,1681,744,66,146
1832930,27,21,1986,2,female,325,311,255,1545,1267,1534,1206,11,61
1968180,28,15,1985,10,male,78,314,264,1815,767,1815,696,0,71
1243372,81,23,1932,4,female,497,315,180,1813,563,1813,385,0,178
1958196,22,10,1991,11,male,263,309,265,1612,1097,1612,1028,0,69
1502797,28,12,1985,5,male,329,307,253,1632,1206,1632,1123,0,83
2054476,18,20,1995,7,male,1167,307,195,1920,2189,425,951,1495,1238
2069869,20,8,1993,2,female,161,309,135,2124,1007,2124,834,0,173
2081347,26,1,1987,1,male,221,316,176,1945,1568,1945,880,0,688
1749371,43,9,1970,9,female,1561,311,178,2700,1477,96,513,2604,964
1598689,63,23,1950,5,male,605,318,234,2481,389,1500,267,981,122
1895583,26,30,1987,5,female,395,314,170,2583,1229,599,125,1984,1104
1546968,36,5,1977,9,female,1859,308,93,3191,1432,800,704,2391,728
1081473,50,1,1963,8,female,1335,312,222,3527,1592,761,697,2766,895
1648114,50,12,1963,1,male,1107,309,230,2854,3504,1697,1271,1157,2233
1568326,19,21,1994,4,female,153,307,239,3230,898,2508,678,722,220
2065561,29,16,1984,7,female,92,314,111,3173,1669,3173,1579,0,90
1304902,42,21,1971,7,male,293,313,211,2694,872,2694,785,0,87
1583962,108,25,1905,8,male,217,319,290,2756,873,2756,619,0,254
2150979,62,4,1951,6,female,344,306,170,6218,1729,1,873,6217,856
1597681,33,28,1980,7,female,38,319,113,6907,4600,0,1843,6907,2757
1200679,78,8,1935,12,male,1253,310,173,4383,3096,94,1912,4289,1184
1885612,54,5,1959,6,female,850,308,125,8347,5191,2574,2506,5773,2685
1030466,21,13,1992,4,female,341,307,101,4841,425,4841,375,0,50
1293191,25,11,1988,9,female,421,318,150,3888,1405,3888,1052,0,353
1273559,26,22,1987,9,female,361,313,89,8021,4152,8021,3194,0,958
2013892,15,8,1998,12,male,421,333,304,0,4,0,2,0,2
1323448,14,9,1999,10,female,216,333,92,0,1,0,1,0,0
1700539,15,24,1998,4,male,525,327,227,0,0,0,0,0,0
1912422,15,14,1998,7,male,425,331,285,0,0,0,0,0,0
1142530,15,29,1998,10,male,174,324,290,0,19,0,15,0,4
1129740,17,12,1996,12,male,185,328,290,0,0,0,0,0,0
1717774,16,16,1997,6,male,364,325,281,0,2,0,2,0,0
2096364,16,15,1997,7,male,558,320,125,0,7,0,4,0,3
1499422,16,17,1997,8,male,455,328,248,0,2,0,0,0,2
1511495,16,6,1997,9,male,494,329,246,0,5,0,1,0,4
1051390,16,26,1997,10,female,592,320,104,0,10,0,8,0,2
1428694,16,31,1997,10,male,412,327,172,0,0,0,0,0,0
1641952,16,28,1997,10,female,170,326,260,0,2,0,2,0,0
1718552,18,14,1995,12,male,77,328,94,0,1,0,0,0,1
1413760,18,1,1995,12,male,290,322,186,0,0,0,0,0,0
2027438,17,28,1996,2,female,415,329,141,0,43,0,19,0,24
1540705,17,25,1996,5,male,590,327,251,0,1,0,1,0,0
1834754,17,6,1996,5,female,113,324,35,0,0,0,0,0,0
1641280,17,10,1996,6,male,351,325,259,0,1,0,0,0,1
1463201,17,7,1996,6,male,249,334,206,0,2,0,0,0,2
1381692,17,10,1996,7,male,449,325,272,0,0,0,0,0,0
1755440,17,7,1996,8,male,627,322,191,0,0,0,0,0,0
1815535,17,20,1996,9,female,431,329,66,0,0,0,0,0,0
1384591,17,9,1996,10,female,385,327,123,0,1,0,1,0,0
1862076,17,6,1996,10,female,299,324,147,0,3,0,2,0,1
1941680,19,7,1994,11,male,316,335,90,0,0,0,0,0,0
1954942,18,25,1995,2,male,682,329,285,0,4,0,4,0,0
2183238,18,16,1995,5,female,106,337,45,0,1,0,1,0,0
1242028,18,18,1995,6,male,659,325,198,0,1,0,0,0,1
1973238,18,8,1995,10,male,191,330,141,0,2,0,1,0,1
1347051,19,24,1994,2,male,397,333,255,0,0,0,0,0,0
1950159,19,17,1994,3,female,364,327,93,0,1,0,1,0,0
1420044,19,29,1994,4,male,623,327,212,0,0,0,0,0,0
1052422,19,14,1994,5,male,1028,327,197,0,0,0,0,0,0
1312829,19,18,1994,5,male,416,321,304,0,0,0,0,0,0
1299609,19,9,1994,6,male,466,337,224,0,0,0,0,0,0
1257256,19,6,1994,7,male,358,329,239,0,6,0,2,0,4
1203879,19,17,1994,8,female,531,334,230,0,0,0,0,0,0
1278505,19,28,1994,8,male,372,334,194,0,0,0,0,0,0
1216379,19,21,1994,9,male,418,325,288,0,0,0,0,0,0
1447174,19,9,1994,9,male,287,334,310,0,0,0,0,0,0
1411561,19,10,1994,10,female,610,333,181,0,9,0,8,0,1
1951212,19,30,1994,10,female,403,331,99,0,0,0,0,0,0
1177790,20,19,1993,9,male,1168,336,203,0,102,0,15,0,87
1404491,20,20,1993,9,male,765,326,265,0,17,0,6,0,11
1841219,22,23,1991,11,male,962,330,230,0,0,0,0,0,0
1536410,21,24,1992,2,male,1404,328,220,0,1,0,1,0,0
1922643,21,18,1992,4,male,180,331,254,0,1,0,1,0,0
2115400,21,1,1992,5,female,726,332,193,0,0,0,0,0,0
1551961,21,8,1992,8,female,653,327,197,0,0,0,0,0,0
2176028,21,5,1992,8,male,450,327,260,0,2,0,2,0,0
1097810,21,16,1992,9,male,1226,333,176,0,1,0,1,0,0
1034205,21,1,1992,9,male,207,337,235,0,1,0,0,0,1
1033919,21,10,1992,10,female,623,331,45,0,1,0,0,0,1
1838358,22,1,1991,1,male,339,323,66,0,3,0,1,0,2
1557972,22,26,1991,4,female,336,332,294,0,0,0,0,0,0
1540567,22,12,1991,6,male,675,330,167,0,0,0,0,0,0
1041453,22,23,1991,6,male,300,333,308,0,0,0,0,0,0
1456649,22,14,1991,10,female,254,329,20,0,0,0,0,0,0
2004036,23,2,1990,4,male,292,320,285,0,0,0,0,0,0
1805487,23,1,1990,4,male,962,331,257,0,0,0,0,0,0
1595820,23,4,1990,6,male,792,328,240,0,17,0,16,0,1
1526932,23,18,1990,7,male,370,335,281,0,4,0,4,0,0
1326209,23,23,1990,8,male,242,322,135,0,1,0,1,0,0
1853120,23,9,1990,9,male,566,327,280,0,0,0,0,0,0
1858092,24,2,1989,1,male,463,335,250,0,0,0,0,0,0
1138940,24,5,1989,7,female,433,323,259,0,0,0,0,0,0
1509628,24,11,1989,8,male,748,331,212,0,0,0,0,0,0
1769748,24,9,1989,9,male,65,323,320,0,0,0,0,0,0
1589010,24,15,1989,10,male,531,321,174,0,5,0,4,0,1
1819593,24,27,1989,10,male,245,331,269,0,6,0,5,0,1
1702004,25,1,1988,1,male,259,330,320,0,0,0,0,0,0
1558626,25,13,1988,7,male,660,324,252,0,0,0,0,0,0
2156054,27,25,1986,12,male,539,332,303,0,7,0,0,0,7
1276729,26,5,1987,2,male,521,322,184,0,0,0,0,0,0
1008324,26,30,1987,10,male,265,329,305,0,0,0,0,0,0
1027700,27,6,1986,1,male,821,336,251,0,3,0,2,0,1
1607605,27,13,1986,8,female,626,326,152,0,0,0,0,0,0
2113221,28,9,1985,5,female,213,335,68,0,1,0,0,0,1
2137790,29,1,1984,2,female,360,325,246,0,0,0,0,0,0
1922828,30,3,1983,2,female,1016,330,77,0,0,0,0,0,0
1397662,30,1,1983,6,female,615,322,197,0,1,0,0,0,1
1186087,30,22,1983,7,male,1155,335,58,0,4,0,2,0,2
1008030,32,30,1981,4,male,567,320,281,0,0,0,0,0,0
1761775,33,6,1980,6,male,1316,329,206,0,3,0,3,0,0
1692097,36,6,1977,2,male,427,324,227,0,0,0,0,0,0
2117957,39,18,1974,3,male,319,329,231,0,1,0,1,0,0
1193671,47,1,1966,3,male,1361,331,134,0,0,0,0,0,0
1864050,49,4,1964,4,male,1478,322,41,0,0,0,0,0,0
1905524,53,9,1960,2,male,136,336,284,0,0,0,0,0,0
2138813,53,29,1960,6,male,1095,330,100,0,3,0,3,0,0
1428214,55,30,1958,8,female,1069,336,187,0,2,0,1,0,1
1227267,56,1,1957,7,male,929,331,99,0,104,0,73,0,31
1795660,103,12,1910,12,female,1459,327,124,0,0,0,0,0,0
2040786,102,19,1911,4,female,905,331,269,0,4,0,4,0,0
1318268,103,1,1910,6,female,454,333,283,0,1,0,0,0,1
1304542,103,7,1910,7,male,1686,333,174,0,1,0,1,0,0
1603293,108,1,1905,12,male,1442,331,249,0,12,0,12,0,0
1844423,108,1,1905,1,male,2394,324,64,0,1,0,1,0,0
1130442,108,1,1905,1,male,1848,329,118,0,1,0,1,0,0
1259115,13,13,2000,2,male,248,330,278,1,0,0,0,1,0
1181569,15,3,1998,3,female,271,330,74,1,0,0,0,1,0
1160488,19,20,1994,3,male,326,335,284,1,0,0,0,1,0
1972594,19,12,1994,6,female,475,330,145,1,0,0,0,1,0
1230466,32,8,1981,11,male,541,337,258,1,0,0,0,1,0
1433237,39,7,1974,4,male,383,329,283,1,0,0,0,1,0
1872675,68,1,1945,5,male,657,333,25,1,1,0,0,1,1
1648796,20,8,1993,11,male,196,320,191,1,7,0,1,1,6
1841766,19,14,1994,9,male,447,325,124,1,5,0,1,1,4
1646410,33,26,1980,5,female,516,320,206,1,12,0,5,1,7
1197620,65,6,1948,9,male,525,331,258,1,5,0,1,1,4
1711882,76,7,1937,4,male,426,336,156,1,4,0,1,1,3
1773910,108,2,1905,5,male,1123,323,266,1,5,0,4,1,1
1576004,13,24,2000,7,male,88,331,300,1,0,1,0,0,0
1939540,17,3,1996,9,female,634,334,223,1,0,1,0,0,0
1731211,19,28,1994,12,female,360,320,246,1,0,1,0,0,0
1147869,18,6,1995,3,male,730,329,301,1,0,1,0,0,0
1618741,18,17,1995,5,male,130,325,300,1,0,1,0,0,0
2007967,18,11,1995,10,male,550,326,276,1,0,1,0,0,0
1875407,19,6,1994,6,female,330,333,252,1,0,1,0,0,0
1469162,29,5,1984,12,male,426,335,304,1,0,1,0,0,0
1800634,79,27,1934,1,male,1434,324,156,1,0,1,0,0,0
1584887,16,25,1997,6,female,408,321,188,1,1,1,0,0,1
1430946,20,20,1993,4,female,395,322,197,1,1,1,0,0,1
1857417,103,26,1910,6,male,656,332,283,1,1,1,1,0,0
1644891,16,1,1997,3,male,638,320,208,1,8,1,5,0,3
1606066,17,14,1996,1,male,688,321,162,1,19,1,12,0,7
1954292,19,12,1994,11,male,869,321,161,1,6,1,2,0,4
1867769,19,3,1994,2,female,382,326,208,1,2,1,2,0,0
1033971,21,24,1992,11,male,700,328,253,1,5,1,2,0,3
1658739,20,23,1993,10,female,702,336,138,1,3,1,1,0,2
1727772,21,14,1992,1,male,1538,320,67,1,4,1,3,0,1
1716317,28,1,1985,1,male,809,329,214,1,10,1,9,0,1
2078240,28,12,1985,3,male,533,337,309,1,3,1,2,0,1
2064182,33,16,1980,5,male,634,336,282,1,9,1,4,0,5
1156176,34,19,1979,8,male,340,320,307,1,2,1,1,0,1
1547231,68,21,1945,1,female,1634,325,89,1,3,1,3,0,0
1341235,96,30,1917,11,male,1443,330,183,1,6,1,6,0,0
2038554,100,25,1913,3,male,216,336,247,1,3,1,3,0,0
1717673,103,1,1910,1,male,2170,335,121,1,4,1,2,0,2
1561374,103,4,1910,4,male,1449,335,218,1,9,1,9,0,0
1479067,103,4,1910,7,female,836,328,19,1,4,1,4,0,0
1967520,108,26,1905,11,female,1002,332,50,1,9,1,8,0,1
1644528,108,27,1905,9,male,1028,329,202,1,3,1,3,0,0
1815810,27,14,1986,6,male,512,332,284,2,0,0,0,2,0
2179565,46,13,1967,3,female,794,332,225,2,0,0,0,2,0
1299710,18,4,1995,6,male,891,330,177,2,1,0,1,2,0
2039705,16,10,1997,5,male,231,327,276,2,170,0,12,2,158
1333705,26,14,1987,3,male,1032,330,199,2,6,0,2,2,4
1970298,17,15,1996,1,male,182,334,320,2,1,1,1,1,0
1079574,18,12,1995,12,male,599,324,242,2,31,1,18,1,13
1886019,23,8,1990,10,male,436,323,240,2,3,1,2,1,1
1541805,26,23,1987,3,male,642,329,203,2,111,1,74,1,37
2113567,73,12,1940,2,male,1898,321,58,2,9,1,3,1,6
2186238,16,30,1997,11,male,637,333,199,2,0,2,0,0,0
1236661,25,24,1988,12,female,695,323,190,2,0,2,0,0,0
1678003,24,1,1989,6,female,655,321,287,2,0,2,0,0,0
1240583,20,20,1993,3,male,540,325,310,2,1,2,0,0,1
1790313,69,22,1944,4,female,119,329,133,2,1,2,1,0,0
1772598,14,2,1999,12,male,494,324,228,2,2,2,2,0,0
1937106,18,30,1995,12,male,674,324,273,2,2,2,2,0,0
1457695,19,1,1994,1,male,552,327,256,2,2,2,2,0,0
1813627,23,17,1990,8,male,264,330,292,2,2,2,2,0,0
1715178,25,18,1988,11,male,987,325,170,2,2,2,2,0,0
2115427,27,27,1986,9,male,479,335,308,2,2,2,2,0,0
1110698,14,24,1999,11,female,341,330,220,2,43,2,33,0,10
2008938,16,17,1997,3,male,1543,324,159,2,5,2,3,0,2
2048865,16,25,1997,7,male,454,327,286,2,9,2,7,0,2
1143267,18,30,1995,9,female,501,322,281,2,65,2,31,0,34
2061942,23,25,1990,12,male,280,322,202,2,10,2,9,0,1
1965275,22,1,1991,5,male,569,322,173,2,4,2,3,0,1
1626514,24,6,1989,12,male,500,336,193,2,10,2,7,0,3
1753334,23,1,1990,1,male,351,331,301,2,5,2,5,0,0
1451220,33,5,1980,7,male,242,326,313,2,8,2,8,0,0
1641437,103,13,1910,10,male,916,324,240,2,3,2,2,0,1
1505690,44,9,1969,4,male,1517,332,216,3,1,0,1,3,0
1835503,23,10,1990,1,female,418,328,192,3,2,0,2,3,0
1857578,13,11,2000,1,male,275,330,276,3,28,2,27,1,1
1666356,102,31,1911,12,female,2119,327,142,3,9,2,4,1,5
2033679,24,8,1989,7,male,231,323,143,3,0,3,0,0,0
1324529,27,3,1986,1,male,602,330,242,3,0,3,0,0,0
1550491,27,5,1986,8,male,524,330,296,3,0,3,0,0,0
1808913,24,6,1989,1,male,448,333,205,3,1,3,1,0,0
2108752,14,7,1999,5,female,254,333,196,3,2,3,2,0,0
1830640,22,28,1991,12,male,438,325,62,3,2,3,1,0,1
2011578,108,30,1905,12,female,722,331,165,3,3,3,1,0,2
1899689,19,29,1994,12,female,854,330,40,3,24,3,24,0,0
1527994,18,1,1995,3,male,320,332,107,3,6,3,4,0,2
1144812,20,7,1993,11,female,556,322,57,3,14,3,13,0,1
1282856,19,12,1994,9,male,780,332,196,3,11,3,6,0,5
1941817,21,27,1992,11,female,455,331,143,3,18,3,7,0,11
1743756,22,22,1991,4,female,599,335,297,4,0,0,0,4,0
1584468,16,28,1997,10,male,548,327,203,4,1,0,1,4,0
1729730,40,30,1973,6,male,415,335,261,4,7,0,4,4,3
1742270,15,7,1998,5,male,588,327,190,4,2,2,1,2,1
1238519,19,1,1994,1,male,1058,321,263,4,4,2,2,2,2
1109992,30,18,1983,12,male,695,330,225,4,15,3,11,1,4
2029487,15,12,1998,8,female,184,329,61,4,0,4,0,0,0
1227356,17,17,1996,4,female,254,337,63,4,0,4,0,0,0
1385165,17,25,1996,9,male,541,335,261,4,2,4,0,0,2
1437818,20,7,1993,9,male,511,333,285,4,1,4,0,0,1
1996857,23,14,1990,11,female,274,321,97,4,1,4,1,0,0
2092870,20,3,1993,4,male,415,336,220,4,4,4,0,0,4
1841822,17,21,1996,6,female,208,329,44,4,16,4,10,0,6
2008692,22,9,1991,2,female,489,333,195,4,10,4,10,0,0
1515191,24,8,1989,1,male,482,320,287,4,9,4,8,0,1
1697245,24,13,1989,6,male,934,320,115,4,24,4,15,0,9
1688333,25,26,1988,7,male,699,330,279,4,30,4,27,0,3
1290061,28,9,1985,12,male,463,323,253,4,35,4,33,0,2
1259824,29,7,1984,7,male,1165,329,288,4,35,4,30,0,5
1922616,30,21,1983,9,male,215,326,304,4,15,4,7,0,8
1815499,108,5,1905,9,male,598,325,256,4,12,4,12,0,0
1317447,18,27,1995,11,female,257,331,57,5,4,0,0,5,4
1382025,108,3,1905,4,male,1131,322,280,5,5,0,5,5,0
1700864,26,25,1987,5,male,665,323,160,5,28,2,10,3,18
1760507,18,25,1995,3,female,354,323,78,5,2,5,1,0,1
1623725,29,15,1984,8,male,565,325,243,5,1,5,1,0,0
2042678,103,18,1910,1,male,311,331,280,5,1,5,1,0,0
2055619,48,26,1965,6,male,824,333,150,5,6,5,4,0,2
1949075,107,9,1906,5,male,1262,321,160,5,6,5,4,0,2
2081752,113,7,1900,10,female,1491,325,80,5,6,5,6,0,0
2046762,14,24,1999,11,female,74,333,37,5,10,5,10,0,0
1472655,14,14,1999,9,female,121,329,21,5,21,5,17,0,4
1557061,20,12,1993,10,male,693,320,245,5,71,5,26,0,45
1841388,22,22,1991,10,male,614,333,80,5,8,5,8,0,0
1296670,23,6,1990,1,female,810,330,143,5,29,5,19,0,10
1843108,25,9,1988,7,female,691,336,219,5,8,5,6,0,2
1661434,38,17,1975,2,male,1357,329,124,5,80,5,76,0,4
1529565,42,17,1971,9,female,456,333,55,5,12,5,7,0,5
1545964,62,30,1951,11,male,185,332,258,5,20,5,20,0,0
1910153,17,29,1996,11,male,686,326,261,6,3,0,0,6,3
1527088,51,30,1962,11,male,369,335,302,6,9,0,5,6,4
1412961,53,25,1960,7,female,541,329,318,6,183,1,20,5,163
1906431,87,18,1926,6,male,31,329,321,6,12,0,2,6,10
1024450,17,25,1996,11,male,952,335,278,6,10,5,4,1,6
2038516,23,5,1990,1,male,539,321,208,6,1,6,1,0,0
1804058,46,15,1967,10,male,706,331,186,6,1,6,1,0,0
1918481,63,22,1950,4,male,2282,322,27,6,1,6,0,0,1
1346408,15,6,1998,11,female,134,337,39,6,26,6,26,0,0
1563104,18,4,1995,1,female,337,332,126,6,56,6,51,0,5
1634026,20,20,1993,2,female,230,322,80,6,34,6,33,0,1
1450282,23,23,1990,3,male,119,322,278,6,16,6,16,0,0
1300865,46,14,1967,2,male,75,329,316,6,12,6,8,0,4
1795480,108,12,1905,5,female,650,320,90,6,12,6,7,0,5
1760146,17,26,1996,4,male,1441,325,237,7,0,0,0,7,0
1081533,18,11,1995,1,male,251,323,260,7,2,1,1,6,1
1359959,33,27,1980,3,male,634,321,274,7,2,0,2,7,0
2066969,21,1,1992,4,male,419,326,207,7,12,6,10,1,2
1896388,20,20,1993,7,female,271,330,154,7,0,7,0,0,0
1668946,18,25,1995,12,female,654,335,133,7,3,7,2,0,1
1044687,17,10,1996,1,male,141,334,307,7,2,7,1,0,1
1076192,17,14,1996,7,male,498,334,262,7,7,7,7,0,0
1851963,33,2,1980,4,male,408,337,263,7,6,7,6,0,0
1494996,103,5,1910,3,male,854,322,236,7,6,7,4,0,2
1523226,16,15,1997,11,female,408,331,113,7,22,7,21,0,1
1868621,19,16,1994,11,male,1304,332,208,7,24,7,15,0,9
1398234,19,12,1994,7,female,644,335,81,7,14,7,5,0,9
1884241,21,24,1992,7,male,616,327,197,7,186,7,135,0,51
1360237,31,14,1982,9,male,435,323,279,7,19,7,15,0,4
1688558,68,17,1945,12,female,1480,320,170,7,13,7,12,0,1
2065392,23,24,1990,11,male,571,336,234,8,2,0,1,8,1
2073054,19,13,1994,5,male,318,333,290,8,4,5,4,3,0
1358873,19,3,1994,8,female,234,325,208,8,2,3,2,5,0
1284842,21,25,1992,5,male,532,335,219,8,16,6,9,2,7
1478592,20,17,1993,8,male,560,337,264,8,0,8,0,0,0
1987671,21,24,1992,4,female,1081,329,99,8,8,8,4,0,4
2023487,23,25,1990,11,male,865,325,101,8,9,8,6,0,3
1139418,37,19,1976,3,male,631,335,222,8,6,8,0,0,6
2102090,18,30,1995,11,female,508,327,81,8,83,8,66,0,17
1429600,94,20,1919,7,male,119,337,308,8,23,8,5,0,18
1614003,24,24,1989,12,male,1167,336,105,9,0,0,0,9,0
1980758,31,3,1982,2,male,230,328,275,9,26,0,18,9,8
1819802,87,5,1926,7,male,809,329,219,9,1,8,1,1,0
1238873,19,15,1994,1,male,110,320,298,9,3,9,2,0,1
1611160,23,20,1990,5,male,424,329,230,9,7,9,6,0,1
1006455,23,10,1990,7,male,1263,336,294,9,6,9,6,0,0
1120846,27,12,1986,12,male,549,329,173,9,9,9,5,0,4
1183166,19,6,1994,7,male,410,331,195,9,31,9,23,0,8
1581873,17,9,1996,8,female,142,322,137,10,4,0,3,10,1
2135992,19,17,1994,8,male,940,329,309,10,0,9,0,1,0
1034859,21,30,1992,12,female,435,323,153,10,26,8,10,2,16
1546603,18,6,1995,6,male,308,321,160,10,0,10,0,0,0
1561714,25,7,1988,4,female,356,334,296,10,13,10,9,0,4
1625611,103,28,1910,2,male,898,323,169,10,13,10,13,0,0
1696487,18,27,1995,1,female,267,322,221,10,17,10,17,0,0
2065312,18,22,1995,2,female,645,329,226,11,1,0,1,11,0
1522753,19,28,1994,4,male,352,336,234,11,0,0,0,11,0
2128769,18,20,1995,3,male,301,321,201,11,3,0,0,11,3
1240530,16,24,1997,2,female,229,330,155,11,14,0,9,11,5
1617195,15,26,1998,11,female,449,323,130,11,14,7,10,4,4
1323329,49,18,1964,9,male,1530,330,57,11,150,3,82,8,68
2043651,54,28,1959,10,female,2210,328,235,11,18,5,3,6,15
1104048,68,24,1945,8,male,526,324,206,11,7,11,7,0,0
1257276,21,15,1992,7,male,604,332,268,11,21,11,10,0,11
1047465,27,10,1986,10,male,884,333,233,11,47,11,38,0,9
1454343,108,3,1905,3,NA,2077,337,207,12,0,3,0,9,0
1759344,22,12,1991,12,male,183,330,276,12,33,11,29,1,4
1500608,29,19,1984,5,male,447,335,273,12,1,12,1,0,0
1697205,18,6,1995,1,male,337,337,258,12,7,12,1,0,6
1179195,19,30,1994,3,male,208,328,209,12,4,12,4,0,0
1607663,15,4,1998,7,female,382,326,190,12,8,12,7,0,1
1052969,21,7,1992,8,female,293,333,183,12,10,12,7,0,3
1857017,24,11,1989,11,male,1430,336,213,12,17,12,10,0,7
2018333,19,19,1994,2,male,1055,322,121,12,75,12,47,0,28
1668425,32,19,1981,2,male,1576,326,276,12,45,12,21,0,24
1838800,108,17,1905,6,male,891,324,173,12,25,12,25,0,0
1020971,19,16,1994,11,male,291,330,256,13,1,2,1,11,0
1749050,73,13,1940,8,female,1582,326,89,13,39,1,26,12,13
1226625,17,6,1996,6,male,408,329,253,13,10,9,4,4,6
1247679,17,13,1996,12,female,389,330,113,13,170,5,94,8,76
1518729,21,7,1992,6,male,574,329,180,13,16,12,6,1,10
1373542,16,30,1997,12,male,590,332,143,13,13,13,11,0,2
1791521,19,24,1994,4,female,86,322,72,13,13,13,10,0,3
1065935,27,4,1986,1,male,670,335,244,13,12,13,12,0,0
1944286,31,12,1982,12,male,1372,328,203,13,19,13,12,0,7
1492763,103,8,1910,1,male,1445,329,146,13,26,13,12,0,14
1777380,107,10,1906,3,female,533,331,292,13,31,13,29,0,2
1559313,14,12,1999,10,female,311,335,135,14,4,0,2,14,2
1115757,50,4,1963,4,female,613,326,211,14,124,0,20,14,104
2069890,18,27,1995,6,female,139,337,129,14,26,4,19,10,7
1476358,19,18,1994,6,female,464,332,303,14,2,14,1,0,1
1453327,35,17,1978,2,male,1266,325,74,14,0,14,0,0,0
2181245,50,22,1963,5,female,1576,324,112,14,21,14,14,0,7
2024723,14,26,1999,2,female,519,333,212,15,97,0,29,15,68
1737185,18,19,1995,2,male,328,337,249,15,59,3,10,12,49
1506117,15,18,1998,2,male,545,333,304,15,0,15,0,0,0
1874765,19,30,1994,3,male,545,324,279,15,2,15,2,0,0
2058236,26,8,1987,4,male,323,326,128,15,0,15,0,0,0
1098561,103,8,1910,4,male,940,335,174,15,0,15,0,0,0
1227505,18,8,1995,6,female,175,332,285,15,87,15,81,0,6
1540251,20,11,1993,4,female,939,320,184,15,52,15,24,0,28
1261602,24,29,1989,8,male,548,320,286,15,24,15,21,0,3
1584403,28,17,1985,9,male,451,324,242,15,24,15,5,0,19
1925160,14,18,1999,8,male,309,332,188,16,5,1,1,15,4
1153980,15,8,1998,4,female,373,322,201,16,3,10,1,6,2
1039903,57,15,1956,9,male,230,323,151,16,9,6,4,10,5
2158128,20,8,1993,1,female,230,322,132,16,34,5,16,11,18
1267458,23,14,1990,2,male,598,322,298,16,0,14,0,2,0
1911235,16,20,1997,3,male,574,332,251,16,8,16,8,0,0
1680305,20,1,1993,1,male,394,329,193,16,9,16,9,0,0
1531097,27,16,1986,7,male,660,322,266,17,10,0,5,17,5
1246571,14,14,1999,9,female,376,333,175,17,10,15,3,2,7
1224553,41,9,1972,4,female,224,335,12,17,72,16,19,1,53
2139337,19,16,1994,5,female,575,325,230,17,7,17,6,0,1
2096058,20,27,1993,9,male,297,333,169,17,24,17,23,0,1
2110710,18,5,1995,10,female,247,332,266,17,43,17,42,0,1
1558200,19,12,1994,5,male,493,323,217,17,28,17,22,0,6
1184685,20,1,1993,5,female,591,321,77,17,70,17,58,0,12
1842304,19,14,1994,12,male,593,332,244,18,0,6,0,12,0
1399530,25,3,1988,6,male,1014,321,212,18,4,5,3,13,1
1162333,14,1,1999,9,male,208,323,185,18,24,13,20,5,4
2096411,44,26,1969,2,female,1607,323,99,18,14,18,13,0,1
2037715,17,13,1996,6,female,1181,323,73,19,8,3,0,16,8
2123890,15,1,1998,8,female,316,324,136,19,19,19,16,0,3
2077904,19,5,1994,11,female,256,329,255,19,72,19,23,0,49
1727624,41,21,1972,7,female,1202,337,95,20,8,3,4,17,4
1991505,18,24,1995,3,male,607,322,144,20,119,1,42,19,77
1612838,98,25,1915,7,male,1563,323,140,20,131,10,69,10,62
1614894,22,2,1991,2,male,573,337,317,20,8,15,7,5,1
1289432,26,27,1987,2,male,663,331,292,20,13,19,12,1,1
1420228,18,2,1995,12,male,946,337,283,20,0,20,0,0,0
1377802,26,30,1987,5,male,1103,336,208,20,18,20,9,0,9
1346948,68,16,1945,12,male,498,332,223,20,13,20,11,0,2
1178343,20,28,1993,7,male,530,335,218,21,1,0,0,21,1
1333749,31,30,1982,5,male,1171,331,148,21,11,7,2,14,9
1771366,28,4,1985,6,female,1214,322,139,21,17,18,12,3,5
1784099,50,30,1963,10,female,465,327,284,21,20,21,17,0,3
2028864,22,21,1991,2,male,416,328,300,22,23,6,10,16,13
1528083,19,7,1994,2,female,295,326,104,22,34,7,28,15,6
2104275,18,21,1995,10,female,221,336,84,22,24,19,7,3,17
1809167,108,7,1905,7,male,1630,327,262,22,11,22,9,0,2
1429625,13,29,2000,3,female,82,334,265,22,160,22,62,0,98
1449421,19,15,1994,2,female,322,326,266,23,28,2,5,21,23
1575545,57,23,1956,12,male,1699,322,231,23,207,0,54,23,153
2164711,22,7,1991,3,male,597,331,169,23,67,15,14,8,53
2102577,100,28,1913,4,male,1901,321,220,23,2,23,2,0,0
1966820,18,2,1995,11,male,375,333,191,23,74,23,56,0,18
2052741,25,12,1988,5,male,464,334,167,24,45,20,13,4,32
1854278,14,30,1999,6,male,362,325,148,24,0,24,0,0,0
2107633,23,22,1990,10,male,1642,334,86,24,31,24,31,0,0
1057938,20,27,1993,5,female,696,329,128,24,55,24,27,0,28
1087235,25,29,1988,3,male,506,325,261,24,40,24,30,0,10
1020429,29,10,1984,11,female,851,324,177,24,49,24,24,0,25
1804881,33,12,1980,4,male,1662,331,255,24,44,24,35,0,9
1925875,17,13,1996,8,male,426,323,222,25,25,10,19,15,6
1016414,19,7,1994,9,female,40,333,326,25,46,12,17,13,29
1582787,23,25,1990,7,male,563,333,286,25,11,23,11,2,0
1344738,27,22,1986,9,male,344,335,293,25,11,24,3,1,8
1865170,24,9,1989,9,male,335,336,306,25,9,25,9,0,0
1395613,23,20,1990,12,male,730,332,276,26,3,2,0,24,3
1390740,15,7,1998,6,male,434,331,252,26,10,5,4,21,6
1550987,113,10,1900,11,male,1223,333,219,26,14,5,4,21,10
2058451,38,29,1975,8,male,44,323,231,26,37,0,13,26,24
2137691,16,28,1997,8,female,352,320,169,26,29,7,8,19,21
2129590,23,15,1990,12,female,292,328,261,26,27,21,25,5,2
1795923,103,5,1910,10,female,650,331,55,26,3,26,3,0,0
2112490,25,17,1988,10,female,218,329,278,26,60,26,59,0,1
1626150,19,4,1994,6,female,496,329,162,27,23,0,14,27,9
1010036,23,21,1990,2,male,511,320,263,27,130,3,120,24,10
2167613,19,24,1994,5,male,554,336,287,27,10,11,6,16,4
1990944,22,15,1991,1,male,317,326,281,27,12,16,10,11,2
1580136,16,29,1997,5,female,721,322,255,27,26,13,11,14,15
1627269,15,13,1998,5,male,286,328,166,27,7,27,5,0,2
1574334,17,19,1996,9,male,146,331,286,27,14,27,8,0,6
1752514,107,2,1906,1,female,1260,325,82,27,13,27,12,0,1
1069129,19,6,1994,2,male,316,334,278,27,36,27,29,0,7
1081398,37,24,1976,2,female,264,327,266,27,25,27,23,0,2
2162893,103,21,1910,12,male,1789,329,104,27,26,27,22,0,4
1992329,17,28,1996,5,male,91,325,289,27,112,27,93,0,19
1745804,19,28,1994,7,male,385,321,179,27,42,27,41,0,1
2096349,25,19,1988,11,female,338,320,62,27,85,27,85,0,0
1629987,60,2,1953,10,male,792,328,255,28,14,0,7,28,7
1878839,96,18,1917,7,male,1020,333,174,28,36,1,18,27,18
2038373,20,16,1993,6,male,465,327,208,28,106,11,40,17,66
1179351,21,1,1992,1,male,895,333,268,28,10,28,9,0,1
1906318,23,1,1990,1,male,679,325,222,28,7,28,7,0,0
1627056,26,25,1987,8,female,297,332,210,28,22,28,3,0,19
1708744,39,26,1974,7,male,1070,327,256,29,1,0,0,29,1
1233401,20,28,1993,4,male,586,327,220,29,70,29,55,0,15
2127219,26,15,1987,8,female,882,331,190,29,322,29,267,0,55
2068720,17,12,1996,9,female,481,321,239,31,53,30,18,1,35
2092333,21,20,1992,11,female,1016,328,196,31,1,31,1,0,0
1733747,21,12,1992,12,male,615,330,305,31,0,31,0,0,0
1362007,53,23,1960,6,male,238,332,262,31,5,31,0,0,5
2055541,42,6,1971,10,male,445,332,305,30,10,30,9,0,1
1490492,17,8,1996,9,male,466,320,235,31,53,31,46,0,7
1178211,20,19,1993,8,female,497,329,183,30,82,30,58,0,24
1277069,51,20,1962,6,female,1643,326,210,32,19,19,13,13,6
1308405,49,17,1964,10,male,479,323,231,33,57,0,16,33,41
1256021,15,20,1998,8,male,620,328,234,33,0,17,0,16,0
1888227,19,1,1994,9,male,503,335,99,33,49,25,16,8,33
1986548,29,7,1984,8,male,498,327,208,33,25,30,21,3,4
1337018,18,7,1995,8,female,114,336,100,33,214,29,137,4,77
1852683,103,6,1910,11,female,1520,320,57,33,18,33,14,0,4
1459775,18,15,1995,2,female,398,336,251,34,17,0,1,34,16
1055136,14,31,1999,5,male,254,325,206,34,131,15,89,19,42
1058059,15,25,1998,5,male,566,335,252,34,8,34,6,0,2
1775310,18,9,1995,5,male,459,321,168,35,14,3,3,32,11
1646953,14,15,1999,11,female,304,325,255,36,28,2,5,34,23
2136525,21,2,1992,4,male,490,326,218,36,25,9,19,27,6
1783421,26,10,1987,2,female,682,331,190,35,77,16,41,19,36
1193705,17,3,1996,5,male,667,333,167,36,13,31,5,5,8
1744415,64,1,1949,7,female,2136,320,213,35,131,29,57,6,74
1100683,38,8,1975,10,male,669,337,285,36,5,36,4,0,1
1158395,19,11,1994,1,female,741,329,148,35,74,35,54,0,20
1328799,19,5,1994,5,male,286,330,274,35,90,35,81,0,9
1754473,14,26,1999,10,female,321,326,169,37,156,3,24,34,132
1620012,55,31,1958,3,female,1469,330,108,37,130,0,27,37,103
1339282,103,18,1910,12,male,864,332,226,37,113,2,23,35,90
1436399,17,21,1996,10,male,468,327,186,37,26,20,3,17,23
1722575,54,24,1959,6,male,1708,328,286,37,24,25,12,12,12
1112469,108,23,1905,8,male,1924,332,196,37,24,23,13,14,11
1872738,17,28,1996,1,male,213,325,122,37,36,37,16,0,20
2034303,25,8,1988,8,male,237,337,267,37,646,37,575,0,71
2039104,16,6,1997,3,male,601,321,226,38,2,2,2,36,0
1573593,19,3,1994,2,female,618,321,124,38,5,31,2,7,3
1710590,53,11,1960,4,male,375,326,174,38,2,31,2,7,0
1081564,22,5,1991,4,male,268,325,130,39,24,38,11,1,13
1431110,27,19,1986,9,male,615,329,185,38,35,29,15,9,20
2156485,16,4,1997,6,female,203,333,176,38,42,38,37,0,5
1542095,108,31,1905,12,male,1079,325,219,39,107,39,102,0,5
2109848,20,28,1993,12,female,350,328,264,40,0,0,0,40,0
1492401,108,1,1905,1,male,259,320,304,40,7,0,4,40,3
1215638,19,26,1994,9,female,1141,323,138,40,0,26,0,14,0
2097019,26,22,1987,8,male,595,325,225,40,57,29,16,11,41
1384124,28,14,1985,10,male,678,334,291,40,174,32,143,8,31
1559589,23,20,1990,7,male,691,329,188,40,1,40,1,0,0
1033324,103,15,1910,9,female,214,321,29,40,32,40,27,0,5
1674999,23,21,1990,7,male,478,330,258,40,70,40,60,0,10
1581818,15,9,1998,4,male,363,336,279,42,6,0,2,42,4
1964490,20,9,1993,8,female,1066,333,116,41,178,0,42,41,136
1067535,60,31,1953,5,male,1275,326,106,41,109,3,65,38,44
1929611,23,15,1990,12,male,278,329,228,42,95,29,14,13,81
1496934,16,6,1997,5,male,437,333,231,44,47,12,4,32,43
2061800,54,10,1959,2,female,903,327,179,44,4,34,3,10,1
1532451,16,10,1997,3,female,143,336,259,43,20,40,8,3,12
1517651,27,25,1986,11,female,433,326,230,44,41,44,26,0,15
1757030,28,18,1985,5,female,439,331,288,43,39,43,19,0,20
1890788,27,14,1986,8,male,277,328,312,43,122,43,114,0,8
1940544,33,27,1980,9,male,538,331,251,45,13,31,7,14,6
1568986,22,17,1991,5,male,638,326,175,45,41,45,33,0,8
1911338,31,20,1982,9,male,536,333,215,45,106,45,74,0,32
1385864,108,21,1905,6,male,1653,327,202,46,24,0,8,46,16
1590101,14,14,1999,9,female,179,335,213,46,77,19,12,27,65
2100912,17,16,1996,2,male,793,336,137,47,9,45,3,2,6
1449934,15,30,1998,6,female,374,326,67,47,0,47,0,0,0
1194149,26,30,1987,3,male,578,321,177,46,9,46,5,0,4
1168279,17,18,1996,12,male,276,337,206,47,45,47,41,0,4
1722546,21,1,1992,12,male,558,326,160,46,277,46,130,0,147
1374305,15,2,1998,8,female,295,337,129,49,88,24,23,25,65
1991548,44,10,1969,2,male,1553,331,118,49,40,42,29,7,11
1617236,18,31,1995,10,female,268,326,91,48,248,43,111,5,137
1470008,24,11,1989,1,female,467,325,101,49,146,43,43,6,103
1850093,25,8,1988,7,male,569,332,286,49,28,49,24,0,4
1067585,17,21,1996,9,female,371,326,208,48,42,48,32,0,10
1989145,29,4,1984,1,female,863,335,216,49,106,49,41,0,65
1790561,53,26,1960,4,female,1400,334,97,49,87,49,58,0,29
1302230,98,14,1915,5,male,1685,334,211,51,29,0,20,51,9
1524496,22,1,1991,9,female,331,332,274,51,62,4,17,47,45
1366634,17,22,1996,3,female,393,332,109,50,107,22,73,28,34
1270717,18,10,1995,3,female,439,332,266,50,17,50,12,0,5
1796947,19,19,1994,5,male,476,337,197,52,84,26,31,26,53
1387626,16,18,1997,9,male,255,333,287,53,7,42,6,11,1
1783940,24,5,1989,10,female,390,332,191,52,21,51,15,1,6
2013242,17,3,1996,7,male,161,333,308,52,56,38,20,14,36
1420348,27,11,1986,1,male,535,337,256,52,95,52,72,0,23
1648621,33,13,1980,9,female,253,325,94,54,13,0,5,54,8
1199245,20,19,1993,3,male,646,326,273,55,9,55,9,0,0
2102276,18,14,1995,2,male,37,329,313,55,53,55,52,0,1
1384748,14,12,1999,5,female,171,337,55,57,52,8,15,49,37
2160489,49,10,1964,5,male,313,332,205,58,115,9,43,49,72
1434920,24,26,1989,11,male,375,324,241,56,1,15,0,41,1
2124095,18,11,1995,8,female,457,329,260,58,22,34,8,24,14
1541370,20,12,1993,2,female,608,328,298,57,15,26,2,31,13
1718593,13,2,2000,3,male,239,329,230,56,39,39,7,17,32
1437876,18,16,1995,12,female,744,331,276,58,38,56,23,2,15
1971825,23,25,1990,11,female,1248,323,207,57,86,55,74,2,12
1123745,17,12,1996,10,female,322,327,120,58,13,58,6,0,7
1835568,19,27,1994,2,female,240,335,189,56,33,56,32,0,1
1349109,30,20,1983,2,female,895,334,131,56,41,56,27,0,14
1043603,35,28,1978,4,male,845,335,159,56,61,56,46,0,15
1636252,16,14,1997,7,female,238,331,99,58,135,58,87,0,48
1431903,50,1,1963,3,female,1845,320,206,57,145,57,86,0,59
1070495,19,3,1994,11,male,553,320,201,59,10,59,2,0,8
2102800,43,25,1970,3,female,1715,335,241,59,153,59,121,0,32
1931518,15,25,1998,1,male,714,322,179,62,31,1,4,61,27
2005295,17,24,1996,6,female,563,334,288,63,32,11,7,52,25
1739219,101,27,1912,10,female,2103,329,120,63,129,2,39,61,90
2104445,25,16,1988,4,female,470,325,282,62,4,13,1,49,3
1116902,16,12,1997,1,female,455,325,77,63,50,47,20,16,30
1237916,22,25,1991,9,female,460,328,257,61,46,52,31,9,15
2056398,52,13,1961,2,male,1559,331,148,61,237,57,96,4,141
1730869,16,25,1997,9,male,532,334,247,65,62,21,33,44,29
2193156,61,3,1952,9,female,961,326,217,64,122,19,14,45,108
1252835,14,25,1999,8,female,355,329,284,64,37,57,6,7,31
1900394,14,2,1999,4,female,866,333,150,65,175,54,95,11,80
1949555,20,16,1993,8,female,459,328,169,64,146,63,74,1,72
2039343,51,13,1962,5,male,2417,326,188,65,219,63,134,2,85
1022182,51,6,1962,4,female,364,323,188,65,17,65,14,0,3
1273661,19,4,1994,2,female,297,322,62,68,204,1,77,67,127
2098838,59,20,1954,7,female,1481,334,234,68,554,0,180,68,374
1870932,59,30,1954,12,male,1142,324,138,67,48,54,28,13,20
1842381,23,25,1990,1,male,1273,334,243,66,18,66,14,0,4
1377266,25,4,1988,10,male,626,328,142,66,14,66,11,0,3
1907418,108,20,1905,5,male,1323,329,263,67,12,67,12,0,0
1584862,15,4,1998,12,female,66,331,107,67,283,67,263,0,20
1072325,19,22,1994,2,female,579,328,224,71,5,2,0,69,5
1474746,28,12,1985,12,female,441,326,265,69,94,0,12,69,82
1491703,67,27,1946,8,male,438,332,78,70,44,6,16,64,28
1965906,20,24,1993,10,male,413,322,152,71,113,3,48,68,65
1231176,20,29,1993,3,male,163,337,151,70,25,66,25,4,0
1278593,14,6,1999,2,male,634,333,245,71,84,60,26,11,58
1811518,100,1,1913,1,male,1490,329,184,70,311,69,231,1,80
1337190,23,1,1990,7,male,1108,333,209,71,15,71,10,0,5
1567248,16,26,1997,3,female,337,324,99,69,58,69,57,0,1
1925335,23,9,1990,3,male,695,322,227,71,93,71,74,0,19
2030704,59,4,1954,11,female,564,332,252,72,169,0,10,72,159
2032577,93,1,1920,9,male,1110,327,215,74,39,19,18,55,21
1921174,15,7,1998,9,female,471,332,183,72,231,30,168,42,63
1358432,25,10,1988,8,female,520,320,255,74,18,69,12,5,6
1377654,26,6,1987,10,male,671,335,85,72,56,58,39,14,17
2013972,63,21,1950,12,female,1925,330,232,74,265,73,147,1,118
1972429,19,21,1994,6,male,316,332,106,72,33,72,21,0,12
1876944,29,25,1984,11,female,510,335,275,73,58,73,27,0,31
2092767,47,9,1966,11,male,335,336,268,72,60,72,49,0,11
1108943,105,28,1908,1,female,1219,333,108,72,52,72,45,0,7
1555904,20,4,1993,6,female,709,333,96,73,160,73,69,0,91
1070702,23,17,1990,2,male,1024,333,275,77,0,0,0,77,0
1215159,15,9,1998,3,male,775,328,154,75,28,26,3,49,25
2055289,107,12,1906,3,male,1093,331,279,76,30,75,20,1,10
1990374,21,27,1992,3,male,594,337,251,77,48,72,39,5,9
1256694,17,2,1996,6,female,270,320,79,75,328,70,122,5,206
2061865,34,27,1979,9,male,265,320,293,76,154,63,125,13,29
1833772,24,25,1989,1,female,291,325,77,75,9,75,7,0,2
1678222,16,11,1997,10,male,218,333,195,76,51,76,39,0,12
1729937,24,12,1989,5,female,182,337,266,77,61,77,57,0,4
1090547,26,25,1987,9,male,718,332,228,76,96,76,95,0,1
1819539,23,11,1990,11,male,501,320,203,78,88,18,31,60,57
1623971,34,18,1979,10,male,1216,322,209,81,7,46,4,35,3
1053867,16,14,1997,10,male,375,336,163,84,28,82,26,2,2
2125689,111,21,1902,2,female,1969,332,168,82,64,60,47,22,17
1348575,22,13,1991,7,female,853,320,112,83,210,83,130,0,80
1421736,30,3,1983,10,male,513,324,233,87,46,62,21,25,25
1198657,19,22,1994,9,female,277,328,58,85,81,50,17,35,64
1657500,108,1,1905,1,male,2329,332,232,87,161,24,38,63,123
1289592,17,2,1996,2,male,514,331,184,86,35,70,31,16,4
1395833,19,10,1994,6,female,350,330,165,86,200,86,176,0,24
1912463,60,8,1953,9,male,897,336,129,89,109,0,38,89,71
1733479,65,23,1948,4,female,780,324,239,89,164,0,65,89,99
1293232,22,1,1991,1,male,563,328,240,91,23,63,19,28,4
1406854,21,8,1992,1,male,216,333,267,88,143,51,95,37,48
2075812,14,7,1999,7,male,262,325,282,91,92,74,44,17,48
1289448,24,19,1989,3,female,108,329,149,88,90,85,57,3,33
1327978,22,28,1991,3,male,393,331,258,88,43,88,42,0,1
1141629,27,13,1986,7,male,668,334,175,89,34,89,23,0,11
1245319,36,10,1977,12,female,327,330,270,88,81,88,27,0,54
1286760,19,1,1994,8,male,185,327,138,89,138,89,124,0,14
1323371,21,18,1992,6,male,199,320,285,91,292,91,251,0,41
2147449,25,8,1988,7,female,559,337,153,95,20,0,17,95,3
2060034,42,23,1971,3,female,1377,328,241,93,53,53,24,40,29
1037405,62,14,1951,7,female,1130,335,214,94,163,42,57,52,106
1674608,21,5,1992,5,female,386,333,217,94,77,72,38,22,39
1611105,21,17,1992,8,male,225,325,217,95,90,78,51,17,39
1701976,108,26,1905,8,female,1748,321,177,93,117,82,50,11,67
2107813,108,5,1905,8,male,670,328,223,95,74,95,69,0,5
1459075,15,20,1998,8,female,211,336,185,96,335,44,103,52,232
1302127,15,8,1998,9,male,413,331,209,96,1,75,1,21,0
2172253,14,7,1999,6,female,318,333,271,97,147,90,117,7,30
1978005,18,27,1995,9,male,415,332,167,97,542,84,462,13,80
1004880,32,28,1981,9,female,228,323,268,98,148,72,56,26,92
1971400,26,6,1987,3,female,616,335,200,99,1088,99,1048,0,40
1756084,61,19,1952,8,female,534,320,209,104,41,2,9,102,32
2173730,28,22,1985,11,female,560,320,174,101,99,29,46,72,53
1271839,101,25,1912,10,male,861,334,236,100,22,100,18,0,4
1612247,32,30,1981,7,female,398,337,273,102,87,102,33,0,54
1262224,17,15,1996,6,female,259,337,167,102,351,102,336,0,15
1971421,30,12,1983,8,male,710,333,189,105,73,47,21,58,52
1789411,103,19,1910,11,female,1744,336,118,108,172,23,109,85,63
1262233,15,1,1998,11,female,77,337,154,109,180,98,123,11,57
1284246,51,4,1962,6,female,1895,320,83,106,320,100,261,6,59
1757138,18,16,1995,7,female,263,322,183,111,47,4,8,107,39
1238835,63,18,1950,11,female,1606,321,217,111,69,66,29,45,40
1155253,59,8,1954,4,male,1248,333,196,113,16,110,6,3,10
1565907,103,14,1910,1,male,807,321,267,111,36,111,36,0,0
1524854,35,21,1978,1,female,358,320,100,113,237,113,65,0,172
1107666,18,24,1995,11,female,331,329,151,119,130,3,17,116,113
1647599,24,17,1989,5,female,183,324,191,115,168,19,47,96,121
1667567,15,18,1998,7,female,242,321,283,115,141,101,116,14,25
1508326,19,30,1994,11,male,653,325,195,118,21,118,7,0,14
1231724,31,11,1982,3,female,219,333,191,116,75,116,52,0,23
1240312,30,13,1983,12,female,940,329,161,116,197,116,99,0,98
2087075,33,25,1980,3,female,317,321,295,114,191,114,121,0,70
1624178,39,30,1974,12,female,1518,332,167,121,209,27,145,94,64
1744479,22,21,1991,6,male,384,325,175,121,120,120,75,1,45
1487499,45,9,1968,2,male,1107,332,110,121,140,121,64,0,76
1602049,22,20,1991,12,male,206,326,286,124,194,124,159,0,35
1000068,22,4,1991,7,male,508,325,207,128,33,2,20,126,13
1041807,14,24,1999,7,female,417,322,233,126,1,30,0,96,1
2089645,38,8,1975,9,male,524,324,175,128,9,46,0,82,9
1494456,30,15,1983,10,female,1810,334,107,126,74,40,46,86,28
1375242,25,18,1988,1,male,331,337,268,128,75,117,29,11,46
1798344,23,8,1990,5,male,508,334,216,130,118,130,109,0,9
1586284,21,6,1992,5,male,275,334,275,132,121,0,27,132,94
1757817,100,29,1913,9,female,760,332,110,136,174,17,77,119,97
1152681,20,6,1993,5,male,390,335,126,133,391,14,135,119,256
2109574,15,27,1998,10,male,568,331,218,134,74,84,48,50,26
1051811,18,11,1995,5,male,387,326,84,131,57,57,20,74,37
1597589,23,17,1990,3,male,326,336,212,131,13,111,3,20,10
1382703,23,5,1990,12,male,823,334,207,135,98,108,63,27,35
1956482,14,12,1999,4,female,333,321,107,133,283,99,35,34,248
1449808,14,3,1999,1,female,307,327,206,135,175,135,144,0,31
2120487,30,17,1983,8,male,194,336,109,133,225,133,183,0,42
1743645,34,22,1979,12,female,287,325,209,134,205,134,180,0,25
2137175,113,20,1900,3,female,1612,335,241,143,26,0,6,143,20
2134973,66,18,1947,7,female,1828,334,200,142,498,5,271,137,227
1192698,108,22,1905,3,female,1025,335,142,137,451,15,244,122,207
1600713,18,14,1995,9,female,423,334,264,140,26,115,7,25,19
1217703,14,6,1999,10,female,88,334,105,143,92,123,47,20,45
1599925,21,15,1992,2,female,637,327,118,140,113,140,109,0,4
1106419,42,7,1971,9,female,627,330,146,137,254,137,238,0,16
1815244,19,27,1994,9,female,408,332,126,147,301,96,77,51,224
1164198,44,26,1969,12,female,1730,337,103,145,26,145,17,0,9
1346423,27,17,1986,7,female,1948,331,134,147,155,147,139,0,16
2073129,16,8,1997,8,female,444,324,138,151,203,105,62,46,141
1590860,108,29,1905,8,female,2641,320,158,155,202,138,143,17,59
1590723,21,4,1992,1,female,464,328,226,157,656,148,436,9,220
1466674,18,15,1995,2,female,426,337,100,157,72,157,59,0,13
1993374,14,28,1999,9,female,225,335,204,156,237,156,232,0,5
1416939,23,28,1990,11,male,613,320,110,153,244,153,204,0,40
1304121,16,9,1997,7,male,673,323,151,161,346,116,197,45,149
1434213,17,16,1996,5,female,397,322,204,159,45,124,24,35,21
1269397,33,10,1980,8,male,682,323,162,163,175,122,157,41,18
1135328,26,17,1987,5,female,1737,323,109,162,327,138,145,24,182
2102408,21,1,1992,10,male,1602,326,52,158,44,158,14,0,30
2060323,33,30,1980,11,female,418,331,259,170,537,74,303,96,234
1761794,17,18,1996,9,male,257,337,114,167,88,153,63,14,25
2004254,71,30,1942,4,female,1893,320,105,169,256,155,135,14,121
1999146,26,14,1987,7,female,339,330,197,167,79,167,66,0,13
1551379,68,10,1945,12,male,885,336,183,168,61,168,60,0,1
1034181,102,24,1911,10,female,1844,329,105,169,66,169,51,0,15
1192176,24,2,1989,2,female,329,327,277,170,230,170,205,0,25
1468998,28,28,1985,1,female,255,332,295,181,46,178,24,3,22
1952484,23,12,1990,8,male,155,325,283,181,154,157,73,24,81
2122722,17,12,1996,12,male,161,332,306,173,112,173,104,0,8
1811943,20,2,1993,11,female,428,336,219,179,194,179,151,0,43
1935330,23,30,1990,6,female,238,330,220,181,207,181,130,0,77
1388639,26,21,1987,6,female,751,333,306,176,262,176,200,0,62
1288676,27,26,1986,7,female,677,321,204,188,192,87,56,101,136
1034801,16,10,1997,2,female,174,324,95,187,73,185,30,2,43
1375400,17,8,1996,4,female,291,332,178,189,219,168,112,21,107
1916600,59,17,1954,12,male,1851,332,121,187,485,147,306,40,179
2086590,14,3,1999,7,female,309,321,187,183,73,183,20,0,53
1574351,53,14,1960,3,male,423,333,262,189,46,189,41,0,5
2137199,23,10,1990,8,female,61,324,305,183,498,183,447,0,51
1224264,28,12,1985,12,female,274,328,225,187,318,187,272,0,46
1260200,53,14,1960,12,female,1641,325,152,193,113,18,66,175,47
1414203,55,21,1958,12,NA,2298,332,207,193,751,26,452,167,299
1317068,22,13,1991,11,male,148,329,294,200,39,111,32,89,7
1372621,82,21,1931,5,female,1804,328,165,193,38,78,19,115,19
1563106,113,1,1900,1,male,1121,321,120,192,51,191,19,1,32
1485725,21,8,1992,7,female,404,332,171,195,93,195,53,0,40
1518223,25,11,1988,9,female,166,327,210,194,108,194,68,0,40
2181361,27,1,1986,11,male,586,323,258,193,85,193,20,0,65
1107874,15,27,1998,1,female,463,330,194,205,38,0,21,205,17
1737736,23,9,1990,7,female,251,327,196,202,66,31,26,171,40
1983677,19,25,1994,7,female,446,322,86,203,208,37,98,166,110
1543191,19,21,1994,4,female,273,325,190,209,578,128,296,81,282
1360687,14,4,1999,10,female,480,333,100,206,91,200,40,6,51
1830882,18,12,1995,6,male,441,324,260,208,9,207,9,1,0
1057953,22,3,1991,6,male,420,320,283,205,19,205,17,0,2
2165165,54,25,1959,3,male,1046,321,143,207,118,207,75,0,43
1964684,19,5,1994,1,female,92,330,214,207,549,207,473,0,76
1485310,102,25,1911,12,male,1544,336,242,215,270,0,159,215,111
1078261,20,13,1993,10,female,590,320,177,220,355,214,212,6,143
1770103,58,13,1955,8,female,1488,331,201,217,342,197,197,20,145
1991924,42,12,1971,10,male,235,330,74,216,124,216,62,0,62
1811870,80,10,1933,8,female,1581,328,160,220,85,220,67,0,18
1640703,18,25,1995,8,male,82,324,233,218,181,218,122,0,59
1367177,22,1,1991,1,male,524,320,296,225,16,10,7,215,9
1687354,23,27,1990,7,male,228,334,255,222,32,37,26,185,6
1192410,29,5,1984,2,female,413,323,243,225,77,126,70,99,7
1853835,22,25,1991,9,female,1371,335,175,232,758,83,284,149,474
1123141,36,19,1977,2,female,240,334,207,222,646,126,235,96,411
1939926,22,23,1991,9,male,544,324,270,230,285,195,113,35,172
2176606,21,24,1992,9,male,125,331,307,228,547,198,270,30,277
1859606,17,21,1996,12,female,358,337,211,230,11,229,11,1,0
1039145,22,14,1991,9,male,698,335,282,222,277,222,257,0,20
1577247,17,30,1996,11,female,290,333,275,241,227,44,40,197,187
2154169,21,25,1992,2,male,1523,323,116,245,540,131,397,114,143
1697815,25,29,1988,6,female,505,329,149,236,105,227,34,9,71
1123046,26,25,1987,6,female,1672,334,197,244,528,217,246,27,282
2174892,21,10,1992,4,male,345,323,104,234,63,234,58,0,5
1503689,68,17,1945,6,male,384,327,277,242,45,242,32,0,13
2176608,20,15,1993,11,male,466,322,280,238,302,238,210,0,92
1810280,60,8,1953,6,male,1659,336,178,246,400,246,293,0,107
1351230,28,13,1985,10,female,402,322,255,250,212,134,62,116,150
1256431,16,17,1997,7,female,387,335,253,252,394,159,189,93,205
1754379,19,7,1994,7,male,313,325,232,259,107,259,86,0,21
1363272,68,10,1945,3,male,252,321,272,275,97,5,13,270,84
1767109,66,12,1947,7,male,1777,324,230,275,102,183,44,92,58
1211132,17,25,1996,12,female,280,320,47,272,370,188,132,84,238
1693776,20,12,1993,5,female,210,330,174,270,329,131,220,139,109
1111463,30,5,1983,9,female,372,328,205,276,325,99,173,177,152
1543814,93,23,1920,11,male,828,330,249,272,43,240,26,32,17
2109222,17,4,1996,5,female,258,324,232,275,166,262,145,13,21
1742681,16,8,1997,2,male,478,320,163,274,218,253,129,21,89
1809441,20,2,1993,6,male,681,327,231,272,416,208,274,64,142
2170339,19,15,1994,6,female,365,321,260,269,11,269,8,0,3
2059454,25,5,1988,3,male,1265,323,134,272,45,272,27,0,18
1485114,101,28,1912,12,male,1605,320,138,271,152,271,116,0,36
1727686,108,20,1905,1,male,811,330,210,266,493,266,261,0,232
1503911,18,24,1995,11,male,273,321,265,280,271,34,60,246,211
1468963,67,12,1946,7,male,373,330,268,288,95,181,61,107,34
1991140,28,13,1985,8,female,472,334,244,291,254,188,132,103,122
2181803,31,15,1982,12,female,565,335,190,292,190,60,82,232,108
1670886,21,8,1992,11,female,412,326,146,287,298,277,121,10,177
1829695,21,22,1992,5,female,177,328,205,289,270,245,154,44,116
1939131,20,7,1993,2,male,186,326,262,301,131,11,48,290,83
1686249,57,2,1956,1,female,945,325,252,304,152,0,68,304,84
1756613,38,22,1975,10,female,1446,322,209,303,223,202,55,101,168
1810996,16,6,1997,6,female,389,335,180,300,365,296,95,4,270
1411859,45,11,1968,1,female,2076,335,78,301,143,301,90,0,53
1433054,15,8,1998,7,female,1091,322,112,311,419,44,316,267,103
1446554,22,25,1991,10,female,465,335,179,318,260,0,66,318,194
1693727,17,10,1996,10,male,79,327,220,313,503,119,231,194,272
2147847,28,8,1985,1,male,405,332,242,314,235,296,101,18,134
1601433,23,3,1990,12,female,408,336,259,317,98,315,64,2,34
1201859,64,25,1949,11,male,1920,327,148,321,173,321,94,0,79
1180970,20,8,1993,8,female,875,325,166,315,242,315,221,0,21
1007711,33,5,1980,8,female,261,330,188,331,276,36,93,295,183
1724607,14,20,1999,5,female,456,321,212,330,2,320,2,10,0
1129618,20,4,1993,2,male,692,323,194,341,314,278,206,63,108
1711249,43,20,1970,3,female,1559,329,189,344,559,270,288,74,271
1201263,50,22,1963,8,female,587,321,182,338,34,338,32,0,2
1111991,17,31,1996,5,male,361,328,221,340,131,340,111,0,20
1700883,23,10,1990,9,female,291,337,64,341,269,341,254,0,15
1950481,51,17,1962,9,female,1059,334,164,355,7,0,5,355,2
1817902,21,10,1992,11,male,107,326,281,367,160,213,90,154,70
1155919,17,18,1996,12,male,516,331,192,366,224,112,47,254,177
1301203,18,7,1995,3,male,651,330,265,366,290,192,233,174,57
1461259,23,24,1990,10,male,674,329,146,366,483,341,168,25,315
1039105,90,29,1923,10,male,1412,335,160,364,543,354,388,10,155
1725628,103,5,1910,8,female,1169,321,139,367,342,278,199,89,143
1899324,26,4,1987,3,female,595,334,200,359,649,325,296,34,353
2086461,34,4,1979,12,female,464,327,238,347,145,346,104,1,41
1390680,50,6,1963,12,female,441,336,275,368,23,368,12,0,11
1775774,32,3,1981,5,male,774,321,201,347,186,347,148,0,38
1602800,108,1,1905,12,male,396,334,271,369,64,369,63,0,1
1752379,26,26,1987,8,male,280,329,240,388,61,130,13,258,48
1513613,86,16,1927,12,male,2241,327,160,390,201,88,86,302,115
2117435,16,23,1997,11,female,222,336,233,371,421,224,172,147,249
1273325,25,2,1988,7,female,598,333,179,390,548,206,274,184,274
2022720,64,30,1949,7,female,1703,337,152,383,62,353,37,30,25
1802356,24,11,1989,9,female,113,332,202,380,227,332,167,48,60
2044374,17,7,1996,10,male,231,334,207,376,445,355,291,21,154
2156028,17,7,1996,6,female,84,335,48,382,103,382,66,0,37
1111332,58,4,1955,4,female,1452,324,135,384,143,384,125,0,18
1636718,18,2,1995,4,female,321,326,138,371,510,371,495,0,15
1889498,15,25,1998,4,female,350,324,107,405,247,50,76,355,171
1814417,50,18,1963,2,female,1794,325,228,411,382,54,27,357,355
1014732,15,15,1998,12,female,597,324,255,405,110,121,30,284,80
1396996,54,4,1959,8,female,2123,334,187,414,190,102,87,312,103
1393147,49,31,1964,1,male,791,324,262,414,104,359,42,55,62
1355798,14,28,1999,5,male,192,329,209,410,479,347,382,63,97
1500611,27,12,1986,10,female,59,327,160,420,286,420,220,0,66
1304533,22,15,1991,12,female,386,320,212,407,968,407,877,0,91
2041738,23,10,1990,10,male,661,324,300,404,897,404,799,0,98
1429927,30,17,1983,3,female,302,335,123,428,219,30,189,398,30
1823342,91,23,1922,3,male,422,332,177,429,282,0,232,429,50
1354600,16,9,1997,6,female,146,324,115,433,319,137,122,296,197
2082965,16,19,1997,4,male,282,331,201,435,227,332,130,103,97
1524999,103,26,1910,9,male,611,334,240,432,754,356,540,76,214
1779781,25,17,1988,6,female,431,321,283,432,1021,429,834,3,187
1415781,50,13,1963,2,female,1967,324,211,431,132,431,52,0,80
1843046,16,19,1997,5,female,216,333,168,446,442,446,171,0,271
1379556,106,20,1907,11,female,103,328,289,437,613,437,501,0,112
1120922,61,7,1952,12,female,985,320,245,482,345,0,39,482,306
2128453,15,25,1998,3,female,218,322,213,479,290,258,154,221,136
1169632,19,1,1994,3,male,346,332,239,471,120,315,113,156,7
1070744,26,24,1987,4,female,501,330,214,459,88,320,21,139,67
1523454,19,14,1994,8,female,95,336,262,458,1638,162,994,296,644
1346719,14,1,1999,2,female,646,331,235,458,401,375,155,83,246
1651576,25,1,1988,11,female,403,324,150,454,381,370,81,84,300
1465945,27,3,1986,3,female,227,333,318,472,585,367,303,105,282
1947314,28,12,1985,3,male,268,326,196,463,1096,339,867,124,229
1916187,19,7,1994,5,female,277,330,87,473,388,472,247,1,141
1688802,21,15,1992,3,male,206,329,278,466,74,466,47,0,27
1924595,61,30,1952,6,female,375,333,205,503,279,0,24,503,255
1623952,61,12,1952,4,female,1592,324,187,512,500,10,183,502,317
2046760,48,27,1965,9,female,281,326,199,489,1199,63,448,426,751
1598304,16,25,1997,11,female,615,321,33,507,70,500,70,7,0
1979411,28,23,1985,8,female,1157,335,173,491,1237,395,810,96,427
1327984,47,2,1966,8,female,1694,331,125,504,1086,396,776,108,310
2041414,19,30,1994,5,male,363,336,306,511,194,511,111,0,83
1302357,74,31,1939,12,female,1864,336,254,506,262,506,251,0,11
1220916,16,5,1997,5,female,95,322,79,508,420,508,299,0,121
1475877,26,19,1987,6,female,109,328,165,518,849,518,708,0,141
1657907,57,14,1956,6,female,440,334,236,523,100,0,14,523,86
1147885,68,2,1945,12,male,704,321,182,527,59,454,52,73,7
1464201,20,6,1993,7,female,706,333,127,527,711,487,265,40,446
1052827,21,28,1992,3,female,332,328,78,530,462,513,201,17,261
1642646,20,28,1993,9,female,268,332,261,535,864,410,384,125,480
1364792,54,8,1959,4,male,992,323,249,530,1035,400,757,130,278
1083838,20,6,1993,2,female,433,336,168,538,128,538,120,0,8
1487390,30,13,1983,5,female,422,328,261,521,449,521,274,0,175
1671415,108,28,1905,8,male,118,323,285,533,522,533,464,0,58
1092473,16,21,1997,2,male,492,328,204,597,449,374,248,223,201
1434420,20,4,1993,3,male,373,337,224,562,612,376,194,186,418
1175080,32,20,1981,12,female,1975,332,199,570,406,207,89,363,317
1570865,36,4,1977,9,female,766,324,172,583,398,334,190,249,208
1745305,21,22,1992,8,male,73,328,258,567,174,550,101,17,73
1552004,50,28,1963,8,female,473,324,269,563,136,554,111,9,25
1759113,15,26,1998,5,female,988,328,77,584,726,500,233,84,493
2093070,27,24,1986,1,female,96,328,286,581,578,476,338,105,240
2141046,17,11,1996,8,female,462,327,136,584,212,584,206,0,6
1778619,15,7,1998,4,male,252,326,251,636,123,42,63,594,60
1171155,93,6,1920,8,female,2226,328,97,613,233,54,93,559,140
1390282,62,1,1951,6,female,1957,335,232,618,656,41,167,577,489
1542139,103,2,1910,11,male,1999,328,109,645,646,184,313,461,333
1791880,19,1,1994,7,female,159,322,139,662,96,645,46,17,50
1507212,20,23,1993,5,female,1527,337,143,637,560,616,305,21,255
1075786,63,21,1950,7,female,1795,324,145,615,691,582,510,33,181
2087165,61,11,1952,12,male,573,333,296,643,114,642,66,1,48
2037620,14,3,1999,3,female,149,324,261,655,120,655,116,0,4
1202077,21,22,1992,7,male,218,333,259,661,214,661,159,0,55
1291355,24,13,1989,7,male,511,326,277,651,225,651,204,0,21
1866648,26,29,1987,7,male,321,327,207,640,143,640,106,0,37
1477024,20,31,1993,10,male,269,329,279,685,399,121,275,564,124
1652384,32,18,1981,10,male,461,321,205,678,60,362,29,316,31
1623425,47,3,1966,10,male,485,332,246,670,447,286,88,384,359
1274387,25,8,1988,6,female,73,337,69,679,1444,326,1148,353,296
1136236,20,1,1993,1,male,306,328,237,686,343,527,202,159,141
2187174,101,13,1912,6,NA,2337,327,257,678,341,576,84,102,257
2107514,38,25,1975,9,male,531,321,217,722,747,686,534,36,213
1406041,20,17,1993,2,male,324,337,204,672,108,672,81,0,27
1439956,23,14,1990,11,female,287,320,206,691,534,691,475,0,59
1931530,38,29,1975,9,female,98,337,178,684,1914,684,1300,0,614
1776553,67,12,1946,7,male,1673,321,95,664,1211,664,282,0,929
1635530,18,13,1995,2,female,239,322,205,772,402,0,34,772,368
1266540,51,3,1962,4,female,484,335,277,792,240,101,65,691,175
1574098,22,26,1991,1,female,629,326,210,765,327,463,166,302,161
1653661,24,28,1989,9,female,1643,323,213,741,767,265,388,476,379
1594908,18,15,1995,12,female,713,331,143,732,269,732,192,0,77
1459055,24,3,1989,11,female,49,332,20,727,221,727,203,0,18
1743257,22,14,1991,2,male,394,334,244,783,773,783,712,0,61
1513520,22,9,1991,6,female,667,331,179,869,880,110,705,759,175
1467881,16,13,1997,2,female,322,326,161,811,585,444,158,367,427
1019027,18,10,1995,5,female,322,321,165,829,564,432,322,397,242
1772521,33,13,1980,6,female,1512,329,169,841,661,456,278,385,383
1135730,23,1,1990,1,male,283,336,235,862,140,828,95,34,45
2095886,19,18,1994,4,female,326,331,110,857,1794,761,843,96,951
1642379,18,16,1995,12,female,374,323,94,876,221,876,188,0,33
2128772,26,1,1987,1,male,356,320,252,838,372,838,310,0,62
1156567,55,13,1958,7,male,871,326,273,872,212,872,166,0,46
1803504,28,9,1985,11,female,641,335,260,836,868,836,743,0,125
1075167,68,17,1945,8,male,578,337,109,848,537,848,483,0,54
1599928,71,23,1942,7,female,653,320,246,889,18,0,10,889,8
1668451,54,30,1959,8,female,333,334,129,920,356,0,49,920,307
2070848,25,26,1988,10,male,193,337,322,897,640,49,284,848,356
2049595,47,28,1966,11,female,1045,327,209,919,933,107,507,812,426
1536255,36,30,1977,10,female,560,324,140,891,697,612,567,279,130
1033101,47,21,1966,2,female,1763,330,159,957,620,628,135,329,485
1486190,16,11,1997,10,female,250,327,100,950,506,698,237,252,269
2019320,23,4,1990,10,male,446,325,192,908,1185,839,732,69,453
1511654,29,23,1984,6,male,186,324,198,960,1392,858,1176,102,216
2191122,48,3,1965,9,female,370,336,289,891,49,891,48,0,1
1092391,26,22,1987,3,male,256,326,291,977,182,977,174,0,8
1706193,33,3,1980,11,male,449,337,289,965,317,965,303,0,14
2088712,25,4,1988,3,female,631,324,228,993,628,29,251,964,377
2129160,58,22,1955,12,female,1468,323,201,1120,3003,155,2103,965,900
1788038,18,23,1995,9,female,244,332,268,1109,349,610,202,499,147
1779236,24,5,1989,5,female,506,325,267,1022,261,412,207,610,54
1414881,16,6,1997,8,female,131,337,183,1009,988,284,221,725,767
1859923,22,23,1991,7,female,852,329,248,1081,672,766,345,315,327
1363858,24,6,1989,6,female,181,333,256,993,511,799,361,194,150
1600300,26,21,1987,4,female,1094,337,172,1100,1002,1059,777,41,225
2076995,40,10,1973,11,male,57,326,282,1022,1961,822,1164,200,797
2148195,19,10,1994,2,female,356,329,197,1067,342,1067,272,0,70
1174270,18,19,1995,3,female,193,328,57,1021,816,1021,652,0,164
1857440,18,1,1995,10,female,571,332,169,1134,509,662,351,472,158
1888984,33,1,1980,6,female,1421,331,170,1279,611,294,363,985,248
1220690,64,23,1949,4,female,1796,326,180,1185,1043,627,467,558,576
1929977,16,9,1997,9,female,143,324,194,1258,1640,1175,1070,83,570
1659693,28,20,1985,8,male,322,334,239,1193,773,1172,620,21,153
1206334,60,25,1953,5,male,640,326,283,1270,28,1270,24,0,4
1765982,35,11,1978,10,female,601,321,82,1283,770,1283,542,0,228
2136517,72,22,1941,8,female,1228,337,299,1307,424,182,191,1125,233
1495124,14,5,1999,1,female,115,323,305,1498,787,596,528,902,259
1625825,76,11,1937,4,female,58,327,168,1314,276,574,102,740,174
1356088,23,4,1990,10,female,1654,326,184,1378,979,848,593,530,386
1720956,14,19,1999,10,female,459,329,255,1413,364,1376,221,37,143
1197798,37,28,1976,4,female,1718,334,145,1291,1603,1270,1051,21,552
2055301,65,8,1948,10,female,2005,324,191,1324,1206,1129,560,195,646
2191145,42,6,1971,8,female,279,323,213,1466,2554,1144,1272,322,1282
2086944,66,26,1947,12,female,1236,337,216,1410,709,1407,580,3,129
2094017,18,24,1995,11,female,89,323,73,1328,253,1328,187,0,66
1178440,22,11,1991,3,male,99,327,234,1306,444,1306,368,0,76
2003021,25,2,1988,3,male,459,321,211,1435,828,1435,740,0,88
1640718,49,25,1964,10,female,770,320,193,1349,2123,1349,1570,0,553
1944711,50,28,1963,3,female,602,325,184,1772,1196,313,262,1459,934
1950074,93,18,1920,4,female,1138,329,183,1548,1127,1,363,1547,764
1206640,14,1,1999,5,female,341,321,236,1687,383,1620,274,67,109
1150886,16,9,1997,1,female,533,333,122,1646,1056,1624,945,22,111
2114838,35,14,1978,9,female,800,331,79,1630,1431,1386,602,244,829
1666716,18,12,1995,8,female,210,320,275,1593,2797,1469,1245,124,1552
1910862,13,10,2000,1,female,440,330,168,1770,652,1770,374,0,278
1434014,56,9,1957,1,female,1246,331,239,1653,544,1653,239,0,305
1957301,21,31,1992,3,female,287,321,223,2208,940,168,239,2040,701
1861781,59,18,1954,10,female,873,333,251,1871,830,103,195,1768,635
1477293,28,13,1985,5,female,292,330,119,2144,2122,1360,1793,784,329
1361152,25,22,1988,7,female,81,332,145,2202,1102,2039,676,163,426
1678475,21,25,1992,3,male,429,323,109,2338,433,2323,191,15,242
1630406,15,15,1998,4,male,309,329,258,2136,299,2136,236,0,63
1772544,43,24,1970,10,female,74,333,201,1994,1099,1994,844,0,255
1433268,57,13,1956,10,female,538,334,143,2184,2360,2184,1626,0,734
1850927,23,30,1990,7,female,389,326,150,1883,3312,1883,2157,0,1155
1407702,19,12,1994,4,female,533,321,177,3166,1615,278,541,2888,1074
1691867,18,28,1995,4,female,283,336,191,3059,2586,423,1046,2636,1540
1339734,15,23,1998,9,female,717,323,131,2591,1322,686,709,1905,613
2090812,15,14,1998,4,female,196,336,238,3055,451,3011,325,44,126
1055695,34,15,1979,5,female,582,322,111,3128,828,3060,492,68,336
1259374,50,2,1963,12,male,237,321,223,2703,4109,2703,2053,0,2056
2028848,57,29,1956,1,male,263,320,259,4578,873,0,334,4578,539
1442960,14,16,1999,9,female,327,332,146,8842,1831,5645,1100,3197,731
2029292,47,19,1966,8,female,1325,332,220,3776,1966,3471,1728,305,238
1926782,21,1,1992,1,male,457,322,193,3945,3910,3532,3478,413,432
1279633,63,1,1950,1,female,251,320,82,12104,2806,12104,2755,0,51
2017371,14,12,1999,12,female,265,347,63,0,0,0,0,0,0
1320881,15,27,1998,11,female,301,341,153,0,10,0,10,0,0
1392134,15,21,1998,12,male,1003,338,184,0,0,0,0,0,0
1606121,14,15,1999,4,male,202,338,284,0,1,0,0,0,1
2108624,14,10,1999,10,male,320,349,307,0,3,0,3,0,0
1850299,14,2,1999,10,male,84,344,317,0,1,0,0,0,1
2058318,16,20,1997,11,female,330,358,248,0,3,0,1,0,2
1689889,15,18,1998,2,female,384,357,167,0,5,0,2,0,3
1488038,15,21,1998,3,female,522,351,244,0,4,0,3,0,1
1801579,15,16,1998,3,male,245,339,310,0,0,0,0,0,0
1757660,15,7,1998,7,male,353,340,310,0,0,0,0,0,0
1661504,15,11,1998,8,female,413,356,238,0,14,0,14,0,0
1638521,15,8,1998,9,female,390,358,297,0,0,0,0,0,0
1262287,16,15,1997,1,male,360,346,234,0,29,0,25,0,4
1990466,16,7,1997,8,female,648,348,235,0,0,0,0,0,0
1539622,16,10,1997,9,male,272,355,148,0,0,0,0,0,0
1182312,17,25,1996,1,male,615,354,293,0,42,0,41,0,1
2051217,17,21,1996,1,female,510,354,16,0,11,0,11,0,0
1292558,17,8,1996,1,male,201,343,330,0,38,0,13,0,25
2025148,17,1,1996,1,male,412,348,289,0,0,0,0,0,0
1926975,17,14,1996,2,male,444,338,319,0,8,0,5,0,3
1893135,17,26,1996,3,male,881,347,245,0,5,0,5,0,0
1744126,17,23,1996,4,female,910,353,221,0,0,0,0,0,0
2186629,17,8,1996,8,male,298,350,290,0,0,0,0,0,0
1310923,17,19,1996,9,male,557,353,221,0,1,0,0,0,1
1102335,19,2,1994,11,female,321,342,260,0,9,0,1,0,8
1632928,18,21,1995,1,male,210,344,319,0,3,0,2,0,1
1883260,18,24,1995,3,male,117,357,288,0,0,0,0,0,0
1115358,18,8,1995,7,male,557,352,202,0,0,0,0,0,0
1662266,18,25,1995,9,male,293,353,305,0,0,0,0,0,0
1634915,19,20,1994,1,male,328,341,297,0,0,0,0,0,0
1852922,19,6,1994,1,female,183,340,107,0,0,0,0,0,0
1455152,19,6,1994,5,female,258,342,39,0,1,0,1,0,0
1468088,19,18,1994,6,female,502,338,95,0,0,0,0,0,0
1792573,19,8,1994,7,male,311,353,41,0,6,0,6,0,0
2055635,19,11,1994,9,female,241,345,254,0,0,0,0,0,0
2139115,19,6,1994,10,male,495,347,315,0,9,0,7,0,2
1110969,20,15,1993,7,female,1131,358,138,0,13,0,8,0,5
1104714,22,8,1991,12,female,642,346,113,0,0,0,0,0,0
1900364,21,31,1992,1,male,616,351,327,0,0,0,0,0,0
2072334,21,23,1992,8,female,490,339,223,0,0,0,0,0,0
1522064,21,12,1992,9,male,235,340,137,0,0,0,0,0,0
1825387,23,23,1990,11,female,395,355,151,0,0,0,0,0,0
2046053,23,15,1990,12,male,585,343,309,0,25,0,22,0,3
1659247,22,17,1991,6,male,2313,354,135,0,0,0,0,0,0
1888172,22,25,1991,7,male,629,344,248,0,1,0,1,0,0
1415025,22,2,1991,10,male,1013,340,251,0,41,0,21,0,20
1031401,23,3,1990,1,male,657,345,286,0,29,0,21,0,8
1044519,23,16,1990,2,male,467,355,67,0,31,0,27,0,4
1386848,23,4,1990,9,male,604,354,307,0,10,0,8,0,2
1203331,25,25,1988,12,male,701,347,259,0,0,0,0,0,0
1797789,24,10,1989,5,female,722,340,298,0,5,0,4,0,1
1850510,24,16,1989,7,male,593,352,180,0,15,0,14,0,1
1498741,24,16,1989,7,male,349,351,195,0,3,0,2,0,1
1784863,25,1,1988,1,male,506,349,327,0,0,0,0,0,0
1306143,25,27,1988,9,male,373,339,255,0,0,0,0,0,0
1823314,26,1,1987,1,female,391,349,133,0,0,0,0,0,0
1496024,26,1,1987,2,male,760,349,151,0,0,0,0,0,0
1906897,26,23,1987,10,male,624,356,238,0,0,0,0,0,0
1919185,28,9,1985,12,male,828,351,180,0,0,0,0,0,0
2101012,28,28,1985,9,male,446,352,311,0,0,0,0,0,0
1039575,29,19,1984,4,male,2205,343,139,0,0,0,0,0,0
1300047,31,3,1982,5,male,1442,354,258,0,0,0,0,0,0
1867567,32,8,1981,9,female,559,338,219,0,5,0,5,0,0
1090335,33,19,1980,4,female,593,343,206,0,0,0,0,0,0
1262772,33,15,1980,9,female,334,341,16,0,2,0,0,0,2
1464062,34,24,1979,6,male,833,349,227,0,0,0,0,0,0
1812529,36,2,1977,12,male,855,344,104,0,5,0,2,0,3
1993880,39,28,1974,8,male,482,353,241,0,1,0,0,0,1
1079368,42,4,1971,3,male,1949,348,119,0,82,0,36,0,46
1529819,47,14,1966,3,male,354,338,262,0,4,0,3,0,1
1994622,51,19,1962,8,male,364,351,202,0,3,0,3,0,0
1086958,54,30,1959,3,female,508,354,140,0,5,0,5,0,0
2006144,55,26,1958,1,male,1262,357,240,0,30,0,9,0,21
1278457,63,25,1950,12,male,1946,355,89,0,0,0,0,0,0
1865564,65,30,1948,4,male,1988,343,101,0,0,0,0,0,0
1407192,67,31,1946,1,male,585,353,300,0,5,0,1,0,4
1041886,67,10,1946,9,female,1101,349,200,0,0,0,0,0,0
1497458,68,19,1945,8,female,160,348,330,0,1,0,1,0,0
1866725,101,16,1912,4,male,2151,341,241,0,4,0,4,0,0
1364861,103,6,1910,12,female,522,347,85,0,5,0,4,0,1
2105311,103,22,1910,5,male,944,354,232,0,1,0,1,0,0
1000015,108,10,1905,2,female,1067,344,79,0,1,0,0,0,1
1768945,15,1,1998,1,male,491,349,174,1,0,0,0,1,0
1416638,19,14,1994,7,male,303,338,160,1,0,0,0,1,0
1851135,24,24,1989,6,male,51,341,315,1,0,0,0,1,0
1296347,24,13,1989,7,male,1073,353,225,1,0,0,0,1,0
1917643,76,4,1937,1,male,1333,352,35,1,0,0,0,1,0
1991754,88,1,1925,8,male,295,352,310,1,0,0,0,1,0
1089393,13,24,2000,5,male,439,342,228,1,1,0,1,1,0
2173819,15,27,1998,4,female,680,339,237,1,1,0,0,1,1
1862763,18,7,1995,6,male,401,352,126,1,1,0,1,1,0
1579188,17,8,1996,6,male,851,341,134,1,3,0,1,1,2
1269294,18,3,1995,2,male,297,342,176,1,11,0,3,1,8
1836231,21,28,1992,11,male,391,353,293,1,4,0,1,1,3
1764717,23,4,1990,4,female,551,349,249,1,32,0,10,1,22
1665287,24,25,1989,3,female,366,356,159,1,37,0,19,1,18
1912914,48,28,1965,10,male,1626,342,277,1,31,0,18,1,13
1570095,53,23,1960,1,female,590,339,280,1,11,0,3,1,8
1174426,68,10,1945,2,male,1350,339,176,1,24,0,12,1,12
1189847,73,19,1940,9,male,869,357,79,1,3,0,2,1,1
1582293,108,26,1905,4,male,1663,344,70,1,12,0,11,1,1
1422937,19,28,1994,9,male,310,355,274,1,0,1,0,0,0
1776460,20,23,1993,8,male,969,355,242,1,0,1,0,0,0
1738987,21,11,1992,9,male,391,341,278,1,0,1,0,0,0
2054125,24,28,1989,5,male,1389,350,254,1,0,1,0,0,0
1161522,24,28,1989,6,male,266,347,253,1,0,1,0,0,0
1890622,28,25,1985,6,male,193,346,174,1,0,1,0,0,0
1471265,35,30,1978,12,male,152,355,342,1,0,1,0,0,0
1553349,38,17,1975,3,male,298,352,131,1,0,1,0,0,0
2023263,93,19,1920,5,female,552,347,117,1,0,1,0,0,0
1255797,102,1,1911,9,female,541,345,173,1,0,1,0,0,0
1117125,15,10,1998,1,male,450,347,252,1,1,1,1,0,0
2064859,19,27,1994,2,male,749,338,231,1,1,1,1,0,0
1612510,20,31,1993,1,male,205,345,161,1,1,1,1,0,0
1411915,20,16,1993,7,male,711,352,303,1,1,1,0,0,1
1191339,23,25,1990,12,male,1123,350,256,1,1,1,1,0,0
1286123,23,9,1990,7,male,292,347,316,1,1,1,1,0,0
1917679,23,2,1990,9,male,524,339,166,1,1,1,1,0,0
1817683,25,21,1988,10,male,364,346,224,1,1,1,1,0,0
1804631,26,6,1987,6,female,449,354,93,1,1,1,1,0,0
1645915,27,19,1986,7,male,539,352,263,1,1,1,1,0,0
1727179,15,3,1998,11,male,189,339,67,1,3,1,3,0,0
1402933,15,3,1998,4,male,338,345,291,1,8,1,6,0,2
1731287,16,3,1997,9,female,543,352,58,1,2,1,2,0,0
1721132,19,13,1994,4,female,288,352,175,1,7,1,4,0,3
2107871,19,15,1994,7,female,193,338,164,1,24,1,16,0,8
1297094,20,3,1993,3,male,425,357,169,1,2,1,2,0,0
1188329,20,12,1993,6,female,546,345,145,1,5,1,3,0,2
1353460,20,19,1993,8,male,1208,343,251,1,33,1,22,0,11
1138773,21,17,1992,8,female,799,349,195,1,29,1,12,0,17
1109116,22,2,1991,1,male,477,355,279,1,2,1,2,0,0
1860089,22,1,1991,1,male,1600,346,169,1,4,1,4,0,0
1655448,22,3,1991,6,male,320,358,231,1,16,1,11,0,5
1461756,24,12,1989,1,male,575,338,250,1,7,1,5,0,2
1011326,24,1,1989,1,female,454,354,202,1,4,1,3,0,1
2006323,26,29,1987,9,male,436,341,230,1,10,1,7,0,3
2031866,28,30,1985,9,male,1365,346,254,1,6,1,0,0,6
2116764,30,8,1983,1,male,1922,351,222,1,13,1,10,0,3
1900255,46,15,1967,9,male,515,347,312,1,6,1,3,0,3
1356063,68,13,1945,5,male,1507,352,153,1,2,1,2,0,0
1110460,71,23,1942,9,female,1661,339,153,1,19,1,15,0,4
1691338,101,13,1912,11,female,248,339,43,1,21,1,15,0,6
1924510,108,12,1905,11,male,59,342,140,1,10,1,7,0,3
1564980,18,5,1995,1,male,562,351,302,2,0,0,0,2,0
1283212,108,1,1905,5,female,878,355,306,2,1,0,1,2,0
1763160,48,13,1965,2,female,1498,339,230,2,2,0,0,2,2
1571493,20,8,1993,8,male,749,338,204,2,28,0,11,2,17
1797849,27,27,1986,9,male,1701,341,244,2,4,0,1,2,3
1421023,47,5,1966,12,female,509,343,252,2,9,0,4,2,5
1448535,99,19,1914,6,female,2003,346,143,2,45,0,16,2,29
1344667,103,22,1910,5,female,1023,338,179,2,138,0,126,2,12
1048884,108,11,1905,3,male,1445,353,77,2,18,0,11,2,7
1001232,18,15,1995,5,male,322,356,81,2,71,1,45,1,26
1664013,23,1,1990,11,male,1158,350,274,2,21,1,18,1,3
1535789,110,1,1903,3,male,1345,339,26,2,4,1,2,1,2
1486405,14,7,1999,5,female,369,347,236,2,0,2,0,0,0
1891748,19,4,1994,5,female,532,356,254,2,0,2,0,0,0
2091393,21,6,1992,4,male,671,343,254,2,0,2,0,0,0
2053855,25,18,1988,4,female,256,355,121,2,0,2,0,0,0
1470044,30,10,1983,7,male,725,346,242,2,0,2,0,0,0
1291101,18,8,1995,12,male,222,352,285,2,1,2,0,0,1
2163557,19,6,1994,3,female,530,348,143,2,1,2,1,0,0
1948932,19,24,1994,8,male,361,349,296,2,1,2,1,0,0
1022807,20,27,1993,6,male,695,348,254,2,1,2,1,0,0
1281715,25,4,1988,10,male,835,343,253,2,2,2,2,0,0
2058379,16,5,1997,9,male,215,341,237,2,9,2,4,0,5
2006245,17,18,1996,5,female,340,344,80,2,37,2,34,0,3
1281700,20,11,1993,11,female,539,349,105,2,108,2,77,0,31
1466523,20,18,1993,3,female,259,355,77,2,6,2,6,0,0
2025357,20,11,1993,9,male,372,348,271,2,6,2,6,0,0
1221451,21,18,1992,3,male,345,344,229,2,13,2,9,0,4
1364989,22,25,1991,4,male,509,343,285,2,24,2,7,0,17
1687159,23,8,1990,4,female,180,345,303,2,16,2,15,0,1
2082337,25,10,1988,2,female,329,349,200,2,9,2,9,0,0
1601266,30,4,1983,4,male,223,352,281,2,7,2,7,0,0
1313587,33,2,1980,11,male,640,356,245,2,3,2,3,0,0
1437614,37,14,1976,11,male,978,343,283,2,139,2,129,0,10
2125494,39,1,1974,1,male,715,344,229,2,7,2,7,0,0
1886616,26,1,1987,1,male,449,356,343,3,0,0,0,3,0
1291391,33,15,1980,11,male,1181,350,170,3,0,0,0,3,0
2088570,103,1,1910,6,male,1652,350,292,3,0,0,0,3,0
1776750,15,26,1998,3,male,298,341,127,3,1,0,1,3,0
1669899,26,22,1987,12,female,589,348,293,3,5,0,0,3,5
1224404,67,30,1946,1,male,1570,353,206,3,6,0,2,3,4
1783246,15,12,1998,12,male,297,355,183,3,0,2,0,1,0
1273648,24,19,1989,1,male,555,352,244,3,2,2,1,1,1
1229617,26,14,1987,11,male,223,343,335,3,0,3,0,0,0
1081488,20,19,1993,3,male,638,342,226,3,1,3,1,0,0
1736123,22,9,1991,10,male,351,343,301,3,1,3,1,0,0
1402415,22,24,1991,10,male,278,345,181,3,1,3,1,0,0
1504701,32,13,1981,3,male,803,356,280,3,1,3,1,0,0
1358465,18,15,1995,2,female,859,345,224,3,2,3,2,0,0
1137975,15,4,1998,11,male,322,351,195,3,7,3,3,0,4
1669167,14,7,1999,4,female,250,352,213,3,76,3,55,0,21
1601790,17,30,1996,7,male,461,343,285,3,51,3,46,0,5
2004147,19,9,1994,11,female,359,350,124,3,6,3,6,0,0
1650304,18,15,1995,1,male,659,358,265,3,9,3,7,0,2
1291285,18,6,1995,8,male,284,346,299,3,43,3,30,0,13
1079258,20,20,1993,11,male,997,353,279,3,68,3,56,0,12
1605563,20,17,1993,7,male,526,348,194,3,9,3,7,0,2
1605357,20,7,1993,9,male,241,352,318,3,5,3,2,0,3
1483680,21,22,1992,3,female,475,342,169,3,25,3,22,0,3
1780857,26,3,1987,10,female,381,354,200,3,35,3,29,0,6
1203684,34,21,1979,9,male,543,343,235,3,46,3,26,0,20
1485369,103,4,1910,3,male,985,351,269,3,9,3,8,0,1
1842011,108,17,1905,5,female,19,343,41,3,5,3,5,0,0
1283454,108,5,1905,7,female,877,344,166,3,58,3,49,0,9
2132767,15,8,1998,9,male,484,341,264,4,7,0,1,4,6
2133392,90,8,1923,5,male,2352,338,149,4,10,0,8,4,2
1115668,23,22,1990,12,male,485,339,118,4,30,2,20,2,10
1099367,23,21,1990,9,male,666,357,256,4,0,3,0,1,0
1652167,15,3,1998,6,male,495,341,262,4,0,4,0,0,0
1940815,18,7,1995,7,male,347,348,291,4,0,4,0,0,0
1734023,21,14,1992,10,female,420,345,271,4,0,4,0,0,0
1710948,21,23,1992,2,male,604,356,324,4,1,4,1,0,0
2061129,34,11,1979,11,male,67,351,261,4,2,4,1,0,1
1126499,108,29,1905,4,female,782,343,203,4,1,4,1,0,0
1925020,18,25,1995,9,female,356,354,259,4,4,4,2,0,2
1082152,17,31,1996,5,male,358,343,281,4,9,4,8,0,1
1303230,17,23,1996,9,male,381,353,324,4,9,4,8,0,1
1353468,20,6,1993,12,male,585,342,271,4,189,4,118,0,71
1568059,20,14,1993,7,male,1688,348,205,4,7,4,7,0,0
1120728,21,14,1992,7,male,537,344,301,4,21,4,18,0,3
1962895,26,17,1987,11,male,1281,354,126,4,37,4,37,0,0
1332619,34,9,1979,3,male,404,351,219,4,70,4,69,0,1
1818585,53,3,1960,10,female,418,339,324,4,6,4,2,0,4
1989301,107,5,1906,5,male,412,338,314,4,18,4,14,0,4
1328342,107,19,1906,9,male,878,353,211,4,32,4,26,0,6
1094572,93,7,1920,2,male,975,353,143,5,6,0,4,5,2
1984194,108,4,1905,6,male,2229,353,295,5,4,0,2,5,2
1654632,73,1,1940,1,male,1053,341,147,5,45,0,26,5,19
1751711,84,5,1929,7,male,1442,339,179,5,17,0,1,5,16
2005113,15,20,1998,3,male,681,342,119,5,1,1,0,4,1
1244486,103,15,1910,9,male,864,348,247,5,13,3,9,2,4
1117571,24,14,1989,8,male,498,344,221,5,0,5,0,0,0
1289963,29,31,1984,1,male,522,349,212,5,1,5,1,0,0
1098715,70,1,1943,11,female,875,350,198,5,3,5,2,0,1
2176324,17,10,1996,8,male,649,352,312,5,7,5,7,0,0
1858314,20,12,1993,9,male,344,342,314,5,6,5,6,0,0
1749283,15,2,1998,1,male,674,347,268,5,36,5,24,0,12
1714774,15,31,1998,3,male,571,355,197,5,20,5,15,0,5
1023944,16,23,1997,8,male,620,352,192,5,74,5,65,0,9
1033453,18,18,1995,3,male,91,343,26,5,50,5,46,0,4
2174932,18,11,1995,8,male,336,356,309,5,17,5,3,0,14
1922529,21,16,1992,11,female,61,354,45,5,14,5,5,0,9
1410465,53,27,1960,1,male,499,339,201,5,45,5,11,0,34
1838142,18,14,1995,3,male,594,357,241,6,2,0,2,6,0
1914872,61,29,1952,12,male,1651,342,111,6,7,0,7,6,0
2019780,24,3,1989,2,male,486,356,244,6,14,0,4,6,10
1632982,16,30,1997,3,male,389,348,206,6,9,3,0,3,9
2093510,18,26,1995,7,male,625,353,307,6,2,6,2,0,0
1696499,108,8,1905,2,female,925,357,23,6,2,6,1,0,1
1933074,18,5,1995,7,female,504,357,101,6,74,6,60,0,14
1597267,29,5,1984,8,female,495,345,283,6,19,6,7,0,12
1244328,85,7,1928,12,female,2043,345,40,7,0,0,0,7,0
1801707,15,2,1998,3,male,497,357,284,7,14,0,7,7,7
1288234,15,14,1998,3,female,628,347,200,7,24,3,5,4,19
1390700,24,29,1989,10,male,556,346,228,7,20,6,13,1,7
1646023,19,12,1994,2,male,259,346,263,7,3,7,2,0,1
1840724,15,21,1998,5,male,234,338,86,7,122,7,110,0,12
1198071,25,27,1988,7,female,147,343,260,7,20,7,17,0,3
1599193,18,16,1995,12,male,307,346,320,8,1,0,0,8,1
1208827,19,29,1994,5,female,544,354,226,8,0,0,0,8,0
1755679,68,1,1945,4,female,1315,352,157,8,3,0,0,8,3
1237834,16,28,1997,11,male,514,352,233,8,12,0,8,8,4
1544108,19,11,1994,4,male,497,351,314,8,4,5,1,3,3
1633631,25,11,1988,6,male,708,350,216,8,7,5,6,3,1
1280478,17,5,1996,12,male,703,356,235,8,0,7,0,1,0
1060646,20,24,1993,12,male,537,339,218,8,0,7,0,1,0
1443788,17,20,1996,10,male,504,340,258,8,5,7,4,1,1
1618750,18,28,1995,12,male,1112,354,184,8,1,8,0,0,1
1205648,21,3,1992,12,male,617,356,242,8,0,8,0,0,0
2069023,20,28,1993,6,male,878,356,249,8,3,8,3,0,0
1837610,22,4,1991,1,female,370,338,228,8,2,8,1,0,1
1231551,28,16,1985,5,male,664,357,264,8,4,8,3,0,1
2124356,15,19,1998,12,female,289,346,85,8,11,8,11,0,0
1076931,19,9,1994,3,female,442,339,214,8,8,8,1,0,7
1141179,108,29,1905,11,female,657,348,56,8,8,8,5,0,3
1272479,15,8,1998,9,male,459,345,307,8,12,8,7,0,5
2162523,28,25,1985,10,male,868,358,173,8,35,8,10,0,25
1218661,108,26,1905,3,female,621,357,126,8,28,8,28,0,0
2176660,28,4,1985,10,male,433,350,305,9,26,0,11,9,15
1858064,24,18,1989,1,male,1230,341,125,9,15,5,6,4,9
1711826,19,10,1994,11,male,645,345,158,9,35,8,14,1,21
1694383,23,3,1990,3,male,563,341,180,9,2,9,2,0,0
1247517,16,13,1997,12,female,160,349,159,9,18,9,11,0,7
1941575,19,26,1994,6,male,395,352,224,9,35,9,26,0,9
1146971,19,8,1994,8,female,465,349,161,9,27,9,26,0,1
1186832,38,22,1975,8,male,481,355,112,9,45,9,14,0,31
1860157,14,4,1999,3,female,329,338,261,10,4,4,1,6,3
1299135,19,4,1994,10,male,714,351,195,10,65,2,15,8,50
1449115,25,2,1988,1,male,1346,350,153,10,19,4,9,6,10
1243121,18,10,1995,11,male,274,345,283,10,10,10,8,0,2
2088668,23,10,1990,10,male,488,342,303,10,8,10,0,0,8
1177759,26,5,1987,3,male,395,349,204,10,12,10,11,0,1
1988331,73,15,1940,8,female,884,340,241,10,10,10,10,0,0
1052557,15,4,1998,2,male,326,353,234,10,43,10,43,0,0
2145372,19,20,1994,1,male,209,347,209,10,15,10,10,0,5
1673622,108,29,1905,12,male,1008,345,170,10,239,10,225,0,14
1597323,113,29,1900,9,male,1435,353,217,11,1,0,0,11,1
2089954,14,3,1999,11,male,176,344,315,11,8,2,2,9,6
1072594,23,1,1990,10,male,758,347,79,11,24,0,13,11,11
1611373,21,7,1992,6,male,409,354,258,11,20,4,7,7,13
1490401,74,10,1939,10,male,856,353,177,11,10,8,5,3,5
1020654,30,4,1983,6,male,703,345,236,11,0,11,0,0,0
1496196,18,4,1995,8,male,490,340,287,11,5,11,5,0,0
2078191,30,9,1983,7,male,191,346,296,11,7,11,7,0,0
1169931,17,6,1996,2,male,487,349,284,11,22,11,2,0,20
1710632,21,3,1992,11,female,369,352,248,11,32,11,10,0,22
1819657,108,30,1905,6,female,1032,356,270,11,19,11,12,0,7
1257341,20,10,1993,10,male,498,352,148,12,4,0,4,12,0
1032011,36,22,1977,3,female,707,342,201,12,95,0,28,12,67
1885063,96,13,1917,1,female,374,358,217,12,55,1,25,11,30
1298516,21,4,1992,11,female,88,348,58,12,26,8,8,4,18
2061571,19,5,1994,8,male,587,352,220,12,29,11,3,1,26
2192438,29,21,1984,4,male,444,340,238,12,1,12,1,0,0
1695518,20,15,1993,9,female,631,354,198,12,6,12,5,0,1
1228650,20,2,1993,1,male,524,350,266,12,17,12,7,0,10
1562347,21,18,1992,8,female,1022,353,218,12,43,12,42,0,1
1239881,27,7,1986,9,female,210,351,246,12,20,12,13,0,7
1897719,29,8,1984,3,male,370,343,255,12,49,12,34,0,15
1036355,108,22,1905,7,male,1771,350,205,12,165,12,96,0,69
2010259,95,27,1918,11,male,1497,338,139,13,39,10,37,3,2
2065869,27,22,1986,3,male,1170,342,217,13,18,13,12,0,6
1556789,18,25,1995,6,male,519,342,229,13,88,13,22,0,66
1382860,23,22,1990,8,male,277,354,245,13,37,13,13,0,24
1663922,32,20,1981,2,male,736,355,295,13,54,13,54,0,0
1468286,103,13,1910,10,male,743,338,151,13,35,13,28,0,7
1407520,84,12,1929,10,female,2190,352,103,14,27,2,18,12,9
1782167,17,2,1996,7,male,873,338,242,14,12,10,10,4,2
1742867,22,12,1991,9,female,416,340,153,14,32,13,24,1,8
1022447,20,7,1993,2,male,901,357,226,14,0,14,0,0,0
1607848,21,10,1992,7,female,233,340,242,14,38,14,37,0,1
1353377,20,25,1993,4,male,742,358,175,15,31,0,8,15,23
1160192,83,7,1930,3,female,1529,347,239,15,18,8,7,7,11
2101444,20,17,1993,4,male,1119,352,87,15,31,8,14,7,17
1870658,21,1,1992,9,female,807,350,172,15,41,12,11,3,30
1905080,25,12,1988,12,male,331,358,276,15,69,12,36,3,33
1089633,28,18,1985,1,male,917,340,238,15,82,14,35,1,47
1995974,20,4,1993,10,female,819,351,111,15,0,15,0,0,0
1783743,18,24,1995,12,female,157,356,179,15,9,15,9,0,0
1194647,18,13,1995,2,female,416,357,157,15,3,15,3,0,0
1072047,107,8,1906,2,male,209,347,300,15,8,15,6,0,2
1167685,22,3,1991,9,female,818,358,206,15,12,15,12,0,0
2020680,28,12,1985,7,male,527,345,310,15,12,15,8,0,4
1649456,16,4,1997,11,male,429,358,255,16,9,0,3,16,6
2013911,108,31,1905,10,male,943,346,300,16,3,1,1,15,2
1794923,62,12,1951,5,male,1366,357,140,16,164,14,87,2,77
1299410,103,13,1910,1,male,908,353,276,16,29,15,21,1,8
1840729,23,16,1990,6,male,557,343,240,16,2,16,0,0,2
2160961,103,29,1910,1,female,1433,344,149,16,8,16,2,0,6
1999216,28,17,1985,8,male,539,346,302,16,89,16,74,0,15
1034629,53,21,1960,1,female,729,342,236,16,45,16,30,0,15
1726833,23,14,1990,6,female,317,352,303,17,12,11,4,6,8
1108554,67,18,1946,3,male,1728,345,274,17,34,14,22,3,12
1873745,19,7,1994,11,male,327,347,305,17,0,17,0,0,0
1125751,60,12,1953,4,male,1402,345,48,17,5,17,4,0,1
1209847,18,22,1995,4,female,300,349,189,17,12,17,8,0,4
2128063,20,3,1993,9,male,637,348,163,17,18,17,7,0,11
1340534,50,20,1963,3,male,1145,342,245,17,18,17,11,0,7
1769813,18,6,1995,5,female,549,346,152,17,69,17,50,0,19
1808001,23,27,1990,5,female,470,341,57,17,53,17,28,0,25
1473667,105,8,1908,10,female,2296,349,79,17,146,17,133,0,13
1072088,21,29,1992,5,male,378,356,217,18,123,14,53,4,70
2038983,83,2,1930,8,male,1525,340,188,18,23,18,22,0,1
1394436,18,19,1995,5,female,209,338,175,18,63,18,56,0,7
1570873,23,19,1990,10,female,419,343,273,19,77,9,60,10,17
1716892,46,12,1967,11,male,1766,341,244,19,82,15,61,4,21
1542026,26,10,1987,7,male,522,347,243,19,24,19,24,0,0
1157978,51,4,1962,1,male,385,339,200,19,23,19,17,0,6
1299323,19,17,1994,1,male,494,340,187,19,32,19,19,0,13
1216290,19,7,1994,3,female,465,356,105,19,76,19,49,0,27
1578336,22,3,1991,10,male,160,354,344,19,60,19,57,0,3
1195805,103,31,1910,8,female,1212,357,195,20,16,10,15,10,1
1940721,37,16,1976,5,female,436,356,186,20,43,4,18,16,25
1560230,19,1,1994,5,female,1295,356,117,20,13,19,12,1,1
2028867,103,16,1910,12,male,467,346,214,20,58,20,55,0,3
1745592,63,1,1950,8,female,1479,350,260,21,152,0,64,21,88
1189700,19,7,1994,1,male,484,355,287,21,62,19,15,2,47
1373546,32,19,1981,4,female,859,340,199,21,31,21,22,0,9
1184515,30,20,1983,1,female,1799,357,140,21,94,21,76,0,18
1556282,18,15,1995,3,female,467,340,181,22,29,0,10,22,19
1438957,21,16,1992,8,female,433,351,196,22,93,7,32,15,61
1876728,30,22,1983,8,male,306,349,242,22,80,8,53,14,27
1588798,17,24,1996,5,male,80,338,330,22,1,22,1,0,0
2092642,22,17,1991,4,male,158,340,286,22,76,22,73,0,3
1886193,37,9,1976,5,male,304,345,293,22,130,22,83,0,47
2165633,68,10,1945,3,male,1412,338,107,22,36,22,32,0,4
1257420,15,3,1998,4,male,266,342,244,23,2,1,0,22,2
2178136,15,17,1998,7,male,417,343,300,23,0,0,0,23,0
2065047,20,23,1993,1,male,506,338,303,23,10,1,7,22,3
2041671,17,6,1996,5,male,229,342,85,23,9,23,5,0,4
1642702,26,26,1987,1,male,380,356,328,23,8,23,7,0,1
1201948,22,17,1991,12,female,548,355,290,23,23,23,13,0,10
1351594,17,18,1996,12,male,230,352,212,24,135,0,25,24,110
1105149,20,26,1993,8,male,286,339,249,24,17,20,11,4,6
1129978,23,8,1990,6,female,280,344,69,24,172,22,95,2,77
1893295,16,2,1997,5,male,658,358,260,24,2,24,2,0,0
1214842,94,22,1919,5,male,828,343,186,24,6,24,6,0,0
1802271,23,29,1990,11,male,616,339,274,24,23,24,19,0,4
1797934,93,1,1920,7,male,1351,343,73,24,31,24,28,0,3
1809765,18,7,1995,12,female,504,352,183,24,84,24,60,0,24
1040919,35,22,1978,6,female,376,342,130,25,149,0,33,25,116
1235253,32,10,1981,5,female,727,344,221,25,13,9,12,16,1
1992223,19,14,1994,8,male,442,349,297,25,35,25,30,0,5
1278053,15,10,1998,7,female,445,356,48,26,1,0,1,26,0
1405264,42,6,1971,3,female,573,353,211,26,13,0,3,26,10
1236903,53,1,1960,10,male,1266,354,302,26,7,26,6,0,1
1499052,95,12,1918,9,female,850,344,126,26,14,26,14,0,0
1204838,18,7,1995,10,female,275,352,144,26,72,26,56,0,16
1712643,103,23,1910,11,male,1228,357,218,27,23,4,17,23,6
1491771,14,20,1999,4,female,290,338,178,27,5,25,4,2,1
1403104,20,2,1993,8,male,278,352,327,27,0,27,0,0,0
1683656,23,4,1990,6,male,568,349,244,27,17,27,17,0,0
1738150,24,24,1989,2,male,540,348,160,27,29,27,29,0,0
1807558,25,12,1988,10,male,905,342,245,27,19,27,13,0,6
1109625,14,12,1999,9,male,361,343,250,28,7,18,4,10,3
1082911,16,23,1997,8,female,526,358,227,28,28,16,7,12,21
1465260,17,11,1996,7,female,264,343,109,28,130,7,80,21,50
1722885,23,28,1990,4,male,154,358,271,28,41,23,20,5,21
2177851,108,3,1905,7,male,1697,344,117,28,30,27,29,1,1
1208364,50,1,1963,7,female,1466,342,186,28,65,23,57,5,8
1321730,18,1,1995,2,male,428,350,186,28,3,28,2,0,1
1828695,19,22,1994,9,male,435,341,268,28,14,28,12,0,2
1464742,27,20,1986,7,male,457,344,47,29,2,0,1,29,1
1009314,19,30,1994,6,male,643,346,81,29,86,3,12,26,74
1124265,19,15,1994,12,male,609,349,298,29,6,19,1,10,5
1463103,36,31,1977,10,male,636,339,308,29,13,27,5,2,8
1349358,63,3,1950,4,female,1270,351,100,29,12,28,11,1,1
1248273,103,21,1910,6,male,1013,358,216,29,15,29,9,0,6
1515688,83,23,1930,11,female,1030,357,135,29,29,29,16,0,13
2048962,108,31,1905,7,male,1449,347,123,30,2,0,0,30,2
1755743,20,7,1993,3,male,168,349,342,30,10,2,5,28,5
1696775,50,25,1963,5,female,786,350,207,30,29,0,3,30,26
2125603,25,18,1988,5,male,762,351,197,30,94,17,39,13,55
1209224,26,15,1987,6,male,939,354,222,31,185,23,71,8,114
1726629,63,1,1950,1,male,82,350,208,31,134,28,86,3,48
1294506,18,1,1995,1,female,277,354,300,31,9,31,9,0,0
1609822,22,4,1991,10,male,464,354,341,31,17,31,11,0,6
1759468,23,1,1990,1,male,204,355,333,30,28,30,27,0,1
1688223,19,4,1994,12,male,1441,350,199,31,125,31,84,0,41
1078553,21,24,1992,5,female,375,353,301,31,59,31,42,0,17
2138208,21,14,1992,10,female,179,348,187,31,53,31,31,0,22
1550888,31,28,1982,8,female,267,358,315,32,16,0,8,32,8
2083706,19,4,1994,10,male,366,354,320,32,0,32,0,0,0
1121078,49,21,1964,11,female,1365,355,113,32,46,32,33,0,13
1037199,100,25,1913,6,male,346,349,310,32,20,32,13,0,7
1407080,29,21,1984,10,female,411,354,195,32,261,32,147,0,114
2072807,42,27,1971,9,male,319,341,327,33,7,14,2,19,5
2014218,20,26,1993,3,male,589,353,280,33,27,33,19,0,8
2185856,24,24,1989,11,male,1087,358,196,33,49,33,44,0,5
1273130,89,10,1924,4,male,2076,344,219,34,40,7,19,27,21
1618310,18,6,1995,6,male,323,343,274,34,26,29,10,5,16
1304035,14,9,1999,5,male,449,349,191,34,1,34,1,0,0
1660599,21,8,1992,7,male,249,345,319,34,0,34,0,0,0
1949570,66,13,1947,8,female,621,344,164,34,2,34,1,0,1
1768138,14,1,1999,4,female,120,341,288,34,40,34,30,0,10
1998236,17,6,1996,11,male,749,347,191,35,3,2,0,33,3
1181830,18,16,1995,6,male,76,346,307,36,44,14,30,22,14
1037002,21,17,1992,11,male,535,340,137,35,98,32,54,3,44
1475782,25,8,1988,8,male,447,358,295,35,9,35,9,0,0
1745482,102,10,1911,12,male,522,343,245,35,7,35,6,0,1
1509970,17,15,1996,5,female,283,353,114,35,51,35,31,0,20
1135320,20,27,1993,4,male,434,340,217,35,29,35,27,0,2
1746098,26,28,1987,12,male,534,346,288,35,51,35,20,0,31
2122259,92,5,1921,10,male,1731,339,181,37,43,0,22,37,21
1551030,37,6,1976,7,male,659,345,170,37,174,22,89,15,85
2034431,58,1,1955,7,female,733,347,219,37,50,37,32,0,18
1736183,98,18,1915,4,male,1895,352,163,37,23,37,6,0,17
1496598,113,14,1900,2,male,1221,356,184,37,62,37,51,0,11
2151253,15,8,1998,12,female,658,355,240,39,2,2,1,37,1
1511558,21,11,1992,7,male,363,352,331,39,4,6,1,33,3
1526779,15,6,1998,8,male,321,353,267,39,28,1,8,38,20
1769376,23,13,1990,2,female,526,355,208,39,76,20,40,19,36
1348702,42,30,1971,5,male,718,346,230,38,16,37,15,1,1
1921503,20,2,1993,7,male,625,350,139,39,39,37,8,2,31
1892400,103,11,1910,3,female,629,342,201,38,56,38,48,0,8
2143175,14,12,1999,4,male,888,357,183,38,83,38,57,0,26
1897347,18,6,1995,2,female,477,358,137,40,36,40,26,0,10
1922738,16,21,1997,6,female,376,346,165,42,0,0,0,42,0
1095666,18,10,1995,1,male,291,345,297,41,0,8,0,33,0
1908770,108,19,1905,6,male,1581,350,218,42,28,0,8,42,20
1318637,65,28,1948,1,female,1757,352,188,41,101,7,19,34,82
2117680,21,14,1992,4,female,146,356,38,42,205,38,199,4,6
1595359,22,30,1991,1,female,160,350,228,42,90,35,48,7,42
1116140,25,2,1988,10,male,693,339,217,42,106,40,74,2,32
1900500,20,10,1993,3,male,396,356,312,42,5,42,5,0,0
1455233,23,20,1990,1,male,634,348,282,42,25,42,20,0,5
1538585,17,2,1996,6,male,229,341,121,41,50,41,42,0,8
1612185,26,3,1987,6,female,798,343,183,42,31,42,23,0,8
1292228,68,12,1945,3,male,676,342,71,41,28,41,26,0,2
1438155,16,27,1997,7,female,179,348,291,42,106,42,83,0,23
1889386,19,14,1994,11,male,371,339,313,43,1,1,0,42,1
1325698,16,15,1997,2,female,338,348,125,44,9,0,2,44,7
1238535,34,3,1979,5,male,285,338,160,44,18,44,14,0,4
1208970,17,9,1996,5,male,338,343,280,44,55,44,43,0,12
2178756,69,10,1944,5,female,1131,354,141,43,28,43,8,0,20
1862064,30,23,1983,1,female,691,340,186,45,11,3,8,42,3
1658774,18,9,1995,6,female,337,349,296,45,19,15,12,30,7
1890860,18,6,1995,8,male,167,350,304,45,0,45,0,0,0
1651771,21,23,1992,5,female,607,342,74,45,31,45,30,0,1
1358294,26,10,1987,5,male,355,356,112,45,569,45,190,0,379
1276971,18,12,1995,5,male,396,345,125,46,52,24,25,22,27
1739913,16,19,1997,8,male,344,352,260,47,21,47,9,0,12
1351404,28,27,1985,2,female,830,352,239,47,51,47,34,0,17
2001074,21,9,1992,9,male,739,340,211,49,16,0,3,49,13
1240446,16,30,1997,10,male,803,345,233,49,22,24,19,25,3
1753220,26,29,1987,8,female,209,358,330,49,120,49,108,0,12
1230963,27,18,1986,2,male,696,346,163,48,91,48,62,0,29
1792563,16,20,1997,11,male,482,358,190,50,19,30,17,20,2
1178755,21,12,1992,10,male,1423,340,190,51,21,20,15,31,6
1263919,18,28,1995,7,male,364,344,290,51,23,37,6,14,17
1914769,15,14,1998,3,female,190,354,227,50,45,44,13,6,32
1711693,16,1,1997,2,female,791,340,151,50,161,47,84,3,77
1345502,47,18,1966,11,female,1070,342,253,50,7,50,5,0,2
1423803,22,26,1991,8,male,1032,339,271,50,18,50,17,0,1
2010861,24,26,1989,6,male,364,353,285,51,37,51,36,0,1
1592631,18,15,1995,5,female,426,358,90,50,158,50,145,0,13
1737477,23,15,1990,7,male,594,356,304,52,72,42,38,10,34
1459455,17,21,1996,9,female,259,350,314,52,153,44,70,8,83
1661433,22,6,1991,6,male,206,344,309,52,20,52,12,0,8
2039870,18,3,1995,11,female,188,341,156,52,164,52,151,0,13
1351817,24,24,1989,5,female,165,355,298,52,151,52,131,0,20
1467055,33,29,1980,9,female,527,352,320,52,119,52,46,0,73
1184316,20,17,1993,8,female,467,342,285,54,1,41,1,13,0
1954076,16,1,1997,4,male,736,355,175,55,33,47,31,8,2
1285159,20,9,1993,4,female,723,338,210,55,6,55,5,0,1
1687024,18,6,1995,10,male,425,349,324,54,27,54,20,0,7
1480759,15,17,1998,8,female,502,344,105,54,114,54,100,0,14
1502525,61,23,1952,7,male,461,342,296,57,21,0,1,57,20
1937763,16,13,1997,2,female,338,346,176,56,28,16,10,40,18
1088475,21,26,1992,2,male,691,351,243,56,15,37,9,19,6
1108744,99,25,1914,7,male,1246,349,195,58,47,12,36,46,11
1620379,16,30,1997,6,female,287,354,117,56,43,56,42,0,1
1693737,15,20,1998,6,female,434,349,281,57,120,57,112,0,8
1453827,18,8,1995,8,male,474,358,233,57,181,57,166,0,15
1976048,16,17,1997,3,female,408,339,298,60,298,11,202,49,96
1631211,14,19,1999,5,male,330,355,306,60,60,33,31,27,29
1389711,18,12,1995,6,female,372,345,196,60,267,35,54,25,213
1676176,35,3,1978,4,female,147,338,298,60,80,56,57,4,23
2192246,20,3,1993,2,female,820,352,143,60,16,60,14,0,2
1116749,20,21,1993,10,female,473,341,166,62,34,7,5,55,29
1367447,18,14,1995,12,male,478,342,152,62,66,7,35,55,31
1498939,18,28,1995,11,male,431,356,150,62,82,38,32,24,50
2144495,17,1,1996,1,female,438,343,46,61,123,28,72,33,51
1357884,23,15,1990,3,male,249,344,47,61,140,31,72,30,68
1933634,44,12,1969,3,male,127,358,278,63,14,62,1,1,13
1473586,20,13,1993,6,female,461,358,219,61,74,46,39,15,35
1852232,57,21,1956,1,female,1715,347,216,63,355,58,200,5,155
1138386,73,27,1940,3,male,630,339,254,62,217,50,160,12,57
1443114,18,3,1995,3,female,175,343,297,61,66,61,65,0,1
2050835,27,13,1986,3,female,405,344,199,65,93,1,25,64,68
2059145,108,13,1905,6,female,1562,352,155,64,188,10,101,54,87
1665183,27,13,1986,3,male,407,351,88,65,821,19,260,46,561
1244244,66,26,1947,8,male,1775,355,200,64,272,43,91,21,181
1060970,22,18,1991,2,male,661,358,225,65,83,47,71,18,12
1023731,21,27,1992,10,female,274,357,65,65,162,61,115,4,47
1383279,20,3,1993,9,male,77,355,264,64,61,64,46,0,15
2156197,22,2,1991,12,male,311,358,283,67,82,10,64,57,18
1562934,21,1,1992,6,male,549,339,190,67,2,67,2,0,0
1297637,23,1,1990,10,male,424,344,168,67,45,67,28,0,17
1701598,28,13,1985,6,male,514,351,13,67,282,67,250,0,32
2116274,15,17,1998,7,male,631,351,206,70,94,1,7,69,87
1976552,44,25,1969,2,male,286,358,178,69,1,69,1,0,0
1862520,19,13,1994,3,male,190,339,319,70,83,70,50,0,33
1318510,21,26,1992,5,male,1499,350,222,71,47,71,43,0,4
2029137,33,23,1980,11,female,310,339,283,69,116,69,106,0,10
2120961,16,25,1997,2,female,1583,347,142,74,57,74,24,0,33
1996041,103,7,1910,3,male,331,345,298,72,92,72,81,0,11
2011676,22,25,1991,2,female,1529,349,264,74,162,74,141,0,21
1186636,79,19,1934,12,female,1474,344,137,75,109,0,54,75,55
1197421,86,10,1927,1,male,2186,345,197,75,65,0,18,75,47
1256095,23,10,1990,7,female,387,353,147,77,61,19,33,58,28
1127371,27,21,1986,4,female,1033,350,198,76,123,48,35,28,88
1474126,106,7,1907,9,male,1547,358,185,75,26,74,16,1,10
1915101,20,26,1993,11,male,627,355,190,76,232,73,145,3,87
1258673,100,23,1913,6,female,1970,343,299,75,33,75,25,0,8
1128896,22,8,1991,4,female,334,340,265,79,368,44,151,35,217
1226847,96,22,1917,9,female,2177,351,146,80,455,20,235,60,220
1148714,20,25,1993,6,male,703,357,255,80,32,74,10,6,22
1845244,108,2,1905,4,male,890,354,222,79,59,76,55,3,4
1859610,22,29,1991,12,male,574,351,224,78,138,72,105,6,33
2068953,23,12,1990,4,male,330,356,319,78,230,77,155,1,75
1894862,17,21,1996,3,male,225,353,214,79,0,79,0,0,0
1864450,25,22,1988,12,male,655,343,309,79,4,79,3,0,1
1502810,18,3,1995,6,male,524,353,266,78,18,78,9,0,9
1655785,33,4,1980,7,male,389,340,177,80,22,80,22,0,0
1088736,108,29,1905,7,male,1530,357,197,78,37,78,32,0,5
1046691,17,11,1996,10,female,183,347,214,80,248,80,197,0,51
2172991,108,13,1905,7,male,1114,338,229,83,11,0,8,83,3
1998876,18,29,1995,4,male,489,352,281,84,29,42,23,42,6
1369264,18,1,1995,12,female,783,357,270,84,310,48,178,36,132
1314841,20,13,1993,1,female,762,356,116,83,64,79,46,4,18
1045760,14,29,1999,5,female,380,346,267,81,36,81,35,0,1
1328534,16,10,1997,7,male,151,340,280,81,23,81,21,0,2
2071623,23,29,1990,4,female,495,348,208,82,43,82,34,0,9
1552349,97,15,1916,11,male,1460,358,286,83,15,83,8,0,7
1859467,71,31,1942,10,male,1358,354,119,81,98,81,57,0,41
1912745,103,22,1910,4,female,807,350,109,83,64,83,60,0,4
1056903,21,14,1992,6,male,58,341,300,83,477,83,373,0,104
1025693,51,4,1962,11,female,296,344,70,86,100,0,17,86,83
1435283,71,26,1942,6,female,1481,339,203,86,303,0,56,86,247
1629522,16,17,1997,4,male,517,348,258,86,40,49,2,37,38
1260570,23,10,1990,2,female,654,340,234,87,84,60,15,27,69
1655352,39,20,1974,11,male,267,349,139,87,79,44,48,43,31
1995593,23,22,1990,10,male,431,350,309,85,8,78,5,7,3
1013802,15,7,1998,11,female,173,357,75,87,112,80,68,7,44
1983290,57,16,1956,6,male,1456,344,213,86,76,86,58,0,18
1608089,20,2,1993,2,female,365,347,131,87,400,87,284,0,116
1379534,103,12,1910,4,female,718,343,201,91,32,0,3,91,29
1927313,108,7,1905,5,female,1937,352,173,88,23,2,14,86,9
1989786,103,12,1910,12,male,996,342,182,89,91,12,75,77,16
1210315,20,16,1993,3,male,362,350,209,91,46,60,29,31,17
1008292,35,9,1978,11,male,406,352,41,89,40,53,32,36,8
1297568,29,10,1984,7,male,300,351,243,90,305,35,99,55,206
1677373,108,9,1905,11,male,446,351,161,93,114,0,52,93,62
1321396,17,15,1996,11,female,489,358,195,94,156,67,103,27,53
2030890,25,2,1988,11,male,827,352,65,95,43,93,37,2,6
1481663,23,4,1990,11,male,227,346,296,92,121,89,94,3,27
1987783,24,11,1989,3,male,1639,342,154,93,136,74,87,19,49
1824065,22,23,1991,10,male,364,356,333,94,28,94,22,0,6
1834971,93,24,1920,5,male,819,350,259,93,25,93,19,0,6
1468221,16,23,1997,3,male,248,338,151,93,71,93,53,0,18
2159675,32,13,1981,8,female,603,341,294,93,89,93,65,0,24
1224159,35,11,1978,4,female,305,348,104,95,93,95,66,0,27
1696325,33,19,1980,6,male,104,345,207,94,395,94,343,0,52
1133930,20,5,1993,3,male,446,341,68,96,149,33,36,63,113
1782198,103,18,1910,9,male,560,351,197,97,157,69,64,28,93
1237689,56,29,1957,11,male,1790,348,209,96,113,91,85,5,28
2079822,22,12,1991,8,male,1337,339,187,99,70,99,66,0,4
1739264,26,14,1987,8,female,1640,343,109,96,136,96,62,0,74
1461141,68,14,1945,8,male,1282,346,171,98,86,98,80,0,6
1075212,17,6,1996,5,female,331,356,203,96,294,96,71,0,223
2099314,55,9,1958,9,female,491,344,297,102,75,0,6,102,69
1009823,15,28,1998,1,female,152,355,77,103,99,53,40,50,59
1451425,23,8,1990,3,female,478,356,183,102,148,58,82,44,66
1779647,100,1,1913,1,male,653,343,172,100,171,55,51,45,120
1549567,20,28,1993,7,female,607,341,247,104,83,101,47,3,36
1643974,103,14,1910,7,male,575,338,281,100,34,100,34,0,0
1862339,15,29,1998,9,female,162,343,250,105,143,18,60,87,83
1902003,15,7,1998,9,female,190,351,158,105,147,46,40,59,107
1821757,60,31,1953,10,female,1380,351,176,109,60,86,47,23,13
1598407,15,23,1998,9,female,372,347,229,107,660,104,412,3,248
1469934,89,19,1924,2,male,470,338,253,108,100,108,90,0,10
1901620,17,28,1996,9,male,352,358,204,111,53,0,17,111,36
1946578,95,5,1918,6,male,658,356,302,113,27,0,13,113,14
1057539,16,16,1997,11,female,270,356,242,113,203,6,94,107,109
1680677,32,14,1981,10,male,1627,354,58,110,137,78,82,32,55
2044900,28,8,1985,6,male,855,347,146,113,258,34,63,79,195
1780764,18,27,1995,11,male,479,345,244,112,41,104,36,8,5
2119934,16,5,1997,7,male,306,347,307,113,48,113,38,0,10
1858483,23,4,1990,4,male,549,353,319,110,33,110,27,0,6
1284761,14,26,1999,3,female,658,353,223,119,137,1,55,118,82
1127205,61,29,1952,8,female,816,358,259,115,127,0,59,115,68
1593543,108,18,1905,2,male,1085,345,196,118,160,10,77,108,83
1345566,18,12,1995,10,male,239,338,281,116,141,67,39,49,102
1826725,49,7,1964,6,male,702,343,60,118,167,40,65,78,102
1840877,29,20,1984,4,female,1342,357,200,114,359,99,49,15,310
1355746,39,6,1974,7,female,478,357,69,118,266,117,132,1,134
1451037,15,31,1998,7,male,395,347,285,117,3,117,1,0,2
1665082,16,4,1997,7,male,372,353,171,123,66,8,21,115,45
2094109,17,16,1996,6,male,527,341,149,121,59,1,22,120,37
1248240,21,24,1992,4,male,297,358,216,124,52,0,25,124,27
1761989,91,11,1922,12,female,829,345,119,122,180,0,40,122,140
1000985,15,15,1998,2,female,488,339,184,122,134,60,106,62,28
1841498,21,30,1992,10,female,265,345,160,123,206,64,178,59,28
1252632,53,24,1960,3,male,595,357,278,123,65,120,57,3,8
1513414,21,26,1992,12,male,455,348,259,124,134,92,76,32,58
1305059,53,1,1960,11,male,1255,355,217,123,91,120,60,3,31
1307503,19,21,1994,3,male,520,342,272,123,58,123,53,0,5
1629556,18,9,1995,1,female,368,342,116,121,109,121,95,0,14
1413390,91,29,1922,12,male,115,345,139,124,379,124,373,0,6
1898083,19,5,1994,12,female,423,352,195,130,68,30,41,100,27
1169791,103,19,1910,8,male,1301,356,244,126,186,114,118,12,68
2156225,22,8,1991,8,female,150,348,222,125,207,113,156,12,51
1127579,18,17,1995,9,male,749,345,148,126,0,126,0,0,0
1369505,24,18,1989,2,male,833,339,151,126,48,126,31,0,17
1795321,19,20,1994,2,female,361,352,210,127,107,127,92,0,15
1699944,21,22,1992,1,female,562,354,141,129,93,129,45,0,48
1001257,50,2,1963,3,male,893,355,260,125,108,125,107,0,1
1914427,18,24,1995,4,female,471,343,186,126,238,126,167,0,71
1582543,17,6,1996,11,male,241,340,295,132,65,7,7,125,58
1250156,14,11,1999,2,female,736,340,207,134,155,122,88,12,67
1446860,16,1,1997,5,male,314,340,229,132,286,128,269,4,17
2116871,22,21,1991,4,male,471,354,297,133,6,133,6,0,0
1861701,19,29,1994,12,male,399,349,292,133,81,133,67,0,14
1181411,19,14,1994,6,male,413,355,274,131,108,131,71,0,37
1616954,27,12,1986,8,female,646,347,261,132,126,132,111,0,15
1344152,31,26,1982,10,female,2340,348,180,134,209,134,174,0,35
1285286,22,24,1991,12,female,455,356,238,139,73,0,26,139,47
2028905,66,5,1947,1,female,1611,338,70,137,115,0,44,137,71
1046190,103,30,1910,6,NA,2127,357,101,137,243,10,89,127,154
1810093,21,7,1992,12,male,1233,356,249,139,136,86,67,53,69
1211767,106,6,1907,8,male,1313,339,182,140,173,31,104,109,69
1610398,20,20,1993,1,male,838,341,252,142,53,126,41,16,12
1647767,50,23,1963,6,male,1099,343,102,138,282,120,108,18,174
2173673,102,20,1911,9,male,709,341,186,137,5,137,5,0,0
1655217,20,4,1993,1,female,247,343,109,143,113,143,74,0,39
1208206,41,11,1972,8,female,764,347,244,140,94,140,74,0,20
1808644,21,20,1992,3,female,156,346,100,143,427,143,379,0,48
1063047,19,23,1994,12,male,446,342,270,145,74,41,27,104,47
1064372,53,27,1960,1,male,960,353,235,145,88,72,47,73,41
2119371,34,6,1979,10,female,1365,344,200,144,240,103,140,41,100
1965112,24,6,1989,4,male,297,343,262,149,76,121,30,28,46
1547590,19,22,1994,10,male,466,350,206,149,354,124,266,25,88
2124936,19,18,1994,5,female,298,343,156,144,46,144,46,0,0
1376910,15,31,1998,5,male,571,341,231,156,63,3,16,153,47
1521991,61,27,1952,6,female,1506,355,158,153,42,2,17,151,25
2146970,65,11,1948,6,female,1631,357,174,153,66,0,28,153,38
2034065,49,28,1964,6,female,1275,352,144,155,233,2,106,153,127
1522045,23,1,1990,10,female,558,338,190,151,205,86,67,65,138
2082979,98,11,1915,5,female,1560,345,241,156,78,143,60,13,18
1285996,100,15,1913,6,female,1047,348,233,151,126,115,61,36,65
1223967,19,22,1994,2,male,765,354,187,156,64,155,22,1,42
2020853,27,18,1986,12,female,1263,342,174,153,141,152,110,1,31
2045848,100,27,1913,2,male,256,340,283,153,16,153,14,0,2
2063711,55,16,1958,11,female,1961,351,214,161,201,27,159,134,42
1539905,17,8,1996,11,female,567,354,215,163,112,86,47,77,65
1378421,17,18,1996,5,female,376,354,217,162,160,91,76,71,84
1365712,49,16,1964,1,female,1201,343,79,159,818,72,564,87,254
1928226,74,25,1939,12,female,202,339,171,163,79,123,36,40,43
1205888,108,3,1905,12,male,1900,345,118,160,37,116,28,44,9
1657722,103,26,1910,1,male,972,355,268,163,13,163,10,0,3
1367486,26,1,1987,1,male,622,348,299,161,63,161,58,0,5
1219099,15,11,1998,11,female,139,354,247,162,103,162,102,0,1
1229352,108,31,1905,1,male,52,342,234,170,199,61,80,109,119
1561371,55,17,1958,4,male,1178,355,147,167,28,167,27,0,1
1830918,100,21,1913,12,male,795,355,291,167,74,167,72,0,2
1622552,106,3,1907,8,male,601,347,303,167,60,167,50,0,10
1408693,44,27,1969,8,female,1379,350,225,171,211,171,167,0,44
1651409,16,10,1997,1,female,233,358,64,177,95,77,34,100,61
1079121,19,9,1994,10,female,203,352,249,175,63,151,28,24,35
1746298,20,18,1993,9,female,1028,344,213,178,316,171,289,7,27
1479588,17,15,1996,6,male,432,352,173,173,237,173,231,0,6
1190056,28,26,1985,1,female,1208,348,186,176,173,176,91,0,82
1800327,30,30,1983,4,male,257,344,271,185,52,2,6,183,46
1317011,17,13,1996,2,female,602,358,192,184,213,34,73,150,140
1789511,103,6,1910,4,male,2331,349,189,184,196,77,117,107,79
1239582,31,29,1982,7,female,463,357,302,184,124,155,83,29,41
1971014,18,16,1995,6,female,447,341,96,187,907,179,355,8,552
1814702,44,27,1969,12,female,272,349,87,182,14,182,13,0,1
1209016,22,2,1991,9,female,181,356,176,183,246,183,201,0,45
2067014,103,27,1910,11,female,732,342,93,184,151,184,135,0,16
1729453,19,12,1994,7,female,202,342,148,189,884,189,725,0,159
1392386,20,18,1993,5,female,637,344,295,184,286,184,153,0,133
1388364,108,1,1905,1,male,928,349,232,197,29,115,3,82,26
1555973,17,3,1996,9,female,524,343,171,194,118,106,93,88,25
1994943,23,22,1990,1,male,848,358,211,191,48,80,20,111,28
1627432,101,28,1912,12,male,1876,348,152,193,85,145,62,48,23
1021700,17,12,1996,12,male,425,339,305,198,241,198,199,0,42
1905782,24,30,1989,12,male,461,343,316,198,132,198,97,0,35
1381068,23,27,1990,8,male,298,347,234,196,175,196,152,0,23
1349241,23,14,1990,9,female,770,345,261,208,102,22,66,186,36
1957399,14,7,1999,5,female,23,345,195,203,229,7,36,196,193
1741409,23,8,1990,8,female,276,354,75,202,688,34,418,168,270
1319984,72,17,1941,12,male,1313,358,237,201,28,78,7,123,21
2079509,16,30,1997,8,male,436,351,188,204,612,70,479,134,133
1871740,23,1,1990,1,female,441,348,200,204,391,147,157,57,234
1875780,53,3,1960,6,male,611,346,108,202,24,198,8,4,16
1459919,18,6,1995,4,male,397,353,223,206,62,201,43,5,19
1465848,19,25,1994,5,female,326,354,237,207,800,204,740,3,60
1282414,24,15,1989,3,male,279,338,295,206,148,205,143,1,5
1138863,14,30,1999,6,female,481,352,284,205,17,205,14,0,3
1926114,17,27,1996,8,male,294,340,226,207,27,207,26,0,1
1431861,15,17,1998,8,male,313,338,139,206,132,206,126,0,6
1892624,19,2,1994,3,male,331,338,255,203,159,203,134,0,25
1617352,24,1,1989,1,male,626,355,257,207,131,207,83,0,48
1949012,19,22,1994,3,female,122,348,216,209,325,209,284,0,41
1124363,55,11,1958,2,female,1578,342,31,214,45,98,19,116,26
1166743,18,13,1995,7,female,489,339,214,216,258,82,52,134,206
1860302,25,29,1988,5,female,264,347,283,216,246,142,107,74,139
1416094,47,1,1966,5,female,727,344,146,220,67,202,50,18,17
2189557,37,14,1976,9,male,722,354,250,221,200,216,192,5,8
1586714,24,16,1989,7,male,747,358,253,212,168,212,164,0,4
1103054,27,15,1986,3,female,145,357,292,221,496,221,337,0,159
2177528,57,22,1956,6,male,7,356,346,227,69,0,22,227,47
1898988,20,18,1993,9,female,444,342,307,222,364,121,259,101,105
1905946,17,13,1996,12,male,459,353,202,225,78,206,52,19,26
1941533,19,6,1994,12,female,852,355,121,223,127,212,110,11,17
1511747,21,21,1992,9,female,1010,349,200,223,241,174,130,49,111
1452295,98,2,1915,5,female,2233,346,226,229,284,190,215,39,69
1616070,23,7,1990,9,female,59,354,256,223,723,206,453,17,270
1075664,35,15,1978,9,male,1300,345,204,244,0,0,0,244,0
1373498,14,3,1999,2,female,86,352,150,239,116,138,46,101,70
2108576,22,5,1991,3,female,1373,349,187,244,260,170,90,74,170
1693462,20,17,1993,4,female,632,354,201,240,82,231,74,9,8
1918876,17,10,1996,3,female,314,339,189,245,243,218,143,27,100
1772230,36,20,1977,4,female,855,341,202,234,289,210,124,24,165
1790645,60,15,1953,11,male,1476,358,224,240,276,226,183,14,93
1078442,28,31,1985,3,female,2033,353,240,244,513,236,456,8,57
1386082,108,30,1905,1,male,1159,347,232,246,106,245,30,1,76
1132575,20,23,1993,8,male,233,351,104,237,75,237,71,0,4
1070469,20,28,1993,5,male,418,342,282,237,166,237,114,0,52
2028129,23,11,1990,11,male,572,341,329,248,32,2,19,246,13
1310629,63,1,1950,1,male,223,338,288,250,62,7,35,243,27
1266665,89,26,1924,3,NA,2420,339,249,247,100,127,41,120,59
1331271,19,23,1994,6,female,393,341,126,249,310,242,242,7,68
1945021,34,29,1979,1,male,954,354,204,249,190,203,77,46,113
1731278,60,31,1953,7,female,1059,345,162,249,701,248,215,1,486
2183769,108,1,1905,7,male,1140,349,225,264,11,0,1,264,10
1536250,18,8,1995,7,female,348,344,146,274,192,138,93,136,99
2038457,15,30,1998,8,male,555,355,266,263,32,258,27,5,5
1513805,20,25,1993,2,female,256,348,233,265,60,200,50,65,10
1255171,23,27,1990,9,female,344,339,270,265,343,214,126,51,217
1292744,64,5,1949,12,female,1680,353,137,262,369,256,215,6,154
1240816,52,22,1961,7,male,785,349,172,266,1328,215,1120,51,208
1620806,19,10,1994,8,male,561,347,244,271,284,271,266,0,18
1364067,19,4,1994,11,male,715,356,115,285,65,28,36,257,29
2171292,44,28,1969,11,female,1788,345,165,279,825,11,502,268,323
1071338,20,20,1993,8,female,655,356,131,278,370,114,112,164,258
1826232,23,20,1990,6,female,434,354,193,286,619,245,316,41,303
2030263,29,26,1984,5,male,1332,352,128,292,578,281,276,11,302
1512800,27,16,1986,5,female,683,348,272,296,369,282,315,14,54
1268504,14,23,1999,9,female,122,346,287,304,41,304,27,0,14
1739428,18,27,1995,4,male,435,351,206,294,256,294,219,0,37
1459019,27,30,1986,7,male,336,345,227,298,203,298,193,0,10
1876566,26,7,1987,7,female,149,342,158,307,617,307,457,0,160
1776051,52,24,1961,12,female,350,343,87,297,614,297,232,0,382
2132104,21,5,1992,12,female,417,354,273,318,185,24,90,294,95
2054016,16,8,1997,1,male,559,346,302,309,142,182,67,127,75
1601977,51,11,1962,2,male,1257,352,141,319,531,166,263,153,268
2193468,57,19,1956,2,male,1940,346,177,323,234,286,105,37,129
1529860,19,26,1994,10,male,701,338,209,315,447,312,401,3,46
2081383,20,26,1993,9,male,485,338,182,313,34,313,28,0,6
1301284,34,30,1979,6,female,707,355,282,323,337,323,257,0,80
2038572,32,26,1981,3,female,194,344,263,327,564,327,427,0,137
2169747,54,6,1959,7,female,313,355,168,328,650,31,202,297,448
1633159,15,26,1998,7,male,277,353,288,343,338,209,222,134,116
1910398,15,20,1998,7,male,315,354,153,343,957,111,392,232,565
2088699,39,1,1974,7,female,510,350,215,339,202,331,156,8,46
1523994,84,1,1929,3,male,2188,338,262,329,368,298,193,31,175
1798801,60,20,1953,5,female,2017,357,94,329,841,328,454,1,387
1738882,20,15,1993,11,female,396,345,258,344,328,344,308,0,20
1972686,41,10,1972,11,male,803,347,240,362,81,58,8,304,73
1154387,108,10,1905,6,male,29,342,318,353,167,0,10,353,157
1488863,108,24,1905,10,female,1264,343,252,363,90,0,22,363,68
1208276,15,25,1998,1,female,201,356,284,361,331,8,100,353,231
1528331,51,17,1962,10,female,645,345,104,351,264,0,102,351,162
1022144,32,7,1981,4,female,818,356,267,354,82,199,55,155,27
1991897,17,25,1996,5,female,429,350,235,369,145,297,64,72,81
1481658,23,19,1990,4,male,364,349,182,362,171,350,95,12,76
1289412,93,21,1920,8,female,1592,346,147,361,561,360,414,1,147
1694856,17,1,1996,3,male,193,352,152,357,46,357,31,0,15
1959288,39,4,1974,11,female,381,348,148,366,133,366,112,0,21
1670240,41,1,1972,1,male,8,343,334,352,258,352,181,0,77
1204749,18,29,1995,11,female,505,349,105,351,693,351,464,0,229
1838381,46,22,1967,11,female,480,358,246,394,239,30,67,364,172
1753537,86,10,1927,6,female,553,342,246,382,273,0,142,382,131
1337779,20,30,1993,8,male,420,348,250,394,144,90,119,304,25
2167175,42,8,1971,1,female,2310,351,152,379,267,148,192,231,75
1686634,23,4,1990,5,male,270,344,145,378,62,354,23,24,39
1856303,20,18,1993,2,female,557,351,219,382,288,323,215,59,73
1033659,20,6,1993,6,female,848,357,151,386,377,327,174,59,203
1510303,39,27,1974,2,male,369,343,244,387,424,349,167,38,257
1276529,13,13,2000,7,female,394,341,145,384,596,292,321,92,275
1558370,103,13,1910,7,female,506,344,218,371,212,371,51,0,161
1940406,15,19,1998,4,male,350,358,285,411,3,0,1,411,2
1046949,14,15,1999,1,female,221,342,126,421,878,116,452,305,426
1649077,14,10,1999,7,female,281,342,187,396,20,327,17,69,3
1039040,58,23,1955,7,female,917,339,259,399,232,394,127,5,105
1195821,25,2,1988,5,female,171,352,187,402,689,389,154,13,535
2043558,16,20,1997,5,female,542,354,247,410,168,409,116,1,52
1653697,18,9,1995,4,female,497,348,240,418,98,418,95,0,3
1337733,22,8,1991,8,male,216,354,297,399,152,399,123,0,29
1148986,42,14,1971,12,female,2203,357,238,435,482,250,299,185,183
1955480,34,7,1979,5,female,342,355,97,448,786,428,646,20,140
1458825,15,4,1998,6,female,151,347,151,436,752,434,566,2,186
1890142,25,29,1988,11,male,295,353,239,436,179,436,158,0,21
1689567,26,24,1987,3,female,1408,343,182,443,253,443,167,0,86
1370627,60,2,1953,7,female,1849,358,286,477,389,6,169,471,220
1598215,23,12,1990,4,female,440,352,147,475,53,274,21,201,32
1857221,21,11,1992,10,female,210,345,224,482,536,134,323,348,213
1465572,27,11,1986,6,female,317,339,271,453,438,229,251,224,187
1245206,19,3,1994,4,male,352,342,127,480,774,111,386,369,388
2127503,22,18,1991,4,female,170,350,323,459,159,385,110,74,49
1303953,21,9,1992,4,male,371,349,104,465,1410,423,903,42,507
1451613,24,12,1989,12,female,780,350,157,465,815,353,582,112,233
2132333,33,15,1980,2,female,1738,352,236,466,838,403,523,63,315
1005958,56,27,1957,3,female,1878,348,199,452,980,443,494,9,486
1426266,19,11,1994,12,male,321,339,224,461,455,459,280,2,175
1858871,22,12,1991,5,female,387,349,98,469,519,468,333,1,186
1225137,31,4,1982,1,female,582,352,137,481,501,479,331,2,170
1223514,23,3,1990,6,male,297,352,295,455,205,455,166,0,39
1449836,17,29,1996,9,female,333,349,187,463,282,463,232,0,50
1367419,24,10,1989,10,female,1617,352,44,455,676,455,544,0,132
1729348,23,19,1990,11,female,361,346,209,478,1310,478,1123,0,187
1102461,32,27,1981,6,female,954,352,245,493,183,50,55,443,128
1789082,14,1,1999,8,female,298,344,275,498,42,168,7,330,35
1200555,21,2,1992,1,female,430,349,317,497,168,159,139,338,29
1370949,15,5,1998,2,female,934,358,198,512,1012,339,309,173,703
1620290,21,20,1992,4,male,225,342,82,517,106,377,89,140,17
1632239,82,8,1931,3,female,988,351,99,510,432,482,344,28,88
1486052,18,12,1995,12,female,90,350,140,500,521,500,354,0,167
1074046,72,18,1941,6,female,1305,341,232,536,167,0,53,536,114
1438121,32,22,1981,3,female,1588,350,95,549,1337,378,1107,171,230
1509668,21,20,1992,4,male,622,343,195,527,299,511,254,16,45
1854187,21,1,1992,6,male,210,346,336,548,270,428,166,120,104
1466709,28,11,1985,7,male,307,343,308,526,120,467,111,59,9
1265737,25,16,1988,5,male,443,348,250,539,216,539,176,0,40
1828394,23,25,1990,2,female,404,350,256,560,403,560,341,0,62
1614223,32,11,1981,4,female,194,348,283,561,373,561,287,0,86
1226982,14,28,1999,1,female,330,358,179,598,316,231,82,367,234
1072365,18,4,1995,9,male,487,338,229,601,700,353,281,248,419
1243416,31,14,1982,2,female,1140,357,211,563,493,157,226,406,267
1273694,20,1,1993,9,female,1462,341,115,608,484,567,424,41,60
1224251,23,18,1990,9,female,269,352,251,584,610,468,331,116,279
1915300,17,15,1996,12,female,372,342,90,566,866,552,713,14,153
1448944,26,14,1987,9,male,462,346,266,604,170,604,112,0,58
1266205,102,21,1911,6,female,155,341,276,599,157,599,132,0,25
1825938,22,15,1991,12,female,367,340,31,580,454,580,268,0,186
1105177,28,17,1985,8,male,668,357,296,598,423,598,346,0,77
1963203,22,17,1991,7,female,661,347,215,628,433,73,82,555,351
2001297,66,21,1947,10,male,1105,346,193,652,657,16,239,636,418
2062347,18,15,1995,9,female,110,354,288,633,660,219,493,414,167
1238734,39,9,1974,11,female,1924,348,153,642,461,241,222,401,239
1114252,59,6,1954,6,male,1664,355,157,630,447,205,159,425,288
1694452,20,3,1993,3,male,378,348,324,611,702,599,552,12,150
1681564,29,23,1984,2,female,750,346,178,658,961,552,783,106,178
1662951,18,10,1995,7,female,147,346,189,615,614,612,446,3,168
1014139,65,6,1948,6,male,755,343,139,634,315,634,165,0,150
1721668,57,22,1956,1,female,1197,353,217,612,379,612,108,0,271
2069989,21,4,1992,3,female,180,356,233,724,383,182,131,542,252
1872569,19,19,1994,7,male,473,358,197,669,948,228,425,441,523
1100599,53,15,1960,5,female,2325,353,158,682,533,191,240,491,293
2134357,20,23,1993,11,male,244,344,283,665,281,644,101,21,180
1738230,21,1,1992,7,female,566,353,263,691,154,543,80,148,74
1616057,23,18,1990,2,female,441,355,145,673,360,552,247,121,113
1454790,20,28,1993,9,female,265,344,175,702,448,685,299,17,149
1124627,16,11,1997,9,female,300,349,84,676,554,673,537,3,17
1701160,17,10,1996,8,male,415,350,271,664,38,664,30,0,8
1896591,35,3,1978,9,female,363,339,130,686,489,686,326,0,163
1565083,18,30,1995,7,female,298,344,46,790,466,411,154,379,312
2024159,49,12,1964,9,male,257,357,315,792,401,263,171,529,230
1218639,19,25,1994,11,female,206,338,160,785,729,755,240,30,489
1962381,20,2,1993,3,female,1971,350,237,749,718,734,607,15,111
1212740,40,16,1973,2,female,1718,346,98,736,659,639,446,97,213
1566442,14,25,1999,7,female,398,352,68,772,1333,714,762,58,571
1386265,18,21,1995,11,female,116,344,120,737,396,737,357,0,39
2190920,21,28,1992,4,female,474,350,160,783,991,783,689,0,302
1018432,17,27,1996,11,female,114,349,327,823,475,462,270,361,205
1770846,19,17,1994,1,female,706,347,277,808,144,563,27,245,117
1613407,103,1,1910,6,male,684,344,150,842,457,585,315,257,142
2027550,16,3,1997,2,female,356,356,165,797,271,689,174,108,97
1441812,18,13,1995,5,male,217,344,244,859,300,742,244,117,56
1363039,28,8,1985,10,female,1629,348,208,857,961,620,464,237,497
1826603,19,11,1994,1,male,517,340,292,857,199,852,101,5,98
1516764,93,23,1920,11,female,1321,344,149,837,652,835,387,2,265
1996973,18,28,1995,12,female,163,352,75,800,483,800,239,0,244
1075936,22,17,1991,5,female,312,340,236,873,627,873,313,0,314
1967994,26,28,1987,4,female,182,354,176,819,706,819,656,0,50
1896474,15,28,1998,3,male,60,344,246,895,300,60,98,835,202
1847255,88,6,1925,2,male,312,355,286,913,454,132,306,781,148
2123029,25,8,1988,9,female,1656,340,171,911,332,251,143,660,189
1124988,16,29,1997,7,female,145,350,213,975,1253,212,497,763,756
1708776,48,15,1965,9,female,1099,358,274,960,712,617,77,343,635
1554030,19,11,1994,12,female,558,352,76,901,353,824,185,77,168
2192862,28,25,1985,10,female,1155,351,211,936,1080,689,671,247,409
1394842,61,27,1952,8,male,855,353,243,899,253,899,240,0,13
1483425,24,18,1989,10,female,252,348,220,930,1338,930,1148,0,190
2146013,28,16,1985,4,female,716,341,136,958,637,958,331,0,306
1805728,52,1,1961,6,female,1675,356,186,1105,2232,93,1203,1012,1029
1161588,53,5,1960,12,female,652,340,197,1113,193,396,65,717,128
1674739,83,1,1930,1,male,900,342,196,995,227,675,142,320,85
1551268,21,1,1992,5,female,584,342,84,1123,1860,246,971,877,889
1838062,18,17,1995,5,male,118,339,303,1084,272,1072,144,12,128
1584614,60,14,1953,6,female,1515,339,59,1018,182,926,174,92,8
1286630,17,28,1996,12,female,149,353,150,1129,2149,1064,697,65,1452
1282517,73,28,1940,9,female,668,348,163,1260,518,0,119,1260,399
1252079,65,23,1948,7,female,1692,358,210,1145,1026,0,715,1145,311
1032665,52,28,1961,8,female,1885,339,199,1189,420,836,108,353,312
2189091,54,28,1959,7,female,1440,355,191,1230,747,368,558,862,189
2152907,108,11,1905,1,female,1789,346,174,1145,594,563,271,582,323
1877278,19,28,1994,9,female,1303,341,143,1187,1372,311,734,876,638
1219965,19,27,1994,9,female,28,347,321,1211,816,667,404,544,412
1067710,24,16,1989,12,female,507,343,172,1135,1112,660,281,475,831
1745659,53,19,1960,9,female,1672,346,125,1270,1252,857,1004,413,248
1574317,14,10,1999,5,female,1028,350,133,1131,881,1011,388,120,493
1982487,19,22,1994,2,female,168,340,131,1169,1204,906,825,263,379
1157424,22,9,1991,7,female,21,338,311,1232,876,1184,682,48,194
1402820,28,20,1985,2,female,427,351,294,1166,903,1095,422,71,481
1175474,19,10,1994,2,female,414,346,279,1171,599,1171,567,0,32
1616642,25,3,1988,6,male,304,343,201,1269,301,1269,89,0,212
1099788,26,14,1987,7,male,272,358,178,1192,379,1192,306,0,73
1034658,17,25,1996,2,female,172,346,29,1244,1556,1244,876,0,680
1729951,33,27,1980,3,female,486,342,156,1196,904,1196,767,0,137
1552446,62,5,1951,2,female,773,355,49,1319,414,9,78,1310,336
1712881,17,9,1996,10,female,699,338,282,1323,179,887,107,436,72
1141350,53,15,1960,1,female,363,357,237,1426,615,748,375,678,240
1973972,19,13,1994,6,male,293,340,199,1326,1556,843,1144,483,412
2103669,44,10,1969,12,male,468,354,219,1302,1203,709,724,593,479
1688257,21,23,1992,4,female,645,349,172,1475,614,1449,245,26,369
1309795,44,17,1969,8,female,2215,358,232,1454,717,1412,507,42,210
1607051,22,28,1991,12,female,280,341,259,1345,1140,1075,517,270,623
1356033,21,11,1992,2,female,683,338,127,1292,109,1292,102,0,7
1279654,18,24,1995,2,male,281,343,237,1326,803,1326,692,0,111
1166499,37,9,1976,10,female,401,351,269,1514,659,1514,547,0,112
2068489,51,17,1962,12,female,1446,343,252,1525,737,0,330,1525,407
1085921,62,17,1951,12,male,1381,351,162,1549,361,0,93,1549,268
1104023,20,10,1993,12,female,507,341,228,1546,1388,1022,807,524,581
1637445,32,5,1981,2,female,1338,340,150,1808,3213,931,2347,877,866
1669305,14,4,1999,6,female,415,357,186,1604,389,1575,242,29,147
1718129,19,26,1994,4,female,597,341,219,1654,964,1279,538,375,426
1370847,20,30,1993,8,male,537,343,130,1651,751,1643,530,8,221
1974462,52,25,1961,7,female,1104,343,176,2249,336,0,85,2249,251
1109894,22,27,1991,7,male,194,350,282,2171,934,6,465,2165,469
1863243,53,24,1960,11,female,1608,344,136,2130,2963,117,1121,2013,1842
1102237,108,10,1905,11,male,606,347,245,2263,4946,30,2991,2233,1955
2061578,23,25,1990,9,female,718,342,277,1968,1133,883,454,1085,679
1350183,33,24,1980,9,female,910,358,99,2132,2110,1314,1433,818,677
1947001,33,10,1980,7,male,22,352,304,2051,3510,924,3055,1127,455
1885552,27,27,1986,2,female,511,342,278,2118,967,2071,622,47,345
1099408,27,5,1986,3,female,519,345,259,2039,695,2039,259,0,436
1964196,53,7,1960,12,female,493,339,158,2085,787,2085,694,0,93
1071149,18,27,1995,10,female,143,341,130,2272,3827,2272,3376,0,451
1570333,16,21,1997,3,female,866,358,197,2657,1012,99,341,2558,671
1910611,32,30,1981,12,female,1515,357,155,2444,1237,792,894,1652,343
1171974,35,16,1978,4,female,457,347,213,2805,1683,2007,883,798,800
2137724,51,29,1962,8,female,1280,354,235,2780,1497,1340,491,1440,1006
1316943,22,20,1991,10,female,64,353,325,3230,2240,1843,986,1387,1254
1246851,33,13,1980,12,female,1911,344,204,3225,195,2877,139,348,56
1130962,15,15,1998,3,female,419,347,278,2664,1562,2421,1007,243,555
1778163,28,4,1985,4,male,346,341,262,3519,1535,3175,1003,344,532
1093730,108,21,1905,2,male,1341,349,270,2962,1551,2532,856,430,695
1036248,21,22,1992,9,female,46,339,315,2917,1804,2823,1586,94,218
1824792,29,17,1984,6,female,234,350,132,2838,1349,2834,1076,4,273
2084144,19,7,1994,8,male,105,339,291,3103,377,3103,323,0,54
1345068,19,13,1994,10,female,171,356,158,5485,5060,1250,977,4235,4083
1596412,64,5,1949,8,female,645,347,255,5084,5348,3529,2879,1555,2469
1567419,16,3,1997,7,female,655,342,60,5773,2422,5319,1795,454,627
1644624,20,28,1993,12,female,370,355,46,5545,2318,5537,1583,8,735
1489463,25,5,1988,1,female,131,351,88,16732,4913,16732,4679,0,234
1108836,15,19,1998,11,male,322,378,214,0,1,0,0,0,1
1984732,14,1,1999,1,male,63,365,353,0,0,0,0,0,0
1901976,14,17,1999,3,female,186,372,26,0,4,0,1,0,3
1500081,14,5,1999,4,male,539,365,276,0,1,0,0,0,1
1574585,16,8,1997,12,female,254,365,314,0,0,0,0,0,0
1090717,15,3,1998,3,female,198,378,39,0,1,0,1,0,0
2079341,17,21,1996,12,male,847,374,150,0,1,0,1,0,0
1213126,16,1,1997,1,male,541,371,241,0,0,0,0,0,0
1760973,16,3,1997,2,female,650,371,34,0,0,0,0,0,0
2180042,16,14,1997,2,male,366,377,342,0,0,0,0,0,0
1214643,16,8,1997,6,male,433,361,179,0,1,0,1,0,0
1075432,18,12,1995,12,male,812,372,241,0,0,0,0,0,0
1672054,18,14,1995,12,male,635,376,265,0,10,0,8,0,2
1729898,18,16,1995,12,male,248,372,311,0,0,0,0,0,0
1261264,17,14,1996,2,female,1477,377,79,0,6,0,5,0,1
1712037,17,21,1996,5,male,581,368,150,0,46,0,27,0,19
1004555,17,10,1996,9,male,1163,374,271,0,0,0,0,0,0
1183142,19,23,1994,11,male,499,381,333,0,5,0,3,0,2
1003169,18,24,1995,1,male,478,375,336,0,1,0,1,0,0
1100159,18,5,1995,3,male,356,374,319,0,0,0,0,0,0
1889279,18,15,1995,5,male,580,373,293,0,2,0,2,0,0
1181855,18,12,1995,6,male,677,368,269,0,0,0,0,0,0
1067738,18,3,1995,7,female,501,377,314,0,0,0,0,0,0
1892307,18,28,1995,7,male,270,368,280,0,0,0,0,0,0
2136172,18,10,1995,8,female,441,361,321,0,2,0,0,0,2
1181681,18,16,1995,8,female,434,360,116,0,0,0,0,0,0
1862782,18,10,1995,8,female,283,359,69,0,0,0,0,0,0
1445473,18,24,1995,9,male,119,361,295,0,56,0,30,0,26
1886216,18,16,1995,9,female,193,363,77,0,0,0,0,0,0
1470707,20,14,1993,11,male,808,362,139,0,0,0,0,0,0
1484599,19,1,1994,1,male,921,375,151,0,2,0,2,0,0
1984584,19,1,1994,1,female,428,368,233,0,2,0,1,0,1
1252180,19,1,1994,1,male,202,363,341,0,0,0,0,0,0
1414802,19,9,1994,6,male,522,362,292,0,0,0,0,0,0
1600064,19,5,1994,7,male,737,368,335,0,3,0,2,0,1
1376008,19,20,1994,9,male,804,371,260,0,1,0,0,0,1
1322113,20,1,1993,2,male,785,363,172,0,13,0,9,0,4
1642071,20,28,1993,5,male,678,379,291,0,0,0,0,0,0
1260717,20,27,1993,8,male,692,361,243,0,3,0,1,0,2
1073110,20,19,1993,8,male,669,374,342,0,0,0,0,0,0
1049094,20,28,1993,10,female,231,380,30,0,2,0,2,0,0
1385527,21,14,1992,2,male,670,361,213,0,0,0,0,0,0
1383343,21,27,1992,4,male,778,375,205,0,27,0,23,0,4
1345036,22,26,1991,1,male,378,373,313,0,0,0,0,0,0
1597918,22,17,1991,7,male,373,379,187,0,9,0,6,0,3
1073921,22,21,1991,7,female,358,376,204,0,1,0,0,0,1
1241165,24,7,1989,12,male,672,364,234,0,10,0,8,0,2
1496889,23,1,1990,1,male,794,363,273,0,13,0,8,0,5
1796126,23,10,1990,2,male,445,360,311,0,2,0,1,0,1
1050163,23,18,1990,5,female,498,361,316,0,1,0,0,0,1
1903841,23,25,1990,6,female,485,376,254,0,2,0,1,0,1
1876526,23,10,1990,8,female,1427,359,86,0,8,0,8,0,0
1036971,23,8,1990,8,female,247,374,100,0,7,0,3,0,4
1282222,23,22,1990,10,male,405,361,333,0,0,0,0,0,0
1790946,25,15,1988,11,male,724,363,221,0,0,0,0,0,0
1575919,24,4,1989,2,female,543,372,291,0,8,0,6,0,2
1147504,24,15,1989,3,male,895,368,267,0,1,0,1,0,0
1389730,24,8,1989,3,male,581,370,330,0,0,0,0,0,0
1022051,24,2,1989,7,male,526,362,306,0,4,0,0,0,4
1761394,26,4,1987,12,male,973,361,230,0,0,0,0,0,0
1748405,25,2,1988,1,male,367,379,357,0,0,0,0,0,0
2052807,25,2,1988,2,male,146,364,347,0,0,0,0,0,0
1104386,25,22,1988,5,male,1250,359,166,0,0,0,0,0,0
1685920,25,12,1988,6,male,672,379,333,0,0,0,0,0,0
1239607,25,15,1988,7,female,503,375,7,0,8,0,6,0,2
1161612,25,13,1988,8,male,486,379,333,0,2,0,2,0,0
1294269,25,8,1988,8,female,453,374,303,0,14,0,12,0,2
1206998,26,11,1987,1,male,318,361,345,0,0,0,0,0,0
2038203,26,11,1987,5,male,1005,364,245,0,2,0,2,0,0
1958094,26,16,1987,5,male,969,359,163,0,4,0,2,0,2
1507731,27,27,1986,4,female,530,379,357,0,0,0,0,0,0
2146559,27,15,1986,10,male,1541,359,217,0,0,0,0,0,0
1184318,28,4,1985,2,male,641,365,262,0,25,0,9,0,16
1805538,30,18,1983,11,male,579,361,338,0,4,0,3,0,1
1153801,30,25,1983,12,male,592,381,329,0,0,0,0,0,0
1229016,30,3,1983,10,female,373,359,251,0,2,0,2,0,0
1374213,32,24,1981,12,female,660,375,248,0,1,0,1,0,0
2135798,32,2,1981,3,male,452,377,182,0,0,0,0,0,0
1546261,45,30,1968,6,male,839,370,222,0,1,0,1,0,0
1274190,54,20,1959,5,female,824,374,68,0,24,0,20,0,4
1038257,60,6,1953,6,female,432,381,278,0,52,0,20,0,32
1671916,64,5,1949,9,female,1380,380,235,0,2,0,2,0,0
1879213,103,15,1910,9,male,905,364,282,0,3,0,3,0,0
2150547,103,28,1910,10,male,1136,377,281,0,0,0,0,0,0
1433484,108,20,1905,4,male,1082,368,198,0,4,0,1,0,3
1024010,108,19,1905,6,male,1626,367,211,0,0,0,0,0,0
1007633,108,24,1905,6,male,1425,363,246,0,39,0,21,0,18
1162938,108,13,1905,6,male,896,375,242,0,0,0,0,0,0
1404641,18,6,1995,12,male,261,371,336,1,0,0,0,1,0
1829430,30,26,1983,11,male,1716,370,193,1,0,0,0,1,0
1003216,17,27,1996,8,male,509,374,290,1,1,0,0,1,1
1326682,19,25,1994,2,male,607,369,335,1,1,0,0,1,1
1884790,16,17,1997,6,female,317,367,25,1,41,0,4,1,37
1051863,53,3,1960,9,male,1116,364,160,1,50,0,31,1,19
1362984,86,18,1927,9,female,425,364,108,1,11,0,8,1,3
1854487,108,2,1905,4,male,1583,361,199,1,22,0,3,1,19
1533732,108,24,1905,5,female,1423,370,107,1,4,0,2,1,2
2078511,14,6,1999,3,female,350,360,208,1,0,1,0,0,0
1526929,16,10,1997,10,female,120,367,119,1,0,1,0,0,0
2147948,17,27,1996,9,male,736,365,272,1,0,1,0,0,0
1013618,20,26,1993,3,male,1476,380,268,1,0,1,0,0,0
1695338,24,23,1989,8,male,614,359,277,1,0,1,0,0,0
2024559,26,28,1987,6,male,177,363,289,1,0,1,0,0,0
1539900,93,14,1920,4,female,218,368,100,1,0,1,0,0,0
2030696,20,19,1993,3,male,628,373,283,1,1,1,1,0,0
1917050,13,23,2000,3,female,140,362,35,1,5,1,5,0,0
2140005,15,22,1998,11,female,351,362,161,1,37,1,15,0,22
1225866,14,15,1999,10,male,339,376,222,1,5,1,5,0,0
1986556,16,23,1997,12,female,160,371,220,1,54,1,46,0,8
1752222,20,8,1993,11,male,950,365,190,1,6,1,2,0,4
1586791,20,9,1993,5,male,1040,359,218,1,4,1,4,0,0
1500339,21,7,1992,10,male,867,378,316,1,11,1,10,0,1
1782821,23,12,1990,11,female,301,362,258,1,3,1,3,0,0
1708704,23,20,1990,12,male,1518,377,143,1,7,1,5,0,2
1249700,23,16,1990,12,female,329,361,173,1,3,1,3,0,0
2124702,23,9,1990,5,female,651,379,146,1,3,1,2,0,1
2101984,25,19,1988,12,female,610,381,317,1,5,1,5,0,0
1431942,25,1,1988,1,male,257,378,364,1,12,1,6,0,6
1018382,25,26,1988,8,female,682,364,216,1,12,1,11,0,1
2095187,28,30,1985,3,male,443,376,336,1,4,1,0,0,4
1378199,28,6,1985,10,male,757,376,302,1,41,1,29,0,12
1281194,33,22,1980,11,female,781,377,93,1,32,1,6,0,26
1311148,35,3,1978,4,male,1098,372,246,1,38,1,37,0,1
2084215,68,17,1945,2,male,489,374,303,1,5,1,5,0,0
1604272,105,16,1908,8,female,500,372,189,1,6,1,5,0,1
1455393,101,30,1912,1,male,1034,361,260,2,1,0,0,2,1
1821199,108,28,1905,7,male,1957,362,272,2,1,0,1,2,0
1779716,14,24,1999,4,female,526,369,242,2,4,0,0,2,4
1372191,26,9,1987,7,male,377,359,145,2,4,0,1,2,3
1715428,28,2,1985,8,female,453,372,172,2,92,0,37,2,55
1443839,21,12,1992,4,male,1417,366,256,2,0,1,0,1,0
1800507,23,2,1990,9,male,888,368,104,2,0,1,0,1,0
1401679,16,22,1997,8,female,109,375,291,2,63,1,36,1,27
2190732,24,23,1989,4,male,564,377,333,2,0,2,0,0,0
1798014,94,21,1919,5,male,849,377,153,2,0,2,0,0,0
1413125,16,2,1997,2,male,440,363,316,2,1,2,0,0,1
1833050,18,6,1995,9,male,673,372,144,2,1,2,1,0,0
1103582,24,10,1989,6,male,531,378,352,2,1,2,1,0,0
2038913,24,13,1989,9,male,893,380,258,2,1,2,0,0,1
1421117,100,21,1913,3,female,1969,369,173,2,1,2,1,0,0
2089216,100,6,1913,8,male,2437,373,176,2,2,2,1,0,1
2137944,14,16,1999,6,male,318,370,311,2,64,2,52,0,12
1121357,17,3,1996,8,male,795,379,290,2,6,2,5,0,1
1390624,20,27,1993,8,male,555,360,106,2,43,2,42,0,1
1234750,21,27,1992,1,female,222,380,123,2,13,2,3,0,10
1757080,21,20,1992,5,male,633,376,237,2,37,2,33,0,4
1435749,22,11,1991,9,male,112,370,347,2,4,2,4,0,0
1962914,25,1,1988,1,male,489,365,307,2,12,2,4,0,8
2065735,63,1,1950,1,male,545,363,328,2,52,2,49,0,3
1817407,93,24,1920,4,male,628,376,308,2,38,2,35,0,3
1289100,99,29,1914,5,female,510,362,111,2,3,2,1,0,2
1468402,104,27,1909,8,female,777,365,42,2,4,2,3,0,1
1953039,113,30,1900,1,female,1535,369,258,2,3,2,0,0,3
1009638,95,15,1918,3,female,1352,372,142,3,1,0,0,3,1
1686997,74,7,1939,3,male,2040,380,250,3,13,0,4,3,9
1359669,14,2,1999,1,male,412,379,280,3,5,1,1,2,4
1873445,15,25,1998,3,male,189,380,310,3,12,1,3,2,9
1625834,103,9,1910,9,male,1326,364,206,3,1,3,1,0,0
1021643,19,1,1994,10,female,702,379,222,3,2,3,2,0,0
1814241,20,13,1993,1,male,266,379,151,3,3,3,2,0,1
1055920,24,4,1989,9,female,405,360,145,3,3,3,3,0,0
2011616,15,22,1998,5,female,68,366,25,3,7,3,6,0,1
1290599,20,13,1993,10,male,230,374,331,3,19,3,17,0,2
2147554,25,10,1988,10,male,594,366,187,3,26,3,17,0,9
1187350,39,1,1974,1,male,576,365,178,3,12,3,10,0,2
1399314,103,4,1910,12,male,2012,366,163,3,16,3,13,0,3
1263120,18,19,1995,12,female,644,378,284,4,0,0,0,4,0
1206004,108,4,1905,2,male,1566,376,257,4,1,0,1,4,0
1263300,22,22,1991,12,male,783,367,256,4,4,0,0,4,4
1457320,20,24,1993,7,female,123,367,161,4,50,0,39,4,11
1331317,64,19,1949,5,male,1180,367,69,4,26,0,11,4,15
1292921,33,14,1980,2,male,805,371,216,4,1,4,1,0,0
1967153,35,13,1978,7,female,866,360,182,4,4,4,4,0,0
1677055,17,3,1996,1,male,928,363,203,4,18,4,18,0,0
1229550,17,22,1996,2,male,607,359,331,4,201,4,175,0,26
1713210,18,28,1995,7,male,296,367,256,4,34,4,33,0,1
1371274,18,4,1995,10,female,388,371,116,4,7,4,7,0,0
1302125,23,27,1990,11,male,499,367,225,4,7,4,7,0,0
1434132,22,15,1991,8,male,352,361,324,4,35,4,32,0,3
1944349,27,17,1986,8,male,791,366,326,4,21,4,21,0,0
2040502,34,11,1979,4,male,1254,367,289,4,25,4,8,0,17
1695840,103,29,1910,6,male,1600,367,219,4,38,4,22,0,16
1755609,23,24,1990,11,male,379,360,316,5,0,0,0,5,0
1456250,14,15,1999,3,male,493,372,31,5,7,0,4,5,3
1805259,93,18,1920,5,male,805,366,125,5,23,0,17,5,6
1492927,27,6,1986,9,male,1301,379,140,5,14,2,10,3,4
1501175,35,22,1978,11,male,948,368,203,5,0,4,0,1,0
1050435,22,1,1991,9,male,533,375,326,5,0,5,0,0,0
1288726,15,8,1998,9,male,505,380,275,5,3,5,2,0,1
1693746,20,20,1993,3,male,804,367,217,5,3,5,3,0,0
1712102,55,25,1958,5,female,1010,359,213,5,2,5,0,0,2
1294198,27,2,1986,1,female,781,363,278,5,7,5,1,0,6
1085892,16,5,1997,3,male,365,374,244,5,8,5,6,0,2
2148137,16,26,1997,6,male,267,367,182,5,88,5,65,0,23
1863220,17,30,1996,3,male,303,379,345,5,16,5,12,0,4
1159554,20,4,1993,9,male,65,366,11,5,8,5,8,0,0
1925527,23,5,1990,1,male,403,365,235,5,10,5,6,0,4
1520435,24,10,1989,3,female,828,360,173,5,15,5,13,0,2
1163114,24,21,1989,9,female,704,363,206,5,21,5,7,0,14
1647275,26,17,1987,6,male,905,359,258,5,23,5,21,0,2
1870226,27,3,1986,9,female,954,366,153,5,52,5,47,0,5
1510959,34,3,1979,11,male,352,359,282,5,18,5,16,0,2
1289453,107,19,1906,9,female,910,360,149,5,30,5,8,0,22
1758523,108,23,1905,6,female,1009,364,64,5,8,5,6,0,2
1777688,19,4,1994,3,male,582,374,249,6,0,0,0,6,0
1138785,14,21,1999,5,male,468,360,271,6,7,0,5,6,2
1847483,18,1,1995,1,male,190,378,155,6,14,0,1,6,13
2093266,20,29,1993,4,female,395,371,188,6,14,0,0,6,14
1723080,23,16,1990,5,male,293,376,350,6,9,0,7,6,2
1222889,108,25,1905,3,male,585,373,295,6,41,0,41,6,0
2138498,15,10,1998,6,female,743,363,165,6,23,4,15,2,8
1915303,20,13,1993,7,female,692,371,105,6,50,3,17,3,33
1671949,17,26,1996,12,male,192,363,265,6,3,6,3,0,0
2159489,39,21,1974,7,female,679,366,254,6,1,6,1,0,0
1968048,103,26,1910,12,female,743,365,95,6,6,6,5,0,1
1282763,15,17,1998,3,male,268,363,63,6,12,6,11,0,1
1266653,18,26,1995,7,male,409,367,269,7,0,0,0,7,0
1646332,15,21,1998,6,female,419,365,92,7,32,1,15,6,17
2092203,15,16,1998,9,female,367,380,181,7,17,3,11,4,6
1144985,102,21,1911,9,female,1411,371,238,7,5,6,2,1,3
1824554,16,2,1997,9,male,107,360,314,7,1,7,1,0,0
2085710,25,25,1988,8,male,244,361,329,7,0,7,0,0,0
1336881,18,30,1995,1,male,302,359,277,7,5,7,3,0,2
1900865,23,17,1990,10,male,491,366,359,7,9,7,9,0,0
1780358,19,15,1994,3,female,568,376,153,7,49,7,32,0,17
1785380,21,15,1992,5,female,426,373,77,7,18,7,9,0,9
1110224,23,10,1990,11,male,356,378,330,7,118,7,67,0,51
1075165,23,29,1990,1,female,371,371,161,7,138,7,115,0,23
1594219,23,3,1990,4,male,318,371,325,7,11,7,9,0,2
1989025,52,21,1961,1,male,310,365,282,7,43,7,39,0,4
1271795,103,18,1910,10,male,1286,375,258,7,85,7,79,0,6
1530175,23,2,1990,5,male,854,377,240,8,7,0,1,8,6
1210398,18,16,1995,5,male,87,378,362,8,4,7,2,1,2
1367764,108,29,1905,12,male,1970,374,258,8,38,7,32,1,6
1644125,23,1,1990,6,male,928,364,66,8,7,8,7,0,0
1027427,27,2,1986,8,female,331,375,70,8,7,8,3,0,4
1868689,47,8,1966,11,male,1113,359,194,8,10,8,5,0,5
1203464,21,21,1992,8,female,803,377,123,8,13,8,11,0,2
2145890,22,8,1991,8,female,1189,372,186,8,30,8,27,0,3
2105674,22,17,1991,8,male,190,363,331,8,221,8,199,0,22
1101103,39,10,1974,7,female,1751,373,169,8,174,8,167,0,7
1387233,108,16,1905,12,male,1789,360,106,8,42,8,37,0,5
1119152,50,9,1963,4,male,278,360,80,9,67,1,35,8,32
1747206,59,24,1954,11,female,2430,370,286,9,227,3,116,6,111
1699955,23,27,1990,7,male,1242,362,310,9,0,9,0,0,0
1343783,24,26,1989,6,male,521,371,345,9,0,9,0,0,0
2104527,18,15,1995,5,male,385,374,205,9,2,9,0,0,2
2085156,26,6,1987,6,female,518,381,154,9,26,9,11,0,15
1372175,27,21,1986,10,male,239,363,350,9,177,9,145,0,32
1929802,103,26,1910,4,female,813,377,285,9,32,9,27,0,5
1993620,15,14,1998,1,male,379,381,351,10,0,0,0,10,0
1546189,20,15,1993,7,male,432,372,302,10,6,0,0,10,6
1766460,23,4,1990,1,male,462,360,301,10,3,0,0,10,3
2091505,108,29,1905,3,female,1463,374,246,10,8,1,6,9,2
1117604,20,27,1993,10,female,410,380,191,10,17,1,15,9,2
1301438,14,29,1999,4,male,463,372,128,10,42,5,7,5,35
1560553,23,5,1990,5,male,596,362,265,10,33,7,30,3,3
1269172,33,1,1980,1,female,429,369,163,10,0,9,0,1,0
1804777,22,24,1991,1,male,557,371,330,10,13,9,13,1,0
1879610,17,8,1996,10,male,743,378,134,10,5,10,3,0,2
2034804,18,22,1995,3,male,364,380,229,10,5,10,5,0,0
1188321,21,21,1992,9,male,231,375,341,10,11,10,5,0,6
1631465,21,29,1992,12,male,1723,364,304,11,6,2,3,9,3
1419799,111,1,1902,2,male,3139,372,40,11,21,2,13,9,8
2085839,18,10,1995,6,male,282,377,240,11,4,3,4,8,0
1151401,23,25,1990,12,male,375,378,274,11,11,5,9,6,2
1450177,20,22,1993,5,male,758,362,224,11,0,9,0,2,0
1358879,78,22,1935,3,female,1161,376,119,11,2,11,2,0,0
1473026,21,14,1992,2,male,363,369,224,11,26,11,16,0,10
1764144,30,18,1983,6,male,480,365,91,11,18,11,15,0,3
1751787,23,29,1990,10,male,994,359,119,12,2,0,2,12,0
1272444,54,14,1959,2,female,985,360,267,12,14,0,1,12,13
1442496,21,8,1992,5,male,712,367,246,12,12,3,2,9,10
1941408,21,25,1992,3,male,578,363,301,12,19,5,16,7,3
1169649,32,21,1981,12,male,136,369,308,12,106,5,20,7,86
1728318,36,21,1977,4,male,619,381,132,12,40,5,28,7,12
1787734,26,13,1987,4,male,485,370,258,12,1,12,1,0,0
1441305,28,14,1985,4,male,752,374,255,12,0,12,0,0,0
1904616,26,3,1987,10,female,238,362,45,12,2,12,1,0,1
1410095,35,24,1978,5,male,879,375,247,12,3,12,3,0,0
1684262,18,15,1995,2,female,293,366,254,12,19,12,19,0,0
1580536,18,5,1995,6,male,367,364,330,13,0,0,0,13,0
1708903,14,2,1999,5,male,488,369,277,13,28,10,8,3,20
1338073,93,7,1920,12,male,1479,381,152,13,1,13,1,0,0
1533582,19,27,1994,1,female,188,374,339,13,5,13,0,0,5
1625011,108,12,1905,3,female,247,365,106,13,6,13,6,0,0
1517275,47,14,1966,5,male,799,373,309,13,11,13,9,0,2
1904996,18,8,1995,2,female,74,379,327,13,122,13,43,0,79
1542083,27,27,1986,7,female,236,360,175,13,40,13,29,0,11
2068965,39,16,1974,9,male,1200,373,143,13,67,13,41,0,26
1459208,21,26,1992,11,male,843,376,333,14,13,2,7,12,6
1799093,108,13,1905,12,female,2006,369,235,14,17,0,7,14,10
1672113,17,12,1996,8,male,582,374,174,14,41,13,11,1,30
1218996,36,26,1977,1,male,142,376,332,14,7,14,5,0,2
1266035,20,25,1993,12,female,46,367,5,14,86,14,74,0,12
2094199,24,29,1989,12,female,320,361,128,14,65,14,58,0,7
1126571,27,10,1986,8,female,252,368,44,14,82,14,28,0,54
1152360,28,1,1985,1,male,573,368,346,15,8,0,5,15,3
1129993,16,13,1997,4,male,454,360,205,15,105,10,20,5,85
1836742,21,10,1992,6,male,857,363,170,15,80,8,12,7,68
1891911,26,9,1987,10,male,628,365,297,15,3,14,3,1,0
1197734,68,10,1945,7,male,2260,373,169,15,14,12,6,3,8
1830976,26,5,1987,10,female,370,369,199,15,305,14,233,1,72
1679765,19,26,1994,12,male,1034,379,197,15,4,15,1,0,3
1590349,26,30,1987,7,male,239,369,285,15,13,15,6,0,7
2120752,27,23,1986,10,male,399,380,330,15,17,15,17,0,0
1096187,14,24,1999,2,male,571,375,358,16,14,0,5,16,9
1305929,19,30,1994,5,male,548,374,313,16,34,0,10,16,24
1809893,57,4,1956,10,male,1674,373,104,16,29,1,9,15,20
1931800,33,14,1980,8,male,448,365,348,16,1,10,0,6,1
1082596,51,1,1962,4,male,1701,359,256,16,85,5,65,11,20
1744679,19,26,1994,1,male,410,372,224,16,13,16,7,0,6
2051430,20,6,1993,8,male,376,378,324,16,10,16,6,0,4
1033753,16,8,1997,2,female,407,368,117,16,28,16,23,0,5
1787958,28,12,1985,5,male,542,375,243,16,24,16,23,0,1
1904265,62,5,1951,10,male,1090,366,290,17,49,0,23,17,26
1003317,108,11,1905,6,female,1508,360,195,17,56,4,39,13,17
1139805,29,13,1984,2,male,203,363,331,17,11,15,6,2,5
1435013,18,15,1995,3,male,257,366,213,17,61,15,30,2,31
1971258,23,27,1990,11,male,1042,375,174,17,71,16,27,1,44
1036305,19,29,1994,9,male,508,372,282,17,4,17,3,0,1
1835927,21,1,1992,1,male,302,367,315,17,5,17,4,0,1
1391182,19,8,1994,7,male,863,374,146,17,22,17,18,0,4
1972802,42,8,1971,4,male,170,367,183,17,45,17,15,0,30
1861500,21,28,1992,12,male,796,377,139,18,1,0,0,18,1
1245446,21,5,1992,9,female,174,368,119,18,6,7,2,11,4
1558364,16,15,1997,4,female,407,370,152,18,10,18,9,0,1
1930010,87,6,1926,9,female,2198,374,138,19,12,0,3,19,9
2165329,17,8,1996,2,male,688,364,267,19,10,15,7,4,3
1529731,18,12,1995,4,male,303,374,252,19,1,19,1,0,0
1370663,16,16,1997,11,male,551,362,259,19,5,19,2,0,3
1277227,100,31,1913,12,male,785,359,273,19,15,19,5,0,10
2095908,21,3,1992,6,male,664,371,335,19,40,19,30,0,10
1391473,24,4,1989,8,male,237,381,288,19,59,19,14,0,45
1588613,68,11,1945,8,male,1135,379,271,20,3,1,2,19,1
1229808,84,16,1929,4,male,839,377,248,20,2,0,0,20,2
1242914,33,3,1980,12,male,620,367,322,20,8,20,7,0,1
1370373,103,27,1910,5,male,632,360,62,20,6,20,6,0,0
1053268,20,18,1993,9,male,376,360,299,20,22,20,13,0,9
1059351,21,12,1992,12,female,303,361,36,20,60,20,14,0,46
1298898,53,7,1960,1,male,504,380,248,20,142,20,102,0,40
1820312,20,17,1993,10,male,1066,361,130,21,9,4,4,17,5
1614465,18,10,1995,12,male,208,374,69,21,201,0,58,21,143
1603252,14,19,1999,7,female,111,367,69,21,143,16,44,5,99
1923798,22,10,1991,6,male,637,370,241,21,21,21,20,0,1
1245956,20,23,1993,8,male,212,362,263,21,33,21,30,0,3
1808110,68,12,1945,9,male,477,377,310,22,2,0,1,22,1
1594891,67,24,1946,8,male,372,375,180,22,11,1,6,21,5
1553872,22,7,1991,10,male,1222,370,291,22,15,7,12,15,3
1619305,26,1,1987,6,male,679,379,100,22,15,20,3,2,12
1328975,20,9,1993,11,male,514,363,264,22,142,19,66,3,76
1927190,38,5,1975,9,female,524,370,252,22,13,22,4,0,9
1422424,16,10,1997,5,male,306,367,236,23,21,0,10,23,11
2038588,43,19,1970,6,male,532,365,133,23,31,4,29,19,2
1889792,103,11,1910,3,female,1876,377,132,23,17,1,11,22,6
1703816,15,14,1998,2,female,647,373,157,23,32,5,7,18,25
1272596,29,27,1984,7,male,945,367,281,23,6,20,6,3,0
1226141,17,31,1996,3,female,570,364,143,23,113,22,56,1,57
1674833,17,21,1996,6,male,445,360,309,23,49,22,32,1,17
2158949,21,9,1992,8,male,583,380,209,23,10,23,9,0,1
1568366,22,9,1991,3,male,642,367,266,23,6,23,6,0,0
1249023,22,20,1991,1,male,431,372,21,23,18,23,13,0,5
1814112,24,13,1989,6,female,264,376,169,23,37,23,16,0,21
1367682,18,19,1995,12,male,169,370,329,24,1,1,0,23,1
1321715,16,1,1997,1,female,416,364,159,24,134,12,104,12,30
1771186,22,27,1991,8,female,733,380,307,24,88,6,70,18,18
1987417,48,25,1965,4,male,1410,363,137,24,45,14,15,10,30
1190582,31,3,1982,3,male,444,361,214,24,34,24,23,0,11
2096368,73,15,1940,2,male,1977,367,159,25,47,1,21,24,26
1701446,19,29,1994,4,male,925,371,160,25,14,12,6,13,8
1037580,100,13,1913,11,male,2039,374,280,25,29,23,24,2,5
1217269,108,18,1905,12,male,491,379,286,25,31,25,29,0,2
2009533,63,4,1950,7,female,1475,371,201,25,346,25,149,0,197
2186459,97,27,1916,6,male,356,377,303,26,2,9,2,17,0
1700971,15,27,1998,5,female,467,367,150,26,11,26,8,0,3
2123946,22,29,1991,4,female,649,371,202,26,13,26,1,0,12
1502657,22,30,1991,8,female,586,365,245,26,23,26,5,0,18
1190950,34,20,1979,11,female,557,372,259,26,32,26,21,0,11
1996777,20,20,1993,8,female,477,380,284,26,105,26,87,0,18
1367529,20,1,1993,7,male,228,373,360,27,2,0,0,27,2
1413823,18,27,1995,4,male,406,366,175,27,22,4,7,23,15
1737611,19,6,1994,6,male,331,360,238,27,89,2,68,25,21
1229502,15,29,1998,7,male,377,359,322,27,68,7,54,20,14
1920519,21,9,1992,6,male,259,373,285,27,59,15,35,12,24
1924757,22,6,1991,1,male,1076,381,255,27,2,21,0,6,2
1956358,17,17,1996,4,male,490,380,289,27,37,26,29,1,8
1841955,18,1,1995,2,female,836,375,93,27,161,22,123,5,38
2033324,53,23,1960,4,male,523,366,241,28,2,0,0,28,2
1191626,22,1,1991,1,male,246,363,272,28,0,28,0,0,0
1141484,13,1,2000,3,male,215,361,259,28,9,28,6,0,3
1040374,21,16,1992,4,male,386,369,341,28,7,28,7,0,0
1402121,15,14,1998,3,female,246,364,255,28,30,28,26,0,4
1053301,22,5,1991,3,male,775,362,248,28,134,28,94,0,40
1091710,20,6,1993,10,male,336,374,260,29,3,29,2,0,1
1583695,19,18,1994,6,male,143,370,344,29,41,29,21,0,20
1605539,34,9,1979,6,male,436,364,228,29,38,29,32,0,6
2124197,20,31,1993,10,female,389,367,201,30,8,0,2,30,6
1588564,103,19,1910,2,male,715,372,198,31,12,31,12,0,0
1764361,56,1,1957,4,male,295,368,268,31,45,31,13,0,32
1998336,32,5,1981,11,female,220,359,11,30,91,30,87,0,4
1707546,40,26,1973,10,female,208,371,167,31,55,31,51,0,4
1068932,19,29,1994,11,male,359,366,273,32,9,6,6,26,3
1273271,21,21,1992,9,female,711,375,126,32,0,24,0,8,0
1554426,14,1,1999,8,male,437,376,235,32,27,24,20,8,7
2047300,17,12,1996,9,female,342,378,189,32,80,32,76,0,4
1564551,18,24,1995,2,female,106,363,129,33,67,6,18,27,49
1428379,102,15,1911,10,male,866,359,89,33,28,33,28,0,0
2190754,17,2,1996,7,male,413,374,258,33,88,33,50,0,38
2134236,21,27,1992,1,female,384,370,74,33,62,33,17,0,45
1198309,86,26,1927,3,male,1548,370,158,34,4,0,1,34,3
2175692,108,16,1905,2,female,1875,367,65,34,34,9,15,25,19
1231937,28,7,1985,9,male,809,373,306,34,4,34,3,0,1
1652522,19,19,1994,7,male,427,371,257,36,6,4,3,32,3
1822470,59,29,1954,8,female,820,362,279,36,109,0,21,36,88
1042507,69,6,1944,8,male,129,372,355,35,3,12,2,23,1
1904195,15,20,1998,9,female,163,363,221,36,167,31,105,5,62
1345507,30,22,1983,9,male,331,366,290,35,1,35,1,0,0
2086028,15,28,1998,6,female,276,374,238,36,7,36,6,0,1
1239820,104,10,1909,7,female,1130,377,202,35,20,35,18,0,2
1137093,15,20,1998,6,female,246,362,198,36,55,36,53,0,2
2063275,108,4,1905,2,male,898,371,288,37,17,0,7,37,10
1725028,18,2,1995,6,male,925,366,170,37,102,18,64,19,38
1571765,16,25,1997,3,female,83,364,330,37,25,37,25,0,0
2158241,26,2,1987,11,male,138,365,203,37,84,37,25,0,59
1089104,108,13,1905,11,male,1264,379,251,39,40,2,13,37,27
1502528,25,20,1988,8,male,564,359,245,38,14,38,12,0,2
2038950,68,13,1945,9,male,1205,368,307,38,16,38,13,0,3
1925776,14,18,1999,6,male,251,365,222,38,32,38,31,0,1
1791636,18,15,1995,11,male,306,379,124,38,29,38,22,0,7
1451840,16,8,1997,8,male,50,373,354,38,88,38,78,0,10
1570539,43,1,1970,12,male,851,374,261,40,324,34,131,6,193
1473349,18,22,1995,1,female,319,359,257,40,43,40,42,0,1
1438090,103,2,1910,2,female,864,359,88,40,40,40,32,0,8
1595578,103,23,1910,9,male,944,363,319,40,167,40,113,0,54
1334472,19,5,1994,9,male,639,360,120,42,70,0,35,42,35
2074907,108,10,1905,10,female,1175,371,158,42,122,6,49,36,73
1764052,78,10,1935,1,female,1002,369,113,42,1,36,1,6,0
1524406,59,14,1954,1,female,2391,365,179,41,55,35,29,6,26
1758206,20,29,1993,8,female,651,361,166,41,234,34,52,7,182
2160649,40,4,1973,4,male,294,379,277,42,115,41,105,1,10
2092515,21,2,1992,1,male,166,359,345,42,47,42,35,0,12
2157557,98,19,1915,7,female,2037,367,168,42,59,42,44,0,15
1208334,103,21,1910,6,male,686,364,188,43,13,0,4,43,9
1618238,108,25,1905,2,female,1661,377,141,43,8,1,4,42,4
1775979,16,19,1997,3,male,422,367,238,44,46,10,22,34,24
2012496,14,4,1999,3,male,429,360,265,44,5,44,5,0,0
1362572,16,22,1997,7,male,473,369,239,44,30,44,20,0,10
1045208,21,10,1992,11,male,360,362,332,44,32,44,25,0,7
1286976,21,5,1992,5,male,502,373,320,43,41,43,38,0,3
2063212,14,18,1999,12,male,146,371,280,43,118,43,117,0,1
1919786,31,20,1982,3,male,1316,362,267,45,66,45,20,0,46
1195793,32,11,1981,5,male,521,371,114,47,15,0,6,47,9
1133978,101,6,1912,12,male,1368,376,224,47,27,13,22,34,5
1236695,108,5,1905,1,male,1246,361,285,47,26,47,18,0,8
1009053,43,10,1970,5,male,571,381,257,46,66,46,58,0,8
1843026,20,25,1993,4,female,483,366,150,47,73,47,64,0,9
1081899,23,13,1990,3,female,241,378,168,46,130,46,67,0,63
1977372,24,10,1989,4,male,391,360,220,48,7,0,0,48,7
1880146,19,1,1994,5,female,301,377,208,48,270,25,122,23,148
1586568,19,26,1994,8,male,832,375,263,49,11,47,6,2,5
2001137,21,25,1992,5,female,522,367,236,49,49,49,36,0,13
1583257,28,1,1985,8,male,617,373,348,49,48,49,25,0,23
1848132,19,12,1994,12,male,358,368,311,49,276,49,216,0,60
1542993,18,27,1995,9,female,354,368,47,50,0,0,0,50,0
1972051,54,8,1959,4,female,1705,381,112,51,40,51,23,0,17
1135571,23,26,1990,3,male,916,365,264,53,6,53,5,0,1
2021059,26,27,1987,8,male,549,371,274,52,57,52,38,0,19
1861820,108,3,1905,11,male,1125,368,124,53,47,53,43,0,4
1505040,49,11,1964,3,female,1660,362,117,54,195,45,133,9,62
1560592,43,16,1970,5,male,637,381,321,57,39,2,10,55,29
1888226,23,28,1990,2,female,744,366,265,56,52,26,14,30,38
1558819,24,7,1989,5,female,176,359,244,58,314,20,188,38,126
1661193,33,11,1980,4,female,1198,363,260,57,123,34,51,23,72
1364930,18,26,1995,9,female,1208,369,86,58,16,47,7,11,9
1037975,18,16,1995,12,female,95,367,138,58,67,55,55,3,12
1517739,19,27,1994,1,male,383,362,276,56,19,56,13,0,6
1144704,108,30,1905,10,female,1746,369,102,56,24,56,21,0,3
1707851,14,9,1999,1,female,202,379,45,58,55,58,50,0,5
1486074,23,7,1990,5,male,287,376,243,57,67,57,56,0,11
1543500,21,29,1992,9,male,408,371,302,57,91,57,87,0,4
1215851,18,11,1995,4,male,412,379,321,59,10,59,3,0,7
1592269,39,28,1974,6,female,556,360,96,60,31,60,25,0,6
1445745,16,28,1997,3,male,677,361,272,59,36,59,17,0,19
2008758,21,23,1992,9,male,1464,380,146,60,89,60,66,0,23
1020118,20,21,1993,12,female,663,373,234,61,6,40,4,21,2
1078980,23,12,1990,12,male,794,379,284,62,3,43,2,19,1
1894992,15,7,1998,10,female,607,372,235,62,21,41,6,21,15
1582727,18,5,1995,5,female,702,370,105,62,52,22,41,40,11
1363479,22,15,1991,9,male,405,366,213,62,125,25,66,37,59
1431374,29,23,1984,10,male,1393,367,190,61,51,59,49,2,2
1861739,17,1,1996,5,male,329,370,275,63,36,63,9,0,27
1996167,18,21,1995,9,male,1024,366,291,62,16,62,8,0,8
1859415,22,23,1991,4,male,316,375,330,62,15,62,11,0,4
1634675,26,21,1987,9,male,1287,370,108,63,54,63,46,0,8
1015183,19,8,1994,11,female,290,372,122,63,426,63,279,0,147
1940139,20,8,1993,1,female,453,372,222,62,827,62,655,0,172
2139235,26,20,1987,4,female,1152,370,297,65,28,15,15,50,13
2050373,15,20,1998,11,female,179,381,306,65,212,15,59,50,153
1170582,20,18,1993,6,male,596,367,214,65,87,63,59,2,28
1442723,24,13,1989,11,male,200,369,203,65,287,64,105,1,182
1956179,22,17,1991,3,female,404,360,231,64,5,64,4,0,1
1638614,19,8,1994,9,female,348,373,188,65,87,65,69,0,18
1247196,109,1,1904,1,female,2330,360,61,64,68,64,57,0,11
1233935,21,19,1992,3,female,550,373,147,68,129,49,35,19,94
1762111,45,19,1968,8,male,1932,361,249,66,15,60,9,6,6
1580851,57,11,1956,5,male,1113,381,283,66,16,63,6,3,10
1385111,16,26,1997,4,male,108,366,335,66,88,63,23,3,65
1253650,37,30,1976,5,male,710,363,61,67,89,66,81,1,8
1876935,26,11,1987,3,male,281,367,326,68,6,68,6,0,0
1318354,27,24,1986,11,female,1543,363,94,68,90,68,65,0,25
1666986,20,15,1993,6,male,482,368,263,70,18,19,18,51,0
1338693,16,13,1997,8,male,350,377,159,71,80,69,47,2,33
1473942,83,18,1930,5,female,2279,381,210,71,18,71,12,0,6
1254141,18,6,1995,6,male,299,381,298,71,72,71,67,0,5
1268073,108,27,1905,9,male,2338,378,207,71,77,71,62,0,15
1008412,17,14,1996,11,female,543,365,182,69,131,69,126,0,5
1428212,22,11,1991,3,male,651,379,161,71,257,71,95,0,162
1667468,27,27,1986,11,male,716,359,140,71,109,71,47,0,62
1480782,64,17,1949,2,male,1676,374,149,73,235,0,73,73,162
1891079,31,6,1982,5,male,238,369,323,72,85,41,38,31,47
1760236,31,26,1982,9,male,332,374,263,74,161,72,136,2,25
1221712,23,27,1990,5,male,43,360,349,73,63,73,48,0,15
1278734,96,27,1917,7,female,1874,379,184,76,83,5,37,71,46
1032523,48,21,1965,5,male,690,366,307,77,403,8,164,69,239
1487202,18,11,1995,8,female,549,374,241,75,83,73,44,2,39
1811026,19,10,1994,7,male,1451,377,154,75,62,69,61,6,1
1248643,60,13,1953,8,male,455,359,300,77,82,76,73,1,9
1968304,47,22,1966,5,male,407,364,336,76,145,60,88,16,57
1208788,17,6,1996,5,male,554,375,218,76,48,76,25,0,23
2000859,86,10,1927,5,male,642,372,168,77,51,77,16,0,35
2151049,17,22,1996,4,female,268,374,88,79,41,0,22,79,19
2022667,103,1,1910,1,male,1376,378,322,78,36,21,4,57,32
1576434,18,1,1995,2,male,548,371,353,80,77,24,64,56,13
1546693,20,22,1993,12,male,103,360,254,78,164,43,89,35,75
1594323,20,25,1993,4,female,342,368,216,79,79,79,78,0,1
2035306,18,8,1995,8,female,328,373,125,78,133,78,114,0,19
2019751,23,12,1990,10,male,409,373,326,80,176,80,165,0,11
1240963,37,26,1976,9,female,87,361,44,82,35,0,16,82,19
1614255,22,22,1991,6,female,569,372,63,81,169,1,35,80,134
1606270,16,17,1997,5,female,381,369,289,82,117,35,69,47,48
1300334,15,10,1998,5,female,427,362,200,83,170,81,79,2,91
1408188,22,5,1991,11,male,487,375,249,82,230,61,48,21,182
1989911,21,25,1992,4,male,765,360,291,85,4,1,3,84,1
1089499,39,1,1974,4,female,503,362,329,87,85,68,37,19,48
1525056,13,1,2000,2,male,236,367,303,85,10,85,10,0,0
1341854,16,1,1997,7,male,295,378,234,85,80,85,38,0,42
1581275,43,6,1970,1,female,360,380,292,87,142,87,21,0,121
1887907,19,18,1994,6,male,295,368,93,88,5,0,0,88,5
1347658,54,11,1959,12,male,438,372,216,89,10,0,1,89,9
1156411,89,18,1924,10,female,1746,362,200,91,48,0,9,91,39
1335267,66,29,1947,6,female,715,363,268,90,13,27,4,63,9
1848547,16,12,1997,12,female,172,368,122,88,54,28,16,60,38
1650279,19,31,1994,3,male,638,375,255,89,6,80,0,9,6
1008650,46,22,1967,4,male,1157,376,217,91,43,66,25,25,18
1237544,31,2,1982,5,male,424,374,288,89,68,83,50,6,18
1340389,55,19,1958,11,female,217,381,295,89,154,80,115,9,39
1015980,25,7,1988,9,female,534,361,218,88,15,88,5,0,10
1743332,32,21,1981,9,male,653,365,310,90,51,90,38,0,13
1020372,21,1,1992,2,male,315,366,229,89,71,89,51,0,20
2147021,21,21,1992,1,male,695,362,222,92,15,91,15,1,0
1782921,14,19,1999,11,female,332,359,70,95,21,81,12,14,9
1980607,13,24,2000,3,male,212,365,321,94,75,75,37,19,38
1853918,18,19,1995,5,female,135,374,214,95,67,94,55,1,12
1569155,103,29,1910,3,female,1686,379,199,92,76,80,38,12,38
1098363,31,18,1982,1,female,483,379,179,95,52,95,34,0,18
1541144,18,10,1995,11,female,321,378,316,95,133,95,84,0,49
1245892,19,31,1994,3,female,64,374,206,93,187,93,97,0,90
1923821,57,11,1956,5,female,1822,364,285,99,60,1,14,98,46
1315117,66,28,1947,5,female,792,370,145,99,120,0,67,99,53
1816215,30,7,1983,10,female,504,378,136,99,221,15,143,84,78
1534838,36,11,1977,9,female,506,362,189,98,88,70,24,28,64
1906789,15,29,1998,8,male,432,367,284,99,42,82,23,17,19
1351224,28,19,1985,4,male,1207,380,129,98,24,83,20,15,4
1238201,16,18,1997,12,male,239,373,200,99,67,73,55,26,12
1623057,21,3,1992,2,female,272,365,108,96,326,80,196,16,130
1043164,22,24,1991,8,male,645,371,254,98,62,98,47,0,15
1651436,15,26,1998,11,female,576,362,237,100,11,8,0,92,11
1925396,25,22,1988,8,female,519,369,221,104,78,41,25,63,53
1770417,17,21,1996,12,female,249,367,234,101,263,63,180,38,83
1175773,103,30,1910,4,female,1602,381,158,102,247,43,107,59,140
1399142,63,6,1950,10,male,132,377,320,100,44,80,42,20,2
1185258,29,29,1984,5,female,606,379,342,102,30,102,25,0,5
1570727,18,26,1995,3,female,282,374,189,100,317,100,285,0,32
1774215,25,1,1988,6,male,135,376,348,102,368,102,326,0,42
2111385,24,28,1989,11,male,338,362,95,105,629,62,343,43,286
1953503,17,2,1996,5,male,663,381,266,107,65,107,57,0,8
1603844,24,15,1989,12,male,549,364,144,107,39,107,34,0,5
1971333,101,2,1912,7,female,516,361,170,107,66,107,50,0,16
1863328,19,2,1994,12,male,296,379,200,106,449,106,421,0,28
1501073,25,16,1988,5,female,995,362,217,108,324,108,242,0,82
2153990,26,1,1987,3,male,517,371,151,108,254,108,228,0,26
1976746,28,26,1985,2,female,533,369,275,111,187,8,21,103,166
2012983,22,19,1991,10,male,497,372,226,110,26,22,5,88,21
1180381,21,18,1992,8,male,453,361,233,110,29,105,11,5,18
2142932,19,21,1994,11,female,603,377,162,110,144,109,137,1,7
1482666,18,11,1995,5,female,196,365,162,113,112,113,86,0,26
1777332,25,22,1988,8,male,219,372,303,113,112,113,98,0,14
1195677,26,26,1987,2,male,1235,372,266,113,78,113,71,0,7
1662584,103,31,1910,12,male,658,377,218,111,75,111,56,0,19
1058209,17,17,1996,10,male,329,364,139,119,31,18,14,101,17
1995627,53,10,1960,11,male,119,378,333,118,168,1,51,117,117
1398218,15,2,1998,6,female,339,373,245,117,199,3,114,114,85
1790503,72,2,1941,12,male,1387,378,239,119,212,0,73,119,139
2071009,14,17,1999,4,female,371,361,173,116,145,61,62,55,83
1769886,20,15,1993,5,male,232,372,283,116,286,72,146,44,140
1843626,17,29,1996,11,male,437,375,247,117,36,107,27,10,9
2109570,23,4,1990,9,male,753,364,91,118,61,118,54,0,7
1281679,18,21,1995,11,female,577,367,150,114,125,114,91,0,34
1322356,18,2,1995,3,male,78,365,304,114,137,114,107,0,30
2012345,21,10,1992,9,female,325,361,44,118,297,118,292,0,5
1978335,23,6,1990,6,female,650,374,197,114,265,114,245,0,20
1823090,16,23,1997,7,male,335,379,280,121,4,0,0,121,4
1877944,18,23,1995,6,male,413,361,325,124,8,55,2,69,6
1837827,103,16,1910,3,male,1471,366,120,123,148,57,86,66,62
1968684,18,12,1995,2,male,152,360,175,124,215,62,84,62,131
1195245,20,13,1993,4,female,720,380,200,120,5,120,4,0,1
1494402,103,29,1910,7,male,1015,372,263,124,15,124,11,0,4
1468938,24,3,1989,6,male,281,368,314,122,181,122,145,0,36
1151984,18,24,1995,6,female,294,360,280,128,133,20,53,108,80
1399439,43,13,1970,9,male,584,361,171,128,128,24,28,104,100
1996473,23,1,1990,1,female,491,363,272,130,88,64,64,66,24
2065176,19,7,1994,4,male,346,373,313,125,285,123,85,2,200
1366863,21,25,1992,7,male,239,361,218,129,216,102,154,27,62
1521744,22,1,1991,2,female,1161,378,222,129,246,127,197,2,49
2037569,26,4,1987,7,male,332,372,263,127,4,127,4,0,0
1644141,26,27,1987,5,female,492,360,235,136,225,18,92,118,133
1392079,108,10,1905,7,male,220,366,322,133,220,95,124,38,96
2054634,33,24,1980,6,female,1028,359,243,131,154,104,120,27,34
1836968,102,10,1911,1,female,1637,378,187,134,22,134,18,0,4
1401024,19,3,1994,1,male,244,378,320,136,44,136,32,0,12
2008481,29,10,1984,4,male,614,377,270,136,84,136,76,0,8
1871219,22,11,1991,8,male,143,360,340,138,56,20,16,118,40
1843292,18,21,1995,11,male,318,371,295,140,74,58,61,82,13
2041505,22,2,1991,9,male,463,363,209,138,135,29,24,109,111
1539847,23,18,1990,6,female,1394,370,204,142,100,134,44,8,56
1909720,17,9,1996,4,male,183,366,210,140,63,140,44,0,19
1434696,17,18,1996,8,male,165,367,335,141,43,141,41,0,2
1447320,65,9,1948,9,female,1165,365,263,139,67,139,52,0,15
1451516,86,10,1927,5,female,605,381,272,140,74,140,62,0,12
2020444,16,11,1997,11,male,190,364,16,145,187,8,101,137,86
1359071,14,23,1999,11,female,154,381,337,145,73,138,50,7,23
1736940,103,12,1910,1,female,1208,370,272,150,45,125,12,25,33
1794517,18,4,1995,6,male,390,377,307,149,180,134,83,15,97
2044256,22,15,1991,1,female,344,367,159,150,109,137,60,13,49
1133079,33,2,1980,2,female,772,375,291,144,160,129,46,15,114
1668729,22,22,1991,12,female,403,374,328,145,432,124,202,21,230
1083000,18,28,1995,7,male,315,374,311,147,0,147,0,0,0
1578220,19,25,1994,3,male,967,369,253,144,1,144,0,0,1
1847346,103,19,1910,12,male,705,367,124,148,134,148,132,0,2
2028030,52,12,1961,7,male,1781,375,107,150,241,150,114,0,127
2131482,46,4,1967,9,female,1437,370,247,153,148,19,52,134,96
2004875,31,18,1982,8,female,1247,361,206,155,224,87,147,68,77
1645913,60,15,1953,2,male,1709,369,191,153,129,99,46,54,83
2166407,28,29,1985,11,female,835,371,236,156,180,130,94,26,86
1152738,65,18,1948,2,female,1538,361,160,152,9,152,6,0,3
1393575,14,3,1999,10,female,472,381,200,156,73,156,46,0,27
1943697,19,1,1994,1,male,575,376,360,156,85,156,80,0,5
1204504,94,6,1919,8,female,530,375,208,157,94,157,85,0,9
1429837,24,6,1989,8,female,562,377,166,154,143,154,101,0,42
2052250,25,10,1988,5,female,810,376,202,164,196,110,140,54,56
1207002,24,5,1989,10,male,276,379,330,164,11,164,11,0,0
2082510,33,7,1980,5,male,779,364,297,164,48,164,30,0,18
1385367,18,26,1995,5,female,607,370,118,158,147,158,142,0,5
2189705,18,10,1995,3,male,391,373,294,168,158,30,53,138,105
1243066,25,4,1988,8,male,789,362,187,172,202,119,126,53,76
1198825,30,2,1983,8,male,2240,366,234,172,151,143,108,29,43
1108462,22,11,1991,11,male,408,372,221,172,130,171,119,1,11
2182790,18,8,1995,5,female,159,378,336,166,27,166,23,0,4
1445653,32,27,1981,4,male,466,373,355,170,75,170,45,0,30
1952342,20,3,1993,11,female,495,362,43,172,653,172,516,0,137
1854003,25,30,1988,6,female,621,381,303,176,106,89,86,87,20
1632011,19,18,1994,10,male,736,369,255,181,148,101,88,80,60
1367142,18,29,1995,9,female,291,369,261,181,295,47,214,134,81
1695715,22,30,1991,1,female,295,369,135,176,49,130,37,46,12
1040057,30,11,1983,2,female,565,368,300,175,693,174,504,1,189
1383460,58,22,1955,2,female,1796,377,123,173,207,173,145,0,62
1435477,16,1,1997,4,male,148,367,327,183,104,89,70,94,34
1475608,16,1,1997,7,female,361,359,157,184,170,79,31,105,139
1426091,93,7,1920,6,female,1546,370,148,185,30,148,17,37,13
1212376,29,23,1984,12,female,934,377,228,189,253,147,162,42,91
1514470,24,9,1989,3,female,963,367,204,187,96,186,59,1,37
1610541,17,6,1996,6,male,193,361,184,187,91,187,71,0,20
1357911,99,13,1914,12,male,1080,376,168,183,59,183,37,0,22
1820356,108,30,1905,12,female,1885,373,163,190,110,190,90,0,20
1276115,14,1,1999,4,female,201,380,122,190,226,190,180,0,46
1897976,27,3,1986,2,female,214,366,272,189,250,189,208,0,42
2039352,33,22,1980,11,male,900,361,237,188,225,188,185,0,40
1267910,34,11,1979,4,female,719,362,238,184,858,184,575,0,283
2133477,39,4,1974,1,male,381,371,197,187,484,187,255,0,229
2141589,108,26,1905,9,female,96,369,337,194,240,31,149,163,91
1132885,65,24,1948,8,male,576,378,214,192,507,7,137,185,370
2146625,50,27,1963,11,female,1600,362,240,193,505,78,199,115,306
1064766,20,5,1993,7,male,783,370,272,197,226,196,99,1,127
1031320,17,14,1996,12,female,399,362,42,192,100,192,84,0,16
1052559,42,9,1971,8,male,285,368,294,199,270,199,226,0,44
1279843,53,5,1960,7,female,378,374,55,211,116,0,24,211,92
1654512,68,26,1945,6,male,1098,369,303,209,118,0,6,209,112
2185100,17,6,1996,1,female,177,378,192,210,133,110,41,100,92
1532204,55,1,1958,1,male,1587,359,179,210,285,86,87,124,198
1597110,16,24,1997,5,female,338,379,189,203,1141,71,235,132,906
1320984,19,15,1994,12,female,396,363,84,203,364,121,281,82,83
1754179,108,27,1905,12,male,2175,378,243,204,123,160,73,44,50
1256844,100,22,1913,1,male,699,368,210,210,16,210,14,0,2
1140308,20,10,1993,10,female,430,369,256,210,69,210,67,0,2
1314813,100,3,1913,6,female,1827,376,238,204,52,204,31,0,21
1998339,103,23,1910,8,female,1285,364,171,214,94,35,28,179,66
1519470,107,2,1906,8,male,1601,361,206,220,113,67,68,153,45
1359366,18,17,1995,1,female,307,380,168,220,159,67,34,153,125
2002756,19,24,1994,1,female,447,360,142,221,197,144,166,77,31
2190048,44,5,1969,7,female,830,374,82,221,138,79,68,142,70
1299359,19,25,1994,7,female,1617,368,114,213,483,129,298,84,185
1438358,16,26,1997,1,female,377,360,270,212,299,208,207,4,92
1128109,29,12,1984,9,female,1551,372,276,221,852,206,414,15,438
1332782,23,6,1990,5,male,500,367,269,215,109,215,74,0,35
1369259,45,21,1968,9,male,46,372,360,215,137,215,116,0,21
1162654,35,17,1978,12,female,395,363,77,231,314,20,53,211,261
1272256,60,18,1953,12,female,667,379,249,233,368,0,60,233,308
2162540,20,15,1993,9,female,620,372,181,222,110,49,60,173,50
1265303,22,10,1991,11,female,626,381,223,228,104,48,27,180,77
2111515,27,5,1986,8,female,511,360,222,224,258,104,152,120,106
1083900,53,8,1960,7,female,2060,374,272,222,312,132,224,90,88
1473260,14,7,1999,1,female,338,367,198,228,210,225,160,3,50
1616881,23,9,1990,12,female,773,372,253,224,197,171,110,53,87
1162021,89,24,1924,11,male,1009,368,105,226,139,209,23,17,116
1259034,16,9,1997,9,female,470,373,83,227,133,227,121,0,12
1901652,103,1,1910,5,male,992,362,221,223,63,223,50,0,13
1408908,19,4,1994,3,female,235,373,84,231,163,231,150,0,13
2124995,28,6,1985,4,female,361,368,324,224,296,224,261,0,35
1611356,16,20,1997,1,male,428,379,234,244,97,2,27,242,70
1533448,18,25,1995,8,male,566,373,316,238,84,43,17,195,67
1221367,94,30,1919,5,female,982,374,204,243,93,12,46,231,47
2017077,18,11,1995,7,female,560,375,277,239,564,21,262,218,302
1090475,62,12,1951,9,female,976,368,321,234,40,229,31,5,9
2020504,16,7,1997,10,male,432,363,127,242,185,231,119,11,66
1794131,23,16,1990,12,female,575,363,182,234,244,228,93,6,151
1555175,22,15,1991,3,female,495,369,156,239,106,239,101,0,5
1127231,13,2,2000,3,female,1399,362,163,235,195,235,160,0,35
1196103,35,19,1978,4,female,345,379,255,246,165,246,102,0,63
1539689,52,20,1961,7,male,945,366,259,258,478,11,194,247,284
2028242,23,9,1990,6,male,240,365,357,247,32,244,18,3,14
1803890,108,15,1905,6,female,2051,372,224,257,335,194,289,63,46
1524489,19,28,1994,4,NA,237,374,194,254,184,252,166,2,18
1325986,17,11,1996,3,female,205,359,46,248,101,248,69,0,32
2137125,21,24,1992,5,male,551,373,297,256,98,256,77,0,21
1785097,33,27,1980,12,female,1500,363,92,256,283,256,227,0,56
1096694,60,19,1953,12,male,434,363,269,253,226,253,129,0,97
2117697,72,15,1941,11,female,504,365,296,265,7,141,4,124,3
1398839,17,3,1996,6,female,106,381,356,267,507,158,195,109,312
1323702,24,15,1989,10,female,826,368,314,268,1337,90,837,178,500
1355264,18,1,1995,10,male,136,369,321,261,73,222,66,39,7
1354953,48,20,1965,12,male,313,373,267,267,279,266,135,1,144
1658326,18,16,1995,8,female,131,376,141,271,97,271,79,0,18
1429672,24,9,1989,4,female,411,359,259,261,59,261,40,0,19
1061623,23,24,1990,6,male,577,363,304,286,103,64,81,222,22
1549219,68,11,1945,7,male,787,363,152,290,352,79,172,211,180
1767636,89,29,1924,4,female,2318,368,234,281,166,246,123,35,43
1547564,14,15,1999,7,male,145,373,301,278,53,278,19,0,34
1993519,21,27,1992,9,male,275,359,311,277,170,277,156,0,14
1705531,31,29,1982,10,female,163,361,52,288,797,288,579,0,218
1485181,17,3,1996,3,female,889,359,166,297,318,120,107,177,211
1440037,17,22,1996,3,female,415,379,160,303,33,296,27,7,6
1419967,19,2,1994,6,male,501,366,275,296,152,296,128,0,24
1887492,16,12,1997,5,female,498,372,225,303,261,303,167,0,94
1043777,21,11,1992,1,male,591,366,257,316,83,51,37,265,46
1963623,89,19,1924,3,male,1625,367,171,318,152,3,88,315,64
1380874,27,29,1986,9,male,477,368,285,317,743,62,556,255,187
1549136,14,16,1999,12,female,205,372,265,321,83,115,38,206,45
1862832,19,12,1994,10,male,516,362,154,322,168,97,47,225,121
1805482,17,9,1996,9,female,604,360,311,326,350,86,170,240,180
1225913,21,1,1992,8,female,1756,369,239,324,359,83,219,241,140
1514706,66,10,1947,1,male,868,375,194,323,178,302,123,21,55
1070254,50,14,1963,12,male,1138,373,23,323,260,310,173,13,87
1026705,23,15,1990,10,male,73,381,289,310,626,292,532,18,94
1253552,21,27,1992,2,female,658,375,57,311,1323,310,1052,1,271
1865175,15,13,1998,2,female,257,369,163,324,105,324,103,0,2
1447584,29,1,1984,2,male,352,372,274,323,67,323,66,0,1
1903180,22,11,1991,11,female,658,378,94,324,252,324,236,0,16
1489151,24,21,1989,7,male,788,381,164,326,329,326,251,0,78
1815486,66,19,1947,12,male,1095,377,256,339,483,0,168,339,315
1807367,77,27,1936,7,male,1211,361,271,339,222,0,93,339,129
1508869,102,26,1911,12,male,1749,374,148,339,210,0,93,339,117
1772547,113,19,1900,10,male,2268,377,169,338,181,229,164,109,17
1386850,19,1,1994,12,female,551,370,162,346,702,302,263,44,439
1819772,19,2,1994,5,male,29,360,285,330,56,327,52,3,4
2164703,62,5,1951,7,female,1320,370,290,328,38,328,30,0,8
1054446,108,23,1905,2,female,1204,368,249,328,274,328,189,0,85
1023818,47,23,1966,2,female,1578,380,260,358,755,127,334,231,421
1446046,15,21,1998,2,female,433,370,183,361,170,279,161,82,9
1960217,59,30,1954,8,male,1515,381,262,350,69,330,36,20,33
1685598,18,25,1995,5,female,466,378,228,367,607,290,360,77,247
2191414,49,30,1964,9,female,1908,369,182,367,1015,350,556,17,459
2005578,25,22,1988,5,female,613,372,184,362,341,360,259,2,82
1579568,23,10,1990,4,female,149,375,220,354,204,354,110,0,94
1084171,54,31,1959,3,female,1641,371,175,351,308,351,203,0,105
1686304,61,3,1952,2,female,578,370,95,392,123,156,47,236,76
1436687,28,25,1985,11,female,399,362,321,379,749,265,472,114,277
1775063,17,22,1996,8,male,478,369,218,374,362,287,212,87,150
1247112,36,5,1977,2,female,1583,363,276,391,572,363,183,28,389
1180255,17,22,1996,2,female,287,379,154,377,310,377,200,0,110
1964905,21,13,1992,9,male,306,359,262,387,565,387,524,0,41
2124709,41,13,1972,2,male,240,379,325,387,268,387,182,0,86
1587836,19,24,1994,5,male,136,372,352,403,359,245,141,158,218
1576953,86,9,1927,7,female,804,376,209,403,578,285,281,118,297
1617126,106,14,1907,6,female,1971,370,240,408,451,249,185,159,266
1566900,21,27,1992,1,female,225,367,248,402,673,284,262,118,411
1956068,17,1,1996,10,male,433,372,247,409,16,342,11,67,5
1861873,25,16,1988,6,male,517,375,214,407,89,384,66,23,23
1998817,28,5,1985,1,female,258,370,268,403,72,331,18,72,54
1129539,15,4,1998,3,female,630,370,237,420,224,420,156,0,68
1786375,27,10,1986,7,male,609,366,241,413,248,413,139,0,109
1365975,57,23,1956,9,male,1497,377,197,413,204,413,197,0,7
1235622,92,6,1921,1,male,1466,359,231,417,237,417,194,0,43
1558394,67,13,1946,5,female,1408,376,171,441,93,0,25,441,68
1699332,59,6,1954,7,male,716,360,172,442,486,81,248,361,238
1802925,100,15,1913,10,female,2461,360,254,450,453,1,199,449,254
1559219,18,1,1995,1,male,517,369,308,432,291,239,161,193,130
2152224,24,9,1989,8,female,410,363,165,432,158,427,131,5,27
1059211,31,2,1982,7,female,1718,380,133,422,83,382,48,40,35
1180509,50,25,1963,8,female,959,371,256,429,238,381,95,48,143
1966892,18,3,1995,9,female,261,379,163,449,511,443,194,6,317
1310370,21,4,1992,4,female,251,367,323,445,346,439,260,6,86
1389726,34,9,1979,2,female,376,381,313,427,586,338,250,89,336
1025440,38,25,1975,9,female,2327,365,148,428,515,416,416,12,99
2170834,16,31,1997,7,female,584,371,104,424,642,418,374,6,268
1744388,24,30,1989,3,male,169,364,207,430,700,427,451,3,249
1985848,19,11,1994,11,male,721,368,317,437,90,437,74,0,16
1878649,18,29,1995,1,female,584,363,282,436,240,436,181,0,59
1836009,18,5,1995,5,female,183,361,161,437,290,437,173,0,117
1182213,21,28,1992,10,female,628,375,46,456,443,45,242,411,201
1138568,108,22,1905,2,female,1126,365,241,452,835,3,115,449,720
1793191,14,21,1999,9,female,355,369,236,480,102,177,85,303,17
1337955,21,17,1992,3,female,77,378,349,468,668,123,261,345,407
2158370,28,18,1985,5,female,331,362,94,476,310,324,155,152,155
1558592,18,27,1995,8,female,538,363,198,464,268,446,56,18,212
1849033,48,7,1965,9,female,1308,364,227,461,423,405,194,56,229
1941082,88,7,1925,4,female,2262,377,200,467,356,415,134,52,222
1930339,22,4,1991,8,male,527,374,204,452,606,448,571,4,35
2126080,18,17,1995,2,male,227,366,288,469,1,469,0,0,1
1630083,17,6,1996,10,male,360,377,317,461,116,461,55,0,61
1236568,21,17,1992,8,female,169,369,81,460,245,460,160,0,85
1152335,14,18,1999,3,female,519,373,210,464,417,464,374,0,43
2094940,21,16,1992,2,female,439,360,250,467,656,467,568,0,88
1197687,29,15,1984,5,female,366,366,304,453,403,453,122,0,281
1705889,39,1,1974,5,female,949,375,221,452,463,452,443,0,20
2192145,22,16,1991,4,female,619,372,78,464,877,464,845,0,32
1164976,23,10,1990,4,male,345,376,309,489,144,27,55,462,89
1149147,63,5,1950,12,female,360,367,316,515,516,11,160,504,356
1226317,20,21,1993,11,male,235,362,196,490,1622,41,450,449,1172
1985648,14,8,1999,4,female,157,380,202,485,234,148,76,337,158
1619774,18,14,1995,5,female,206,378,307,513,300,333,166,180,134
1900018,18,25,1995,9,female,248,362,152,491,580,180,161,311,419
1659672,19,15,1994,3,female,183,370,221,496,471,145,183,351,288
1751825,14,14,1999,8,male,319,371,293,488,40,377,33,111,7
1378934,16,19,1997,7,female,162,371,282,514,345,445,222,69,123
1392295,23,15,1990,12,male,673,378,221,508,254,508,209,0,45
2133187,38,15,1975,11,male,481,359,220,516,560,516,471,0,89
1536129,43,10,1970,4,male,629,374,341,527,246,357,90,170,156
1382529,19,20,1994,1,female,776,371,158,542,404,341,178,201,226
1071525,14,16,1999,4,female,505,381,186,533,272,523,147,10,125
1669075,22,28,1991,3,female,684,376,323,545,320,481,240,64,80
1400584,40,3,1973,9,female,2289,374,96,558,697,476,484,82,213
1167050,107,18,1906,5,female,1548,378,139,558,376,410,326,148,50
1732564,56,21,1957,6,female,1233,367,277,538,478,538,367,0,111
1299907,100,26,1913,8,female,2261,375,71,537,443,537,347,0,96
1251625,34,23,1979,9,female,510,360,215,578,673,12,484,566,189
1350252,22,17,1991,6,male,493,377,313,609,30,263,18,346,12
1482419,18,2,1995,9,female,629,376,205,566,570,347,294,219,276
1080827,21,5,1992,5,female,594,362,225,576,627,254,237,322,390
1852781,34,2,1979,4,male,643,370,81,594,361,491,174,103,187
1908192,16,28,1997,6,female,520,380,216,576,577,471,225,105,352
1697564,20,18,1993,9,female,156,376,345,582,438,457,212,125,226
1798445,24,3,1989,2,female,1463,381,230,599,514,513,214,86,300
1041558,26,10,1987,7,male,448,362,229,593,366,497,199,96,167
1016141,103,9,1910,2,female,806,362,82,586,826,576,462,10,364
1057605,93,11,1920,12,female,292,363,254,589,282,589,245,0,37
1390770,16,23,1997,7,female,224,370,254,604,618,604,453,0,165
1680019,31,20,1982,10,female,290,368,262,566,505,566,312,0,193
1084676,34,15,1979,1,female,604,371,230,610,537,42,132,568,405
1894974,19,29,1994,10,female,243,378,302,659,1137,39,136,620,1001
1502990,25,2,1988,6,female,589,371,215,618,1294,21,532,597,762
1232870,14,9,1999,4,female,451,367,251,613,374,355,217,258,157
1060397,18,2,1995,6,female,427,378,198,626,623,409,327,217,296
2037760,20,2,1993,9,female,506,359,188,651,508,470,304,181,204
2031763,36,24,1977,10,female,1314,371,233,648,769,467,441,181,328
1259942,26,20,1987,7,female,525,361,268,619,366,594,335,25,31
1698628,23,10,1990,9,female,589,367,274,630,580,507,427,123,153
1692503,51,6,1962,1,female,509,370,293,638,703,625,501,13,202
1846049,23,29,1990,1,male,454,370,87,619,1,619,1,0,0
1462058,41,21,1972,1,male,95,377,128,635,486,635,351,0,135
2174047,39,25,1974,12,female,644,377,177,626,951,626,394,0,557
1574074,19,24,1994,5,male,441,362,227,724,716,8,77,716,639
1841189,59,5,1954,7,female,492,365,321,693,552,42,185,651,367
1962626,70,24,1943,2,female,828,372,136,681,620,25,229,656,391
1668397,52,29,1961,5,female,699,361,170,665,1171,0,468,665,703
1193664,19,26,1994,5,female,384,365,141,681,604,394,135,287,469
1486056,19,23,1994,5,female,491,374,263,716,222,662,113,54,109
1957378,27,29,1986,5,female,1193,379,163,716,535,594,329,122,206
1420903,16,6,1997,6,female,337,379,254,722,112,722,107,0,5
1419332,22,16,1991,10,male,229,373,317,695,186,695,133,0,53
1794248,20,29,1993,6,female,568,370,159,680,678,680,580,0,98
1052609,16,8,1997,5,female,441,371,158,762,50,76,19,686,31
1865065,51,8,1962,2,female,1095,372,254,745,107,293,39,452,68
1038531,20,26,1993,1,female,768,373,88,771,393,228,94,543,299
1244980,35,1,1978,1,female,708,360,211,787,340,201,167,586,173
1539910,55,28,1958,10,female,1395,375,240,765,440,465,182,300,258
1534412,28,25,1985,3,female,805,376,302,730,226,648,110,82,116
1334320,15,2,1998,10,female,254,369,169,738,733,594,360,144,373
1226689,19,27,1994,6,female,217,373,143,735,595,697,406,38,189
2097455,17,29,1996,3,female,1004,375,156,794,934,786,561,8,373
2132738,18,16,1995,10,male,624,373,339,785,84,785,79,0,5
1304678,24,7,1989,5,female,566,361,192,794,455,794,387,0,68
1454444,25,6,1988,9,female,181,378,148,761,432,761,286,0,146
1904578,41,18,1972,5,female,1006,374,269,873,975,70,446,803,529
1989441,108,17,1905,6,male,996,367,253,862,754,550,442,312,312
1896980,18,10,1995,12,male,250,365,291,821,374,598,285,223,89
1205014,17,25,1996,5,female,334,361,246,855,449,790,342,65,107
1652959,26,1,1987,4,male,451,360,179,798,326,677,213,121,113
1229192,18,24,1995,12,female,289,374,190,858,757,781,450,77,307
1890715,19,23,1994,5,male,360,374,237,858,1034,725,822,133,212
1769410,28,29,1985,8,female,243,362,251,811,581,640,420,171,161
1684143,19,14,1994,6,female,1326,378,99,872,1765,812,949,60,816
1820605,14,5,1999,7,female,442,381,228,857,399,857,91,0,308
1865375,24,28,1989,10,male,342,361,216,850,204,850,151,0,53
2113650,16,25,1997,1,female,205,359,194,813,1022,813,868,0,154
2139218,20,14,1993,10,female,316,368,216,853,821,853,377,0,444
2062822,21,17,1992,9,female,537,371,246,804,585,804,517,0,68
1624244,37,4,1976,4,female,546,375,266,798,636,798,535,0,101
1345844,96,30,1917,3,male,151,363,251,929,2,0,1,929,1
1165658,20,15,1993,5,male,67,379,336,908,651,623,500,285,151
1177561,27,23,1986,2,female,63,366,307,950,741,639,533,311,208
1177546,28,25,1985,9,female,1128,368,202,887,605,618,494,269,111
1568646,35,30,1978,10,female,389,380,256,959,990,414,358,545,632
1860565,57,23,1956,10,female,1384,370,196,896,1136,236,297,660,839
2121518,18,29,1995,1,female,352,366,132,951,144,868,133,83,11
1731429,18,17,1995,8,female,261,381,137,904,1044,894,592,10,452
1650678,85,1,1928,7,female,1774,368,295,955,862,794,431,161,431
1504624,18,23,1995,9,female,378,367,326,939,478,937,304,2,174
1585249,23,22,1990,9,female,580,381,171,962,397,962,64,0,333
1540867,62,21,1951,10,female,1823,368,193,1058,657,413,364,645,293
1219737,108,26,1905,9,male,299,369,267,1094,146,1065,64,29,82
1054180,15,2,1998,4,female,503,376,225,1018,232,940,210,78,22
1493289,58,3,1955,12,female,2251,373,210,1129,684,886,245,243,439
1618473,18,3,1995,5,male,381,366,286,1125,1536,948,1196,177,340
1129820,19,31,1994,8,female,643,364,100,1059,775,1026,495,33,280
1718176,48,20,1965,2,female,334,380,319,1103,1634,1065,870,38,764
1590659,24,17,1989,1,female,531,361,95,1086,182,1080,133,6,49
1009429,57,16,1956,12,female,1370,369,185,1064,686,1063,355,1,331
1398661,48,1,1965,1,male,350,365,290,1057,564,1057,419,0,145
1055632,22,17,1991,5,male,276,362,158,1089,678,1089,464,0,214
1794031,16,5,1997,6,female,736,370,312,1148,341,193,118,955,223
2015442,65,30,1948,3,female,1956,381,197,1212,2583,0,685,1212,1898
2023232,49,19,1964,10,female,1399,371,160,1200,436,651,254,549,182
1800424,16,24,1997,1,male,48,364,309,1181,855,315,145,866,710
1488353,31,22,1982,10,female,232,365,209,1286,1462,891,433,395,1029
1352257,18,6,1995,7,female,437,380,262,1207,413,1071,224,136,189
1723968,28,23,1985,9,female,674,379,127,1219,587,971,247,248,340
1550843,33,16,1980,12,female,770,372,186,1151,640,921,265,230,375
1285921,55,27,1958,6,female,1651,375,110,1137,448,1009,255,128,193
1648371,15,1,1998,1,female,567,367,282,1213,930,1212,776,1,154
1774538,18,9,1995,9,female,484,361,172,1230,764,1230,505,0,259
1297644,28,24,1985,9,male,551,375,101,1496,441,73,249,1423,192
2160762,18,3,1995,1,female,1414,374,152,1305,1822,11,815,1294,1007
1805142,37,14,1976,6,male,1555,367,175,1321,1210,191,497,1130,713
1276726,41,6,1972,6,female,166,359,307,1480,1652,120,597,1360,1055
2188918,68,9,1945,9,male,886,369,241,1446,991,253,525,1193,466
1363300,25,25,1988,5,female,294,369,98,1523,314,981,184,542,130
1863370,54,19,1959,4,female,498,373,220,1446,704,466,513,980,191
1938262,19,23,1994,11,female,414,362,254,1353,1726,963,1030,390,696
1412579,22,31,1991,5,female,176,371,263,1403,523,1363,452,40,71
1888928,25,19,1988,6,female,249,367,282,1467,1536,1466,1267,1,269
1800332,24,28,1989,5,female,375,378,36,1375,1451,1375,795,0,656
2163517,46,9,1967,4,female,1620,359,250,1625,588,722,353,903,235
1181482,52,3,1961,2,female,871,363,208,1807,562,1277,89,530,473
1877693,23,5,1990,5,female,150,371,243,1673,302,1569,268,104,34
1955848,33,5,1980,8,female,1108,372,223,1545,558,1529,163,16,395
1970221,56,3,1957,8,female,1757,379,283,1840,710,1631,470,209,240
1267146,101,9,1912,5,female,553,373,178,1610,742,1467,457,143,285
1187982,53,12,1960,2,male,435,361,248,1651,95,1651,71,0,24
1325333,18,11,1995,7,female,529,375,162,1750,545,1750,277,0,268
1470505,22,11,1991,4,male,232,372,187,1815,621,1815,566,0,55
1319237,16,10,1997,6,female,96,372,176,2370,3523,18,792,2352,2731
1680911,18,6,1995,3,female,448,364,178,2164,324,533,199,1631,125
1919887,19,20,1994,12,female,462,359,159,1918,2173,1109,1334,809,839
1321146,23,2,1990,10,female,231,379,193,1947,1363,1324,348,623,1015
1103697,18,27,1995,7,female,678,369,206,2191,2083,1838,1206,353,877
1795145,62,25,1951,6,female,1418,379,278,3248,1879,0,366,3248,1513
2066988,19,12,1994,12,male,726,362,225,2540,342,941,225,1599,117
1367966,18,22,1995,4,female,120,365,277,2624,2572,1822,980,802,1592
1720499,69,9,1944,2,female,805,368,279,2511,2347,1036,924,1475,1423
1150268,24,18,1989,6,female,64,381,355,3131,1184,2872,591,259,593
1990967,20,17,1993,11,female,63,368,80,3266,828,3266,491,0,337
1451647,32,31,1981,1,female,262,365,144,2604,725,2604,681,0,44
1538492,55,3,1958,1,female,1347,369,115,2701,1488,2701,1290,0,198
1311280,22,11,1991,9,female,51,380,202,5277,5284,59,613,5218,4671
2003239,27,29,1986,6,male,1222,366,248,4948,3653,956,1654,3992,1999
1407241,13,21,2000,5,female,485,373,214,6927,2094,5667,1497,1260,597
1625507,17,27,1996,5,male,92,371,330,4073,1027,4073,597,0,430
1112735,19,14,1994,1,female,71,375,172,5704,1506,5704,1143,0,363
2028654,44,21,1969,11,female,211,379,334,4218,2413,4218,2215,0,198
1346478,54,16,1959,6,male,654,367,219,9181,4610,9181,3455,0,1155
2057059,14,2,1999,3,female,513,383,107,0,2,0,2,0,0
2021460,14,1,1999,5,female,501,392,173,0,0,0,0,0,0
1494705,16,22,1997,11,female,304,398,93,0,7,0,6,0,1
2080878,15,13,1998,1,male,485,399,339,0,3,0,3,0,0
1500182,15,22,1998,5,male,798,393,278,0,0,0,0,0,0
1169741,15,1,1998,5,female,294,385,81,0,2,0,1,0,1
2192046,15,5,1998,6,female,462,407,253,0,1,0,0,0,1
2121792,15,7,1998,9,female,196,386,123,0,11,0,7,0,4
1447457,17,3,1996,12,female,595,391,176,0,0,0,0,0,0
1707204,16,22,1997,4,male,734,400,225,0,0,0,0,0,0
1356367,16,17,1997,5,female,419,391,125,0,0,0,0,0,0
1414592,16,25,1997,5,male,150,395,330,0,29,0,25,0,4
2105775,17,8,1996,2,male,530,400,353,0,0,0,0,0,0
1851895,17,11,1996,4,male,276,397,305,0,0,0,0,0,0
1429390,17,18,1996,5,male,687,393,292,0,2,0,1,0,1
1048699,17,16,1996,6,female,578,409,194,0,4,0,3,0,1
1861966,17,28,1996,9,male,992,387,327,0,5,0,0,0,5
1162082,17,25,1996,9,male,770,394,187,0,0,0,0,0,0
1714193,19,14,1994,12,male,415,385,344,0,0,0,0,0,0
1021377,18,1,1995,7,male,434,399,225,0,63,0,56,0,7
1121518,18,14,1995,8,male,192,385,141,0,0,0,0,0,0
1217151,18,11,1995,9,male,248,386,350,0,25,0,23,0,2
1502575,18,3,1995,10,male,78,408,255,0,1,0,1,0,0
1499721,20,29,1993,12,male,378,406,313,0,0,0,0,0,0
1704740,19,18,1994,3,male,627,383,236,0,9,0,6,0,3
1503718,19,17,1994,4,male,1154,407,111,0,1,0,1,0,0
2190665,19,16,1994,4,male,541,393,330,0,6,0,2,0,4
1595096,19,15,1994,5,male,450,404,297,0,2,0,1,0,1
2025174,19,12,1994,9,female,603,391,42,0,0,0,0,0,0
1846639,20,2,1993,3,male,202,406,375,0,0,0,0,0,0
1997818,20,19,1993,5,male,397,405,378,0,0,0,0,0,0
1867556,20,12,1993,8,female,652,396,280,0,0,0,0,0,0
1347789,20,13,1993,9,male,620,382,250,0,1,0,0,0,1
1428092,22,12,1991,12,male,1174,405,310,0,3,0,2,0,1
1536117,22,21,1991,3,male,751,409,270,0,5,0,0,0,5
1817965,22,5,1991,5,male,153,401,392,0,0,0,0,0,0
1244089,22,22,1991,6,female,643,406,195,0,2,0,2,0,0
1993557,22,27,1991,6,female,468,382,93,0,1,0,1,0,0
1645791,22,23,1991,8,female,343,396,52,0,0,0,0,0,0
1872743,23,3,1990,3,female,1204,387,153,0,6,0,5,0,1
1489490,23,13,1990,3,male,630,388,295,0,0,0,0,0,0
1876781,23,17,1990,3,male,232,393,341,0,1,0,1,0,0
1025914,23,28,1990,6,male,1282,395,83,0,0,0,0,0,0
1196558,23,7,1990,8,male,606,392,366,0,15,0,11,0,4
2178368,23,16,1990,8,male,398,391,266,0,0,0,0,0,0
1036611,23,25,1990,9,male,673,386,305,0,0,0,0,0,0
1694090,24,5,1989,3,male,227,401,224,0,0,0,0,0,0
1320977,24,11,1989,8,male,1353,403,160,0,6,0,6,0,0
2088241,24,1,1989,8,male,489,391,297,0,1,0,0,0,1
2164229,24,19,1989,9,male,389,398,357,0,0,0,0,0,0
2012534,24,17,1989,10,male,608,386,264,0,1,0,1,0,0
1483059,26,5,1987,12,male,764,385,342,0,0,0,0,0,0
1012368,25,11,1988,6,male,565,406,327,0,145,0,102,0,43
1405064,25,5,1988,6,female,188,386,47,0,22,0,20,0,2
1834976,25,8,1988,8,male,1118,404,354,0,0,0,0,0,0
1199785,25,14,1988,8,male,892,384,292,0,1,0,0,0,1
1146716,27,19,1986,12,male,966,396,203,0,5,0,2,0,3
1615738,26,25,1987,5,male,196,401,394,0,10,0,1,0,9
1443133,26,28,1987,6,female,674,388,190,0,1,0,0,0,1
2086325,26,8,1987,7,female,553,385,296,0,0,0,0,0,0
1312684,28,23,1985,4,male,524,404,223,0,2,0,2,0,0
1216610,32,13,1981,9,male,1027,397,220,0,0,0,0,0,0
1777861,33,15,1980,2,male,394,407,361,0,8,0,2,0,6
1331284,33,6,1980,5,male,1166,394,320,0,17,0,5,0,12
1592490,34,3,1979,2,female,309,398,151,0,1,0,0,0,1
1218428,36,22,1977,4,male,711,397,373,0,0,0,0,0,0
1335443,37,14,1976,10,male,942,399,223,0,0,0,0,0,0
1460110,38,6,1975,3,male,222,403,23,0,0,0,0,0,0
1252470,55,17,1958,6,male,1391,401,322,0,12,0,3,0,9
1428058,61,26,1952,7,female,881,391,82,0,3,0,3,0,0
1078304,65,3,1948,12,male,813,384,232,0,0,0,0,0,0
1645457,64,20,1949,4,female,496,389,175,0,20,0,13,0,7
1559075,68,28,1945,5,male,681,399,191,0,12,0,9,0,3
1163683,75,21,1938,11,male,231,385,340,0,3,0,3,0,0
1748147,93,14,1920,10,female,329,393,34,0,52,0,28,0,24
1799343,108,8,1905,12,male,484,383,318,0,47,0,28,0,19
1381691,108,15,1905,3,male,1033,387,272,0,1,0,0,0,1
1604080,108,27,1905,10,male,1298,402,293,0,17,0,8,0,9
2105205,17,2,1996,1,male,635,388,279,1,1,0,1,1,0
1034011,28,1,1985,3,male,54,408,392,1,1,0,1,1,0
1619969,15,2,1998,7,male,542,395,333,1,5,0,3,1,2
2021618,18,12,1995,4,male,126,408,106,1,6,0,2,1,4
1903215,45,22,1968,3,male,921,387,47,1,3,0,1,1,2
2002240,67,1,1946,2,male,233,396,283,1,4,0,1,1,3
1387999,68,30,1945,9,female,634,386,232,1,2,0,0,1,2
1150403,82,16,1931,4,female,1138,391,281,1,4,0,2,1,2
1802576,108,31,1905,12,male,1181,409,76,1,4,0,2,1,2
1168501,113,19,1900,2,male,1634,407,233,1,9,0,5,1,4
1493086,14,17,1999,11,male,311,391,353,1,0,1,0,0,0
1177501,15,14,1998,5,male,284,382,258,1,0,1,0,0,0
2186482,22,31,1991,5,female,231,385,337,1,0,1,0,0,0
1286158,25,20,1988,4,male,293,395,362,1,0,1,0,0,0
1257860,26,23,1987,9,female,530,407,300,1,0,1,0,0,0
1156058,26,14,1987,9,male,292,397,363,1,0,1,0,0,0
1909742,31,4,1982,2,female,280,399,120,1,0,1,0,0,0
1100461,23,25,1990,12,male,165,386,363,1,1,1,1,0,0
1175797,32,18,1981,12,male,559,386,340,1,1,1,0,0,1
1898335,14,14,1999,7,female,227,390,270,1,11,1,9,0,2
1871429,15,3,1998,1,female,613,407,156,1,27,1,18,0,9
1593632,18,11,1995,4,male,375,387,254,1,3,1,3,0,0
2037519,19,27,1994,6,male,1583,393,274,1,2,1,2,0,0
1497191,19,1,1994,6,male,270,405,290,1,2,1,1,0,1
1631410,19,16,1994,9,female,606,387,325,1,57,1,53,0,4
1135448,20,30,1993,9,female,360,409,254,1,5,1,4,0,1
1482783,22,5,1991,6,male,613,382,206,1,14,1,10,0,4
1153131,23,8,1990,3,male,214,400,223,1,2,1,0,0,2
1083316,24,9,1989,5,male,323,387,219,1,4,1,3,0,1
1854740,24,27,1989,9,male,624,390,262,1,23,1,14,0,9
2070995,26,18,1987,9,male,1026,385,226,1,6,1,5,0,1
1174729,96,8,1917,9,male,1860,383,164,1,11,1,9,0,2
2019042,98,15,1915,12,female,351,397,189,1,3,1,1,0,2
2150695,103,31,1910,12,male,1142,391,303,1,6,1,6,0,0
2026238,18,2,1995,8,female,802,394,191,2,0,0,0,2,0
1710298,106,8,1907,6,male,1284,399,218,2,0,0,0,2,0
1040489,23,3,1990,1,male,503,407,371,2,5,0,2,2,3
2076514,23,30,1990,8,male,576,383,331,2,7,0,2,2,5
2037203,57,4,1956,9,male,536,406,244,2,285,0,84,2,201
1309980,17,15,1996,10,male,1037,401,337,2,0,1,0,1,0
1968785,44,29,1969,5,male,1560,397,137,2,0,1,0,1,0
1876619,68,4,1945,1,female,1672,385,136,2,64,1,39,1,25
1309084,83,1,1930,1,male,1915,392,261,2,12,1,5,1,7
1933633,96,29,1917,1,female,1557,389,83,2,15,1,8,1,7
1369881,18,7,1995,8,male,246,386,247,2,0,2,0,0,0
1935432,21,15,1992,8,male,1492,393,188,2,0,2,0,0,0
1522719,31,18,1982,9,male,271,386,86,2,0,2,0,0,0
1620029,22,26,1991,6,male,226,392,38,2,1,2,1,0,0
1083519,20,27,1993,12,female,69,399,47,2,2,2,1,0,1
2182052,23,1,1990,10,male,1060,402,347,2,2,2,2,0,0
1824051,25,21,1988,12,male,189,399,285,2,2,2,2,0,0
1472379,53,5,1960,7,male,566,400,262,2,2,2,2,0,0
1778095,103,3,1910,10,male,1012,391,146,2,2,2,1,0,1
1237915,13,11,2000,1,female,260,393,322,2,9,2,4,0,5
1082252,15,23,1998,6,male,465,403,338,2,20,2,13,0,7
2091479,17,26,1996,12,male,185,401,330,2,28,2,12,0,16
2033749,17,29,1996,8,female,414,383,134,2,14,2,2,0,12
1300318,19,10,1994,11,male,715,397,301,2,9,2,8,0,1
1294615,19,9,1994,12,male,436,393,344,2,10,2,9,0,1
1480644,19,29,1994,12,female,73,387,31,2,15,2,10,0,5
1074454,18,20,1995,3,male,837,385,263,2,3,2,0,0,3
1192386,18,16,1995,5,female,397,407,284,2,3,2,3,0,0
1436584,19,16,1994,5,male,437,399,138,2,24,2,23,0,1
2044695,24,3,1989,2,female,34,407,11,2,18,2,15,0,3
1809162,38,29,1975,4,male,393,399,285,2,32,2,22,0,10
1714895,53,11,1960,9,male,346,407,240,2,4,2,3,0,1
1561141,57,10,1956,11,female,1474,396,266,2,5,2,4,0,1
2180910,108,9,1905,3,female,998,392,194,2,5,2,2,0,3
1910582,108,25,1905,5,female,1008,403,139,2,9,2,8,0,1
1996908,19,11,1994,12,male,491,388,232,3,1,0,1,3,0
1310827,32,21,1981,3,male,294,404,325,3,1,0,1,3,0
1278477,54,15,1959,9,female,1026,394,311,3,279,0,23,3,256
1462932,40,29,1973,1,male,846,383,337,3,0,2,0,1,0
1013311,22,6,1991,5,male,474,388,248,3,3,2,2,1,1
1581125,25,28,1988,9,female,152,384,284,3,134,2,80,1,54
1944887,18,3,1995,3,male,653,403,360,3,4,3,1,0,3
1946470,17,11,1996,9,female,596,405,234,3,12,3,11,0,1
1375550,21,11,1992,11,male,546,398,222,3,17,3,16,0,1
1354050,26,23,1987,12,female,421,386,235,3,35,3,32,0,3
1821051,33,10,1980,4,male,1028,396,260,3,18,3,16,0,2
1582003,103,1,1910,12,female,1129,395,174,3,20,3,18,0,2
1003211,15,15,1998,10,male,226,389,350,4,5,0,4,4,1
1594490,103,21,1910,2,male,1002,390,72,4,173,0,46,4,127
1069499,23,6,1990,2,female,569,386,262,4,0,2,0,2,0
1378434,61,28,1952,2,male,380,398,196,4,2,1,1,3,1
1378753,19,18,1994,5,male,279,392,212,4,21,1,14,3,7
2095805,19,1,1994,7,male,291,404,164,4,11,2,6,2,5
1996101,108,10,1905,8,male,1402,397,140,4,7,1,2,3,5
1538899,25,16,1988,12,male,234,399,394,4,0,4,0,0,0
1634420,25,12,1988,9,male,277,400,266,4,0,4,0,0,0
1879112,25,1,1988,1,male,660,395,290,4,1,4,1,0,0
1655694,14,7,1999,8,female,268,389,90,4,4,4,4,0,0
1060903,18,5,1995,12,male,180,395,332,4,3,4,3,0,0
1349232,18,18,1995,4,male,1115,402,340,4,40,4,35,0,5
1789712,24,8,1989,12,male,358,399,364,4,9,4,7,0,2
1409087,25,1,1988,1,male,133,389,370,4,6,4,4,0,2
2178444,25,7,1988,10,male,1646,394,193,4,8,4,8,0,0
1535003,34,10,1979,11,male,718,408,344,4,36,4,32,0,4
1949843,103,8,1910,5,female,826,392,198,4,11,4,7,0,4
1102615,108,29,1905,12,male,1459,385,123,4,6,4,5,0,1
1220396,15,6,1998,5,male,783,399,284,5,0,0,0,5,0
1011467,20,9,1993,2,male,338,402,260,5,3,0,0,5,3
2081143,25,18,1988,12,male,480,393,295,5,7,0,5,5,2
1614374,63,10,1950,1,male,1570,399,160,5,7,0,1,5,6
1064738,16,16,1997,2,male,273,390,251,5,0,4,0,1,0
1058569,17,20,1996,4,male,350,401,351,5,33,4,20,1,13
1478349,22,20,1991,3,male,539,388,209,5,0,5,0,0,0
1210766,21,25,1992,12,male,410,392,342,5,2,5,1,0,1
1882528,103,5,1910,5,female,989,386,90,5,3,5,3,0,0
2137912,108,5,1905,7,female,1485,386,149,5,3,5,3,0,0
1201254,19,23,1994,7,male,444,382,318,5,4,5,1,0,3
1392020,21,2,1992,12,male,534,398,335,5,6,5,3,0,3
2076346,17,23,1996,9,male,405,400,321,5,45,5,20,0,25
1547202,18,10,1995,9,male,91,400,376,5,17,5,10,0,7
1215342,20,27,1993,9,female,342,382,74,5,37,5,26,0,11
1498743,22,2,1991,6,male,299,397,346,5,24,5,18,0,6
1501583,23,5,1990,7,female,411,391,325,5,9,5,8,0,1
1291928,26,17,1987,8,male,332,384,272,5,20,5,18,0,2
2006702,26,4,1987,10,male,292,398,148,5,13,5,13,0,0
1421615,100,31,1913,1,male,842,391,336,5,45,5,35,0,10
1456551,108,20,1905,4,female,1208,388,23,5,13,5,6,0,7
1361290,20,2,1993,9,male,568,400,160,6,17,0,5,6,12
1626359,21,13,1992,8,male,808,386,120,6,16,4,10,2,6
2121847,34,8,1979,8,male,393,396,309,6,15,2,7,4,8
2186984,38,11,1975,9,female,997,395,266,6,0,6,0,0,0
1684816,19,2,1994,10,male,488,390,345,6,3,6,3,0,0
1345587,65,15,1948,11,female,891,384,150,6,5,6,5,0,0
1210157,14,10,1999,1,male,584,402,290,6,19,6,16,0,3
1738819,18,22,1995,11,male,499,382,292,6,19,6,18,0,1
1510916,18,29,1995,10,female,179,395,16,6,28,6,20,0,8
1162012,19,27,1994,2,male,242,409,326,6,90,6,74,0,16
1019165,19,31,1994,3,female,231,396,142,6,309,6,277,0,32
1314128,23,29,1990,12,male,568,388,5,6,20,6,13,0,7
1774315,23,22,1990,5,male,1194,395,312,6,25,6,17,0,8
1826921,23,15,1990,6,female,337,393,71,6,34,6,29,0,5
1186532,26,16,1987,7,male,612,392,208,6,557,6,447,0,110
1247494,27,2,1986,4,male,881,394,347,6,20,6,15,0,5
1015307,15,23,1998,12,female,297,385,15,7,4,0,3,7,1
1926424,19,8,1994,9,male,756,395,279,7,2,0,2,7,0
2180167,108,12,1905,7,female,1271,406,202,7,4,0,0,7,4
2001387,22,5,1991,8,male,588,382,318,7,3,4,2,3,1
1520601,25,14,1988,11,male,460,396,319,7,57,6,14,1,43
1468446,18,25,1995,12,male,518,385,337,7,5,7,5,0,0
1602888,43,3,1970,8,male,559,401,77,7,7,7,3,0,4
1737197,19,15,1994,6,male,329,405,246,7,19,7,9,0,10
2047255,24,27,1989,3,female,1419,398,39,7,25,7,9,0,16
1052387,103,9,1910,12,female,1112,395,108,7,24,7,22,0,2
1233327,108,6,1905,8,female,1836,385,158,7,196,7,149,0,47
1967937,21,19,1992,8,male,941,400,139,8,20,0,14,8,6
1906606,43,11,1970,4,male,607,382,279,8,2,5,0,3,2
1270873,84,29,1929,3,female,1911,384,201,8,1,7,1,1,0
1794690,26,15,1987,1,female,883,406,265,8,0,8,0,0,0
1559442,108,29,1905,4,female,1266,406,88,8,1,8,1,0,0
1220330,103,4,1910,8,male,492,397,349,8,4,8,4,0,0
1154765,16,1,1997,1,male,557,404,308,8,7,8,6,0,1
1838356,109,11,1904,9,male,1458,383,173,8,8,8,6,0,2
1150532,21,13,1992,8,male,374,408,349,8,32,8,31,0,1
1564450,34,12,1979,3,male,708,402,183,8,85,8,42,0,43
1236719,45,18,1968,4,male,2088,385,238,8,14,8,11,0,3
1029443,53,5,1960,4,female,227,404,141,8,91,8,72,0,19
1040462,108,5,1905,5,male,2229,398,161,8,14,8,12,0,2
1117343,26,4,1987,3,male,430,407,377,9,0,0,0,9,0
1296933,58,31,1955,1,male,1163,384,300,9,0,0,0,9,0
1401517,55,2,1958,5,female,328,391,305,9,4,0,0,9,4
1077415,16,27,1997,8,male,374,401,243,9,23,0,13,9,10
1255786,15,17,1998,11,male,123,402,266,9,131,6,58,3,73
1140291,108,21,1905,4,male,1030,384,168,9,45,6,34,3,11
1881913,14,28,1999,10,female,306,384,117,9,69,8,29,1,40
1737825,35,29,1978,11,male,493,382,242,9,4,9,4,0,0
1592212,16,18,1997,2,male,521,389,166,9,11,9,3,0,8
2023116,18,10,1995,1,male,406,382,238,9,167,9,100,0,67
2016187,18,10,1995,6,female,381,400,231,9,40,9,15,0,25
1615921,17,25,1996,7,male,587,404,217,10,0,0,0,10,0
2133380,17,8,1996,8,male,475,394,303,10,3,0,2,10,1
2159391,15,21,1998,12,female,329,399,308,10,14,1,10,9,4
1483111,21,12,1992,9,male,518,396,295,10,15,7,14,3,1
1073121,48,5,1965,3,male,823,382,123,10,39,5,14,5,25
1224417,23,25,1990,5,male,1481,383,108,10,23,10,10,0,13
1634076,20,3,1993,12,male,360,398,280,11,3,0,1,11,2
1806629,19,8,1994,8,male,234,402,336,11,3,1,1,10,2
1354325,18,25,1995,12,male,1103,393,318,11,7,4,2,7,5
1497424,39,13,1974,11,male,1571,402,166,11,28,7,22,4,6
1048935,19,7,1994,12,female,428,386,22,11,271,10,186,1,85
1476217,68,14,1945,5,male,415,407,269,11,1,11,1,0,0
1642907,60,24,1953,9,female,659,403,192,11,3,11,3,0,0
2186374,83,8,1930,12,male,760,384,300,11,2,11,0,0,2
1987248,108,12,1905,7,male,1099,408,227,11,5,11,3,0,2
1097862,17,23,1996,9,female,205,394,122,11,53,11,50,0,3
1101732,24,6,1989,6,male,789,389,307,12,2,0,0,12,2
1080184,63,14,1950,2,male,808,392,211,12,12,1,7,11,5
1687041,21,17,1992,5,male,160,385,311,12,98,12,83,0,15
1255897,23,22,1990,2,male,1248,407,165,12,32,12,27,0,5
1250806,23,28,1990,9,male,57,405,393,12,42,12,42,0,0
1550125,17,21,1996,10,female,310,382,263,13,3,0,2,13,1
1203063,14,8,1999,7,female,300,399,130,13,9,4,1,9,8
1182879,22,4,1991,2,male,643,383,122,13,26,4,16,9,10
1279151,28,10,1985,12,female,654,394,235,13,17,10,14,3,3
1960097,15,17,1998,3,male,565,405,322,13,0,13,0,0,0
1030172,16,25,1997,6,male,632,404,364,13,1,13,1,0,0
1655654,18,9,1995,8,female,261,386,119,13,9,13,9,0,0
1188985,18,19,1995,12,female,204,383,37,13,23,13,22,0,1
1921350,24,31,1989,1,female,777,394,280,13,27,13,23,0,4
2161240,43,25,1970,3,male,863,384,243,13,27,13,16,0,11
1935421,20,3,1993,5,male,649,399,272,14,19,12,2,2,17
2174888,68,27,1945,12,male,1347,400,282,14,6,14,6,0,0
1469279,23,10,1990,10,male,963,405,330,14,14,14,13,0,1
1910097,16,29,1997,6,female,425,409,186,14,32,14,28,0,4
1408233,18,2,1995,8,female,537,386,259,14,40,14,36,0,4
2145994,23,6,1990,5,male,459,404,300,14,75,14,31,0,44
1588737,28,4,1985,11,male,684,404,129,14,77,14,69,0,8
2052390,108,28,1905,1,female,1327,399,230,14,30,14,14,0,16
1645110,19,10,1994,4,female,449,391,253,15,5,0,0,15,5
1836955,18,13,1995,3,female,423,389,298,15,18,8,7,7,11
1537246,61,15,1952,9,female,1706,403,203,15,6,15,1,0,5
1736715,49,25,1964,3,female,1117,396,206,15,10,15,6,0,4
1514188,102,3,1911,3,male,2139,401,248,15,20,15,18,0,2
1021283,18,29,1995,8,male,568,391,339,16,0,0,0,16,0
1789346,25,17,1988,2,male,258,387,216,16,10,0,4,16,6
1083208,23,1,1990,6,female,572,388,344,16,16,10,7,6,9
1105797,14,16,1999,6,male,106,403,369,16,6,13,2,3,4
1839092,26,1,1987,1,male,335,403,147,16,11,14,10,2,1
1173316,108,21,1905,7,female,683,390,316,16,10,16,4,0,6
1931144,103,3,1910,5,female,2430,407,196,17,13,4,8,13,5
1822639,107,18,1906,6,male,1946,407,264,18,6,0,5,18,1
1166083,23,16,1990,1,female,525,402,126,18,201,2,96,16,105
1609322,15,6,1998,4,male,511,386,231,18,13,4,10,14,3
1567223,15,11,1998,1,male,283,407,227,18,58,17,29,1,29
1625148,30,21,1983,4,male,254,392,293,18,27,16,19,2,8
1607311,16,23,1997,3,male,760,396,176,18,11,18,11,0,0
1404393,16,16,1997,6,female,410,403,200,18,13,18,2,0,11
1790271,20,11,1993,3,male,92,402,400,18,19,18,19,0,0
2079519,24,25,1989,8,male,1556,407,144,18,37,18,33,0,4
1008884,94,20,1919,10,female,209,402,82,18,52,18,27,0,25
1941640,55,29,1958,10,male,594,399,199,19,1,0,0,19,1
1257737,16,9,1997,9,male,427,406,351,19,8,4,5,15,3
1569809,69,3,1944,5,female,1274,389,147,19,1,19,1,0,0
1839193,18,6,1995,1,male,890,400,287,19,4,19,1,0,3
1239413,25,13,1988,11,male,1487,384,102,19,13,19,5,0,8
1639248,16,4,1997,10,male,297,398,188,19,32,19,23,0,9
1333104,108,28,1905,2,male,851,390,174,19,44,19,42,0,2
2167377,16,5,1997,7,male,292,389,276,20,13,9,13,11,0
1362927,103,1,1910,1,male,2018,402,308,20,19,19,7,1,12
1778162,33,5,1980,5,male,457,401,284,20,306,17,276,3,30
1051111,17,17,1996,3,male,171,382,81,20,3,20,3,0,0
2189669,25,18,1988,12,female,638,382,162,20,61,20,57,0,4
1568548,18,20,1995,2,female,894,386,183,21,60,17,47,4,13
1620668,108,10,1905,4,female,2296,405,197,21,41,17,24,4,17
1133721,22,21,1991,4,female,561,397,209,21,21,21,15,0,6
1714161,18,7,1995,10,female,905,386,157,21,91,21,76,0,15
1584493,14,11,1999,8,female,377,400,274,22,3,0,1,22,2
1130411,15,11,1998,9,male,321,400,305,22,29,3,5,19,24
1659396,19,29,1994,8,female,432,392,145,22,48,0,16,22,32
1827264,101,5,1912,4,male,2026,388,293,22,8,21,6,1,2
1577434,17,27,1996,3,male,119,396,197,22,112,18,41,4,71
1348205,79,19,1934,1,female,1619,402,248,22,17,22,15,0,2
2054931,16,7,1997,7,female,429,388,210,22,52,22,45,0,7
1788677,21,10,1992,6,male,425,396,188,22,38,22,35,0,3
1324392,23,26,1990,7,female,845,399,180,22,85,22,68,0,17
1601643,58,3,1955,4,male,990,401,256,22,49,22,45,0,4
1881007,19,17,1994,8,male,379,402,278,23,3,0,1,23,2
1656839,15,11,1998,5,male,343,386,156,23,173,0,83,23,90
1786934,21,6,1992,12,male,1816,401,248,23,1,16,0,7,1
1432914,18,4,1995,11,male,385,405,232,23,9,14,7,9,2
1082026,15,22,1998,5,male,661,388,225,23,0,23,0,0,0
1759035,33,16,1980,12,female,1437,386,220,23,35,23,12,0,23
1702770,22,16,1991,8,male,534,401,196,24,3,0,2,24,1
1577006,48,10,1965,1,female,477,386,265,24,51,1,12,23,39
2091406,58,8,1955,8,male,1644,382,207,24,20,14,13,10,7
1495812,23,14,1990,2,female,549,406,222,24,185,12,64,12,121
1010181,15,25,1998,2,male,959,398,184,24,119,22,81,2,38
1863533,17,3,1996,5,male,602,390,290,24,1,24,0,0,1
1353611,21,4,1992,3,female,1124,384,199,24,40,24,33,0,7
1893184,20,10,1993,10,male,735,384,207,25,24,1,2,24,22
1619561,28,26,1985,2,male,394,395,315,26,74,0,26,26,48
1295061,20,17,1993,11,female,1142,407,186,26,24,18,9,8,15
1526556,108,4,1905,1,male,1486,393,208,26,20,18,8,8,12
1227464,16,17,1997,11,female,361,390,140,26,2,26,2,0,0
2001900,15,23,1998,3,female,593,406,164,27,17,0,6,27,11
1217567,23,9,1990,9,female,1393,386,107,27,51,7,25,20,26
1268390,108,5,1905,8,female,115,395,211,27,17,27,14,0,3
1851301,53,20,1960,7,male,1487,388,73,27,44,27,34,0,10
2064966,65,29,1948,12,female,1597,386,28,28,101,0,27,28,74
1465846,17,9,1996,10,female,456,383,247,28,91,16,62,12,29
1346896,24,8,1989,9,male,572,405,310,28,6,28,6,0,0
1605790,108,13,1905,9,female,1688,382,181,28,39,28,30,0,9
1683659,20,22,1993,5,male,481,409,292,29,42,0,17,29,25
1351897,24,16,1989,6,male,495,395,272,29,143,6,126,23,17
1290841,15,2,1998,4,female,354,393,357,29,7,29,1,0,6
1240927,15,27,1998,4,female,64,399,36,29,195,29,184,0,11
2018225,19,26,1994,6,female,447,396,72,29,280,29,175,0,105
1095095,23,3,1990,3,male,592,391,292,30,16,17,10,13,6
1577888,16,22,1997,3,female,51,401,285,31,107,13,64,18,43
1920275,20,26,1993,9,male,353,399,222,31,89,28,34,3,55
1500345,20,18,1993,3,male,985,384,238,31,4,31,2,0,2
1893755,16,20,1997,6,female,276,399,355,31,21,31,14,0,7
1359843,18,3,1995,9,female,207,388,273,30,51,30,41,0,10
2026885,22,12,1991,1,male,271,405,373,30,151,30,46,0,105
1787305,41,12,1972,8,male,246,403,83,30,108,30,103,0,5
1328140,44,16,1969,1,female,1169,391,167,30,51,30,43,0,8
1817823,18,15,1995,6,male,323,401,271,32,4,0,1,32,3
1694088,66,5,1947,3,male,654,399,270,32,135,0,32,32,103
2050913,33,18,1980,12,male,1293,401,117,32,25,7,10,25,15
1249235,16,19,1997,12,male,613,393,256,32,18,32,9,0,9
1664073,70,14,1943,1,NA,1849,402,210,32,6,32,4,0,2
1785894,22,18,1991,9,male,531,388,265,32,31,32,28,0,3
2105638,26,12,1987,10,male,329,408,268,33,10,0,0,33,10
1684444,30,29,1983,9,male,1369,401,124,33,2,16,0,17,2
1547405,25,30,1988,5,male,1345,396,255,33,54,12,23,21,31
1434989,19,29,1994,5,male,868,407,246,33,29,31,14,2,15
2012585,99,28,1914,3,male,272,409,279,33,74,30,53,3,21
1795987,15,4,1998,8,female,252,392,73,34,128,4,60,30,68
1003430,20,1,1993,12,male,1377,409,176,34,9,21,8,13,1
1223239,93,30,1920,1,male,1787,397,260,34,92,10,30,24,62
1851321,19,6,1994,4,female,357,399,189,34,101,34,99,0,2
1981055,20,2,1993,7,male,436,387,274,34,236,34,183,0,53
1777435,23,4,1990,4,female,1433,384,63,34,287,34,211,0,76
2085222,58,23,1955,11,female,224,396,298,35,39,0,4,35,35
1254517,67,19,1946,7,female,1834,398,210,36,297,8,68,28,229
1411413,34,19,1979,8,female,1302,386,166,35,97,29,86,6,11
1093581,32,23,1981,2,male,339,386,292,35,12,35,12,0,0
2054387,103,13,1910,1,male,871,382,255,35,14,35,6,0,8
1202666,20,27,1993,5,female,207,407,56,35,23,35,16,0,7
2182911,24,16,1989,7,female,354,401,168,36,154,36,98,0,56
1594517,45,21,1968,9,female,996,407,217,35,95,35,71,0,24
1268041,20,2,1993,8,male,535,393,233,37,10,1,1,36,9
1700689,22,8,1991,2,male,1062,383,219,37,39,18,28,19,11
1684502,68,8,1945,8,male,1491,384,192,37,16,37,9,0,7
1773094,23,13,1990,1,female,319,387,259,37,57,37,47,0,10
1801403,85,29,1928,7,male,721,396,295,37,108,37,62,0,46
1107269,65,23,1948,5,male,408,400,315,38,11,0,3,38,8
1359618,64,9,1949,10,male,832,384,332,38,195,10,115,28,80
2115797,20,3,1993,12,female,961,384,132,39,59,39,26,0,33
1314956,21,7,1992,7,female,609,385,315,38,116,38,87,0,29
2110485,23,21,1990,9,male,288,407,308,38,123,38,96,0,27
1720847,60,9,1953,12,female,2334,395,231,40,61,2,33,38,28
1464256,18,7,1995,5,male,181,391,354,42,1,0,1,42,0
1552773,27,4,1986,6,male,834,385,219,41,9,0,0,41,9
1823355,89,5,1924,3,male,595,399,327,41,8,29,2,12,6
1123271,103,8,1910,3,female,1948,407,221,41,8,13,5,28,3
1884625,16,2,1997,9,female,665,389,138,42,87,29,58,13,29
1737405,18,23,1995,1,male,521,386,266,42,62,31,47,11,15
1726835,19,21,1994,3,male,664,389,323,41,24,41,17,0,7
1206757,20,8,1993,7,male,417,403,247,44,37,37,33,7,4
1434155,15,27,1998,11,male,426,390,231,43,115,41,93,2,22
2156581,93,31,1920,1,female,911,388,228,43,74,38,56,5,18
1183498,18,27,1995,3,male,252,384,343,44,0,44,0,0,0
2149288,15,13,1998,1,female,743,401,198,43,14,43,7,0,7
1618076,23,3,1990,5,female,744,398,213,44,128,44,83,0,45
1871594,46,11,1967,4,male,897,399,156,44,221,44,189,0,32
1813133,18,11,1995,11,male,874,408,229,45,22,13,9,32,13
1855438,19,1,1994,10,male,575,408,184,45,51,23,16,22,35
1735456,34,14,1979,2,female,286,391,324,45,17,43,15,2,2
1782228,19,18,1994,10,male,462,401,274,45,77,45,64,0,13
1987494,15,16,1998,12,male,290,383,327,47,7,36,6,11,1
1377183,16,19,1997,4,female,463,397,270,47,50,47,26,0,24
1111996,18,19,1995,9,male,641,389,135,48,7,15,5,33,2
2078912,17,6,1996,9,male,631,401,328,49,33,12,15,37,18
1411049,15,6,1998,10,male,267,406,175,49,45,39,21,10,24
1637558,18,28,1995,9,female,300,405,209,48,55,45,44,3,11
1486313,51,23,1962,1,female,1713,405,217,49,45,42,37,7,8
1812024,22,21,1991,2,male,255,400,243,49,217,44,80,5,137
1673550,20,2,1993,10,male,462,395,293,48,16,48,16,0,0
2011537,30,6,1983,12,male,637,396,335,48,56,48,40,0,16
1144203,53,22,1960,8,male,1016,399,274,48,39,48,36,0,3
1678594,108,8,1905,2,female,312,398,163,48,104,48,100,0,4
1985871,103,25,1910,1,male,2019,408,138,51,7,0,3,51,4
1188340,17,20,1996,4,male,491,405,335,50,10,0,8,50,2
1552789,15,23,1998,11,male,482,382,309,50,44,3,13,47,31
1506038,108,2,1905,8,male,1462,384,246,50,60,6,17,44,43
1731039,85,11,1928,3,female,1747,399,224,51,78,0,14,51,64
1367340,13,1,2000,1,male,459,405,280,51,201,47,153,4,48
1803944,15,22,1998,7,female,309,407,276,51,286,51,204,0,82
1014709,20,26,1993,4,male,925,387,204,51,114,51,90,0,24
1330428,13,20,2000,3,male,161,401,191,53,30,7,17,46,13
2002378,108,5,1905,3,male,2008,407,190,52,29,4,19,48,10
2019019,18,5,1995,10,female,135,385,332,52,0,26,0,26,0
1178716,103,22,1910,12,female,808,387,188,53,22,18,8,35,14
1116934,23,11,1990,10,male,462,405,254,52,51,36,18,16,33
1273286,17,18,1996,2,male,377,397,295,52,91,34,54,18,37
1345026,19,27,1994,1,male,234,408,234,52,77,51,72,1,5
1139275,26,14,1987,3,male,478,387,285,52,14,52,9,0,5
1494379,32,8,1981,11,male,369,397,346,53,35,53,35,0,0
1383601,15,18,1998,11,female,31,395,61,53,1428,53,1104,0,324
1514091,15,31,1998,12,female,293,392,286,54,0,35,0,19,0
1351674,15,29,1998,10,male,223,406,300,55,42,54,34,1,8
2191557,22,29,1991,7,male,419,395,350,55,86,44,36,11,50
1391455,23,30,1990,7,male,233,389,342,55,83,53,68,2,15
2178554,15,1,1998,1,female,133,393,69,55,31,55,11,0,20
2050170,26,15,1987,9,male,422,388,231,54,85,54,58,0,27
1930279,51,25,1962,9,male,659,389,141,57,320,3,32,54,288
1878423,69,20,1944,5,female,696,384,210,56,7,40,2,16,5
1920845,18,20,1995,8,male,705,392,174,56,134,53,102,3,32
1233629,41,11,1972,12,male,1006,401,323,56,34,56,26,0,8
1190503,14,3,1999,2,female,252,391,82,57,107,57,97,0,10
1291942,21,1,1992,1,female,380,386,52,56,356,56,295,0,61
1064300,16,19,1997,11,female,519,389,266,60,67,59,56,1,11
2064463,16,4,1997,11,female,121,396,48,60,46,53,7,7,39
2003818,17,1,1996,5,male,832,387,172,60,66,59,57,1,9
1417792,27,31,1986,8,male,1611,391,158,59,30,59,12,0,18
1881025,103,6,1910,11,male,671,387,257,60,26,60,25,0,1
1148354,100,17,1913,3,male,582,382,331,59,46,59,44,0,2
2088801,18,15,1995,9,female,208,393,165,60,202,60,91,0,111
1840999,21,30,1992,9,female,352,390,173,59,170,59,90,0,80
1311877,55,30,1958,3,female,727,390,86,63,156,1,53,62,103
1467959,13,2,2000,5,male,228,396,291,62,8,17,3,45,5
2006905,108,10,1905,10,female,2234,383,186,62,82,41,58,21,24
1772728,113,12,1900,5,male,1276,398,135,63,88,61,47,2,41
1580828,18,5,1995,9,female,396,382,221,61,21,61,17,0,4
2094309,20,30,1993,11,male,330,398,251,62,78,62,68,0,10
1625354,21,14,1992,11,male,447,388,168,62,87,62,53,0,34
2055226,103,10,1910,1,male,989,397,254,63,47,63,43,0,4
1762085,103,15,1910,7,female,670,395,76,63,63,63,54,0,9
2121434,18,31,1995,3,female,158,387,263,61,128,61,112,0,16
1261862,20,2,1993,6,female,530,403,55,62,248,62,210,0,38
1706592,28,12,1985,12,female,618,392,305,63,561,63,382,0,179
1846844,45,17,1968,4,female,2264,398,202,61,104,61,91,0,13
1137006,15,12,1998,7,female,364,407,312,65,3,65,3,0,0
1165373,28,16,1985,7,male,330,393,369,64,22,64,17,0,5
1258851,17,31,1996,5,male,336,389,288,65,61,65,12,0,49
1039675,23,12,1990,9,female,620,409,202,65,73,65,61,0,12
2123181,25,6,1988,11,female,719,399,133,65,68,65,53,0,15
1192003,16,24,1997,12,female,457,398,94,67,85,12,67,55,18
1195140,30,10,1983,10,male,1388,395,142,68,2099,17,847,51,1252
1629923,24,15,1989,12,male,377,397,296,68,21,61,10,7,11
1680761,16,20,1997,11,male,171,383,73,68,69,68,35,0,34
1820630,18,31,1995,12,male,400,408,393,69,17,2,10,67,7
1516876,24,15,1989,7,male,385,397,256,71,16,35,10,36,6
1880076,16,1,1997,3,female,518,408,110,70,168,15,125,55,43
1213986,17,8,1996,4,female,26,403,79,71,32,62,15,9,17
1550998,22,29,1991,5,female,1178,395,176,70,92,66,75,4,17
1543167,63,28,1950,1,male,536,405,50,72,30,0,5,72,25
1263626,108,12,1905,5,female,1405,403,188,73,118,12,82,61,36
1093893,103,22,1910,4,male,1097,385,249,72,1,49,0,23,1
1634478,65,25,1948,7,male,606,401,305,74,20,19,5,55,15
1562024,25,23,1988,4,male,523,385,35,72,28,72,10,0,18
1839954,29,15,1984,10,female,668,394,112,75,110,32,68,43,42
1455038,18,1,1995,11,male,82,385,324,77,695,77,464,0,231
1629049,16,26,1997,8,female,346,387,287,80,18,4,8,76,10
1728877,20,4,1993,1,female,383,403,329,79,33,11,25,68,8
1529021,50,28,1963,8,female,565,389,197,79,125,3,32,76,93
1965872,18,12,1995,11,female,208,402,210,79,141,50,48,29,93
1797145,19,13,1994,12,female,779,400,188,80,219,30,100,50,119
2013309,108,13,1905,10,male,1535,386,230,80,32,63,10,17,22
1092083,113,29,1900,9,male,1154,382,250,80,39,78,32,2,7
1193694,17,1,1996,4,female,317,399,248,80,122,79,76,1,46
1690252,53,10,1960,6,male,1428,393,132,78,37,78,17,0,20
2049366,21,17,1992,3,male,563,394,297,79,59,79,42,0,17
1815930,21,14,1992,11,female,243,400,103,78,193,78,164,0,29
2192150,17,28,1996,5,male,548,386,285,84,4,0,1,84,3
1645924,15,14,1998,12,female,829,387,187,84,96,41,32,43,64
1194262,54,16,1959,1,male,801,390,38,82,140,81,69,1,71
1176524,17,27,1996,5,male,397,388,172,84,24,84,24,0,0
1342360,107,3,1906,5,female,547,394,219,83,30,83,27,0,3
1810857,21,23,1992,10,female,415,389,245,83,201,83,191,0,10
2110614,113,23,1900,3,female,1299,402,110,84,144,84,91,0,53
1735615,19,9,1994,5,male,299,409,370,87,17,10,10,77,7
1498379,31,28,1982,9,male,1323,390,292,86,137,64,96,22,41
1909744,20,14,1993,6,male,378,388,302,86,47,86,42,0,5
1607364,32,19,1981,7,male,693,384,323,87,26,87,26,0,0
1499303,68,10,1945,8,male,411,392,328,87,16,87,16,0,0
1477297,19,5,1994,10,male,214,406,157,85,138,85,90,0,48
2064429,17,12,1996,7,male,463,402,344,88,29,1,7,87,22
1785760,18,18,1995,3,female,639,408,247,88,12,49,10,39,2
1303784,16,20,1997,1,female,85,382,131,89,243,28,233,61,10
1636296,20,13,1993,5,male,336,404,297,91,141,81,54,10,87
1235910,17,13,1996,9,male,666,388,252,92,33,2,11,90,22
1789111,16,11,1997,11,male,276,402,288,92,137,25,73,67,64
1645359,23,8,1990,11,female,1266,403,144,93,116,30,53,63,63
1090695,62,17,1951,10,female,1595,405,284,94,167,62,76,32,91
1963654,108,27,1905,7,male,1131,406,204,95,166,48,116,47,50
1564919,25,3,1988,2,male,298,394,180,95,139,70,69,25,70
1910680,103,5,1910,7,male,677,395,316,94,10,94,6,0,4
1347045,21,1,1992,1,male,386,388,225,92,39,92,18,0,21
1836319,21,7,1992,5,male,520,392,273,95,18,95,14,0,4
1778559,23,20,1990,3,female,363,408,242,97,88,30,34,67,54
1899128,21,1,1992,7,female,559,398,169,97,189,41,38,56,151
1455422,19,26,1994,9,male,473,401,300,97,119,87,48,10,71
1312978,19,3,1994,9,female,389,397,299,99,294,75,102,24,192
2066938,24,1,1989,5,male,662,406,145,97,102,97,85,0,17
1432626,93,24,1920,4,female,2279,398,195,99,125,99,104,0,21
1423659,108,16,1905,2,female,1053,393,120,98,126,98,123,0,3
1397508,15,3,1998,12,female,273,408,76,100,23,0,10,100,13
1566310,26,19,1987,3,male,1401,386,223,102,174,9,65,93,109
1810812,30,27,1983,11,male,357,384,286,100,100,28,37,72,63
1690002,18,3,1995,4,male,290,385,262,101,48,101,23,0,25
1099006,74,16,1939,7,female,836,396,158,103,40,103,34,0,6
1157790,19,29,1994,11,male,431,401,317,101,72,101,69,0,3
1054267,21,6,1992,7,female,401,409,311,104,198,104,189,0,9
1059658,63,25,1950,12,male,651,383,221,109,33,0,13,109,20
1427823,16,7,1997,11,female,246,407,275,106,47,48,16,58,31
1270255,34,5,1979,10,female,1459,390,235,107,104,53,82,54,22
1916074,29,7,1984,6,male,586,392,294,108,647,102,513,6,134
1570712,26,21,1987,8,male,575,396,311,109,27,109,27,0,0
1630143,18,20,1995,5,female,336,384,67,107,105,107,82,0,23
1691396,94,11,1919,5,female,2321,388,214,108,171,108,131,0,40
1244352,70,10,1943,4,male,760,383,298,111,56,0,38,111,18
1017725,20,5,1993,3,male,661,395,228,111,81,0,13,111,68
1651347,30,19,1983,8,female,1218,382,253,111,298,16,204,95,94
1557753,20,22,1993,4,male,552,396,308,111,92,61,24,50,68
1562601,33,14,1980,1,female,573,402,176,112,118,73,31,39,87
1867411,15,31,1998,8,male,1016,402,215,113,32,111,30,2,2
1820758,23,9,1990,2,female,1435,385,257,110,69,106,38,4,31
1663500,14,6,1999,10,female,62,408,87,111,169,109,154,2,15
1237143,15,17,1998,2,male,596,393,219,111,60,111,60,0,0
1804562,68,8,1945,8,female,596,386,119,113,109,113,91,0,18
1917002,103,7,1910,9,female,129,404,97,110,130,110,117,0,13
2065172,18,6,1995,7,female,70,405,94,113,173,113,159,0,14
2105489,19,10,1994,10,male,421,396,287,117,103,32,12,85,91
1868891,19,28,1994,12,female,559,398,144,116,4,116,4,0,0
1952575,18,11,1995,4,female,417,407,232,117,71,117,68,0,3
1537938,28,20,1985,8,male,435,391,308,115,37,115,28,0,9
2175202,23,11,1990,3,female,415,388,287,117,146,117,137,0,9
1113372,92,12,1921,6,male,1014,396,105,124,122,0,45,124,77
1466067,106,17,1907,11,male,1776,401,161,123,134,10,33,113,101
1750695,17,29,1996,6,female,25,406,175,122,286,59,154,63,132
1780904,53,6,1960,7,female,1344,393,208,121,276,81,181,40,95
1331120,19,3,1994,3,male,434,405,355,121,1,121,1,0,0
1815844,39,23,1974,8,female,475,383,353,120,253,120,172,0,81
1260066,17,31,1996,5,male,1025,396,259,130,10,1,4,129,6
1216987,20,5,1993,10,male,552,409,174,126,48,11,16,115,32
1843540,102,11,1911,10,male,2305,402,161,129,55,50,9,79,46
1833735,18,18,1995,12,male,573,389,223,125,131,45,61,80,70
1125210,83,27,1930,5,male,183,385,275,129,18,129,14,0,4
1676120,21,21,1992,1,male,157,404,235,125,58,125,11,0,47
2081983,22,17,1991,6,female,185,393,301,125,160,125,118,0,42
1926711,23,2,1990,1,male,250,408,328,130,148,130,107,0,41
1739748,26,22,1987,5,female,1093,399,75,125,158,125,131,0,27
1986739,22,29,1991,7,female,1737,386,210,128,276,128,214,0,62
1159992,104,23,1909,3,female,337,408,367,132,20,0,10,132,10
1030610,14,12,1999,4,female,308,404,333,136,73,79,57,57,16
1176374,103,13,1910,10,male,754,400,242,131,47,58,21,73,26
1946916,32,13,1981,4,male,153,387,361,134,407,58,366,76,41
1466219,18,16,1995,10,female,393,391,52,131,69,96,53,35,16
1394899,106,15,1907,11,male,1387,396,235,132,7,132,1,0,6
1202986,103,9,1910,10,female,717,406,259,136,45,136,40,0,5
1823303,32,27,1981,11,male,792,387,330,134,276,134,214,0,62
1944963,105,29,1908,2,female,2107,384,143,139,43,19,17,120,26
2064195,16,16,1997,9,male,503,385,278,141,21,64,12,77,9
1977366,18,29,1995,12,female,480,390,151,141,67,80,9,61,58
1103102,103,31,1910,5,female,1759,404,186,137,55,81,31,56,24
1206986,32,20,1981,8,female,852,398,229,139,96,93,45,46,51
1292962,26,25,1987,3,female,115,403,306,142,345,90,247,52,98
1498465,19,22,1994,12,female,445,388,275,138,54,111,17,27,37
1547503,19,27,1994,5,male,221,383,245,140,75,107,32,33,43
1900098,18,9,1995,2,male,325,406,332,137,185,129,111,8,74
1380215,28,14,1985,5,male,504,407,324,143,184,139,70,4,114
1907132,32,24,1981,10,male,480,383,168,141,193,130,133,11,60
1520272,47,30,1966,4,male,1774,400,221,143,483,113,259,30,224
1108043,14,12,1999,3,female,404,399,223,139,62,139,14,0,48
1263378,26,28,1987,8,female,299,409,349,140,107,140,102,0,5
1371064,18,14,1995,8,female,111,385,186,140,613,140,413,0,200
1920662,18,6,1995,9,male,356,392,359,147,31,3,23,144,8
1863835,48,7,1965,9,female,887,397,176,148,102,1,11,147,91
1501208,95,16,1918,2,male,1146,394,188,144,138,17,96,127,42
1423777,18,8,1995,6,male,568,389,294,147,2,114,0,33,2
1242246,45,27,1968,5,female,743,389,120,145,509,113,146,32,363
1333233,23,16,1990,7,female,234,383,114,150,112,150,107,0,5
1390983,22,30,1991,1,female,440,396,139,147,223,147,172,0,51
1111287,38,12,1975,9,male,401,401,304,150,408,150,252,0,156
1828357,16,16,1997,8,male,401,390,357,155,64,0,16,155,48
1031498,88,15,1925,11,male,1148,393,144,155,39,18,9,137,30
2085229,90,16,1923,5,male,1667,409,164,155,97,9,34,146,63
1907778,101,23,1912,10,female,1482,386,208,155,244,3,55,152,189
2131495,18,21,1995,3,female,388,384,182,156,61,100,18,56,43
1528400,93,8,1920,1,female,315,388,228,154,61,105,30,49,31
1833651,19,13,1994,11,male,271,393,255,151,158,151,78,0,80
1289129,18,29,1995,10,female,445,390,201,157,199,157,149,0,50
1731286,66,2,1947,4,female,1686,382,185,151,307,151,169,0,138
1961683,23,3,1990,1,male,291,388,298,159,318,25,123,134,195
1227288,17,4,1996,7,male,347,392,317,159,2,59,1,100,1
1724544,18,31,1995,3,male,236,388,276,163,48,64,21,99,27
1599893,19,23,1994,2,female,484,404,33,159,335,33,83,126,252
1595416,18,27,1995,5,male,455,407,352,164,24,152,19,12,5
2100125,28,3,1985,9,male,352,402,305,158,71,158,43,0,28
1612329,48,14,1965,2,female,1134,392,312,158,55,158,43,0,12
2107866,19,1,1994,1,male,348,400,357,165,105,0,45,165,60
2034323,42,17,1971,6,female,750,406,215,170,660,0,124,170,536
1226878,15,3,1998,2,female,410,404,217,167,406,94,276,73,130
1341286,19,30,1994,10,female,811,397,316,170,206,164,120,6,86
2170172,14,18,1999,2,female,382,404,222,167,55,167,34,0,21
1283447,20,19,1993,9,female,354,394,238,169,102,169,28,0,74
1652635,18,17,1995,3,female,325,391,168,167,164,167,133,0,31
1799355,14,21,1999,2,male,335,399,130,180,102,91,49,89,53
1966034,22,27,1991,9,female,271,398,287,181,596,85,224,96,372
1961262,22,31,1991,5,female,301,398,359,179,188,138,15,41,173
1408635,20,20,1993,6,female,255,396,296,174,293,143,122,31,171
1953369,19,21,1994,12,male,457,409,363,176,86,176,68,0,18
1472734,29,17,1984,9,male,924,401,321,180,55,180,47,0,8
1286321,16,21,1997,10,male,518,406,327,186,32,116,16,70,16
1529599,21,10,1992,10,female,1344,404,202,182,657,89,234,93,423
1444522,17,18,1996,11,male,381,405,367,190,63,184,38,6,25
1572874,58,14,1955,3,female,2133,409,228,187,379,141,280,46,99
1690688,18,3,1995,9,female,500,406,187,184,206,184,169,0,37
1129165,18,5,1995,10,male,381,407,300,186,685,186,515,0,170
2192850,18,12,1995,2,female,186,385,111,196,76,10,14,186,62
2078716,60,16,1953,12,female,1762,406,244,191,193,99,101,92,92
1076027,16,4,1997,4,female,659,386,167,196,145,186,59,10,86
1127938,16,12,1997,9,female,691,393,170,197,283,164,176,33,107
2031260,18,19,1995,2,female,497,390,215,200,253,149,62,51,191
1363732,93,6,1920,9,female,1520,405,92,194,79,194,62,0,17
2086589,30,6,1983,6,male,1295,398,223,199,234,199,130,0,104
1369817,54,17,1959,10,female,1818,405,267,206,106,110,75,96,31
1387993,16,27,1997,4,male,112,404,381,209,148,201,86,8,62
1963798,23,15,1990,7,female,1535,391,202,204,207,187,143,17,64
1757253,24,3,1989,7,male,644,386,320,201,188,183,118,18,70
1692568,26,8,1987,3,female,509,390,289,204,347,151,274,53,73
1752082,104,14,1909,1,female,1465,408,182,213,241,29,107,184,134
1505694,14,18,1999,12,male,318,391,274,218,156,209,31,9,125
2159809,19,4,1994,5,female,572,406,77,217,176,214,98,3,78
1449773,103,27,1910,9,female,2194,389,274,217,235,213,191,4,44
2117852,18,3,1995,11,female,551,399,191,216,379,186,117,30,262
1546254,108,1,1905,12,male,775,397,179,216,58,214,30,2,28
1435910,106,9,1907,12,female,1293,397,129,219,134,217,57,2,77
1320252,13,1,2000,1,male,607,384,198,218,124,218,94,0,30
1024769,32,9,1981,3,male,213,407,355,219,129,219,105,0,24
1941250,20,13,1993,8,female,350,394,246,214,271,214,227,0,44
1863881,19,27,1994,12,female,120,385,350,220,681,220,659,0,22
1965892,15,3,1998,11,female,624,400,295,227,170,79,156,148,14
2041580,103,4,1910,2,male,943,399,188,232,127,180,104,52,23
2079372,105,25,1908,4,male,187,387,211,227,89,195,73,32,16
2066894,16,22,1997,12,female,243,393,252,233,327,217,207,16,120
1680446,18,11,1995,3,female,465,391,159,227,240,167,168,60,72
1178611,32,26,1981,5,female,1274,392,265,231,264,203,226,28,38
2159347,46,11,1967,8,female,701,405,260,232,212,218,173,14,39
1289323,21,8,1992,10,female,292,398,113,229,473,179,318,50,155
1276847,44,4,1969,9,male,766,383,137,229,352,219,177,10,175
1383852,23,4,1990,12,male,277,391,308,222,429,222,357,0,72
1559546,98,17,1915,6,male,1645,393,292,244,152,0,59,244,93
1787947,31,11,1982,3,female,1039,407,259,238,614,64,313,174,301
1023926,18,2,1995,9,male,231,398,225,243,143,228,134,15,9
1012143,13,15,2000,1,female,175,402,239,241,61,241,60,0,1
1915608,25,5,1988,2,female,381,385,334,246,139,246,108,0,31
1572113,53,25,1960,10,male,1533,383,343,240,143,240,136,0,7
1348364,17,20,1996,3,female,918,397,207,242,272,242,195,0,77
1650994,27,2,1986,4,female,170,401,270,249,220,0,153,249,67
1138655,108,22,1905,9,female,2050,383,135,256,223,21,131,235,92
2083960,14,21,1999,7,male,430,402,318,260,5,145,1,115,4
1540427,67,9,1946,6,male,180,386,314,254,77,233,19,21,58
1785037,25,6,1988,11,female,163,409,77,260,469,249,343,11,126
1489122,24,5,1989,9,male,694,404,356,247,43,247,41,0,2
1639230,56,21,1957,2,female,623,393,202,260,247,260,207,0,40
2115568,68,13,1945,7,female,538,394,216,252,644,252,571,0,73
1229169,18,13,1995,8,male,649,389,321,265,95,52,27,213,68
2015120,16,6,1997,5,male,542,392,186,270,361,0,72,270,289
2096046,61,23,1952,10,female,1517,382,282,268,185,40,71,228,114
1814884,20,28,1993,12,female,516,386,239,268,534,0,122,268,412
1139015,108,13,1905,12,male,1121,406,223,266,14,141,6,125,8
1019064,19,28,1994,7,male,217,396,281,266,230,138,184,128,46
1909661,39,28,1974,4,male,2170,401,201,265,476,187,407,78,69
1394445,30,15,1983,6,female,838,401,198,268,400,232,186,36,214
1282382,38,11,1975,12,female,967,390,104,266,306,249,140,17,166
1317946,17,20,1996,5,female,56,403,101,274,727,252,472,22,255
1669180,22,25,1991,6,male,319,391,302,265,497,197,228,68,269
1197476,97,26,1916,9,female,1489,382,156,272,82,272,45,0,37
1769699,19,24,1994,11,female,495,386,310,263,185,263,122,0,63
2072348,19,2,1994,6,female,658,387,102,263,187,263,141,0,46
1891411,20,10,1993,1,male,879,395,130,263,355,263,331,0,24
1656198,41,7,1972,3,male,420,389,241,261,237,261,185,0,52
1578638,16,30,1997,1,female,106,408,373,273,917,273,885,0,32
1483504,55,18,1958,12,female,796,382,333,280,99,0,50,280,49
2090615,68,28,1945,8,male,1053,387,223,290,130,290,115,0,15
1035510,103,3,1910,11,male,895,401,268,302,365,2,57,300,308
1654557,39,3,1974,11,female,375,408,320,298,62,184,34,114,28
1548747,20,1,1993,2,male,514,392,308,307,32,224,18,83,14
2001446,17,28,1996,3,female,1187,400,183,294,102,279,93,15,9
1041880,27,16,1986,3,male,767,391,299,306,324,266,301,40,23
2024515,33,11,1980,12,male,367,386,370,300,239,300,219,0,20
1810178,103,28,1910,1,female,587,384,181,303,1168,303,1055,0,113
2100986,14,8,1999,8,male,244,401,158,325,6,106,1,219,5
1081336,16,22,1997,3,female,309,396,268,314,337,204,241,110,96
1141611,19,4,1994,10,female,386,396,353,325,372,158,161,167,211
1358379,23,3,1990,12,female,686,402,210,315,420,166,261,149,159
1361128,52,29,1961,6,female,2026,396,247,310,544,207,376,103,168
1969826,18,11,1995,8,female,1195,384,243,318,198,310,104,8,94
1286162,100,3,1913,9,male,540,385,191,325,74,325,72,0,2
1795218,108,16,1905,2,female,441,382,166,316,163,316,160,0,3
1948079,21,31,1992,8,female,214,396,248,314,270,314,154,0,116
1813712,54,4,1959,7,male,462,397,329,326,236,326,135,0,101
1747569,21,15,1992,9,female,840,388,219,328,185,303,101,25,84
1543827,19,10,1994,4,female,324,406,255,333,263,295,112,38,151
1958481,19,18,1994,7,female,415,389,260,344,456,317,322,27,134
2098024,22,12,1991,7,female,1091,403,264,342,240,323,209,19,31
1295522,37,3,1976,11,female,2345,406,278,337,329,317,158,20,171
1136393,54,9,1959,8,male,673,398,322,338,365,316,225,22,140
1863725,22,24,1991,2,female,135,390,317,342,573,323,195,19,378
1676028,108,3,1905,11,female,1244,403,273,331,421,329,290,2,131
1235976,32,8,1981,1,male,307,402,340,333,536,330,494,3,42
1961334,19,8,1994,11,male,459,409,365,336,88,336,82,0,6
1807498,20,10,1993,8,female,406,399,106,338,171,338,125,0,46
1336454,37,25,1976,11,female,630,402,331,343,148,343,123,0,25
1772899,21,2,1992,11,female,495,398,296,342,402,342,306,0,96
2163934,56,11,1957,10,female,1075,400,97,336,522,336,201,0,321
1972272,49,31,1964,10,female,197,398,291,366,190,16,63,350,127
1560362,44,25,1969,5,female,1579,394,232,348,552,11,270,337,282
1534364,17,16,1996,3,female,644,383,205,351,120,76,83,275,37
1527043,14,20,1999,8,male,350,397,275,353,178,287,74,66,104
1701711,20,28,1993,2,female,425,393,74,354,77,324,52,30,25
1114953,98,1,1915,1,male,1288,407,344,356,213,327,103,29,110
1754327,18,27,1995,6,male,739,382,341,353,510,259,378,94,132
1851062,19,14,1994,3,female,658,404,248,367,402,337,162,30,240
1317258,25,13,1988,10,female,286,394,206,369,424,368,217,1,207
1205100,14,13,1999,10,female,346,398,305,347,130,347,117,0,13
1317739,24,16,1989,5,female,593,390,277,356,232,356,138,0,94
1862353,52,30,1961,3,female,931,403,229,368,369,368,80,0,289
1984249,21,12,1992,5,female,593,395,290,384,272,249,115,135,157
1481883,53,20,1960,3,male,1193,403,149,383,310,82,241,301,69
2164309,21,1,1992,2,female,73,395,314,377,660,225,326,152,334
1221929,86,12,1927,10,female,2315,382,180,383,231,350,195,33,36
1505859,18,16,1995,5,female,216,405,239,374,764,303,277,71,487
1473011,21,25,1992,11,male,525,382,319,375,53,375,47,0,6
1112435,21,17,1992,12,female,468,383,242,379,189,379,184,0,5
1105527,20,13,1993,11,female,654,384,240,395,387,282,202,113,185
1322292,26,15,1987,8,female,905,399,173,420,534,260,207,160,327
1136525,14,13,1999,3,female,79,407,138,404,214,379,165,25,49
1229425,15,7,1998,3,female,326,403,126,414,150,409,61,5,89
1943481,18,17,1995,4,female,239,390,161,421,392,409,342,12,50
1397169,48,16,1965,12,female,1243,388,311,410,395,380,163,30,232
1989369,15,18,1998,5,female,563,392,224,403,388,399,254,4,134
1047359,26,25,1987,2,female,553,402,230,404,177,404,141,0,36
1576766,68,13,1945,9,male,1407,401,165,413,198,413,179,0,19
1156877,46,15,1967,2,female,359,389,309,424,161,3,57,421,104
1544011,14,6,1999,4,female,726,407,194,422,222,244,91,178,131
2152861,16,6,1997,2,female,254,386,270,425,591,259,355,166,236
1493207,18,20,1995,10,male,134,386,149,434,592,98,249,336,343
1060378,23,10,1990,12,female,799,401,144,431,531,310,278,121,253
1537068,18,10,1995,11,male,562,394,322,438,298,361,226,77,72
1054710,52,28,1961,1,female,1244,409,94,450,387,439,249,11,138
1930713,20,20,1993,6,female,616,393,199,450,127,450,122,0,5
1463442,28,2,1985,10,female,2592,387,285,428,237,428,211,0,26
2050111,101,4,1912,5,male,792,396,346,426,155,426,150,0,5
1359056,49,14,1964,7,female,981,407,93,426,360,426,159,0,201
1492197,108,6,1905,1,male,1340,385,271,471,270,0,165,471,105
1268434,18,7,1995,7,male,511,401,95,483,134,213,80,270,54
1483886,53,27,1960,11,female,1815,406,211,454,281,113,170,341,111
1313136,24,17,1989,7,female,553,390,240,459,343,353,200,106,143
1045094,33,11,1980,8,female,1317,386,296,476,629,378,463,98,166
1415540,24,23,1989,1,female,890,390,235,481,552,481,493,0,59
1498413,24,13,1989,8,female,603,392,175,469,608,469,262,0,346
1521165,51,31,1962,3,female,1722,391,316,465,452,465,331,0,121
1951151,15,6,1998,10,female,309,404,225,502,588,4,76,498,512
1502535,27,4,1986,3,male,1333,404,323,510,463,108,198,402,265
1897585,18,1,1995,10,female,626,387,263,516,160,506,138,10,22
1733157,23,17,1990,3,female,667,387,259,488,153,445,41,43,112
1587692,20,7,1993,7,female,1142,404,288,514,151,514,116,0,35
2110633,25,16,1988,4,male,588,387,343,488,134,488,122,0,12
1555506,23,4,1990,7,male,361,401,316,543,170,0,115,543,55
1120483,27,22,1986,1,female,670,400,232,529,440,81,198,448,242
1173755,29,31,1984,7,male,777,399,260,523,140,319,122,204,18
1575264,28,12,1985,6,female,1081,404,260,533,343,266,237,267,106
1376917,35,23,1978,11,female,2161,399,341,539,532,309,148,230,384
1679380,20,22,1993,9,female,1500,409,278,555,215,423,122,132,93
1285558,34,12,1979,10,female,1637,390,206,520,475,395,186,125,289
1906007,18,14,1995,6,female,590,403,198,524,1705,493,718,31,987
1667841,15,1,1998,12,female,100,406,294,549,804,547,762,2,42
1550597,20,18,1993,10,male,553,385,237,557,351,552,294,5,57
1141430,17,26,1996,5,male,351,402,342,550,53,550,36,0,17
2149476,21,2,1992,7,female,365,401,250,526,339,526,277,0,62
1093887,108,11,1905,9,male,1714,408,232,535,372,535,250,0,122
2128278,41,23,1972,1,female,757,405,336,593,472,209,291,384,181
1449761,27,21,1986,6,female,304,401,274,588,1810,260,571,328,1239
1480551,37,17,1976,10,female,119,393,144,586,931,279,302,307,629
1356388,22,13,1991,9,male,332,404,233,567,761,553,612,14,149
1629157,21,28,1992,10,female,543,389,228,563,3679,444,2780,119,899
1412999,23,23,1990,11,female,1353,406,206,588,996,514,577,74,419
1890201,17,15,1996,7,female,457,397,247,571,177,571,154,0,23
1839110,37,3,1976,4,male,717,398,235,601,362,601,277,0,85
2162906,14,21,1999,8,female,296,403,310,619,266,94,56,525,210
2095145,19,24,1994,1,female,357,400,108,611,287,121,125,490,162
1639924,14,8,1999,6,female,290,391,85,617,144,422,82,195,62
1564859,16,12,1997,1,female,363,406,310,635,693,456,429,179,264
1139097,17,4,1996,9,male,593,409,275,645,102,603,96,42,6
1310648,15,18,1998,2,female,346,408,283,642,303,568,157,74,146
1320852,30,11,1983,7,female,419,389,325,657,175,650,86,7,89
1607994,31,1,1982,4,female,276,397,286,621,366,519,285,102,81
1796380,19,25,1994,11,female,1709,406,250,636,425,593,268,43,157
1491970,20,14,1993,3,female,459,384,179,612,1194,608,987,4,207
1994186,18,1,1995,12,male,600,382,234,652,91,652,89,0,2
1217850,18,26,1995,7,female,132,386,306,660,384,660,344,0,40
1068026,25,14,1988,8,female,93,399,259,611,527,611,457,0,70
1517306,26,2,1987,1,male,601,408,360,624,1042,624,986,0,56
2116066,18,18,1995,8,male,220,389,289,703,411,46,203,657,208
1028464,19,12,1994,3,female,1769,396,272,698,333,195,227,503,106
1733280,45,29,1968,10,female,283,384,141,685,655,157,170,528,485
2128529,18,31,1995,12,female,474,409,322,691,109,554,61,137,48
1868572,17,30,1996,10,male,119,400,331,692,267,560,121,132,146
1915099,22,19,1991,11,female,485,388,242,703,383,678,264,25,119
1875969,61,18,1952,5,female,854,395,129,695,167,632,69,63,98
1422997,33,10,1980,4,female,1782,386,258,726,444,672,369,54,75
1152207,22,10,1991,10,female,680,404,293,676,150,675,145,1,5
1624022,29,24,1984,10,female,780,401,36,668,732,667,504,1,228
2120628,31,29,1982,7,female,600,393,290,715,549,715,403,0,146
1015192,35,17,1978,2,female,142,382,262,724,777,724,662,0,115
1113686,48,18,1965,11,male,350,387,44,785,100,0,10,785,90
1802986,16,6,1997,7,male,243,409,228,728,323,1,210,727,113
1190172,108,6,1905,4,male,1187,398,199,771,381,85,279,686,102
1174067,23,13,1990,8,female,553,399,362,741,242,318,152,423,90
2018879,24,5,1989,4,female,1205,397,206,753,216,210,137,543,79
1769944,100,15,1913,12,female,936,393,245,794,378,515,298,279,80
1048543,23,16,1990,11,male,1658,382,193,730,647,388,471,342,176
1409141,26,20,1987,12,male,683,408,203,729,510,374,303,355,207
1885408,18,24,1995,1,female,469,407,37,788,203,774,156,14,47
1649905,35,28,1978,4,female,1026,385,275,727,588,543,169,184,419
1094732,41,15,1972,10,female,1247,405,144,730,1123,671,547,59,576
1221526,24,14,1989,8,female,311,407,327,794,290,793,127,1,163
1206965,26,14,1987,10,female,514,383,271,757,242,750,156,7,86
1569081,19,9,1994,10,male,238,389,347,781,69,781,48,0,21
1930036,47,14,1966,4,female,541,383,207,775,61,775,52,0,9
1921693,20,16,1993,3,female,217,402,89,775,1101,775,801,0,300
1200153,32,20,1981,2,female,494,382,276,794,683,794,636,0,47
1470589,48,8,1965,6,female,1193,391,311,750,819,750,359,0,460
1578063,59,12,1954,5,female,1775,406,298,847,355,73,104,774,251
1513625,51,27,1962,10,female,126,396,279,819,634,76,293,743,341
1610612,23,3,1990,12,male,468,385,282,809,165,572,121,237,44
1920789,25,30,1988,3,female,306,404,217,848,387,186,133,662,254
1066079,17,14,1996,9,female,677,394,170,852,816,285,362,567,454
1223554,31,27,1982,9,female,772,388,230,826,719,561,235,265,484
1228100,14,30,1999,10,male,554,408,287,813,265,747,201,66,64
1779872,29,12,1984,5,female,446,397,325,830,173,821,144,9,29
1606549,17,11,1996,4,female,261,400,108,821,506,600,224,221,282
1413935,24,22,1989,9,female,566,386,153,816,548,615,135,201,413
1324387,17,21,1996,2,female,194,398,227,854,297,854,291,0,6
1126219,39,16,1974,8,female,285,399,326,857,252,857,188,0,64
1128267,45,11,1968,9,female,112,387,340,835,341,835,229,0,112
1265245,22,26,1991,2,female,334,388,360,849,1116,849,947,0,169
1366054,36,9,1977,11,female,749,388,127,797,1475,797,896,0,579
1210014,55,7,1958,2,female,2019,384,274,816,1256,816,1078,0,178
1423839,108,24,1905,6,male,1136,396,253,921,6,140,1,781,5
1830212,18,27,1995,9,female,1029,387,227,933,1028,446,591,487,437
1488285,56,29,1957,3,female,1944,407,240,958,893,489,414,469,479
1855917,17,19,1996,4,female,211,384,249,923,306,880,144,43,162
1943828,19,16,1994,4,male,362,402,164,926,307,925,273,1,34
1348610,28,13,1985,7,female,1509,407,159,961,437,956,290,5,147
1608465,77,18,1936,5,male,141,408,365,891,450,891,386,0,64
1422578,21,21,1992,7,female,662,391,278,1054,276,191,98,863,178
1556202,53,25,1960,4,female,1250,390,95,992,331,197,112,795,219
1441800,15,23,1998,8,female,198,394,262,1100,755,108,256,992,499
1062248,108,1,1905,4,male,102,403,329,1071,1467,0,210,1071,1257
1267863,62,15,1951,9,female,1180,407,143,987,118,451,63,536,55
1386662,49,6,1964,8,female,1523,405,233,1015,410,579,168,436,242
1388001,28,27,1985,5,male,203,394,332,1045,1051,224,453,821,598
1875649,16,25,1997,12,female,290,394,138,1103,730,1002,406,101,324
1351549,16,24,1997,4,male,626,387,191,1066,2168,822,1392,244,776
1899407,20,11,1993,6,female,887,406,257,1018,1955,987,1542,31,413
1653079,21,8,1992,3,male,625,384,247,1091,387,1090,352,1,35
1948675,31,2,1982,11,female,292,404,134,1063,380,1063,351,0,29
1633952,18,10,1995,8,female,391,388,286,1026,682,1026,473,0,209
1954039,90,3,1923,3,male,1724,400,359,1026,1030,1026,611,0,419
1200619,14,20,1999,3,female,419,386,283,1153,431,134,135,1019,296
1630943,16,3,1997,3,female,487,384,275,1247,1209,124,665,1123,544
1687197,21,10,1992,9,male,1460,384,250,1214,776,71,264,1143,512
1383452,20,2,1993,6,female,502,401,233,1197,657,856,263,341,394
1864764,15,4,1998,12,female,766,401,252,1163,850,574,506,589,344
1674438,43,8,1970,4,female,1402,400,157,1265,827,704,483,561,344
1959359,20,17,1993,6,female,1368,406,184,1235,3524,905,1757,330,1767
1867020,17,17,1996,2,female,141,389,92,1135,719,1130,520,5,199
1455276,27,26,1986,6,female,467,404,151,1252,1040,1249,962,3,78
2048503,36,20,1977,3,female,887,384,175,1252,609,1252,512,0,97
1740016,42,4,1971,5,male,599,400,232,1171,1190,1171,855,0,335
1605722,60,21,1953,12,male,1830,393,176,1444,786,13,353,1431,433
1413169,95,15,1918,12,male,1249,405,292,1299,324,3,60,1296,264
1531773,14,26,1999,2,male,668,404,248,1406,1067,215,556,1191,511
1522520,103,11,1910,10,male,1487,405,162,1355,848,129,253,1226,595
1486256,63,4,1950,10,female,1018,401,239,1501,375,332,90,1169,285
1944689,23,7,1990,8,male,107,401,205,1359,992,363,597,996,395
1561452,21,26,1992,7,female,267,399,120,1471,2263,339,962,1132,1301
1494038,18,1,1995,9,female,445,391,107,1416,738,1084,354,332,384
2102587,110,17,1903,6,female,1244,406,319,1340,468,1300,295,40,173
1563965,50,13,1963,12,female,2218,403,245,1357,1823,1330,699,27,1124
1741068,50,25,1963,6,female,53,395,344,1333,740,1332,369,1,371
1448587,19,12,1994,10,female,376,387,204,1443,1620,1441,1247,2,373
1816824,23,13,1990,3,female,183,407,319,1471,1442,1469,1062,2,380
2131538,16,12,1997,12,female,927,397,247,1385,279,1385,163,0,116
1551575,16,13,1997,5,female,482,383,262,1513,316,1513,154,0,162
1565795,21,10,1992,10,female,360,401,113,1337,937,1337,830,0,107
2015135,23,2,1990,11,female,119,387,338,1364,1402,1364,1254,0,148
1814374,23,15,1990,8,male,602,396,345,1823,684,619,201,1204,483
1588393,25,12,1988,12,female,528,391,217,1770,736,735,389,1035,347
1954672,25,5,1988,10,female,1435,389,239,1638,835,487,381,1151,454
1813482,31,29,1982,9,female,1870,401,261,1563,2004,512,740,1051,1264
1854845,57,4,1956,8,female,1817,397,200,1719,1524,617,931,1102,593
1320205,34,23,1979,9,female,520,399,284,1608,947,1170,647,438,300
1018731,16,24,1997,7,female,650,408,257,1719,658,1708,216,11,442
1766727,16,1,1997,8,female,206,408,218,1737,1480,1724,845,13,635
1568016,20,26,1993,6,female,181,408,192,1788,309,1788,280,0,29
2176202,14,3,1999,2,female,466,388,228,2199,1318,1559,695,640,623
1025905,17,19,1996,5,female,98,402,273,2336,2447,1943,2046,393,401
1570726,17,24,1996,7,female,476,400,168,2180,2645,1985,2228,195,417
1414607,45,7,1968,1,female,776,409,101,2143,2960,2099,1584,44,1376
1815453,27,2,1986,3,female,197,401,327,2264,1110,2242,587,22,523
1872154,16,22,1997,12,male,270,386,157,1892,1970,1890,1913,2,57
1659344,108,5,1905,4,male,2033,383,120,2323,248,2323,213,0,35
1625407,30,24,1983,12,male,381,408,322,2355,519,2355,469,0,50
1501856,20,2,1993,11,female,219,383,242,2044,1268,2044,957,0,311
1968628,21,8,1992,8,female,101,403,37,2275,5499,2275,5049,0,450
1534257,31,19,1982,10,female,417,384,305,3526,3700,647,1241,2879,2459
1235576,21,15,1992,3,female,475,386,251,2763,704,1327,318,1436,386
1735038,47,19,1966,5,female,1334,382,114,2919,1667,1425,701,1494,966
1869492,42,17,1971,7,female,1897,395,146,2959,4182,1427,2951,1532,1231
1638924,19,3,1994,10,male,36,389,316,3071,1195,2947,302,124,893
2044856,45,16,1968,5,female,695,407,336,3136,1404,2840,878,296,526
1995930,14,22,1999,2,female,260,399,150,3497,3422,3194,1266,303,2156
1752426,20,3,1993,2,male,337,385,227,2757,1328,2754,1110,3,218
2104307,21,1,1992,3,male,530,391,102,3102,1126,3101,338,1,788
1627451,19,13,1994,10,female,118,388,280,2761,4131,2748,3859,13,272
1565655,44,12,1969,8,female,184,389,324,3089,2427,3088,1268,1,1159
2189292,93,18,1920,5,male,829,392,292,2465,903,2465,738,0,165
2114638,25,24,1988,9,male,303,405,269,3138,1962,3138,1650,0,312
1562291,53,2,1960,4,male,635,400,319,5211,52,282,2,4929,50
1452943,62,8,1951,3,female,1280,384,223,4849,9607,0,1411,4849,8196
1767504,14,25,1999,6,female,31,387,318,3924,1145,1160,504,2764,641
1986013,17,27,1996,5,female,379,399,206,5216,1384,1147,898,4069,486
1316302,53,9,1960,12,female,1651,393,234,5238,5032,2841,1142,2397,3890
1351830,21,18,1992,9,female,491,383,230,5185,1257,5052,935,133,322
1688058,27,7,1986,11,female,494,388,269,5016,2052,4957,1565,59,487
1752803,28,13,1985,9,female,890,403,142,4123,933,3915,391,208,542
1257530,17,1,1996,4,female,294,408,109,3750,2938,3106,2003,644,935
1747227,29,6,1984,11,female,598,394,98,4366,5808,3795,2115,571,3693
1530572,47,25,1966,7,male,320,408,261,4831,7725,4778,5537,53,2188
1937130,17,28,1996,8,female,209,398,290,4877,1553,4871,1015,6,538
1030328,16,30,1997,1,female,452,403,201,4501,4091,4486,3274,15,817
1515932,47,19,1966,6,male,33,385,356,4539,1811,4539,1490,0,321
1283471,24,28,1989,8,male,373,386,207,7815,5489,7815,938,0,4551
1996635,13,7,2000,1,male,199,418,360,0,8,0,5,0,3
1484103,15,11,1998,11,male,364,437,379,0,2,0,0,0,2
1811626,14,8,1999,2,male,287,426,376,0,0,0,0,0,0
1793284,14,27,1999,5,female,207,415,193,0,9,0,9,0,0
2178897,15,8,1998,3,female,480,418,272,0,0,0,0,0,0
1732479,15,16,1998,8,male,667,438,391,0,0,0,0,0,0
1843807,15,3,1998,10,female,119,419,301,0,0,0,0,0,0
1698548,17,3,1996,12,female,254,425,120,0,10,0,7,0,3
1540018,16,15,1997,3,male,483,439,400,0,0,0,0,0,0
1226327,16,2,1997,5,male,446,421,407,0,1,0,1,0,0
2167851,16,1,1997,6,male,480,421,151,0,0,0,0,0,0
2038002,16,10,1997,7,male,395,436,313,0,36,0,2,0,34
1918854,17,18,1996,8,male,516,422,334,0,0,0,0,0,0
2153135,17,16,1996,10,male,592,424,332,0,0,0,0,0,0
1544043,17,2,1996,10,male,292,427,252,0,0,0,0,0,0
1870186,18,24,1995,1,male,694,435,368,0,2,0,2,0,0
2099888,18,3,1995,1,male,296,430,89,0,10,0,8,0,2
1339838,18,5,1995,3,male,475,418,376,0,0,0,0,0,0
2138599,18,8,1995,4,male,419,425,220,0,0,0,0,0,0
1938024,18,20,1995,4,male,148,411,393,0,0,0,0,0,0
2151168,18,11,1995,7,male,720,418,310,0,0,0,0,0,0
1130248,18,28,1995,8,female,639,421,344,0,0,0,0,0,0
2038900,18,18,1995,10,male,1223,436,301,0,0,0,0,0,0
1994977,18,5,1995,10,male,717,421,227,0,2,0,1,0,1
1302188,18,25,1995,10,male,200,422,151,0,1,0,1,0,0
2010688,19,4,1994,1,male,623,428,363,0,0,0,0,0,0
1506104,19,24,1994,3,male,495,417,311,0,0,0,0,0,0
1519219,19,19,1994,3,male,309,422,407,0,11,0,11,0,0
1138741,19,12,1994,4,male,1158,438,114,0,3,0,1,0,2
1561247,19,25,1994,9,female,652,410,246,0,0,0,0,0,0
1923416,20,31,1993,8,male,406,415,354,0,5,0,5,0,0
1460530,21,23,1992,1,male,513,436,388,0,11,0,4,0,7
1843353,21,12,1992,2,male,669,423,188,0,2,0,2,0,0
1402656,21,4,1992,2,male,650,429,290,0,1,0,1,0,0
1763348,21,8,1992,10,male,825,435,185,0,1,0,0,0,1
1683268,22,25,1991,1,female,504,416,256,0,0,0,0,0,0
1737989,22,9,1991,3,male,1388,437,246,0,0,0,0,0,0
1351065,22,20,1991,3,male,437,420,205,0,20,0,7,0,13
1383934,22,20,1991,6,male,342,426,380,0,191,0,70,0,121
1742811,22,1,1991,6,male,418,417,271,0,1,0,0,0,1
1292386,23,18,1990,1,female,851,431,114,0,1,0,1,0,0
2123161,23,1,1990,2,male,545,421,367,0,63,0,27,0,36
1358044,23,8,1990,4,male,324,436,365,0,0,0,0,0,0
1383782,23,1,1990,4,male,957,420,331,0,0,0,0,0,0
1292201,23,10,1990,10,female,383,416,150,0,0,0,0,0,0
1567974,24,12,1989,2,male,487,437,339,0,4,0,4,0,0
1904607,24,17,1989,5,male,436,414,347,0,0,0,0,0,0
2109112,26,29,1987,11,male,302,415,387,0,19,0,17,0,2
1118593,25,25,1988,1,male,1509,416,164,0,0,0,0,0,0
1308393,25,8,1988,8,male,1134,432,259,0,1,0,0,0,1
2107583,27,18,1986,12,male,655,411,116,0,0,0,0,0,0
2170410,26,12,1987,2,male,1200,418,253,0,3,0,0,0,3
1715386,26,29,1987,6,male,490,428,383,0,0,0,0,0,0
1489164,26,22,1987,9,male,1272,429,230,0,3,0,3,0,0
2129264,28,18,1985,11,male,619,422,330,0,1,0,1,0,0
1647631,29,31,1984,12,male,332,419,389,0,115,0,39,0,76
1540664,28,6,1985,6,female,50,426,17,0,3,0,2,0,1
1381818,30,8,1983,8,male,648,439,305,0,28,0,19,0,9
1255121,32,16,1981,11,male,1179,415,373,0,12,0,9,0,3
1968954,37,22,1976,7,female,910,418,267,0,0,0,0,0,0
1141624,53,29,1960,6,male,644,421,274,0,0,0,0,0,0
1131902,55,1,1958,1,male,794,433,49,0,3,0,1,0,2
1985838,63,29,1950,5,male,1539,429,298,0,0,0,0,0,0
1995558,68,20,1945,2,male,860,430,314,0,0,0,0,0,0
1888216,68,17,1945,8,male,331,432,268,0,0,0,0,0,0
1385489,86,29,1927,9,female,1119,437,179,0,6,0,3,0,3
1325223,93,9,1920,3,male,1528,423,230,0,11,0,5,0,6
1471168,103,5,1910,12,male,1436,414,388,0,0,0,0,0,0
1274679,103,11,1910,8,female,280,416,42,0,20,0,17,0,3
1673643,103,29,1910,9,male,1257,435,199,0,0,0,0,0,0
1600997,107,24,1906,10,male,1513,419,263,0,3,0,0,0,3
1661409,108,18,1905,6,male,1189,434,341,0,0,0,0,0,0
2038069,108,16,1905,6,female,749,420,173,0,0,0,0,0,0
1251285,108,20,1905,7,male,1357,427,155,0,1,0,1,0,0
1033213,108,7,1905,7,female,577,418,297,0,0,0,0,0,0
1388784,108,21,1905,10,male,1525,436,123,0,68,0,60,0,8
1530744,16,10,1997,1,female,421,410,386,1,6,0,4,1,2
1613388,18,14,1995,3,female,354,434,100,1,5,0,5,1,0
1506059,19,10,1994,9,female,211,412,65,1,5,0,3,1,2
1538091,22,10,1991,1,female,491,416,142,1,11,0,3,1,8
1576214,22,21,1991,6,male,552,432,349,1,30,0,20,1,10
1374346,22,6,1991,8,female,359,430,235,1,39,0,17,1,22
1967030,58,20,1955,5,male,679,416,257,1,22,0,22,1,0
1230768,22,1,1991,12,male,487,412,341,1,0,1,0,0,0
1856242,24,21,1989,9,male,816,426,312,1,0,1,0,0,0
2174925,49,11,1964,12,male,308,418,173,1,0,1,0,0,0
1554736,20,16,1993,4,male,570,430,266,1,1,1,0,0,1
1657374,20,5,1993,5,female,808,426,50,1,1,1,1,0,0
1701645,68,15,1945,4,male,486,414,308,1,1,1,0,0,1
1345823,14,8,1999,7,female,209,420,238,1,15,1,10,0,5
1839867,16,3,1997,5,male,400,439,313,1,9,1,8,0,1
1672478,18,10,1995,8,male,249,413,350,1,13,1,12,0,1
2186281,18,7,1995,10,female,349,414,237,1,3,1,1,0,2
1071341,19,27,1994,3,female,683,431,374,1,3,1,2,0,1
1527152,21,19,1992,1,male,302,426,371,1,3,1,3,0,0
1804276,23,29,1990,4,female,759,428,239,1,5,1,5,0,0
2029029,23,7,1990,5,male,672,431,384,1,12,1,9,0,3
2167318,24,2,1989,6,male,507,419,360,1,6,1,5,0,1
1614140,24,15,1989,7,female,405,435,80,1,11,1,10,0,1
1708016,26,27,1987,5,female,941,429,305,1,6,1,5,0,1
1379346,28,9,1985,4,male,599,421,373,1,13,1,11,0,2
1295619,30,26,1983,1,male,576,413,345,1,13,1,10,0,3
1325993,36,19,1977,11,male,1381,419,220,1,6,1,6,0,0
1592150,43,1,1970,1,male,783,434,277,1,16,1,9,0,7
1727864,55,24,1958,3,male,999,413,358,1,16,1,14,0,2
1229416,68,25,1945,1,female,1229,424,174,1,32,1,30,0,2
1630064,90,8,1923,4,male,1491,412,215,1,12,1,10,0,2
1191632,22,4,1991,2,male,480,413,369,2,1,0,1,2,0
1024575,33,16,1980,4,male,676,414,350,2,1,0,0,2,1
1008669,103,7,1910,2,female,921,412,98,2,1,0,0,2,1
1099031,17,31,1996,12,male,636,434,362,2,2,0,2,2,0
1041716,15,15,1998,9,male,224,415,88,2,3,0,1,2,2
1519431,19,17,1994,11,female,519,431,286,2,11,0,6,2,5
1581363,22,12,1991,2,male,451,413,51,2,3,0,1,2,2
1980155,22,15,1991,10,male,508,433,414,2,18,0,6,2,12
2039884,23,13,1990,10,male,326,435,358,2,6,0,1,2,5
1698989,15,18,1998,8,female,209,438,209,2,0,1,0,1,0
1709409,14,4,1999,10,male,280,431,302,2,33,1,27,1,6
1530287,17,11,1996,5,male,357,411,245,2,5,1,4,1,1
1654973,17,12,1996,6,male,734,434,324,2,29,1,15,1,14
1140246,18,12,1995,6,male,283,415,397,2,0,2,0,0,0
1719186,16,2,1997,6,male,477,424,310,2,1,2,1,0,0
1716806,81,28,1932,2,male,1524,425,213,2,1,2,1,0,0
1688277,16,18,1997,2,male,313,416,347,2,65,2,58,0,7
1983981,18,8,1995,6,male,372,439,387,2,9,2,6,0,3
1437597,18,10,1995,8,male,562,430,350,2,14,2,6,0,8
1812253,19,2,1994,2,male,442,440,364,2,17,2,13,0,4
1019429,19,18,1994,5,female,423,418,162,2,5,2,4,0,1
1472912,19,11,1994,10,female,620,433,305,2,5,2,5,0,0
1454764,19,23,1994,10,male,301,411,215,2,33,2,31,0,2
2002489,21,9,1992,5,male,876,425,224,2,4,2,3,0,1
1535010,22,1,1991,11,female,565,424,190,2,27,2,18,0,9
1759362,25,18,1988,4,female,812,420,256,2,4,2,3,0,1
1375731,28,4,1985,5,male,173,420,336,2,6,2,6,0,0
1802013,98,30,1915,5,male,325,438,179,2,7,2,7,0,0
1202754,108,21,1905,2,female,975,424,214,2,7,2,7,0,0
1554957,19,25,1994,12,male,660,411,139,3,0,0,0,3,0
1630825,55,6,1958,10,male,619,421,342,3,8,0,0,3,8
2141319,104,8,1909,5,male,1854,414,288,3,48,0,21,3,27
2150267,108,29,1905,1,female,1566,435,324,3,36,2,18,1,18
2190853,18,20,1995,12,male,515,434,312,3,0,3,0,0,0
1846451,23,2,1990,12,male,801,414,201,3,0,3,0,0,0
1423622,18,3,1995,7,male,72,430,399,3,3,3,3,0,0
1409781,14,24,1999,12,male,193,414,391,3,31,3,12,0,19
1257503,16,30,1997,12,female,662,433,241,3,13,3,12,0,1
1687992,16,10,1997,2,female,809,433,160,3,13,3,7,0,6
1289497,16,26,1997,2,male,285,440,314,3,5,3,4,0,1
1211306,16,3,1997,7,male,392,414,344,3,5,3,2,0,3
1136925,17,12,1996,6,male,584,428,334,3,19,3,6,0,13
1383688,19,24,1994,9,male,430,418,325,3,13,3,13,0,0
1413560,20,1,1993,1,male,821,423,144,3,11,3,8,0,3
1679174,21,18,1992,8,male,148,428,398,3,17,3,4,0,13
1158726,25,1,1988,1,male,216,412,387,3,10,3,8,0,2
1875570,25,12,1988,6,male,475,425,59,3,5,3,5,0,0
1168834,34,9,1979,4,male,1398,418,270,3,20,3,19,0,1
1951003,38,23,1975,3,female,539,415,305,3,13,3,13,0,0
1489272,74,28,1939,5,male,1303,416,342,3,5,3,2,0,3
2192987,85,27,1928,12,female,749,414,308,3,23,3,19,0,4
2084141,103,28,1910,12,female,1064,414,274,3,97,3,65,0,32
1489619,108,17,1905,8,male,1135,428,204,3,12,3,9,0,3
1159800,17,12,1996,2,male,208,414,348,4,0,0,0,4,0
1152544,13,4,2000,2,male,329,412,160,4,1,0,0,4,1
1281974,59,10,1954,12,male,1208,431,192,4,4,0,3,4,1
2022971,20,20,1993,3,male,758,428,270,4,2,4,2,0,0
1888755,14,8,1999,3,female,291,413,315,4,9,4,9,0,0
2187034,17,14,1996,2,female,286,414,197,4,46,4,18,0,28
2152694,18,3,1995,10,female,414,430,310,4,23,4,13,0,10
2044513,19,21,1994,10,male,608,434,337,4,23,4,22,0,1
1032567,20,5,1993,9,female,409,427,64,4,41,4,33,0,8
1751138,26,23,1987,11,female,1459,434,200,4,19,4,11,0,8
1071486,29,10,1984,11,male,588,435,378,4,73,4,58,0,15
1856757,31,3,1982,5,male,321,437,426,4,8,4,5,0,3
2107545,77,31,1936,3,male,1203,432,329,4,22,4,12,0,10
1362992,103,1,1910,2,male,1563,429,41,4,29,4,18,0,11
1918628,18,23,1995,4,male,221,432,390,5,2,0,1,5,1
1663924,19,8,1994,8,male,727,439,258,5,33,2,25,3,8
1365629,21,22,1992,10,male,990,439,259,5,26,2,13,3,13
1430889,28,3,1985,11,male,1307,414,330,5,19,3,4,2,15
1759911,29,15,1984,2,female,794,418,197,5,9,2,2,3,7
1510737,39,22,1974,6,male,1643,438,82,5,21,3,5,2,16
1288816,103,27,1910,8,male,1352,433,248,5,24,4,9,1,15
1444563,16,3,1997,3,female,1167,425,159,5,0,5,0,0,0
1519323,28,11,1985,7,male,502,423,367,5,2,5,2,0,0
1349767,108,14,1905,11,male,904,432,252,5,3,5,3,0,0
1618957,18,7,1995,5,female,480,410,343,5,25,5,17,0,8
1342022,18,28,1995,9,female,507,431,256,5,56,5,42,0,14
1135329,21,5,1992,12,male,396,425,332,5,27,5,9,0,18
1208566,22,11,1991,7,female,1502,423,201,5,21,5,6,0,15
2112836,23,10,1990,10,male,277,412,378,5,64,5,42,0,22
2083902,29,8,1984,6,male,528,423,280,5,30,5,22,0,8
1209624,68,24,1945,2,female,1033,436,364,5,16,5,11,0,5
1889596,113,2,1900,8,male,1257,421,223,5,119,5,54,0,65
1419503,18,2,1995,2,male,129,431,382,6,7,0,0,6,7
1287687,32,2,1981,5,male,932,431,223,6,8,0,4,6,4
1336542,19,8,1994,10,male,360,432,368,6,38,0,29,6,9
1871392,16,23,1997,7,female,549,427,246,6,60,5,49,1,11
1174734,14,28,1999,3,female,252,418,273,6,2,6,2,0,0
1963473,16,16,1997,6,male,677,438,390,6,4,6,4,0,0
1117839,18,13,1995,11,male,206,420,357,6,6,6,4,0,2
1924651,19,25,1994,8,male,371,436,327,6,8,6,6,0,2
1891710,18,13,1995,1,female,418,435,219,6,13,6,12,0,1
1714769,88,12,1925,5,male,1722,417,206,6,38,6,23,0,15
1966059,102,3,1911,5,female,384,421,107,6,19,6,11,0,8
1245825,108,28,1905,2,male,718,439,348,6,37,6,28,0,9
1477033,95,11,1918,9,male,776,433,345,7,0,1,0,6,0
1737152,17,28,1996,3,male,728,425,235,7,5,0,3,7,2
1908090,19,18,1994,5,male,195,413,283,7,21,3,4,4,17
1337013,18,11,1995,1,male,355,433,295,7,3,7,3,0,0
1640178,15,19,1998,10,male,164,410,357,7,36,7,26,0,10
1185922,17,22,1996,11,male,993,412,255,7,77,7,40,0,37
1047132,21,2,1992,2,male,353,417,338,7,12,7,9,0,3
1577636,31,11,1982,1,male,1122,431,339,7,13,7,13,0,0
1058590,52,1,1961,3,male,641,419,154,7,43,7,37,0,6
1739046,108,31,1905,10,female,1751,415,247,7,11,7,10,0,1
1058263,17,10,1996,3,male,769,413,228,8,0,1,0,7,0
1241277,23,1,1990,1,male,602,440,170,8,16,0,10,8,6
1856849,18,10,1995,5,female,231,423,353,8,6,4,6,4,0
1039156,32,8,1981,10,male,562,413,204,8,34,5,20,3,14
1025666,103,20,1910,11,male,412,415,308,8,1,6,0,2,1
1971648,15,1,1998,5,male,149,426,393,8,6,7,6,1,0
2025438,68,1,1945,1,male,1271,420,142,8,48,6,11,2,37
1770228,20,5,1993,10,male,161,423,302,8,7,8,4,0,3
1504055,16,26,1997,1,male,535,437,213,8,44,8,32,0,12
1485866,32,19,1981,6,male,540,440,287,8,184,8,115,0,69
1297474,16,2,1997,12,male,587,410,315,9,1,0,0,9,1
1696972,89,10,1924,11,male,1625,432,268,9,12,0,4,9,8
1399233,68,8,1945,10,male,945,435,292,9,25,5,17,4,8
1582267,22,10,1991,4,male,214,436,422,9,9,7,6,2,3
1487389,21,2,1992,7,male,410,423,266,9,0,9,0,0,0
1280097,15,16,1998,11,male,156,412,365,9,8,9,6,0,2
2079547,16,31,1997,10,female,460,439,284,9,7,9,5,0,2
1963185,17,1,1996,2,female,367,410,390,9,10,9,8,0,2
1080033,103,20,1910,8,male,1409,424,75,9,9,9,7,0,2
1033984,16,1,1997,10,male,335,428,395,9,36,9,14,0,22
1594531,19,14,1994,2,female,417,424,90,9,112,9,90,0,22
2051161,23,1,1990,6,male,239,437,384,9,45,9,26,0,19
2157715,25,6,1988,4,male,370,413,232,9,207,9,131,0,76
2024188,103,17,1910,3,male,716,416,344,9,41,9,41,0,0
1379983,22,5,1991,9,female,644,412,112,10,21,1,20,9,1
2076130,22,5,1991,11,female,334,419,225,10,8,2,3,8,5
1866030,38,4,1975,12,male,1583,422,272,10,38,6,8,4,30
1626536,20,14,1993,10,male,819,422,272,10,16,8,11,2,5
1726247,23,6,1990,3,male,807,434,222,10,1,10,1,0,0
1101371,20,27,1993,7,male,502,412,219,10,5,10,4,0,1
1886075,29,28,1984,8,male,1666,415,243,10,3,10,1,0,2
1894701,102,18,1911,2,male,1668,414,259,10,12,10,11,0,1
2175513,91,21,1922,1,female,1281,421,133,10,108,10,76,0,32
1765127,94,22,1919,8,female,758,430,90,10,23,10,21,0,2
1745168,19,9,1994,12,male,547,433,371,11,0,0,0,11,0
1562055,35,20,1978,7,male,409,420,399,11,0,0,0,11,0
1297131,75,8,1938,2,male,1362,428,142,11,0,9,0,2,0
1624611,15,27,1998,7,male,108,411,356,11,5,10,3,1,2
1594007,19,28,1994,8,male,375,411,393,11,5,11,4,0,1
2191329,103,30,1910,3,male,2235,440,308,12,3,6,3,6,0
1710535,21,13,1992,6,male,689,428,168,12,45,6,19,6,26
1054891,23,18,1990,10,male,474,422,331,12,43,3,14,9,29
1462960,27,18,1986,2,male,439,410,301,12,49,3,36,9,13
1903341,55,25,1958,4,female,1547,430,115,12,78,3,43,9,35
1197625,15,26,1998,3,female,368,423,298,12,3,12,2,0,1
1279856,16,28,1997,10,male,116,433,404,12,4,12,3,0,1
2052969,26,20,1987,9,male,1229,439,309,12,40,12,32,0,8
1781091,19,13,1994,6,male,1462,410,215,13,7,5,4,8,3
1927595,46,11,1967,1,male,525,437,327,13,12,5,4,8,8
1841094,15,6,1998,12,male,650,413,107,13,20,12,6,1,14
1055338,23,6,1990,9,female,1510,414,179,13,59,11,30,2,29
1676662,54,9,1959,6,male,139,414,128,13,26,11,11,2,15
1135585,18,9,1995,8,male,513,439,114,13,11,13,6,0,5
1200169,23,9,1990,2,male,636,429,399,13,8,13,8,0,0
2053050,23,27,1990,9,male,388,425,385,13,8,13,8,0,0
1710650,21,28,1992,10,female,508,428,248,13,75,13,66,0,9
1562641,19,8,1994,3,male,448,419,335,14,6,0,2,14,4
2040525,63,19,1950,7,female,837,434,230,14,148,0,28,14,120
1108056,91,10,1922,4,male,1583,429,246,14,18,5,17,9,1
1445670,20,13,1993,8,male,221,416,313,14,6,14,6,0,0
1380588,21,18,1992,3,male,626,432,327,14,33,14,28,0,5
2140858,23,19,1990,7,male,375,418,28,14,39,14,27,0,12
2092758,57,16,1956,6,female,827,433,410,14,80,14,75,0,5
1536971,101,8,1912,4,female,2266,438,142,14,73,14,56,0,17
2059712,108,10,1905,11,female,1372,440,311,15,7,1,6,14,1
1449643,18,29,1995,3,male,481,434,290,15,18,0,6,15,12
1276325,54,25,1959,4,male,444,428,365,15,12,0,7,15,5
1404867,37,3,1976,8,male,1516,430,315,15,2,15,1,0,1
1733210,16,26,1997,3,female,734,412,131,15,13,15,5,0,8
1028061,20,12,1993,8,male,410,413,365,15,88,15,79,0,9
1870345,19,7,1994,7,female,639,427,227,16,20,16,18,0,2
1269295,14,15,1999,2,female,206,434,111,17,53,6,29,11,24
1387423,15,25,1998,7,female,806,440,226,17,142,16,67,1,75
1611941,21,21,1992,1,female,984,412,68,17,139,15,58,2,81
1207755,19,1,1994,1,male,516,426,405,17,0,17,0,0,0
1323219,71,12,1942,3,male,1533,411,200,17,2,17,0,0,2
1341528,17,11,1996,11,male,681,428,389,17,11,17,11,0,0
1264450,20,1,1993,10,female,593,426,294,17,68,17,34,0,34
1681051,23,28,1990,1,female,1377,425,171,17,147,17,100,0,47
1733579,20,21,1993,5,female,1272,423,209,18,98,8,51,10,47
1215195,103,10,1910,5,male,1227,419,217,18,43,4,21,14,22
1847002,14,18,1999,4,male,249,421,381,18,2,17,2,1,0
1603636,48,22,1965,9,male,1316,436,197,18,106,14,49,4,57
1798649,13,15,2000,1,male,227,422,388,18,1,18,1,0,0
1084227,108,26,1905,3,male,1786,415,334,18,1,18,0,0,1
2050879,26,9,1987,10,female,646,429,320,18,9,18,9,0,0
1126433,15,29,1998,8,male,371,436,348,18,22,18,22,0,0
2104303,17,20,1996,6,female,359,433,345,18,25,18,10,0,15
1623244,27,7,1986,8,male,876,430,355,18,11,18,11,0,0
1223337,22,12,1991,2,female,255,410,127,18,156,18,99,0,57
1013387,22,12,1991,5,male,317,421,278,18,427,18,309,0,118
1354822,15,7,1998,8,male,302,414,370,19,0,0,0,19,0
2004477,72,6,1941,10,male,1883,439,250,19,10,2,9,17,1
2121819,17,13,1996,5,male,404,419,358,19,17,0,2,19,15
1146457,19,27,1994,12,male,781,428,340,19,17,0,2,19,15
1846257,18,27,1995,8,female,784,427,199,19,16,15,1,4,15
1252101,57,3,1956,1,male,662,437,305,19,4,19,3,0,1
1688190,97,16,1916,1,male,1343,440,151,19,9,19,8,0,1
1622045,16,4,1997,4,male,602,423,234,19,58,19,54,0,4
1035027,19,1,1994,10,male,128,426,405,19,51,19,18,0,33
1804083,22,28,1991,4,male,309,413,237,20,23,0,0,20,23
1512533,16,4,1997,11,male,727,415,336,20,2,8,0,12,2
2102886,27,24,1986,12,female,578,438,191,20,20,20,17,0,3
1351877,17,8,1996,10,female,316,437,247,20,36,20,19,0,17
2182816,16,22,1997,1,male,439,431,265,21,57,2,10,19,47
2050072,44,29,1969,8,male,1362,420,289,21,5,13,0,8,5
2171571,108,28,1905,3,male,912,412,74,21,124,18,115,3,9
1164303,22,11,1991,11,female,361,439,156,21,10,21,9,0,1
1853312,16,24,1997,11,male,427,415,323,21,48,21,41,0,7
1097883,15,4,1998,3,male,566,425,223,21,35,21,24,0,11
2107344,59,11,1954,7,female,1213,440,186,21,34,21,34,0,0
1547819,66,25,1947,8,female,501,413,76,21,175,21,160,0,15
1372206,28,25,1985,12,female,340,414,196,22,35,0,25,22,10
1043265,23,10,1990,9,male,516,416,318,22,31,22,30,0,1
1284996,16,15,1997,4,female,21,425,26,22,193,22,142,0,51
2049402,19,17,1994,8,male,400,427,97,22,36,22,31,0,5
1822337,20,7,1993,7,male,407,422,303,22,176,22,153,0,23
1321651,52,18,1961,6,female,836,439,254,23,43,0,6,23,37
1716097,94,19,1919,12,male,1233,419,275,23,0,19,0,4,0
1654218,16,15,1997,8,female,82,413,121,23,12,22,12,1,0
1026549,19,12,1994,5,female,728,413,252,23,92,23,32,0,60
1148013,19,5,1994,4,male,916,418,338,24,5,11,3,13,2
1537966,14,18,1999,5,male,139,410,392,24,10,18,5,6,5
1778001,18,20,1995,11,male,195,424,361,25,7,25,4,0,3
1672306,60,1,1953,3,male,1341,416,351,25,14,25,13,0,1
1428111,19,24,1994,4,male,127,438,29,25,50,25,39,0,11
1408417,28,2,1985,3,male,506,422,369,25,74,25,69,0,5
1877400,18,14,1995,7,female,250,415,178,26,5,1,0,25,5
1636899,27,2,1986,12,female,804,437,298,26,114,25,72,1,42
1099198,108,18,1905,7,male,1271,410,355,26,10,26,9,0,1
1835558,28,3,1985,10,female,289,428,280,26,104,26,99,0,5
1117157,20,27,1993,9,male,652,438,351,27,1,5,1,22,0
1781576,21,21,1992,6,male,582,417,332,27,83,4,76,23,7
1129213,15,25,1998,12,female,210,423,284,27,0,7,0,20,0
2157187,17,19,1996,10,female,224,427,210,27,34,15,18,12,16
1003116,18,7,1995,9,male,613,430,280,27,52,17,24,10,28
1511714,94,31,1919,1,female,1382,430,162,27,36,26,24,1,12
1243909,54,6,1959,2,male,1274,431,181,27,44,24,12,3,32
1867308,14,28,1999,8,female,255,436,106,27,12,27,6,0,6
1811719,21,24,1992,4,female,429,416,238,27,26,27,26,0,0
2060270,103,14,1910,10,male,831,414,84,27,31,27,31,0,0
1101872,16,31,1997,7,female,272,413,84,27,144,27,126,0,18
1912280,22,5,1991,4,female,171,412,398,27,415,27,217,0,198
1728964,16,14,1997,6,female,468,412,268,28,28,0,7,28,21
2094690,108,29,1905,5,male,1032,435,50,28,30,1,6,27,24
1244808,14,15,1999,4,female,246,424,243,28,6,28,4,0,2
1601230,103,2,1910,2,female,458,439,99,28,20,28,16,0,4
2184876,23,15,1990,5,male,374,412,337,28,127,28,112,0,15
1849715,13,19,2000,1,male,264,417,330,29,101,7,68,22,33
1724391,21,13,1992,12,male,736,416,222,29,38,23,14,6,24
2186411,22,7,1991,8,male,737,412,120,29,61,29,60,0,1
2108100,18,21,1995,1,female,568,416,276,31,2,0,0,31,2
1278293,35,23,1978,2,female,376,436,167,30,4,0,4,30,0
1326486,17,11,1996,2,male,357,439,407,30,6,0,5,30,1
2040016,24,7,1989,3,male,326,433,261,31,18,22,2,9,16
1397165,112,30,1901,12,female,1645,433,199,31,28,16,8,15,20
1750519,21,15,1992,12,male,430,437,257,31,3,31,3,0,0
1168902,58,17,1955,2,male,1499,422,123,31,3,31,3,0,0
1546240,18,17,1995,7,male,218,412,315,30,9,30,8,0,1
1174379,18,27,1995,8,female,431,413,142,31,32,31,31,0,1
1726296,24,16,1989,1,female,413,432,268,30,139,30,103,0,36
1574687,65,20,1948,12,male,2050,439,95,30,133,30,35,0,98
1231707,103,5,1910,10,female,1397,425,197,32,18,0,8,32,10
2083676,23,7,1990,4,male,418,429,318,32,112,0,18,32,94
1505810,103,19,1910,6,male,1188,424,199,32,23,22,13,10,10
1591455,27,2,1986,6,female,540,410,316,32,9,32,8,0,1
2126289,25,17,1988,2,female,123,426,400,33,321,21,168,12,153
1165089,50,17,1963,5,female,1124,434,293,33,94,21,59,12,35
1283833,47,15,1966,2,male,702,418,278,33,18,32,14,1,4
1974254,24,20,1989,4,male,283,410,84,33,5,33,4,0,1
1034257,18,14,1995,4,male,1017,419,238,33,48,33,40,0,8
1840112,23,20,1990,6,female,306,425,385,33,33,33,33,0,0
1468042,103,12,1910,1,female,82,421,382,33,43,33,43,0,0
1721272,21,1,1992,11,male,479,436,336,34,87,15,47,19,40
2097407,30,20,1983,3,male,654,430,286,36,1,0,1,36,0
1016280,20,20,1993,11,male,506,421,231,36,46,26,6,10,40
2026104,57,1,1956,12,male,1374,419,211,36,2,34,0,2,2
1976782,18,25,1995,2,male,206,429,274,35,42,34,34,1,8
1120963,68,2,1945,4,male,201,439,249,36,175,31,136,5,39
1794998,108,2,1905,11,male,1031,428,308,35,7,35,7,0,0
1706358,17,2,1996,4,male,305,417,155,35,146,35,109,0,37
1941757,17,8,1996,5,male,500,439,355,37,14,20,5,17,9
1728693,25,18,1988,7,female,865,434,163,37,93,32,51,5,42
1927730,18,19,1995,9,male,182,412,341,37,0,37,0,0,0
1237561,18,19,1995,6,female,552,433,288,37,61,37,53,0,8
1422915,17,6,1996,3,male,507,424,353,38,1,38,1,0,0
1633063,41,18,1972,3,female,544,418,297,39,29,39,22,0,7
1148954,105,2,1908,5,NA,2025,411,230,40,2,0,2,40,0
1053023,20,6,1993,4,male,704,440,352,40,10,2,0,38,10
1461131,23,11,1990,1,male,1446,428,105,40,21,0,4,40,17
1816873,16,28,1997,4,female,240,429,350,40,37,8,15,32,22
1870054,24,2,1989,7,female,559,436,252,40,94,24,46,16,48
1062104,48,6,1965,1,female,1333,413,152,40,57,40,28,0,29
1649868,17,5,1996,12,female,175,413,141,40,212,40,162,0,50
1752887,18,19,1995,7,male,293,417,349,40,108,40,73,0,35
2141140,94,16,1919,2,male,1380,421,284,42,12,2,5,40,7
1953935,18,20,1995,7,female,335,429,222,41,124,39,78,2,46
1812429,17,6,1996,12,male,702,411,132,42,43,42,24,0,19
1630322,17,4,1996,10,male,768,423,193,41,44,41,43,0,1
1253113,108,14,1905,10,male,931,414,306,43,13,0,4,43,9
1246241,34,7,1979,9,male,2165,421,66,44,29,44,24,0,5
1453511,108,6,1905,1,male,852,410,315,43,59,43,38,0,21
1678204,28,9,1985,6,male,388,423,122,43,122,43,111,0,11
2026994,18,7,1995,8,male,423,420,327,45,13,30,4,15,9
1465894,17,24,1996,9,male,546,420,253,45,16,45,4,0,12
1864640,41,8,1972,10,male,874,437,57,45,41,45,25,0,16
1517526,28,21,1985,5,male,339,434,388,46,11,1,4,45,7
1101264,23,9,1990,8,male,230,431,414,47,30,3,9,44,21
1415625,14,27,1999,4,female,469,431,252,47,103,23,83,24,20
1666415,22,10,1991,4,male,426,420,266,47,15,45,12,2,3
1272830,27,20,1986,5,female,469,427,355,46,349,42,228,4,121
1895897,16,27,1997,2,female,1286,425,105,46,17,46,4,0,13
1516043,24,3,1989,7,male,367,434,328,47,162,47,105,0,57
1907857,23,23,1990,12,male,495,425,303,49,6,34,2,15,4
1508117,15,2,1998,9,female,496,423,152,49,149,19,72,30,77
1658718,21,29,1992,7,female,539,423,239,48,67,46,47,2,20
1166483,20,23,1993,4,female,613,424,141,49,4,49,4,0,0
1441547,16,29,1997,12,male,625,437,216,49,21,49,11,0,10
1476178,103,23,1910,12,female,713,420,373,49,45,49,32,0,13
2023625,103,10,1910,3,male,1334,438,200,48,36,48,13,0,23
1513902,15,6,1998,2,male,309,439,299,51,25,0,7,51,18
1254493,39,3,1974,1,female,308,421,349,51,60,50,49,1,11
1302378,19,25,1994,3,male,442,431,271,51,84,41,68,10,16
1056274,19,1,1994,5,male,385,414,391,51,101,38,24,13,77
1820901,20,21,1993,12,female,138,416,67,50,33,50,25,0,8
1786493,22,30,1991,11,male,153,430,367,51,39,51,38,0,1
1207917,31,25,1982,6,male,424,431,265,51,51,51,19,0,32
1770404,35,26,1978,5,female,586,416,355,52,68,0,29,52,39
1541255,21,20,1992,3,female,242,416,268,53,177,37,125,16,52
2071296,22,22,1991,6,female,418,420,153,53,101,42,42,11,59
1998435,20,14,1993,6,male,42,435,400,52,30,52,23,0,7
1264138,38,5,1975,11,female,326,420,194,54,275,53,102,1,173
1422296,101,6,1912,10,female,750,417,215,55,97,55,92,0,5
1574331,108,14,1905,4,male,2888,430,183,54,103,54,93,0,10
2177662,17,2,1996,5,male,451,425,351,57,36,0,23,57,13
1901052,13,23,2000,1,male,252,421,231,58,127,48,68,10,59
1475866,17,17,1996,11,female,433,434,114,58,128,55,118,3,10
2133732,23,1,1990,11,male,1086,422,289,56,7,56,7,0,0
1862254,16,28,1997,7,female,229,417,95,57,84,57,81,0,3
1837633,20,22,1993,1,female,773,411,136,58,79,58,72,0,7
1013664,19,19,1994,1,female,49,435,25,58,108,58,72,0,36
1425595,23,30,1990,8,female,262,422,304,58,119,58,64,0,55
1064342,92,17,1921,10,male,958,438,257,56,921,56,746,0,175
1151488,36,8,1977,7,female,625,410,164,59,113,0,94,59,19
1492835,18,17,1995,8,female,646,431,348,60,34,32,28,28,6
1477063,15,6,1998,1,female,184,434,140,60,94,22,47,38,47
2119011,16,8,1997,6,male,367,429,287,59,61,57,25,2,36
1226510,68,4,1945,10,male,249,438,396,59,54,59,41,0,13
2130794,18,27,1995,9,female,1116,429,193,60,107,60,66,0,41
1743799,22,30,1991,8,male,480,411,363,61,66,4,11,57,55
1620802,26,14,1987,6,female,542,426,316,62,66,3,13,59,53
1523724,17,4,1996,12,male,450,437,359,62,152,19,28,43,124
1761059,94,9,1919,7,female,622,422,247,62,77,62,71,0,6
1535505,20,26,1993,4,female,311,410,51,63,211,63,143,0,68
1881947,108,2,1905,7,female,1996,431,348,64,33,31,17,33,16
1378227,14,23,1999,5,female,254,431,208,65,70,62,10,3,60
1737089,55,17,1958,9,female,976,422,181,68,303,2,165,66,138
1908487,74,3,1939,8,male,1559,428,185,68,25,28,13,40,12
1461520,23,26,1990,2,male,1614,436,290,67,99,50,67,17,32
1344581,33,1,1980,7,female,828,429,216,66,649,65,226,1,423
2049697,19,8,1994,2,male,549,434,309,68,40,68,37,0,3
1871744,22,19,1991,8,female,578,437,103,68,71,68,51,0,20
1334887,38,12,1975,6,male,697,411,375,66,92,66,73,0,19
1256649,93,23,1920,7,male,945,411,273,66,82,66,75,0,7
1199018,16,13,1997,7,male,276,422,367,70,1,0,1,70,0
1933182,108,21,1905,7,male,2626,437,213,70,83,11,39,59,44
1045240,15,14,1998,7,male,390,423,157,70,26,32,14,38,12
1427680,18,6,1995,11,male,408,423,371,71,43,16,31,55,12
2051771,21,27,1992,4,female,1318,427,207,70,71,28,11,42,60
1360613,20,15,1993,7,male,145,436,376,71,107,20,40,51,67
1848839,16,12,1997,9,female,335,431,149,70,3,69,2,1,1
1066118,30,12,1983,7,male,620,421,164,70,12,68,11,2,1
2152748,31,26,1982,7,female,788,433,209,71,124,60,107,11,17
2121358,18,5,1995,2,male,552,414,344,69,60,69,53,0,7
1409365,105,19,1908,1,female,823,416,108,71,50,71,46,0,4
1558846,19,23,1994,8,male,276,419,326,71,111,71,101,0,10
1712903,44,5,1969,7,male,476,423,136,69,120,69,54,0,66
1134913,108,6,1905,12,male,1648,419,242,72,47,31,15,41,32
1564179,110,3,1903,9,male,1649,429,257,72,9,66,5,6,4
1170518,27,10,1986,6,male,589,432,290,72,13,66,9,6,4
1597785,16,22,1997,7,male,575,426,267,72,29,72,12,0,17
2080495,20,19,1993,8,male,614,415,300,73,282,73,230,0,52
1835051,16,13,1997,1,male,447,425,387,76,16,0,10,76,6
2031697,17,8,1996,1,male,778,435,174,77,257,7,160,70,97
1857717,76,5,1937,6,male,1511,418,98,76,289,11,183,65,106
1383941,19,24,1994,5,male,653,425,401,77,39,36,33,41,6
2044536,18,25,1995,12,male,630,434,363,75,13,63,12,12,1
1862781,90,13,1923,6,male,620,430,366,76,18,61,10,15,8
1108815,16,10,1997,7,male,580,413,340,77,77,72,65,5,12
1591747,14,27,1999,10,male,379,420,312,75,139,74,59,1,80
1218931,25,13,1988,2,male,458,435,378,77,34,77,28,0,6
1423874,103,30,1910,11,female,452,419,256,76,54,76,47,0,7
2116180,21,7,1992,1,female,230,411,164,75,259,75,148,0,111
1938524,26,6,1987,11,male,520,433,357,79,18,54,6,25,12
1733754,53,27,1960,7,female,700,417,316,80,42,29,28,51,14
1068231,28,12,1985,8,female,1106,412,198,79,663,77,527,2,136
1903866,100,6,1913,8,female,1441,439,165,80,214,73,195,7,19
2187005,25,25,1988,6,male,839,436,257,78,28,78,8,0,20
1663299,28,27,1985,1,male,371,413,262,78,33,78,28,0,5
1023216,18,9,1995,11,male,555,437,223,79,126,79,120,0,6
1188601,21,16,1992,12,female,563,436,107,79,279,79,266,0,13
2081342,24,23,1989,8,female,288,432,185,81,191,4,102,77,89
1275552,93,7,1920,4,male,1809,436,243,81,1123,1,327,80,796
1954414,17,16,1996,11,female,570,432,364,83,20,70,11,13,9
1981179,16,27,1997,11,female,343,439,289,84,89,83,49,1,40
2121880,20,28,1993,6,female,492,413,218,81,428,63,244,18,184
1577708,21,6,1992,6,male,510,416,301,83,10,83,9,0,1
1021365,18,6,1995,7,male,207,422,356,81,40,81,37,0,3
2103442,17,26,1996,8,female,639,415,146,85,131,60,85,25,46
1674523,103,27,1910,9,female,972,436,236,85,58,85,43,0,15
1063068,18,9,1995,2,female,332,416,115,87,357,87,196,0,161
1833887,18,16,1995,10,female,520,424,248,87,143,87,76,0,67
1500552,23,26,1990,2,male,647,420,326,91,263,10,195,81,68
1120226,16,10,1997,2,female,485,422,17,88,192,54,140,34,52
1308360,17,13,1996,8,male,313,432,259,89,107,69,96,20,11
1274296,19,30,1994,3,female,268,420,194,90,63,84,33,6,30
1845358,21,5,1992,1,male,579,437,394,91,96,90,90,1,6
1562476,19,14,1994,2,male,528,420,178,91,20,91,20,0,0
2185512,108,24,1905,2,female,837,432,212,91,60,91,57,0,3
1522303,18,19,1995,11,female,639,411,236,90,305,90,210,0,95
1542651,18,19,1995,5,male,113,411,388,95,69,0,28,95,41
1197178,15,9,1998,3,female,39,414,85,94,400,29,177,65,223
1954382,30,5,1983,2,female,1209,419,235,95,387,24,165,71,222
1778395,17,21,1996,3,male,906,415,176,93,106,93,68,0,38
2174180,14,12,1999,4,female,168,414,120,96,44,0,11,96,33
1905830,102,2,1911,4,female,942,427,325,99,25,0,13,99,12
1124862,66,10,1947,9,male,899,411,95,99,160,0,46,99,114
1586431,103,1,1910,10,male,875,418,293,99,165,1,36,98,129
1249817,20,28,1993,7,female,540,432,229,99,183,68,79,31,104
2173991,19,3,1994,10,female,294,431,264,97,112,83,84,14,28
1471494,23,8,1990,11,male,523,425,148,99,490,96,372,3,118
2003645,21,24,1992,6,female,668,414,236,97,84,97,66,0,18
1619191,28,13,1985,6,male,650,433,224,97,81,97,54,0,27
2111911,16,23,1997,3,male,325,423,226,100,5,0,0,100,5
1366804,17,29,1996,2,female,293,432,73,104,0,46,0,58,0
1771453,18,23,1995,2,male,649,430,214,102,63,94,24,8,39
1166886,54,8,1959,4,male,405,427,377,103,136,78,103,25,33
1274250,18,18,1995,1,female,424,429,290,102,192,75,78,27,114
1465139,18,21,1995,10,female,517,430,322,101,204,96,152,5,52
2017328,42,14,1971,3,female,755,422,346,101,209,89,183,12,26
1720865,15,30,1998,3,male,397,416,332,104,5,104,5,0,0
1831594,18,1,1995,4,male,586,422,356,103,0,103,0,0,0
1611119,18,10,1995,10,male,241,436,419,100,4,100,4,0,0
2061517,93,8,1920,7,male,901,421,295,101,28,101,23,0,5
1871877,15,25,1998,1,female,594,428,200,103,116,103,96,0,20
1688956,28,10,1985,7,male,509,420,408,106,22,0,6,106,16
1923941,46,25,1967,8,female,538,414,225,105,19,3,3,102,16
1596210,101,9,1912,10,male,1158,434,161,109,154,4,23,105,131
1195571,17,7,1996,5,female,528,432,190,108,35,26,24,82,11
1104413,108,15,1905,9,female,1663,422,154,108,75,48,26,60,49
1322694,20,5,1993,4,male,505,434,345,105,25,105,25,0,0
1621057,26,11,1987,9,female,578,426,340,106,99,106,50,0,49
1516746,103,13,1910,7,male,1260,428,242,108,121,108,81,0,40
1177676,22,1,1991,12,female,472,413,303,107,214,107,167,0,47
1812716,16,27,1997,7,male,192,418,394,113,71,43,58,70,13
1403253,24,11,1989,1,female,490,415,300,112,132,67,73,45,59
1258012,21,4,1992,12,female,674,413,254,112,180,77,69,35,111
1701443,31,15,1982,3,male,603,418,293,113,654,59,574,54,80
1300373,24,2,1989,3,male,871,431,356,113,16,91,6,22,10
1932183,32,28,1981,7,male,657,440,94,111,301,106,158,5,143
1030103,15,21,1998,6,female,566,430,262,111,9,111,0,0,9
1442462,68,25,1945,4,female,264,415,316,112,484,112,430,0,54
2068131,97,2,1916,7,male,1687,410,203,115,12,12,1,103,11
1706707,20,9,1993,4,male,487,437,211,114,318,26,128,88,190
1779032,15,5,1998,5,female,571,426,341,115,9,109,7,6,2
1215516,94,12,1919,6,NA,2214,430,241,119,27,88,19,31,8
1191348,15,18,1998,8,female,542,430,269,119,386,102,215,17,171
1141216,20,26,1993,8,male,587,424,348,116,101,116,99,0,2
1158613,20,8,1993,8,male,460,430,187,122,18,0,1,122,17
1079920,19,1,1994,7,female,542,425,287,123,73,84,26,39,47
1238182,21,1,1992,7,female,415,423,117,122,45,48,12,74,33
2018091,108,1,1905,1,male,604,420,258,120,142,106,123,14,19
1975478,54,24,1959,3,male,1446,433,222,124,193,112,109,12,84
1659824,18,2,1995,11,male,517,425,291,120,49,120,44,0,5
2072121,18,2,1995,5,male,267,437,387,120,23,120,23,0,0
2044452,80,20,1933,1,female,937,416,208,124,71,124,52,0,19
1616266,52,8,1961,2,male,448,418,242,127,193,0,19,127,174
1610491,113,1,1900,7,female,1476,439,275,129,71,118,65,11,6
1931931,21,6,1992,12,female,1552,440,237,126,172,120,91,6,81
1553729,102,1,1911,1,male,946,416,149,125,91,100,86,25,5
1505774,19,6,1994,11,female,550,420,249,129,351,100,295,29,56
1213592,103,4,1910,11,female,142,413,172,125,189,105,109,20,80
1011204,16,22,1997,10,male,127,418,41,128,42,128,42,0,0
1204406,24,18,1989,7,female,37,426,225,127,161,127,119,0,42
1248788,74,4,1939,3,male,88,436,245,136,113,0,3,136,110
1951191,21,15,1992,10,male,772,416,304,135,40,96,38,39,2
2156139,106,1,1907,4,male,279,439,339,134,149,125,144,9,5
1138024,24,21,1989,9,female,285,411,282,136,337,115,107,21,230
1482872,20,12,1993,3,female,618,438,167,134,317,134,306,0,11
1458290,16,14,1997,8,female,365,435,219,142,144,66,43,76,101
1805850,19,21,1994,5,female,568,422,250,137,127,71,17,66,110
1440985,103,13,1910,11,female,654,420,199,141,179,39,102,102,77
1720705,21,29,1992,3,female,227,434,332,141,372,70,170,71,202
1501091,70,23,1943,5,male,557,437,209,142,41,128,25,14,16
2124791,15,1,1998,9,female,279,424,117,138,88,105,33,33,55
2103649,17,14,1996,12,male,438,426,241,141,130,138,64,3,66
1471165,60,22,1953,7,female,1090,410,359,141,130,109,75,32,55
1229795,108,20,1905,8,male,1516,430,215,143,11,143,5,0,6
1039609,19,10,1994,6,male,786,437,332,141,29,141,26,0,3
1906274,17,7,1996,3,female,403,431,187,140,86,140,86,0,0
1101420,20,16,1993,3,male,232,418,225,140,380,140,348,0,32
2057927,21,25,1992,3,female,1430,427,261,141,230,141,179,0,51
1882845,22,6,1991,9,female,333,425,286,148,31,0,10,148,21
1395732,17,5,1996,12,male,219,428,368,149,42,34,28,115,14
1296345,23,25,1990,1,male,243,410,334,149,83,32,23,117,60
1337524,18,12,1995,10,male,52,410,398,145,111,72,41,73,70
2065510,16,14,1997,9,female,164,437,417,146,45,132,38,14,7
1047582,108,9,1905,7,male,1926,419,223,148,78,120,38,28,40
2014425,20,8,1993,5,female,645,430,341,145,136,121,74,24,62
1344423,105,19,1908,8,male,229,429,237,147,138,142,79,5,59
2087232,100,17,1913,2,male,2088,421,226,152,129,10,15,142,114
1692321,15,23,1998,4,male,267,435,353,151,163,92,40,59,123
1604718,24,25,1989,8,male,156,428,250,157,69,154,56,3,13
1366351,91,29,1922,3,female,2443,434,241,154,123,137,96,17,27
1758593,34,29,1979,12,female,242,417,97,156,86,156,68,0,18
1705866,113,30,1900,3,female,2243,425,268,154,84,154,35,0,49
1225929,17,7,1996,1,male,346,432,349,152,215,152,152,0,63
1025852,17,20,1996,8,female,498,422,300,156,113,156,75,0,38
1411983,37,19,1976,7,female,468,435,188,157,176,157,119,0,57
2021728,22,22,1991,6,male,395,424,294,156,236,156,187,0,49
1673751,33,8,1980,7,female,447,412,294,152,243,152,190,0,53
1938386,20,4,1993,1,female,446,420,198,163,150,112,24,51,126
1912662,36,17,1977,8,female,1254,437,129,159,38,159,26,0,12
1976698,93,30,1920,7,female,1130,429,366,159,206,159,172,0,34
1939300,103,5,1910,2,male,1511,417,261,160,101,160,77,0,24
2007797,18,27,1995,6,female,383,418,304,169,13,27,7,142,6
1670416,56,1,1957,10,female,1732,440,140,170,64,3,24,167,40
1859031,103,28,1910,10,male,1253,411,131,167,352,29,163,138,189
1586979,103,5,1910,4,female,1461,432,94,172,29,67,5,105,24
2128767,22,31,1991,12,male,232,415,57,169,373,75,113,94,260
1915187,28,10,1985,10,male,156,431,392,166,360,40,191,126,169
1176232,31,19,1982,4,female,2040,424,79,168,300,108,180,60,120
1935036,18,29,1995,4,female,127,434,316,167,238,150,170,17,68
2117240,51,3,1962,4,female,1721,411,254,170,242,162,236,8,6
1217177,48,28,1965,10,female,256,433,314,180,75,3,6,177,69
1102253,15,11,1998,1,female,592,421,343,181,95,63,65,118,30
1370506,16,12,1997,11,female,425,436,352,175,109,111,26,64,83
1830907,24,24,1989,1,male,292,411,287,177,183,117,118,60,65
1152120,103,1,1910,1,male,1166,424,259,175,121,104,53,71,68
1310824,44,18,1969,12,female,720,414,221,174,21,157,11,17,10
1787859,21,8,1992,4,female,555,419,137,180,76,167,53,13,23
1371569,106,17,1907,9,male,479,436,303,178,235,178,203,0,32
2149190,39,23,1974,6,female,1268,428,240,180,318,180,238,0,80
1004345,51,20,1962,2,male,413,422,243,190,13,33,5,157,8
1595269,18,26,1995,5,male,412,418,255,186,196,72,86,114,110
1747894,27,4,1986,4,male,507,432,304,188,114,188,95,0,19
2053582,21,17,1992,10,male,682,433,274,188,156,188,111,0,45
1452558,90,14,1923,10,female,1848,440,120,182,122,182,110,0,12
1046363,22,1,1991,5,female,673,411,176,183,376,183,327,0,49
1797795,14,16,1999,4,male,415,439,399,195,5,69,3,126,2
1779056,21,15,1992,10,female,920,415,167,194,260,89,103,105,157
1494500,73,1,1940,8,female,1797,416,249,199,272,68,99,131,173
1759105,21,17,1992,6,female,378,430,296,199,330,70,107,129,223
1397024,108,22,1905,10,male,1086,416,73,200,164,157,67,43,97
1930181,103,27,1910,8,female,1057,423,139,200,813,188,472,12,341
1376136,25,11,1988,1,female,958,428,153,194,75,194,61,0,14
1595679,16,19,1997,8,female,349,427,336,199,126,199,105,0,21
1226241,17,2,1996,7,female,190,410,117,196,252,196,223,0,29
2169327,18,23,1995,2,male,408,432,405,196,144,196,110,0,34
1038204,22,8,1991,8,male,444,435,411,191,160,191,159,0,1
2189843,30,15,1983,7,female,155,428,342,200,217,200,136,0,81
1740310,28,16,1985,3,male,272,420,368,194,566,194,460,0,106
1122944,20,30,1993,12,female,350,427,165,209,126,100,87,109,39
1259502,20,25,1993,7,female,396,438,261,201,190,184,72,17,118
1828624,20,11,1993,7,female,1040,420,244,209,368,175,187,34,181
1443060,14,28,1999,1,female,442,423,291,201,44,200,30,1,14
1669100,23,15,1990,6,female,685,421,255,209,0,209,0,0,0
1969675,108,28,1905,9,female,95,436,151,214,439,3,384,211,55
1222287,18,24,1995,11,male,467,421,364,220,67,149,40,71,27
1823910,16,21,1997,4,male,405,430,320,217,210,128,130,89,80
2092739,25,4,1988,11,female,1018,425,267,221,436,153,220,68,216
2095778,16,23,1997,3,male,217,412,391,219,14,219,14,0,0
2128293,16,1,1997,3,female,93,429,190,215,340,215,271,0,69
1042317,101,11,1912,12,male,528,419,341,215,359,215,311,0,48
1099146,27,14,1986,6,female,613,425,189,224,625,1,168,223,457
1574942,58,15,1955,3,female,1984,424,180,230,378,15,172,215,206
1624788,97,6,1916,2,male,1477,413,236,226,30,114,17,112,13
1536411,20,22,1993,2,male,378,420,333,233,113,99,79,134,34
1711823,19,23,1994,2,female,448,412,197,225,167,112,79,113,88
1331100,20,18,1993,8,male,295,428,340,223,327,126,276,97,51
1959598,20,9,1993,12,female,715,418,260,228,127,210,116,18,11
1348978,19,24,1994,7,male,708,422,205,233,53,226,36,7,17
1511569,17,24,1996,10,male,972,438,239,232,221,222,134,10,87
1270101,113,16,1900,4,female,1634,417,277,225,179,201,31,24,148
1162473,18,27,1995,12,female,233,431,58,223,100,223,65,0,35
2084565,52,11,1961,3,female,665,416,161,233,495,233,230,0,265
1788133,105,18,1908,6,male,908,417,278,245,232,12,99,233,133
1817628,21,28,1992,8,female,264,416,337,236,738,5,462,231,276
1054991,17,30,1996,3,female,374,414,80,235,468,163,232,72,236
1951734,15,23,1998,3,female,503,415,185,240,697,177,394,63,303
1773342,23,11,1990,5,female,2042,438,195,239,369,226,264,13,105
1809041,20,5,1993,9,female,1023,440,185,242,189,240,174,2,15
1638781,17,8,1996,11,female,357,425,246,242,61,242,59,0,2
1498798,16,3,1997,2,female,416,426,325,246,264,246,164,0,100
1694165,25,7,1988,11,female,390,436,334,234,185,234,157,0,28
1155536,15,8,1998,4,female,237,429,280,252,776,100,247,152,529
1303606,20,30,1993,12,female,354,412,238,248,378,166,170,82,208
1089763,18,16,1995,7,male,416,426,246,254,164,251,98,3,66
1469857,22,24,1991,9,female,1992,430,330,255,174,245,167,10,7
1877949,88,12,1925,10,male,623,421,283,254,210,222,159,32,51
1192842,34,28,1979,6,male,460,432,388,252,0,252,0,0,0
1388722,23,28,1990,9,male,547,428,234,260,307,260,173,0,134
1431955,19,20,1994,2,female,173,418,158,249,451,249,296,0,155
1885756,19,10,1994,6,male,443,431,350,259,475,259,311,0,164
1088391,108,25,1905,11,male,2301,421,193,274,120,9,89,265,31
1867934,23,26,1990,9,female,345,421,218,275,218,0,33,275,185
2022264,54,5,1959,12,female,1508,431,193,271,248,3,38,268,210
1764796,103,15,1910,10,female,809,410,209,273,192,50,13,223,179
1457505,16,19,1997,5,female,183,413,294,262,74,125,38,137,36
1496425,21,23,1992,2,female,591,434,311,272,113,65,41,207,72
1996534,18,7,1995,10,female,673,432,230,271,274,67,172,204,102
1814106,45,28,1968,10,female,2018,426,321,275,1434,183,1013,92,421
1037948,24,17,1989,8,male,711,424,236,268,91,248,51,20,40
1137487,48,3,1965,5,female,330,431,20,265,89,253,41,12,48
1672991,71,16,1942,1,male,1953,411,192,271,114,203,58,68,56
1651007,18,1,1995,5,female,554,413,180,269,269,233,95,36,174
1910822,18,6,1995,6,male,424,436,138,271,22,271,21,0,1
2075345,14,1,1999,4,male,177,421,54,264,167,264,131,0,36
1891829,36,10,1977,3,female,1878,436,153,268,1442,268,1242,0,200
2061810,108,16,1905,2,male,1191,433,270,291,27,0,4,291,23
1180601,67,18,1946,5,male,1555,430,380,288,89,0,31,288,58
1850892,76,17,1937,9,female,1381,439,190,290,87,11,36,279,51
1528241,17,3,1996,5,male,608,424,297,279,236,10,34,269,202
1185797,29,3,1984,4,female,747,422,176,288,403,1,158,287,245
1383577,22,23,1991,2,male,173,414,315,277,52,145,32,132,20
2190044,38,12,1975,10,male,668,430,248,291,114,165,55,126,59
1569796,17,9,1996,6,female,632,418,122,277,192,166,64,111,128
2144458,23,26,1990,10,female,270,418,107,284,352,119,183,165,169
1454791,108,21,1905,3,male,1747,417,285,286,379,126,111,160,268
1390527,18,19,1995,10,female,524,438,27,279,702,67,387,212,315
1605050,18,19,1995,5,male,146,410,370,280,381,276,274,4,107
2065001,40,22,1973,7,female,1652,421,270,289,247,272,167,17,80
1507330,42,2,1971,8,female,1999,439,323,284,504,234,363,50,141
1442513,58,10,1955,10,female,1717,432,257,285,1084,263,557,22,527
2107149,18,22,1995,5,male,1026,438,282,291,114,289,49,2,65
2098875,18,15,1995,12,female,472,418,80,292,388,292,359,0,29
1973724,14,26,1999,5,female,357,411,359,301,141,10,41,291,100
1978576,15,22,1998,7,female,688,426,234,307,127,39,92,268,35
1280411,71,3,1942,6,female,729,429,244,301,66,47,31,254,35
1926611,108,6,1905,9,female,961,413,241,301,128,9,47,292,81
1443057,25,9,1988,6,female,1101,433,98,306,1073,54,894,252,179
1008803,58,1,1955,8,female,510,434,337,303,523,215,419,88,104
2004741,73,26,1940,6,male,147,410,270,304,478,191,211,113,267
2019070,108,23,1905,12,male,127,425,361,304,495,191,204,113,291
1510975,15,20,1998,7,female,459,418,145,301,203,265,58,36,145
1998477,23,3,1990,7,male,211,413,395,301,152,301,137,0,15
1474604,57,27,1956,11,female,1634,424,122,302,73,302,25,0,48
1754965,68,31,1945,5,female,1147,413,293,313,31,2,22,311,9
1455323,16,2,1997,6,male,331,432,350,312,74,0,54,312,20
1053633,108,31,1905,12,male,9,435,423,321,114,3,79,318,35
1424285,14,29,1999,5,female,487,432,333,313,217,122,117,191,100
1111076,103,23,1910,12,male,1023,425,252,326,41,279,30,47,11
1711077,18,17,1995,2,female,363,412,304,312,115,245,18,67,97
1002470,52,8,1961,12,female,1724,416,287,310,678,307,469,3,209
1442286,20,12,1993,10,female,448,415,210,313,113,313,108,0,5
1424347,25,1,1988,1,female,29,422,68,310,1355,310,1167,0,188
1766051,14,10,1999,11,female,616,421,282,329,271,95,119,234,152
1737288,19,16,1994,11,female,435,435,107,336,421,195,243,141,178
1019021,44,19,1969,4,female,1465,414,233,340,310,259,100,81,210
1395867,57,7,1956,11,female,2005,411,230,344,784,309,228,35,556
2060478,18,1,1995,2,female,748,417,273,340,303,340,203,0,100
2090112,18,30,1995,7,female,130,412,272,345,583,345,358,0,225
2190707,20,27,1993,2,male,150,411,267,330,829,330,639,0,190
1539946,57,16,1956,4,female,1032,414,292,361,109,7,30,354,79
1000529,103,21,1910,10,female,1763,433,273,364,125,67,48,297,77
1153649,23,12,1990,1,female,792,421,363,348,392,72,144,276,248
1259438,48,4,1965,8,female,750,432,163,351,309,158,157,193,152
1281522,54,16,1959,8,female,1367,421,227,354,395,93,109,261,286
1451057,108,13,1905,5,male,1931,428,221,367,465,216,334,151,131
1905862,57,13,1956,3,female,1553,427,272,357,935,172,519,185,416
2156898,22,6,1991,5,female,418,414,279,356,85,346,51,10,34
1047758,25,28,1988,3,male,179,428,315,351,45,351,38,0,7
1567582,21,22,1992,2,male,288,427,304,364,123,364,90,0,33
1976172,28,6,1985,2,male,727,436,312,348,206,348,76,0,130
1398089,72,3,1941,5,female,859,439,299,361,212,361,104,0,108
1244681,14,21,1999,2,female,237,410,289,360,450,360,338,0,112
1763464,26,2,1987,1,male,648,427,262,364,827,364,777,0,50
1806979,16,22,1997,9,male,802,412,318,381,335,6,148,375,187
1100148,18,6,1995,4,female,889,430,242,386,257,0,18,386,239
1190970,108,17,1905,11,female,1715,439,208,380,543,24,155,356,388
2171648,18,29,1995,8,female,327,438,225,376,133,139,95,237,38
1469329,29,7,1984,5,female,880,437,382,373,358,172,206,201,152
1042995,60,11,1953,12,female,703,424,262,380,27,344,7,36,20
1635010,17,3,1996,7,male,364,438,280,376,480,326,322,50,158
1593390,19,21,1994,11,female,521,428,341,378,56,377,46,1,10
1752284,30,25,1983,7,female,1071,434,296,371,184,371,153,0,31
1684204,36,23,1977,1,male,516,411,348,380,195,380,135,0,60
1261080,25,24,1988,6,female,358,412,161,387,344,387,328,0,16
1231116,16,27,1997,5,female,155,431,342,396,8,74,5,322,3
1153429,19,6,1994,6,female,414,424,269,413,289,6,23,407,266
1064330,20,24,1993,9,male,375,425,295,405,343,59,96,346,247
1150082,18,12,1995,3,female,328,439,323,419,214,200,92,219,122
1954745,16,30,1997,3,female,121,413,235,418,412,155,133,263,279
1438732,15,13,1998,4,male,237,415,311,395,197,321,165,74,32
1008326,36,9,1977,7,male,230,436,353,402,283,399,227,3,56
1046560,16,8,1997,2,male,495,414,160,396,124,396,112,0,12
1068028,20,11,1993,3,male,365,426,278,406,186,406,180,0,6
1348999,113,29,1900,10,male,1345,418,308,417,115,417,106,0,9
1840073,16,31,1997,1,male,372,419,217,399,376,399,269,0,107
1719134,17,7,1996,9,female,369,424,226,405,321,405,243,0,78
1581927,108,4,1905,5,female,2249,435,308,416,272,416,116,0,156
1420577,50,19,1963,5,female,1757,411,246,424,478,279,336,145,142
1207797,64,8,1949,6,female,2361,429,278,442,225,326,80,116,145
1744580,47,7,1966,3,male,586,426,211,436,316,386,138,50,178
1232528,20,12,1993,10,female,1761,429,134,439,1298,437,928,2,370
1373055,20,17,1993,11,female,438,437,333,423,426,423,280,0,146
1981501,20,12,1993,2,female,497,432,210,437,320,437,123,0,197
1148492,51,14,1962,12,male,213,424,277,457,238,51,86,406,152
2083465,24,30,1989,5,female,869,416,115,466,311,139,157,327,154
1861776,16,2,1997,12,female,118,420,230,472,385,456,344,16,41
1294913,29,26,1984,11,female,1150,434,268,472,511,442,364,30,147
1627144,20,3,1993,3,female,476,421,254,464,55,462,16,2,39
1595853,14,26,1999,10,female,244,419,186,482,259,482,182,0,77
1315487,24,10,1989,4,female,254,436,19,468,1246,468,1185,0,61
1905326,63,16,1950,11,female,1108,410,230,491,107,91,45,400,62
1121421,21,6,1992,6,female,515,427,248,486,424,10,116,476,308
1271644,47,1,1966,5,male,297,411,341,519,561,0,55,519,506
1412092,19,17,1994,10,female,502,423,112,498,934,46,711,452,223
1538576,25,7,1988,6,female,1467,437,133,484,866,32,390,452,476
1890927,18,6,1995,6,female,793,421,166,495,680,139,165,356,515
1713074,102,23,1911,7,female,1610,417,255,516,395,254,226,262,169
1004782,17,27,1996,11,female,844,432,203,493,796,278,451,215,345
1867412,20,29,1993,1,female,1265,426,126,500,876,165,240,335,636
1461767,58,29,1955,5,male,1769,414,291,512,98,417,62,95,36
1347425,14,15,1999,10,female,280,411,200,506,565,462,290,44,275
1785484,25,1,1988,9,female,252,427,372,496,567,431,216,65,351
1877438,108,9,1905,2,female,2350,433,263,511,578,430,215,81,363
1741294,18,4,1995,12,male,458,424,198,509,339,507,161,2,178
1471705,23,4,1990,4,female,690,437,295,508,501,508,297,0,204
1552408,66,22,1947,2,female,431,412,240,530,646,0,56,530,590
2000931,71,20,1942,5,female,1454,410,245,539,852,14,342,525,510
2042677,30,17,1983,4,female,1541,431,315,530,608,200,237,330,371
1996123,18,29,1995,8,female,479,410,183,542,1661,369,832,173,829
1364630,33,25,1980,3,female,951,438,174,534,1251,337,644,197,607
1762680,16,9,1997,9,female,505,430,243,556,666,532,443,24,223
1090342,113,23,1900,6,female,2238,435,275,543,746,475,521,68,225
2094354,103,3,1910,7,female,653,427,234,547,277,547,142,0,135
1938930,18,19,1995,1,female,481,435,333,521,393,521,158,0,235
1896293,103,23,1910,9,female,761,425,283,561,398,561,310,0,88
1832068,32,29,1981,5,female,588,425,333,579,568,18,134,561,434
2164700,16,15,1997,2,female,520,425,196,585,172,355,148,230,24
1841389,51,30,1962,12,female,1600,419,333,586,1154,420,621,166,533
1021146,13,22,2000,3,female,94,413,120,608,394,551,170,57,224
1858652,18,7,1995,1,female,497,436,191,583,422,575,254,8,168
1185971,22,1,1991,4,female,185,428,252,565,989,496,748,69,241
1160927,24,7,1989,4,female,772,428,197,575,200,575,122,0,78
1250702,17,7,1996,1,male,419,425,309,638,272,60,83,578,189
1827806,108,31,1905,12,female,1781,416,200,648,485,0,158,648,327
1450669,18,18,1995,6,female,625,410,189,647,213,157,117,490,96
1230641,29,7,1984,7,female,547,412,109,634,237,129,85,505,152
1689957,15,30,1998,8,female,223,433,285,643,197,614,68,29,129
2109664,51,11,1962,7,male,254,440,199,620,1289,620,863,0,426
1480355,14,1,1999,10,female,430,436,271,679,211,140,125,539,86
1982906,103,28,1910,7,female,617,433,281,698,200,683,181,15,19
2099265,59,10,1954,11,female,1666,424,96,688,1284,550,850,138,434
2146790,21,25,1992,6,male,484,432,318,688,123,688,99,0,24
1391751,77,4,1936,4,female,966,419,289,706,259,706,191,0,68
1993329,103,4,1910,10,female,353,436,163,689,397,689,285,0,112
1783891,17,22,1996,1,female,1231,434,178,775,497,63,267,712,230
1034761,31,29,1982,1,female,358,413,354,739,504,23,318,716,186
1263833,51,14,1962,9,female,1423,425,282,762,509,27,104,735,405
1719589,108,11,1905,6,male,1779,426,299,787,912,86,492,701,420
1338585,17,19,1996,5,female,430,410,356,792,669,276,294,516,375
1665192,28,1,1985,6,male,284,436,293,776,402,765,244,11,158
2087598,69,29,1944,1,female,1456,412,276,728,293,681,277,47,16
1108701,17,25,1996,7,female,29,429,188,761,635,710,562,51,73
1774773,19,7,1994,3,male,571,440,273,791,994,647,757,144,237
1506507,25,21,1988,6,female,388,426,334,786,293,783,201,3,92
1093702,21,27,1992,8,female,787,415,223,780,524,776,297,4,227
1404554,71,27,1942,12,female,2026,412,222,745,509,739,268,6,241
1422687,46,8,1967,11,female,1559,419,273,776,408,776,264,0,144
1165152,14,7,1999,10,female,279,432,366,872,480,0,217,872,263
1967563,76,18,1937,2,female,706,430,354,818,487,131,272,687,215
1984993,22,19,1991,1,male,1032,427,196,850,492,302,137,548,355
1208890,46,1,1967,6,female,505,417,261,845,215,457,135,388,80
1131727,18,17,1995,8,male,427,427,364,870,571,444,274,426,297
1549689,46,10,1967,11,female,1004,426,296,847,1145,597,821,250,324
1843247,25,8,1988,8,male,263,414,406,869,138,850,126,19,12
2082663,14,15,1999,4,female,410,431,238,800,751,777,84,23,667
2190932,31,1,1982,1,female,2268,435,316,879,660,752,493,127,167
1837517,42,8,1971,10,female,2224,429,237,817,608,764,122,53,486
1861380,88,21,1925,2,female,563,431,121,826,552,825,426,1,126
2086407,80,2,1933,2,male,474,413,305,876,145,876,138,0,7
1185342,34,30,1979,4,female,507,424,182,811,206,811,203,0,3
1513572,16,28,1997,6,female,159,431,319,869,913,869,758,0,155
2183120,51,27,1962,2,female,665,415,239,957,844,4,318,953,526
1292919,69,6,1944,6,male,292,425,75,885,1142,124,558,761,584
1953891,17,13,1996,12,female,251,435,344,981,790,633,474,348,316
1920018,16,2,1997,5,male,174,411,254,889,312,791,263,98,49
1063026,21,11,1992,6,female,730,415,331,927,472,894,246,33,226
1285416,53,13,1960,10,female,2159,440,218,897,289,864,157,33,132
1468505,15,19,1998,10,female,349,432,206,974,930,973,814,1,116
2031851,19,22,1994,2,female,456,423,140,914,218,914,169,0,49
1732830,33,11,1980,7,female,569,418,323,893,335,893,273,0,62
1842931,58,18,1955,1,female,398,417,350,988,206,20,109,968,97
1153739,88,25,1925,10,male,685,417,274,1068,488,4,356,1064,132
2052679,21,7,1992,3,female,454,422,163,1005,819,24,273,981,546
1675994,30,17,1983,10,female,864,428,235,1021,594,660,292,361,302
1084322,62,10,1951,11,female,1888,411,217,989,497,345,196,644,301
1025721,16,21,1997,5,female,417,432,268,1022,897,276,328,746,569
1988258,43,13,1970,3,female,1244,428,304,1129,814,372,267,757,547
1002617,18,2,1995,4,female,81,410,176,1070,1832,610,1167,460,665
1388476,22,16,1991,9,male,223,439,293,1060,1670,315,1370,745,300
1015943,96,1,1917,10,NA,2181,437,68,1010,1934,570,1108,440,826
1281189,18,28,1995,12,female,604,425,189,1108,652,879,369,229,283
1412960,18,4,1995,1,female,383,423,179,1086,629,994,372,92,257
2018523,19,3,1994,3,male,1251,434,280,1044,1299,930,999,114,300
1072572,60,1,1953,6,female,459,435,218,1059,1244,853,942,206,302
1573812,48,16,1965,7,female,1969,423,257,997,2397,974,1443,23,954
1341187,26,6,1987,7,female,670,410,176,1080,660,1077,471,3,189
1282603,16,18,1997,7,female,426,411,226,1047,211,1047,185,0,26
1462487,57,17,1956,3,male,53,414,333,1006,426,1006,291,0,135
1614452,81,4,1932,4,female,1819,426,338,1130,569,1130,448,0,121
2012652,63,19,1950,1,female,1396,415,204,1258,387,0,53,1258,334
1411176,49,16,1964,3,female,708,421,175,1252,786,12,326,1240,460
2033738,38,1,1975,8,female,2373,432,312,1217,889,473,352,744,537
1523086,16,14,1997,11,female,429,415,255,1190,2133,884,1659,306,474
1339399,103,30,1910,11,male,1032,425,243,1162,92,1162,57,0,35
1609245,18,3,1995,4,female,279,437,200,1143,293,1143,192,0,101
1823665,18,7,1995,8,female,328,417,265,1246,273,1246,183,0,90
1091276,21,16,1992,1,female,627,426,151,1201,1711,1201,1438,0,273
1125311,13,20,2000,1,female,581,412,252,1308,116,26,29,1282,87
2020370,106,26,1907,2,female,1541,410,166,1323,173,0,57,1323,116
1104616,29,14,1984,8,male,248,416,286,1298,312,222,222,1076,90
1043685,43,2,1970,9,female,714,431,245,1331,2457,216,642,1115,1815
1935835,29,5,1984,3,female,238,437,257,1476,1813,1024,839,452,974
1267269,50,13,1963,4,female,309,414,145,1514,616,1449,458,65,158
1411842,15,20,1998,1,female,108,432,94,1341,1125,1007,585,334,540
1590209,16,10,1997,1,female,364,426,291,1313,1158,1054,871,259,287
1345062,18,8,1995,3,female,471,416,281,1410,902,1300,647,110,255
1523107,19,26,1994,9,female,1568,433,148,1357,1079,1113,840,244,239
1822030,102,2,1911,1,male,809,418,166,1292,1173,963,976,329,197
1317082,15,31,1998,8,male,166,417,264,1301,1188,1301,1062,0,126
1271541,15,17,1998,6,female,158,432,308,1755,1028,94,288,1661,740
1074361,47,7,1966,3,female,1526,436,211,1746,727,160,362,1586,365
2120855,19,9,1994,4,male,184,411,341,1717,2372,109,1058,1608,1314
1817639,23,11,1990,10,female,876,422,239,1717,1736,258,1169,1459,567
1297913,20,2,1993,10,female,732,424,154,1559,908,804,593,755,315
1464861,19,24,1994,1,female,612,411,293,1587,582,1292,511,295,71
1743886,51,16,1962,10,female,436,422,156,1722,574,1568,252,154,322
1625032,58,27,1955,8,female,1286,431,256,1653,749,1497,299,156,450
1418909,23,10,1990,3,male,412,429,356,1843,115,1843,95,0,20
2187678,21,11,1992,2,male,648,418,242,1753,1013,1753,913,0,100
1765626,17,20,1996,5,female,408,420,280,1753,1846,1753,1402,0,444
1007106,19,10,1994,2,female,206,438,207,1630,1105,1630,770,0,335
2102459,24,10,1989,4,female,447,422,295,2100,1052,68,461,2032,591
1368795,57,14,1956,10,female,948,424,165,2100,1564,406,419,1694,1145
1472719,16,23,1997,4,female,160,426,279,1994,745,1300,391,694,354
1284225,66,11,1947,10,male,1146,421,269,2240,801,1509,426,731,375
1675176,15,19,1998,10,female,256,431,298,2371,1201,2097,892,274,309
1748191,19,8,1994,5,female,207,410,200,2008,405,1979,283,29,122
2080666,37,5,1976,5,female,1340,436,273,2336,1611,1912,1064,424,547
2094526,16,18,1997,3,female,335,411,103,2215,4014,1727,1948,488,2066
1866860,35,30,1978,9,male,451,434,271,2339,189,2339,74,0,115
1900762,17,4,1996,2,male,167,431,342,2318,796,2318,553,0,243
1693052,46,13,1967,8,female,303,432,302,2030,1418,2030,1150,0,268
1325226,28,17,1985,7,female,178,428,229,2236,3542,2236,3383,0,159
1778053,17,3,1996,12,female,399,429,323,2859,719,15,220,2844,499
1432335,33,15,1980,8,female,242,431,210,2619,515,270,174,2349,341
1724844,95,22,1918,8,male,1737,436,242,3258,1088,128,506,3130,582
1649297,20,5,1993,7,female,770,413,147,3350,4818,90,2346,3260,2472
1198981,45,3,1968,2,male,219,420,75,2513,1796,1750,558,763,1238
2024258,16,21,1997,10,female,419,413,299,2628,1567,2278,1353,350,214
1998595,26,21,1987,3,female,1121,439,248,3178,2076,2692,1101,486,975
1957914,18,17,1995,6,female,247,427,212,3359,7956,3311,5907,48,2049
1157980,24,2,1989,11,male,368,425,286,2911,1534,2911,1422,0,112
1875126,23,8,1990,8,female,270,424,149,2642,1362,2642,1200,0,162
2011488,26,15,1987,1,male,193,437,346,2547,666,2547,573,0,93
2109815,42,18,1971,10,male,492,426,210,2611,583,2611,256,0,327
1445860,19,1,1994,1,female,74,427,36,3288,3389,3288,2671,0,718
1379311,18,15,1995,5,female,433,419,141,3783,1065,296,289,3487,776
1094721,36,19,1977,3,female,966,434,284,7964,1156,4196,988,3768,168
1383221,19,29,1994,10,female,1240,436,149,4071,2281,1111,394,2960,1887
1161776,21,15,1992,8,female,1744,412,173,5544,3201,3193,1595,2351,1606
1828510,18,23,1995,8,female,109,426,184,4708,3125,3328,1846,1380,1279
1366674,24,10,1989,10,female,519,414,135,6071,7704,4792,5543,1279,2161
1089270,15,13,1998,1,female,106,438,212,5447,2930,5447,1975,0,955
1337209,40,10,1973,6,female,653,411,263,4422,2347,4422,1165,0,1182
1921433,64,6,1949,2,female,1068,420,174,3716,1229,3716,750,0,479
1859725,14,26,1999,5,female,346,463,360,0,0,0,0,0,0
1695909,14,3,1999,10,male,301,449,400,0,1,0,0,0,1
1721932,15,1,1998,1,male,630,476,360,0,1,0,0,0,1
1730874,15,28,1998,2,male,951,474,302,0,2,0,2,0,0
2026287,15,20,1998,2,female,380,456,400,0,19,0,4,0,15
1903938,15,4,1998,5,male,537,471,372,0,0,0,0,0,0
1959420,15,15,1998,10,male,216,463,441,0,0,0,0,0,0
1113682,16,13,1997,1,male,623,454,418,0,1,0,1,0,0
1374698,16,14,1997,5,female,911,449,183,0,162,0,25,0,137
1183467,16,17,1997,7,female,883,455,179,0,2,0,1,0,1
2119633,16,2,1997,9,male,381,457,223,0,25,0,6,0,19
1555281,16,11,1997,10,female,679,452,399,0,69,0,27,0,42
1264831,18,1,1995,12,male,219,471,230,0,0,0,0,0,0
1386520,17,22,1996,5,male,518,472,374,0,0,0,0,0,0
1673154,17,10,1996,7,male,426,473,415,0,0,0,0,0,0
2109695,17,10,1996,10,male,219,445,387,0,1,0,1,0,0
1242494,18,6,1995,2,male,361,449,201,0,0,0,0,0,0
1280757,18,25,1995,2,male,317,447,269,0,30,0,19,0,11
1087991,18,1,1995,3,male,518,465,416,0,0,0,0,0,0
1881935,18,28,1995,4,female,613,442,388,0,0,0,0,0,0
1459971,18,6,1995,8,female,496,461,99,0,77,0,69,0,8
1443459,18,9,1995,8,male,277,443,349,0,2,0,1,0,1
2082731,18,17,1995,8,male,206,475,433,0,0,0,0,0,0
1081741,18,10,1995,9,male,422,445,291,0,1,0,1,0,0
2016222,18,10,1995,9,male,279,459,377,0,7,0,2,0,5
1062769,20,4,1993,11,male,446,458,49,0,1,0,0,0,1
1600428,19,6,1994,1,male,741,457,332,0,5,0,5,0,0
1640797,19,17,1994,5,male,892,447,371,0,0,0,0,0,0
1272429,19,25,1994,5,female,445,468,81,0,0,0,0,0,0
1533681,19,6,1994,7,male,643,474,189,0,9,0,9,0,0
1088153,19,9,1994,7,male,434,465,396,0,0,0,0,0,0
1017370,19,11,1994,8,male,808,467,363,0,1,0,0,0,1
2149784,19,6,1994,9,male,354,451,380,0,0,0,0,0,0
1504895,21,12,1992,12,male,928,471,300,0,0,0,0,0,0
1408466,20,24,1993,10,male,766,455,309,0,4,0,4,0,0
1778093,21,25,1992,2,male,470,452,403,0,0,0,0,0,0
1506956,21,15,1992,5,male,348,443,344,0,0,0,0,0,0
1639585,21,10,1992,5,male,338,470,431,0,25,0,19,0,6
1365650,21,12,1992,5,male,330,443,313,0,0,0,0,0,0
2184343,21,5,1992,6,male,298,452,326,0,0,0,0,0,0
1692231,22,14,1991,8,male,930,455,202,0,0,0,0,0,0
2175307,22,12,1991,9,male,969,448,284,0,5,0,1,0,4
1356639,22,25,1991,9,male,244,472,18,0,2,0,2,0,0
1308774,23,10,1990,1,female,1109,467,269,0,1,0,1,0,0
1570556,23,3,1990,2,male,574,453,362,0,18,0,5,0,13
1088408,23,13,1990,2,male,417,469,424,0,0,0,0,0,0
2118190,23,24,1990,3,NA,965,474,335,0,4,0,2,0,2
1171872,23,29,1990,3,male,409,457,425,0,5,0,5,0,0
1071211,23,4,1990,5,male,712,459,425,0,24,0,23,0,1
1690285,23,4,1990,7,male,883,442,299,0,8,0,5,0,3
1950923,23,20,1990,7,female,683,445,300,0,10,0,9,0,1
1797408,23,14,1990,7,male,340,474,397,0,0,0,0,0,0
1684491,24,17,1989,1,female,656,446,221,0,8,0,5,0,3
1426326,24,12,1989,1,male,564,454,182,0,0,0,0,0,0
1195500,25,12,1988,5,male,1211,445,361,0,1,0,1,0,0
1203984,25,8,1988,8,male,1205,445,251,0,0,0,0,0,0
1852076,25,7,1988,10,female,535,468,404,0,0,0,0,0,0
1370067,27,20,1986,3,male,182,468,358,0,8,0,0,0,8
1419880,27,21,1986,9,male,900,455,305,0,3,0,3,0,0
1305762,29,5,1984,11,male,773,448,313,0,0,0,0,0,0
2159843,31,23,1982,1,male,449,457,299,0,1,0,1,0,0
1986631,37,5,1976,9,male,1726,447,143,0,0,0,0,0,0
1821970,44,14,1969,2,male,878,473,333,0,5,0,5,0,0
1708398,46,1,1967,10,male,264,449,336,0,2,0,2,0,0
2067941,53,1,1960,4,male,214,472,203,0,0,0,0,0,0
1023799,57,14,1956,4,male,1403,470,172,0,0,0,0,0,0
1626967,59,12,1954,3,female,538,450,373,0,0,0,0,0,0
1830842,61,22,1952,1,male,1910,444,187,0,0,0,0,0,0
1070056,63,31,1950,12,male,199,466,206,0,0,0,0,0,0
1930072,64,29,1949,10,male,1665,462,250,0,0,0,0,0,0
1283393,85,1,1928,2,female,1516,464,246,0,2,0,2,0,0
1369059,94,11,1919,1,male,726,474,212,0,7,0,7,0,0
2132734,94,30,1919,4,female,1372,472,343,0,2,0,2,0,0
2159815,99,18,1914,6,male,542,452,376,0,8,0,5,0,3
1948958,99,1,1914,10,male,593,474,301,0,1,0,1,0,0
1499788,102,11,1911,2,male,1184,476,190,0,2,0,1,0,1
2043943,103,3,1910,3,female,646,445,282,0,29,0,12,0,17
2160820,103,10,1910,5,male,1544,458,279,0,2,0,2,0,0
2037923,108,20,1905,2,female,1335,474,164,0,0,0,0,0,0
1801392,108,10,1905,5,male,1008,444,186,0,2,0,0,0,2
2051289,108,7,1905,8,female,1331,460,48,0,1,0,1,0,0
1131602,108,16,1905,10,male,182,475,465,0,0,0,0,0,0
1404731,24,1,1989,7,female,701,474,287,1,0,0,0,1,0
1033717,52,25,1961,6,male,1242,442,145,1,0,0,0,1,0
1542884,17,16,1996,12,female,495,476,268,1,4,0,1,1,3
1916976,59,27,1954,5,male,1022,469,192,1,14,0,13,1,1
1907764,20,7,1993,5,female,259,464,179,1,0,1,0,0,0
1478155,36,22,1977,9,male,618,461,70,1,0,1,0,0,0
2050756,38,18,1975,2,male,640,453,357,1,0,1,0,0,0
1690060,103,31,1910,12,female,1549,457,189,1,0,1,0,0,0
1727986,17,22,1996,9,female,602,471,316,1,1,1,1,0,0
1435896,26,26,1987,12,male,914,472,329,1,1,1,1,0,0
2035996,53,4,1960,4,male,894,452,239,1,1,1,1,0,0
1765334,61,23,1952,1,male,1250,449,385,1,1,1,0,0,1
1519818,14,28,1999,12,male,285,454,288,1,17,1,16,0,1
1081640,14,23,1999,4,female,97,453,211,1,24,1,12,0,12
1944298,16,3,1997,9,female,335,467,165,1,129,1,66,0,63
1426969,17,22,1996,1,male,281,451,243,1,21,1,13,0,8
1121196,18,18,1995,1,female,582,445,326,1,8,1,8,0,0
1488548,20,9,1993,11,female,335,467,24,1,17,1,13,0,4
1630390,20,6,1993,12,female,788,448,304,1,4,1,4,0,0
2082123,20,17,1993,1,male,984,471,343,1,3,1,3,0,0
1610064,20,20,1993,2,female,424,458,206,1,11,1,11,0,0
1759897,20,25,1993,4,male,803,454,402,1,19,1,9,0,10
1283099,21,9,1992,1,male,688,471,340,1,6,1,3,0,3
1075274,23,30,1990,12,female,148,441,109,1,65,1,37,0,28
1292930,22,21,1991,4,male,678,473,447,1,37,1,23,0,14
1069771,26,17,1987,3,male,695,453,356,1,10,1,9,0,1
1286019,30,3,1983,12,male,1679,467,227,1,17,1,17,0,0
1419756,30,20,1983,4,male,459,475,443,1,18,1,5,0,13
1009420,31,27,1982,4,male,1107,459,157,1,10,1,6,0,4
1683684,68,4,1945,12,male,2179,454,151,1,6,1,4,0,2
2127662,95,18,1918,1,male,270,468,354,1,35,1,24,0,11
1475553,103,10,1910,12,male,886,449,424,1,14,1,8,0,6
1107806,103,14,1910,1,male,1020,449,435,1,6,1,4,0,2
1065581,103,5,1910,4,male,602,475,307,1,7,1,5,0,2
1063764,113,23,1900,3,male,1627,455,191,2,0,0,0,2,0
1885695,16,29,1997,12,male,320,472,412,2,10,0,7,2,3
1257479,23,17,1990,8,male,455,462,407,2,9,0,6,2,3
2076824,16,14,1997,4,male,670,458,400,2,0,1,0,1,0
1667520,20,12,1993,4,male,190,447,409,2,1,1,1,1,0
1070484,18,2,1995,4,female,874,442,67,2,7,1,4,1,3
1164711,18,17,1995,8,male,248,463,338,2,19,1,16,1,3
1702480,17,26,1996,12,male,979,445,344,2,0,2,0,0,0
1923163,18,4,1995,2,male,300,442,396,2,0,2,0,0,0
1816601,18,10,1995,6,male,999,470,339,2,0,2,0,0,0
1723649,32,10,1981,12,male,1580,473,305,2,0,2,0,0,0
1999136,103,10,1910,8,male,959,451,263,2,0,2,0,0,0
1617057,16,25,1997,7,male,479,465,424,2,1,2,0,0,1
1794170,16,16,1997,12,male,318,454,317,2,5,2,5,0,0
1814507,15,18,1998,7,male,311,473,436,2,12,2,3,0,9
1419397,18,17,1995,12,male,287,451,415,2,6,2,5,0,1
1705721,18,27,1995,2,male,224,476,389,2,17,2,9,0,8
1999883,18,18,1995,3,male,270,456,141,2,7,2,5,0,2
2015485,19,8,1994,9,male,316,453,281,2,11,2,10,0,1
1864646,21,6,1992,6,female,423,449,169,2,27,2,22,0,5
1835934,23,28,1990,12,male,570,445,382,2,30,2,20,0,10
1708922,22,8,1991,8,male,316,449,361,2,3,2,3,0,0
1533680,23,19,1990,1,female,316,464,114,2,24,2,20,0,4
1230527,23,25,1990,3,female,1340,464,64,2,15,2,14,0,1
1071088,23,7,1990,5,male,1406,455,310,2,6,2,5,0,1
1216219,27,14,1986,8,male,987,459,246,2,18,2,17,0,1
1310349,29,15,1984,7,male,776,451,391,2,13,2,9,0,4
1325740,50,17,1963,6,male,128,451,374,2,5,2,4,0,1
1997955,55,10,1958,8,male,746,441,311,2,5,2,4,0,1
1679914,59,20,1954,5,male,297,460,414,2,29,2,19,0,10
1241679,108,23,1905,4,male,830,465,276,2,26,2,22,0,4
1532031,17,22,1996,4,female,632,456,120,3,3,0,1,3,2
1832118,14,21,1999,2,male,243,473,343,3,24,0,0,3,24
1867705,64,2,1949,9,female,965,460,176,3,9,0,8,3,1
1213352,103,10,1910,2,female,539,466,372,3,16,1,14,2,2
1997914,23,26,1990,7,male,573,462,439,3,0,3,0,0,0
1414126,103,1,1910,1,female,737,444,250,3,0,3,0,0,0
1764455,108,24,1905,4,male,191,448,367,3,1,3,1,0,0
1402181,17,12,1996,5,female,479,465,290,3,3,3,2,0,1
1337696,17,16,1996,9,male,398,470,360,3,4,3,2,0,2
1891842,19,9,1994,11,female,435,474,247,3,2,3,2,0,0
1081567,18,3,1995,2,female,257,476,371,3,4,3,3,0,1
1179437,19,24,1994,5,male,877,471,404,3,2,3,1,0,1
1184363,103,30,1910,8,male,287,465,362,3,2,3,1,0,1
1078766,16,4,1997,3,male,641,469,370,3,474,3,407,0,67
1108272,18,3,1995,8,female,360,450,227,3,11,3,9,0,2
1302993,25,29,1988,10,female,73,460,31,3,60,3,27,0,33
1129555,29,10,1984,6,male,376,447,405,3,25,3,18,0,7
1457457,31,18,1982,3,female,603,468,57,3,29,3,7,0,22
1664505,37,1,1976,1,male,839,462,352,3,208,3,100,0,108
1297212,68,28,1945,7,male,947,470,302,3,37,3,22,0,15
1917200,20,24,1993,10,male,624,450,410,4,1,0,0,4,1
1742143,86,26,1927,3,male,1260,451,100,4,11,0,1,4,10
1027797,16,13,1997,6,male,206,463,168,4,1,1,0,3,1
1535786,23,12,1990,8,female,648,474,257,4,3,1,0,3,3
1758976,103,28,1910,8,male,589,471,431,4,5,2,5,2,0
1913692,24,3,1989,2,male,602,449,372,4,90,1,47,3,43
1440119,103,22,1910,3,male,877,443,86,4,23,2,15,2,8
2191309,27,15,1986,12,male,1165,445,179,4,1,3,1,1,0
1816707,25,5,1988,1,female,1603,476,99,4,39,3,18,1,21
2168825,108,26,1905,3,male,1002,466,89,4,0,4,0,0,0
1689593,19,1,1994,5,female,440,450,293,4,5,4,5,0,0
1043795,15,9,1998,11,male,361,467,387,4,36,4,34,0,2
1475107,17,8,1996,8,male,227,441,327,4,60,4,8,0,52
2037499,18,31,1995,1,male,648,465,351,4,17,4,14,0,3
1626333,19,25,1994,6,male,417,469,209,4,13,4,10,0,3
1022855,53,16,1960,4,female,970,467,205,4,55,4,31,0,24
1903280,22,19,1991,11,male,973,456,305,5,0,0,0,5,0
1366771,19,19,1994,8,male,407,449,252,5,1,0,0,5,1
1053726,21,24,1992,4,male,207,457,217,5,3,0,2,5,1
1365907,108,4,1905,12,male,1822,457,79,5,13,0,12,5,1
1843254,19,29,1994,3,male,258,466,355,5,15,1,4,4,11
1810632,20,7,1993,4,male,502,452,303,5,0,5,0,0,0
1898499,32,5,1981,7,male,776,463,392,5,2,5,2,0,0
1945690,15,10,1998,9,male,326,456,182,5,91,5,70,0,21
1348564,18,14,1995,7,female,414,476,355,5,99,5,63,0,36
1520230,21,24,1992,11,male,887,469,265,5,38,5,24,0,14
1982172,20,14,1993,7,female,300,447,124,5,9,5,7,0,2
1773741,21,27,1992,6,female,764,448,119,5,17,5,17,0,0
1059519,23,26,1990,5,male,643,470,286,5,15,5,15,0,0
1942926,88,26,1925,2,female,661,466,106,5,19,5,6,0,13
1329665,39,21,1974,7,male,205,475,382,6,0,0,0,6,0
1192385,19,27,1994,3,male,763,444,303,6,1,0,0,6,1
2102098,20,19,1993,6,female,592,443,317,6,86,4,24,2,62
1752014,17,25,1996,3,male,868,450,301,6,7,6,5,0,2
1612970,21,7,1992,2,male,672,441,260,6,4,6,2,0,2
1968409,29,15,1984,3,male,415,444,337,6,5,6,0,0,5
1931735,16,22,1997,2,male,249,451,217,6,10,6,8,0,2
2094988,18,9,1995,5,male,663,446,180,6,52,6,7,0,45
1635724,18,1,1995,6,female,370,442,313,6,13,6,12,0,1
1474087,26,3,1987,12,male,831,476,300,6,76,6,75,0,1
1747324,29,3,1984,5,male,1514,458,237,6,20,6,16,0,4
1298193,78,24,1935,10,male,876,446,388,6,67,6,26,0,41
1428841,103,5,1910,9,male,481,455,335,6,66,6,64,0,2
1867904,24,5,1989,12,female,306,463,243,7,4,0,0,7,4
1495235,24,23,1989,7,male,195,451,372,7,1,7,1,0,0
1261503,20,22,1993,8,female,592,465,118,7,661,7,588,0,73
2062393,21,17,1992,8,female,245,468,29,7,198,7,125,0,73
2090100,25,14,1988,1,male,756,468,237,7,229,7,193,0,36
2068963,25,27,1988,1,male,280,454,156,7,18,7,15,0,3
1472049,30,1,1983,1,male,830,448,201,7,11,7,8,0,3
1460201,62,4,1951,5,female,843,456,75,7,11,7,9,0,2
1239684,17,15,1996,10,male,818,442,301,8,2,0,0,8,2
1425879,26,30,1987,10,male,473,450,390,8,9,2,9,6,0
1837420,26,9,1987,6,male,623,475,382,8,6,8,6,0,0
1379864,19,11,1994,12,male,351,464,316,8,26,8,24,0,2
1451775,18,13,1995,4,female,275,475,51,8,13,8,11,0,2
2189762,108,8,1905,7,male,149,448,407,8,31,8,30,0,1
1625665,14,6,1999,7,male,213,452,237,9,0,0,0,9,0
1358669,21,2,1992,2,male,275,454,378,9,26,8,7,1,19
1544122,19,5,1994,8,male,243,456,393,9,0,9,0,0,0
1312750,38,3,1975,6,male,1445,448,88,9,1,9,0,0,1
1981345,13,13,2000,4,female,306,458,271,9,160,9,98,0,62
1950517,14,30,1999,5,female,512,470,87,9,20,9,18,0,2
1019216,17,9,1996,5,female,246,475,75,9,91,9,55,0,36
1805527,28,18,1985,1,male,243,465,234,10,17,6,3,4,14
1537351,47,11,1966,8,female,1616,455,183,10,73,8,45,2,28
2158379,32,31,1981,8,female,311,470,328,10,7,10,6,0,1
1586350,14,25,1999,6,female,15,461,68,10,305,10,132,0,173
2064008,17,12,1996,9,male,268,460,302,10,182,10,135,0,47
1453391,18,30,1995,6,female,241,453,306,10,34,10,18,0,16
1147599,55,1,1958,9,female,492,468,5,10,38,10,33,0,5
2130899,50,19,1963,1,male,767,471,280,11,0,0,0,11,0
1639192,15,21,1998,8,male,309,441,178,11,7,0,1,11,6
1429601,19,7,1994,4,male,384,452,390,11,13,0,10,11,3
1502390,20,12,1993,3,male,1131,464,68,11,28,7,15,4,13
1349635,108,15,1905,5,female,1648,457,138,11,3,10,2,1,1
2162570,35,17,1978,1,male,1445,458,277,11,30,10,17,1,13
1237984,26,15,1987,2,male,713,461,140,11,6,11,6,0,0
1385867,20,2,1993,1,female,234,470,269,11,201,11,76,0,125
1919611,26,7,1987,9,female,768,469,202,11,34,11,26,0,8
1555539,72,4,1941,4,male,1511,441,84,11,23,11,22,0,1
1153876,49,19,1964,4,female,1042,465,278,12,1,0,0,12,1
1456337,101,30,1912,1,male,1868,468,266,12,13,6,9,6,4
1973856,28,22,1985,7,female,1493,463,207,12,109,8,95,4,14
2040683,18,26,1995,9,male,535,443,309,12,13,11,8,1,5
1900003,18,29,1995,6,male,236,456,63,12,35,10,20,2,15
1185753,31,16,1982,9,male,353,443,398,12,1,12,1,0,0
1585272,21,26,1992,10,female,290,454,212,12,89,12,54,0,35
1537659,23,15,1990,8,male,399,474,425,12,56,12,42,0,14
1561755,21,9,1992,6,male,1181,449,167,13,17,0,8,13,9
1944330,22,4,1991,7,male,878,447,268,13,11,4,7,9,4
1495304,103,9,1910,9,NA,2112,451,360,13,16,5,3,8,13
1837948,15,5,1998,9,female,405,455,63,13,3,13,3,0,0
1930767,21,8,1992,10,male,744,473,240,13,10,13,8,0,2
1841368,26,27,1987,5,male,898,476,138,13,8,13,8,0,0
1970892,17,13,1996,3,male,188,445,386,13,130,13,59,0,71
1598509,17,27,1996,8,male,344,452,221,13,119,13,55,0,64
1119248,19,1,1994,1,male,418,459,283,13,99,13,61,0,38
1236373,21,11,1992,12,male,300,467,431,14,6,2,6,12,0
1327406,19,27,1994,5,female,558,441,157,14,10,0,0,14,10
1589155,108,3,1905,7,female,1456,454,175,14,99,14,87,0,12
1048588,68,27,1945,7,male,485,449,365,15,126,9,59,6,67
1901486,25,23,1988,3,male,594,451,358,15,3,15,3,0,0
1869706,20,22,1993,8,male,421,475,96,15,95,15,93,0,2
1405897,38,26,1975,7,male,1018,471,217,16,1,3,0,13,1
1388670,71,3,1942,12,female,730,446,319,16,32,0,9,16,23
1641454,108,1,1905,1,male,286,444,371,16,29,0,13,16,16
1083834,16,27,1997,5,female,378,447,292,16,104,15,56,1,48
1659036,27,10,1986,12,male,1303,464,208,16,29,16,13,0,16
1095863,53,3,1960,1,male,396,449,27,17,35,0,2,17,33
1116193,19,5,1994,10,female,323,457,396,17,10,11,7,6,3
1366025,47,10,1966,4,male,208,468,77,17,318,11,173,6,145
1680317,18,14,1995,10,female,374,457,402,17,17,16,10,1,7
1036364,21,23,1992,2,male,577,476,321,17,10,17,6,0,4
1995186,95,7,1918,3,male,1596,443,263,17,12,17,9,0,3
1927601,15,17,1998,8,female,53,447,52,17,151,17,115,0,36
1980327,24,28,1989,3,male,437,467,362,17,107,17,80,0,27
1660710,20,15,1993,12,male,495,446,325,18,14,18,9,0,5
1828368,14,6,1999,5,male,50,466,445,18,80,18,75,0,5
2047310,27,1,1986,12,male,430,471,409,18,28,18,26,0,2
1701874,106,18,1907,11,female,2926,456,209,19,12,0,7,19,5
1659422,15,26,1998,9,female,646,442,177,19,16,9,16,10,0
2005957,64,8,1949,3,female,1291,455,66,19,16,13,4,6,12
1117298,16,22,1997,3,male,650,456,231,19,70,15,27,4,43
1060744,17,12,1996,2,female,819,468,114,19,34,19,15,0,19
1992314,18,12,1995,1,female,292,451,335,19,179,19,170,0,9
1230460,19,14,1994,3,female,518,443,259,19,40,19,39,0,1
2070022,19,20,1994,10,male,403,456,309,20,15,2,9,18,6
1883192,108,1,1905,1,male,1694,465,266,20,70,0,54,20,16
1174510,16,1,1997,6,female,825,453,283,20,23,20,17,0,6
1905646,26,3,1987,10,male,317,454,412,20,36,20,27,0,9
1909505,105,1,1908,10,male,1234,460,389,21,43,1,28,20,15
1726978,20,2,1993,4,female,724,471,257,21,62,8,23,13,39
1973249,31,11,1982,6,male,1326,459,347,21,11,21,7,0,4
1390336,19,5,1994,10,male,812,471,331,21,21,21,16,0,5
1078855,108,21,1905,3,female,210,467,340,21,83,21,83,0,0
1699112,108,5,1905,8,female,1194,449,224,22,14,0,7,22,7
1895257,21,16,1992,4,male,1075,461,343,22,65,17,42,5,23
1879947,15,9,1998,4,male,722,476,302,22,0,22,0,0,0
1265167,19,2,1994,10,male,299,447,378,22,1,22,1,0,0
1147562,36,29,1977,8,male,252,465,162,22,11,22,9,0,2
1064131,108,26,1905,1,female,1133,457,217,22,18,22,18,0,0
1849683,20,5,1993,10,male,769,445,140,22,240,22,223,0,17
1053411,21,19,1992,3,male,168,468,430,23,97,4,72,19,25
1708092,20,12,1993,9,male,220,448,412,23,14,22,9,1,5
1521824,29,16,1984,1,male,676,456,157,23,5,23,4,0,1
1480844,15,14,1998,5,male,816,474,268,23,83,23,63,0,20
1186409,17,3,1996,6,female,401,460,257,23,55,23,32,0,23
1337400,22,5,1991,7,female,425,476,135,23,119,23,110,0,9
1193152,23,24,1990,1,male,378,462,374,23,43,23,7,0,36
2007387,68,22,1945,2,male,1203,447,227,23,47,23,31,0,16
1083138,18,8,1995,7,male,89,464,319,24,80,3,42,21,38
1699884,22,16,1991,11,male,693,447,396,24,27,15,10,9,17
1345497,25,19,1988,8,female,247,460,233,24,126,24,100,0,26
2052387,19,29,1994,4,female,390,468,300,25,34,25,30,0,4
2014813,20,11,1993,8,male,352,468,381,25,42,25,37,0,5
1356136,19,19,1994,5,male,395,443,197,26,20,15,2,11,18
1147765,18,4,1995,11,male,887,476,355,26,2,26,2,0,0
1306498,18,1,1995,8,male,391,475,436,26,2,26,2,0,0
1936274,14,8,1999,5,female,196,471,88,26,9,26,5,0,4
1280270,18,19,1995,5,male,1193,448,161,26,18,26,13,0,5
1939673,24,6,1989,12,male,320,448,414,26,27,26,23,0,4
1430832,103,16,1910,4,female,1234,471,176,27,27,15,15,12,12
1894122,103,23,1910,8,female,285,442,195,27,113,11,34,16,79
1607383,23,15,1990,5,female,334,451,394,27,43,23,36,4,7
1019569,21,12,1992,12,male,489,473,318,27,28,27,26,0,2
1873507,108,1,1905,1,female,1109,456,113,28,52,0,14,28,38
1241324,18,12,1995,10,male,293,467,405,28,11,28,9,0,2
1339042,22,4,1991,9,female,81,449,205,28,242,28,132,0,110
1839706,18,12,1995,4,male,223,458,297,29,0,29,0,0,0
1029710,19,17,1994,6,male,570,455,310,29,20,29,12,0,8
1720556,15,5,1998,12,male,621,466,411,30,1,0,0,30,1
1656861,16,8,1997,8,male,512,475,298,31,60,1,41,30,19
2136261,17,6,1996,9,female,649,447,263,30,40,13,8,17,32
1961295,73,21,1940,12,female,97,474,428,30,252,9,154,21,98
1425363,23,30,1990,3,male,1352,476,151,30,3,27,2,3,1
1835914,51,6,1962,6,male,635,447,287,31,34,27,29,4,5
1936456,73,25,1940,5,NA,1509,470,360,31,126,30,22,1,104
1045658,108,26,1905,2,male,1570,460,142,30,109,28,75,2,34
1759639,25,12,1988,10,male,325,442,321,30,18,30,17,0,1
1836988,83,15,1930,4,male,1438,471,96,31,16,31,16,0,0
1349885,23,16,1990,4,male,225,459,417,31,20,31,13,0,7
1459772,26,6,1987,6,female,648,456,221,31,69,31,51,0,18
1046741,103,24,1910,11,male,920,460,131,30,45,30,29,0,16
1344769,60,23,1953,8,male,318,466,294,32,18,3,12,29,6
1224320,80,12,1933,5,male,1853,457,203,32,14,0,5,32,9
1060332,100,2,1913,7,male,2080,466,285,32,67,0,62,32,5
1212233,107,10,1906,4,male,1379,452,326,32,63,0,22,32,41
1822623,14,14,1999,2,female,419,470,157,32,4,10,2,22,2
1842250,14,19,1999,3,female,358,450,52,32,2,32,1,0,1
1679446,17,17,1996,6,female,227,454,177,32,13,32,6,0,7
1215073,20,19,1993,4,male,595,447,406,32,31,32,21,0,10
1351728,26,10,1987,6,male,1047,442,244,32,46,32,35,0,11
1869387,19,15,1994,11,male,183,459,419,33,5,0,1,33,4
1105528,23,30,1990,5,male,374,466,402,33,12,28,12,5,0
1417430,20,22,1993,4,female,643,473,152,33,2,33,2,0,0
1019505,17,2,1996,5,male,777,466,359,34,0,4,0,30,0
2088421,14,31,1999,12,male,143,475,275,34,44,17,10,17,34
1314102,103,15,1910,6,male,1510,465,202,34,24,30,15,4,9
1165095,31,15,1982,8,male,887,458,299,34,5,34,5,0,0
1776582,18,14,1995,8,female,176,459,114,34,136,34,98,0,38
2024664,21,5,1992,11,male,443,471,346,34,131,34,115,0,16
1778135,63,10,1950,11,male,752,457,229,36,77,0,23,36,54
1298578,73,26,1940,6,female,1740,442,291,35,14,23,9,12,5
1306758,18,28,1995,9,male,395,476,218,36,116,25,63,11,53
1720400,26,1,1987,1,male,781,451,293,36,149,26,130,10,19
2158170,19,23,1994,6,male,373,474,394,36,82,33,58,3,24
1611162,17,22,1996,12,male,493,448,212,36,30,36,14,0,16
1018831,22,24,1991,1,female,413,456,202,35,62,35,57,0,5
1878550,107,26,1906,11,male,876,464,218,35,168,35,132,0,36
1687546,17,20,1996,9,male,414,461,427,37,3,0,3,37,0
2135891,15,24,1998,9,male,93,468,425,37,87,12,58,25,29
1855644,20,17,1993,10,female,48,462,190,37,200,35,158,2,42
1627616,18,7,1995,7,male,331,475,406,37,17,37,11,0,6
1258567,15,24,1998,7,female,188,469,227,37,137,37,93,0,44
1418894,27,1,1986,1,male,458,464,298,38,12,0,5,38,7
1729912,102,9,1911,5,male,1083,452,265,39,17,0,5,39,12
1452899,17,26,1996,12,female,700,463,122,38,62,27,11,11,51
1218829,19,25,1994,12,female,731,468,161,38,9,36,4,2,5
1268492,22,4,1991,2,male,551,450,360,38,8,37,4,1,4
1599135,29,19,1984,11,female,204,449,238,39,44,37,17,2,27
1605455,22,23,1991,6,female,740,468,168,39,100,38,86,1,14
2189604,14,20,1999,6,male,496,474,325,39,36,39,34,0,2
1353517,22,13,1991,6,male,437,451,249,38,27,38,16,0,11
1174599,14,29,1999,4,female,287,441,196,38,107,38,53,0,54
1436232,14,13,1999,5,male,383,461,238,40,4,1,3,39,1
1476602,103,11,1910,2,male,1354,463,282,40,26,0,17,40,9
1619364,15,18,1998,3,male,825,445,316,40,13,20,5,20,8
1241178,18,5,1995,11,female,367,462,137,40,1255,34,711,6,544
1642258,49,28,1964,1,female,530,468,326,40,140,34,64,6,76
1166559,16,29,1997,7,male,997,473,315,40,46,40,38,0,8
1055439,103,15,1910,8,male,853,460,223,40,38,40,37,0,1
1591850,24,7,1989,6,male,1092,453,164,41,10,0,8,41,2
1878990,55,29,1958,5,male,1688,471,352,41,19,10,13,31,6
1198770,101,11,1912,4,male,1777,442,303,41,64,26,19,15,45
1277968,27,1,1986,7,female,199,452,316,41,20,41,12,0,8
1161064,108,18,1905,9,male,2306,472,74,41,43,41,37,0,6
2066462,18,2,1995,10,female,240,441,306,41,140,41,110,0,30
1850214,19,1,1994,9,male,441,449,289,44,175,3,33,41,142
2060400,53,25,1960,4,male,1512,441,253,44,46,13,18,31,28
1822451,73,7,1940,10,male,285,445,414,44,27,44,23,0,4
1523913,107,26,1906,2,female,63,475,411,45,78,0,11,45,67
1490383,22,19,1991,4,male,266,455,390,45,19,45,15,0,4
1824336,81,5,1932,11,female,1687,460,189,45,46,45,45,0,1
2109877,27,20,1986,12,male,515,474,297,45,97,45,51,0,46
2053860,21,20,1992,3,male,306,451,306,46,26,6,14,40,12
1628023,17,22,1996,5,female,385,441,154,47,368,0,213,47,155
1413910,16,25,1997,2,male,476,453,392,46,22,17,4,29,18
2121754,17,19,1996,11,male,297,442,358,47,6,39,2,8,4
1013059,42,2,1971,2,male,135,462,419,47,257,40,167,7,90
2089901,24,15,1989,12,male,500,450,341,47,11,47,11,0,0
1002786,13,9,2000,5,female,349,447,220,46,36,46,35,0,1
1719417,17,26,1996,9,male,292,467,252,47,156,47,66,0,90
1649308,17,3,1996,10,male,537,471,256,46,113,46,104,0,9
1077237,24,6,1989,12,female,797,476,274,46,128,46,100,0,28
1373338,94,19,1919,5,male,729,456,374,48,3,0,0,48,3
1947809,103,11,1910,8,male,796,463,287,49,66,0,17,49,49
1791188,24,1,1989,3,female,608,465,261,48,54,46,51,2,3
2161450,18,6,1995,11,female,595,459,342,49,87,38,41,11,46
2051648,20,5,1993,8,female,263,443,307,48,24,48,21,0,3
1300576,48,25,1965,1,male,474,448,234,51,13,9,9,42,4
1050173,108,12,1905,5,male,920,460,225,50,38,0,10,50,28
1231369,100,2,1913,10,female,1599,467,328,50,92,0,16,50,76
1964655,20,16,1993,8,male,270,454,373,51,86,42,43,9,43
1361395,15,4,1998,3,male,180,451,356,50,30,50,11,0,19
1321814,106,9,1907,6,male,1859,462,130,53,23,3,9,50,14
1012243,100,16,1913,12,female,2004,449,246,52,3,17,3,35,0
1435307,21,24,1992,1,male,631,472,305,53,4,51,2,2,2
1263747,68,20,1945,4,male,882,454,348,52,5,52,5,0,0
1719146,106,22,1907,12,female,108,459,316,52,21,52,17,0,4
1146177,20,14,1993,11,male,311,445,345,53,109,53,67,0,42
1849372,108,8,1905,7,male,301,471,314,52,193,52,153,0,40
1418214,113,20,1900,6,male,1522,450,287,55,2,0,0,55,2
1907873,20,14,1993,5,male,598,453,292,54,99,49,49,5,50
1215174,69,17,1944,10,male,661,443,256,54,219,42,141,12,78
1520671,19,10,1994,11,male,378,466,316,55,10,55,10,0,0
1719905,16,20,1997,11,male,426,455,301,57,6,0,2,57,4
1532080,101,28,1912,7,female,1533,442,319,56,5,19,3,37,2
1505933,20,29,1993,11,male,659,471,340,58,43,33,20,25,23
1576736,81,4,1932,5,female,1562,466,111,57,534,24,380,33,154
1992132,19,28,1994,11,male,643,461,395,56,23,54,23,2,0
1100503,18,27,1995,6,male,484,444,262,58,30,53,14,5,16
1942225,69,25,1944,4,male,1675,460,211,58,11,57,10,1,1
1913790,100,16,1913,2,male,1413,455,76,56,51,52,29,4,22
1250463,14,1,1999,8,male,253,452,71,56,11,56,7,0,4
1782015,40,27,1973,6,female,511,465,340,56,21,56,16,0,5
1997741,21,19,1992,11,male,654,449,316,57,61,57,27,0,34
1240111,103,2,1910,9,male,578,468,261,57,48,57,44,0,4
1080031,16,27,1997,3,female,131,456,144,60,9,0,2,60,7
1444583,90,26,1923,4,male,1420,447,187,59,2,0,2,59,0
1055925,103,10,1910,10,male,1765,461,339,60,132,1,58,59,74
1894055,18,25,1995,5,male,215,445,410,59,22,32,18,27,4
1795908,53,10,1960,8,female,1556,456,349,60,133,48,118,12,15
1973136,113,27,1900,10,female,1534,470,158,60,177,51,97,9,80
1812006,16,4,1997,4,male,481,469,263,59,12,59,4,0,8
1865724,83,29,1930,6,male,513,446,341,60,39,60,26,0,13
1610998,103,14,1910,3,female,654,473,185,59,36,59,22,0,14
1784105,25,2,1988,12,female,265,448,247,60,909,60,747,0,162
1090018,17,21,1996,4,male,482,451,252,62,18,2,6,60,12
1394302,18,20,1995,12,female,495,443,213,62,75,58,55,4,20
2132524,19,17,1994,6,male,355,469,377,61,24,61,20,0,4
1142413,19,14,1994,3,male,528,461,347,63,58,63,45,0,13
1537441,23,20,1990,4,female,490,467,323,65,66,38,24,27,42
2179477,15,20,1998,4,male,303,471,321,64,146,16,55,48,91
1704998,69,1,1944,7,female,1847,461,405,65,31,56,19,9,12
1191690,24,22,1989,2,female,635,471,88,65,223,65,183,0,40
1432691,22,22,1991,11,male,1525,473,155,67,393,12,172,55,221
1694671,17,6,1996,6,male,650,461,237,66,18,26,5,40,13
1053125,18,5,1995,6,male,722,473,299,67,92,46,75,21,17
1306722,102,8,1911,6,male,2096,452,143,66,97,15,43,51,54
1305636,16,10,1997,1,male,774,475,269,68,31,65,10,3,21
1785253,26,4,1987,9,male,325,441,206,68,39,67,9,1,30
1537093,108,2,1905,3,female,1703,447,227,67,59,67,36,0,23
2145113,46,12,1967,2,female,297,442,331,71,13,0,8,71,5
1261987,83,16,1930,3,female,1434,445,193,69,102,0,25,69,77
1924613,15,20,1998,5,female,366,473,241,71,58,22,14,49,44
1664695,16,22,1997,5,female,489,453,340,69,410,44,323,25,87
1933948,22,16,1991,8,male,1490,458,182,69,522,46,209,23,313
1657935,53,18,1960,11,female,437,472,439,71,6,54,5,17,1
1355457,23,18,1990,7,female,405,454,72,69,48,65,22,4,26
1994538,18,8,1995,11,female,512,441,212,71,167,55,108,16,59
1969030,18,27,1995,9,male,267,455,262,69,392,64,282,5,110
1803794,17,3,1996,7,female,376,443,198,69,353,69,337,0,16
1179900,18,21,1995,11,female,288,447,289,74,14,13,2,61,12
2059126,15,26,1998,10,female,155,454,352,73,110,7,12,66,98
1030973,108,23,1905,11,male,2065,476,203,73,6,42,5,31,1
1833683,24,18,1989,11,female,1080,446,171,72,52,33,25,39,27
1219381,47,25,1966,8,male,295,470,348,73,585,47,173,26,412
1401101,61,18,1952,1,female,828,452,75,72,8,72,4,0,4
1020494,19,8,1994,10,female,275,468,33,72,29,72,27,0,2
1804054,50,31,1963,1,male,363,461,387,77,53,0,14,77,39
1473884,108,7,1905,8,male,1854,462,248,75,205,3,51,72,154
1606782,16,28,1997,11,male,181,453,383,75,48,25,39,50,9
1825300,22,15,1991,1,female,1434,453,309,75,126,51,97,24,29
1551063,68,10,1945,3,male,1416,476,354,77,69,70,40,7,29
1036069,93,14,1920,6,male,2118,452,166,77,101,61,43,16,58
1440318,21,7,1992,8,male,677,462,422,77,23,77,19,0,4
1542435,19,31,1994,12,female,426,464,230,77,68,77,35,0,33
2159442,23,25,1990,10,male,542,461,229,76,78,76,67,0,11
1335575,16,1,1997,9,male,625,441,356,80,103,37,32,43,71
1240977,44,12,1969,6,female,2078,459,216,80,109,71,99,9,10
1983695,68,15,1945,3,male,1317,443,287,78,220,60,209,18,11
1258502,20,22,1993,8,male,1138,463,259,80,106,80,92,0,14
1654842,35,3,1978,2,female,1112,451,188,83,67,6,42,77,25
2133359,47,23,1966,10,female,1708,460,346,84,208,1,80,83,128
1631358,79,1,1934,2,male,1934,467,238,81,89,32,72,49,17
1023124,48,20,1965,1,male,2255,471,248,82,174,24,115,58,59
1787873,18,22,1995,3,female,360,458,314,82,39,60,32,22,7
2142817,23,18,1990,6,female,644,446,175,84,46,84,44,0,2
2166838,56,2,1957,9,female,398,476,307,82,67,82,50,0,17
1783731,20,20,1993,7,male,278,459,426,85,60,85,50,0,10
2121148,23,30,1990,4,male,454,443,412,85,63,85,48,0,15
1811705,27,7,1986,2,male,766,463,265,86,109,86,86,0,23
1553522,19,17,1994,7,female,87,468,278,89,95,13,33,76,62
2057190,31,6,1982,4,female,1563,454,282,88,275,40,227,48,48
1520448,103,3,1910,3,male,575,473,388,89,10,73,6,16,4
1971812,21,7,1992,8,female,533,458,259,91,91,80,71,11,20
1829981,16,22,1997,6,male,265,465,286,94,45,7,39,87,6
2045061,16,23,1997,8,female,256,441,266,94,209,43,37,51,172
1460865,65,15,1948,1,female,1432,471,164,92,166,56,70,36,96
1968113,13,28,2000,1,male,656,450,268,93,5,70,0,23,5
2087567,33,16,1980,4,male,615,453,246,95,85,94,52,1,33
1196581,50,20,1963,8,male,1311,461,203,94,398,83,274,11,124
1643195,102,31,1911,1,female,527,448,289,93,140,93,114,0,26
1574754,103,10,1910,1,male,1094,476,368,95,182,95,173,0,9
2108075,22,10,1991,9,female,744,443,365,99,9,23,3,76,6
2158339,21,10,1992,5,female,1573,466,331,97,100,37,65,60,35
1347279,107,8,1906,2,female,1084,446,198,97,139,78,53,19,86
1037613,22,16,1991,2,female,852,443,248,96,240,78,185,18,55
1680340,23,8,1990,6,male,611,444,323,97,48,97,33,0,15
1210631,25,5,1988,1,male,155,454,422,97,358,97,306,0,52
1554851,20,16,1993,9,male,430,449,420,100,6,77,6,23,0
1882266,100,14,1913,10,female,1832,475,215,103,40,88,30,15,10
2131468,15,8,1998,10,female,478,475,302,100,404,99,184,1,220
1397314,19,7,1994,10,female,298,447,100,100,163,100,147,0,16
1832192,26,26,1987,7,male,355,466,389,109,317,102,66,7,251
1527922,47,16,1966,12,male,842,452,348,107,11,106,6,1,5
1664329,23,19,1990,6,male,587,443,335,105,43,105,35,0,8
1316925,103,8,1910,2,female,764,465,115,107,227,107,126,0,101
1931489,15,3,1998,6,female,409,473,343,113,172,33,35,80,137
1121913,19,2,1994,12,female,507,471,301,111,119,111,116,0,3
1044701,108,18,1905,11,female,408,459,178,111,128,111,82,0,46
1933863,68,9,1945,9,male,1858,472,196,116,18,0,6,116,12
1480754,21,25,1992,3,female,311,446,272,114,195,55,45,59,150
1707082,108,3,1905,11,male,952,475,341,119,75,111,36,8,39
1402068,21,25,1992,4,female,1030,476,197,118,272,117,103,1,169
2143146,75,3,1938,7,male,589,468,370,116,34,116,31,0,3
1509396,38,16,1975,10,male,544,456,396,117,173,117,120,0,53
1559661,19,12,1994,10,female,376,461,262,116,249,116,207,0,42
1273405,56,12,1957,5,female,1712,467,31,119,1215,119,935,0,280
1308440,108,13,1905,5,male,1118,473,232,121,17,20,11,101,6
1180347,16,3,1997,3,male,262,474,355,123,1,49,1,74,0
1699308,20,17,1993,12,male,343,445,255,124,62,84,32,40,30
1060021,108,3,1905,12,male,844,473,230,121,140,29,51,92,89
1587433,17,13,1996,7,male,581,443,344,124,187,78,116,46,71
1341936,103,26,1910,8,male,1678,450,103,122,136,113,50,9,86
1534738,19,4,1994,9,female,335,448,296,123,62,123,39,0,23
2129375,25,15,1988,7,male,190,441,417,123,53,123,41,0,12
1157708,28,5,1985,7,female,210,454,249,123,73,123,61,0,12
1615285,18,26,1995,6,male,655,459,317,122,94,122,87,0,7
1556424,17,30,1996,3,female,290,465,259,130,29,1,9,129,20
2026525,14,26,1999,5,male,465,444,268,127,543,77,338,50,205
1907624,90,30,1923,3,female,2098,474,251,127,183,111,87,16,96
1192378,18,19,1995,2,female,1762,462,245,129,334,117,196,12,138
1170896,68,20,1945,12,female,1400,448,176,128,64,127,38,1,26
1659296,20,8,1993,1,female,638,458,334,127,34,127,26,0,8
1326640,17,21,1996,6,female,528,466,370,129,98,129,66,0,32
1783780,18,19,1995,4,male,681,475,296,127,88,127,73,0,15
1433883,22,18,1991,1,female,769,453,183,126,453,126,363,0,90
1183963,34,7,1979,10,male,667,466,394,134,4,67,2,67,2
1222821,20,24,1993,9,male,862,463,178,132,45,101,17,31,28
1665249,28,10,1985,6,male,702,449,395,135,24,134,17,1,7
2173008,15,24,1998,5,female,104,442,110,133,105,133,56,0,49
1365574,18,22,1995,3,male,253,458,415,133,116,133,98,0,18
1392082,30,28,1983,8,male,513,448,372,136,246,136,201,0,45
1665250,15,11,1998,10,female,386,462,350,142,19,101,12,41,7
1111102,14,8,1999,6,female,360,445,146,141,273,69,141,72,132
1081346,15,2,1998,2,male,406,472,351,140,12,105,3,35,9
1307321,17,27,1996,4,female,546,470,259,140,36,138,35,2,1
1662677,18,22,1995,6,female,220,476,152,138,237,105,177,33,60
1210000,18,11,1995,5,male,199,459,357,142,110,142,102,0,8
1854335,21,10,1992,4,male,621,449,313,141,125,141,104,0,21
1935615,27,14,1986,2,male,299,465,406,139,163,139,145,0,18
1134261,62,22,1951,5,male,1651,445,350,150,175,96,80,54,95
1401592,108,4,1905,6,female,1676,442,379,148,33,137,30,11,3
2013785,16,22,1997,11,female,486,475,242,149,100,134,87,15,13
1455762,18,22,1995,9,female,477,452,322,145,392,130,317,15,75
1897138,18,21,1995,7,male,653,462,215,144,185,144,100,0,85
1622978,108,5,1905,5,male,1734,454,284,146,94,146,73,0,21
1117102,30,14,1983,2,female,175,453,383,149,414,149,280,0,134
2163357,21,11,1992,9,female,158,459,412,157,5,0,4,157,1
1434811,65,23,1948,7,female,1073,468,343,157,238,2,177,155,61
1115916,23,4,1990,3,male,393,471,342,152,54,147,46,5,8
1373003,18,6,1995,7,female,586,469,203,155,199,119,127,36,72
1053033,28,18,1985,9,female,532,446,328,157,307,118,132,39,175
1972318,31,9,1982,1,female,1575,476,158,157,62,157,44,0,18
1331343,100,1,1913,11,female,1072,450,127,153,152,153,122,0,30
1782047,31,18,1982,5,female,464,450,334,158,49,12,15,146,34
1809755,14,27,1999,6,female,438,445,199,162,138,3,33,159,105
1218188,15,12,1998,4,male,543,468,242,164,192,136,98,28,94
1744609,21,21,1992,9,female,1457,473,82,160,802,158,661,2,141
1715473,108,15,1905,3,male,910,443,239,161,247,146,210,15,37
1436609,19,29,1994,12,male,461,463,369,159,125,159,109,0,16
2033038,26,2,1987,4,female,262,450,229,164,111,164,71,0,40
1366638,27,14,1986,8,female,636,461,362,164,165,164,73,0,92
2072176,27,16,1986,4,male,492,452,330,171,149,0,129,171,20
1727845,33,8,1980,10,male,319,459,359,169,67,66,25,103,42
2162386,16,29,1997,5,female,508,470,255,167,253,112,219,55,34
1360583,14,10,1999,3,female,592,455,324,166,18,133,16,33,2
1985564,25,9,1988,5,male,585,441,335,168,26,135,5,33,21
2114452,29,12,1984,9,male,557,464,396,167,143,144,133,23,10
1372815,17,7,1996,1,female,107,462,113,169,279,159,225,10,54
2010805,27,10,1986,6,female,699,464,258,165,512,162,471,3,41
1678284,19,23,1994,3,female,326,445,100,165,24,165,13,0,11
2107142,68,10,1945,10,male,991,441,359,166,36,166,32,0,4
1286999,20,23,1993,11,male,506,452,312,167,166,167,130,0,36
1787017,18,5,1995,3,female,205,446,132,165,528,165,473,0,55
2130791,29,31,1984,7,female,827,465,277,178,282,10,133,168,149
1256315,15,12,1998,6,male,503,451,328,174,48,37,28,137,20
1627998,16,29,1997,9,female,296,469,378,176,191,69,129,107,62
1122890,19,11,1994,2,male,265,455,311,180,81,159,64,21,17
1488854,50,21,1963,4,female,844,465,342,176,222,171,164,5,58
1877113,39,14,1974,11,female,407,442,381,175,378,145,189,30,189
2028052,31,3,1982,3,male,427,475,333,174,24,174,15,0,9
2163547,27,11,1986,7,male,458,471,406,173,116,173,108,0,8
1400005,29,16,1984,4,male,415,467,394,173,117,173,106,0,11
1217201,18,3,1995,3,male,231,442,250,177,450,177,341,0,109
1253682,18,18,1995,7,female,243,454,195,177,464,177,385,0,79
1770753,21,11,1992,11,female,346,466,161,179,630,179,547,0,83
1554603,59,2,1954,10,female,1189,441,183,185,17,0,1,185,16
1467443,32,3,1981,11,female,1401,446,159,186,190,100,118,86,72
1934585,29,1,1984,1,female,203,462,400,190,334,76,217,114,117
1275739,17,18,1996,9,male,1483,451,133,190,85,162,27,28,58
2157344,25,17,1988,1,female,1523,450,143,187,107,172,56,15,51
1663807,15,17,1998,7,female,755,460,240,190,204,171,145,19,59
1525115,37,1,1976,7,male,803,460,403,188,163,176,88,12,75
1436169,15,15,1998,5,female,333,441,114,182,215,182,206,0,9
2010197,19,2,1994,5,female,334,469,119,189,129,189,83,0,46
1449756,19,10,1994,10,female,217,469,105,186,240,186,140,0,100
1765852,20,27,1993,2,male,329,467,350,190,249,190,239,0,10
1359048,74,8,1939,3,male,1646,458,226,193,13,90,8,103,5
1672485,40,2,1973,12,female,616,466,280,200,80,130,64,70,16
2079321,108,8,1905,5,male,510,461,179,198,136,68,60,130,76
1544617,29,19,1984,12,male,397,450,397,196,107,164,34,32,73
1346843,51,22,1962,5,female,474,445,187,195,128,192,65,3,63
1950626,26,30,1987,4,male,698,444,190,199,210,197,121,2,89
1029177,17,16,1996,1,female,157,454,328,193,67,193,42,0,25
1513260,24,25,1989,8,female,260,444,99,194,112,194,60,0,52
1324536,18,4,1995,3,female,506,444,213,202,101,63,58,139,43
2099869,103,20,1910,11,male,1540,458,251,208,346,57,207,151,139
1713701,103,5,1910,1,male,900,471,319,206,385,134,266,72,119
1207929,103,30,1910,11,female,1426,446,228,205,166,181,134,24,32
2049667,21,24,1992,6,female,567,466,363,210,135,209,122,1,13
1865498,27,4,1986,5,male,331,442,382,204,60,204,36,0,24
1952673,21,21,1992,4,female,503,442,262,210,160,210,151,0,9
1938755,93,7,1920,6,male,569,461,258,201,176,201,168,0,8
1911178,21,16,1992,3,male,625,455,185,215,168,128,103,87,65
1686097,46,19,1967,10,female,558,459,328,219,251,78,163,141,88
1580623,21,9,1992,7,male,229,452,364,214,145,193,77,21,68
1399117,25,1,1988,10,male,1260,466,198,217,172,205,138,12,34
1754366,68,26,1945,3,male,430,474,299,221,139,162,45,59,94
1833560,15,14,1998,6,female,183,475,221,217,329,213,156,4,173
1914505,24,20,1989,7,male,545,443,286,213,468,178,406,35,62
1895360,18,15,1995,2,female,458,470,162,220,583,218,407,2,176
1016833,107,10,1906,7,male,1365,476,70,221,114,221,81,0,33
1458751,21,16,1992,12,female,304,448,358,215,160,215,150,0,10
2013095,33,17,1980,3,male,431,451,347,215,540,215,415,0,125
1475809,14,28,1999,8,male,249,447,276,233,71,2,21,231,50
1073197,22,16,1991,5,male,389,469,327,233,40,0,26,233,14
1292150,37,8,1976,12,male,1797,463,348,222,72,112,55,110,17
1559877,20,30,1993,3,female,209,458,156,226,156,117,63,109,93
1748536,23,29,1990,10,female,1438,458,196,229,187,63,76,166,111
1203648,17,4,1996,11,male,374,441,280,227,366,128,110,99,256
2104013,30,19,1983,12,female,967,472,248,226,437,153,243,73,194
1714972,102,3,1911,3,female,1998,459,204,226,68,212,39,14,29
2053005,108,1,1905,1,male,1656,461,245,224,217,196,66,28,151
1357079,34,3,1979,9,female,368,448,323,224,984,210,778,14,206
1365353,21,18,1992,7,male,454,441,191,229,180,228,98,1,82
1080116,19,1,1994,2,male,522,452,386,228,193,228,179,0,14
1347768,19,11,1994,11,female,386,448,78,223,365,223,245,0,120
1041375,108,1,1905,1,male,1487,473,197,244,439,0,354,244,85
1905773,15,29,1998,9,female,409,446,375,242,54,139,11,103,43
1849751,20,19,1993,12,female,701,460,350,245,131,153,72,92,59
1099900,84,30,1929,12,male,1905,448,221,234,509,80,369,154,140
1332058,31,19,1982,3,female,2023,456,129,237,854,204,717,33,137
1859054,28,8,1985,8,male,168,463,445,243,131,243,128,0,3
1608982,15,21,1998,2,female,352,453,277,236,297,236,271,0,26
1608994,18,20,1995,3,female,417,476,359,237,266,237,242,0,24
1686243,25,24,1988,2,female,430,476,342,246,184,246,167,0,17
1445308,25,29,1988,8,female,530,459,250,245,3833,245,2769,0,1064
1602515,17,28,1996,3,male,1003,472,175,248,237,92,69,156,168
1583345,38,27,1975,7,female,274,474,417,249,46,227,6,22,40
1366865,19,18,1994,1,male,897,470,288,251,156,208,86,43,70
1702013,94,3,1919,9,female,1793,464,238,247,203,239,94,8,109
1701466,31,18,1982,8,female,1499,449,195,254,840,201,548,53,292
1551338,19,24,1994,6,male,214,464,128,255,62,255,43,0,19
1421604,17,24,1996,10,male,219,472,337,259,527,259,417,0,110
1969932,103,5,1910,3,female,1163,463,187,264,231,0,68,264,163
1671247,18,6,1995,7,female,400,448,206,272,301,57,121,215,180
1401456,15,5,1998,10,male,242,468,352,262,179,250,78,12,101
1124167,102,14,1911,4,female,789,446,60,270,252,270,215,0,37
1228119,35,30,1978,8,female,334,443,260,277,69,0,11,277,58
1012564,29,12,1984,12,female,460,450,162,283,412,38,152,245,260
1556561,23,7,1990,6,female,861,456,201,285,228,167,132,118,96
1943446,30,28,1983,3,male,326,451,281,278,239,200,55,78,184
1732957,20,24,1993,8,female,665,441,271,282,135,255,57,27,78
1387415,40,21,1973,8,female,606,449,268,288,285,269,158,19,127
1916091,15,22,1998,4,female,1405,468,332,290,184,288,149,2,35
1427837,20,12,1993,1,male,297,443,347,284,98,284,56,0,42
1453275,22,18,1991,5,female,809,445,383,277,206,277,159,0,47
2006880,27,27,1986,8,male,534,476,277,284,388,284,274,0,114
1414213,50,28,1963,8,female,1673,441,265,287,493,287,404,0,89
1224603,103,4,1910,12,male,1250,462,281,299,94,0,12,299,82
2057980,26,19,1987,9,female,378,442,288,303,1044,49,382,254,662
1084195,18,21,1995,5,female,253,450,167,305,160,97,73,208,87
1204255,20,20,1993,11,female,458,466,243,301,337,193,71,108,266
1021287,33,9,1980,9,female,384,464,282,303,385,188,157,115,228
1434535,91,28,1922,4,male,662,454,165,304,457,139,123,165,334
2043051,22,4,1991,6,female,1918,464,250,293,174,213,159,80,15
1491992,30,26,1983,9,male,427,448,208,297,126,291,86,6,40
1173013,15,13,1998,12,female,458,465,274,300,241,255,135,45,106
1785981,18,14,1995,1,female,232,450,101,297,71,297,66,0,5
1335519,21,16,1992,6,female,556,451,65,296,173,296,150,0,23
1343537,27,12,1986,12,female,598,454,106,304,167,304,129,0,38
1549928,25,9,1988,5,female,1401,454,265,316,308,0,23,316,285
2046122,94,9,1919,9,male,234,461,303,317,456,16,178,301,278
1984983,17,4,1996,5,male,261,454,329,324,48,218,37,106,11
2125497,61,1,1952,3,female,283,454,332,319,174,114,127,205,47
1024358,102,16,1911,10,male,1162,456,312,321,846,93,641,228,205
1615766,18,30,1995,3,male,301,450,261,322,233,311,139,11,94
1578530,46,17,1967,6,male,1756,462,179,325,214,256,48,69,166
1084003,28,5,1985,5,female,830,452,286,313,715,242,487,71,228
1749684,71,10,1942,4,female,1796,463,345,337,349,3,155,334,194
1382146,22,15,1991,4,female,665,472,350,346,194,226,64,120,130
1520141,18,9,1995,9,female,234,463,200,341,376,149,278,192,98
2110578,17,10,1996,2,male,170,447,377,341,84,254,64,87,20
1379727,19,7,1994,6,female,753,443,214,328,206,273,157,55,49
1580963,19,23,1994,1,male,814,458,290,328,68,328,62,0,6
1022899,25,3,1988,2,male,243,463,355,343,82,343,51,0,31
1512186,21,24,1992,12,male,344,458,390,333,209,333,196,0,13
2097633,18,13,1995,6,female,132,456,161,330,623,330,380,0,243
1958030,32,12,1981,3,female,452,452,201,346,894,346,585,0,309
1172258,103,31,1910,5,male,1599,467,372,357,250,4,12,353,238
1822515,18,27,1995,8,female,458,470,360,357,110,240,53,117,57
2096037,27,29,1986,7,female,523,446,406,354,197,349,162,5,35
1392306,19,21,1994,9,female,334,453,250,359,1046,332,470,27,576
2022516,17,19,1996,2,female,429,460,110,348,158,348,128,0,30
1823766,108,9,1905,7,female,1751,454,289,386,67,53,50,333,17
1222242,24,15,1989,2,female,303,461,209,392,262,27,86,365,176
1735498,15,10,1998,7,female,477,447,262,382,254,122,130,260,124
1180826,22,26,1991,7,female,1517,459,243,394,491,194,359,200,132
1547232,113,1,1900,11,NA,1252,441,309,385,313,169,97,216,216
1904623,20,16,1993,10,male,398,450,284,385,1032,91,406,294,626
1116820,35,28,1978,9,female,1284,464,318,374,1098,230,417,144,681
1726794,24,4,1989,5,female,2281,451,111,371,138,345,30,26,108
1380629,21,31,1992,1,female,638,441,204,393,303,314,162,79,141
1807388,21,10,1992,4,male,275,456,319,372,306,364,211,8,95
1800998,22,5,1991,10,female,400,471,386,383,286,322,130,61,156
1014600,17,31,1996,12,male,307,444,311,370,173,368,117,2,56
1711130,18,18,1995,7,female,48,466,20,387,133,387,123,0,10
1202897,18,3,1995,7,male,310,461,353,378,364,378,309,0,55
1407400,103,1,1910,2,male,585,465,271,374,241,374,147,0,94
1455595,21,8,1992,2,male,414,459,165,412,304,276,53,136,251
1445101,23,12,1990,12,female,2071,463,197,410,368,236,121,174,247
1977191,25,24,1988,6,female,323,476,392,396,507,280,208,116,299
1782138,52,9,1961,11,female,2185,473,219,397,339,261,125,136,214
2075319,38,16,1975,11,male,593,454,399,399,27,364,25,35,2
1664661,31,29,1982,3,male,653,450,228,396,189,381,103,15,86
2046848,16,29,1997,8,female,524,474,232,413,323,335,211,78,112
1274072,18,14,1995,4,female,915,452,317,417,539,383,307,34,232
1556882,21,8,1992,8,female,586,453,339,405,302,394,234,11,68
1066700,81,30,1932,7,male,1063,464,197,408,567,388,246,20,321
1503771,108,18,1905,10,female,2031,448,207,411,406,406,131,5,275
1731962,19,13,1994,2,female,289,469,255,408,1698,371,852,37,846
1304360,52,23,1961,5,male,1457,459,244,401,246,401,192,0,54
2102219,28,4,1985,4,male,1686,452,226,451,232,106,90,345,142
1659132,54,4,1959,5,female,1468,444,303,424,594,244,382,180,212
1097470,60,30,1953,6,male,2279,442,266,438,406,185,238,253,168
1461761,17,22,1996,12,male,280,441,198,427,108,398,74,29,34
1957493,34,7,1979,11,female,783,449,356,433,111,402,52,31,59
1757027,24,21,1989,6,male,621,450,396,441,441,441,327,0,114
1921309,30,30,1983,6,female,380,457,263,423,533,423,502,0,31
2143586,47,10,1966,7,male,124,465,448,466,220,196,157,270,63
1171082,55,31,1958,10,female,2112,470,346,479,185,165,130,314,55
1984414,95,9,1918,2,male,1727,452,313,465,163,335,130,130,33
2075667,21,4,1992,2,female,636,451,267,460,637,272,504,188,133
1183635,18,6,1995,12,female,407,441,88,483,870,117,305,366,565
1239355,22,16,1991,2,male,373,451,259,459,149,420,81,39,68
1785768,21,24,1992,11,male,243,450,350,482,361,478,197,4,164
1207744,19,7,1994,2,male,290,458,357,479,633,479,442,0,191
1140116,26,5,1987,5,male,855,442,326,453,595,453,449,0,146
1978326,60,13,1953,8,female,1745,455,199,472,528,472,279,0,249
1182212,103,22,1910,6,male,1914,448,211,491,456,218,339,273,117
1381131,25,14,1988,8,male,1295,447,316,494,1,372,1,122,0
1994650,18,17,1995,10,male,596,463,406,495,399,415,321,80,78
1058243,50,13,1963,9,female,1727,442,253,484,484,439,296,45,188
1907671,63,15,1950,4,female,1111,448,221,506,295,506,167,0,128
1107883,23,26,1990,2,male,173,467,416,527,94,172,78,355,16
1293160,21,10,1992,10,male,455,461,339,529,575,341,267,188,308
2088146,22,21,1991,2,female,919,447,290,547,409,330,315,217,94
1557351,22,13,1991,9,female,201,456,231,521,617,254,300,267,317
1409084,47,6,1966,6,female,1259,443,372,533,625,293,313,240,312
1220248,22,1,1991,1,female,213,474,231,555,425,516,303,39,122
2048063,23,17,1990,7,female,650,450,276,520,446,493,231,27,215
1656310,24,16,1989,2,male,529,446,212,549,342,542,165,7,177
1123758,44,28,1969,6,female,2260,466,252,524,862,447,539,77,323
1626457,23,3,1990,7,male,459,441,253,532,169,530,87,2,82
2001431,53,9,1960,4,male,529,442,371,531,3,531,3,0,0
1408513,100,5,1913,5,male,1229,472,299,550,191,550,163,0,28
1667029,90,13,1923,5,female,1018,453,104,539,545,539,512,0,33
2069728,100,13,1913,2,female,772,444,212,595,334,0,79,595,255
1791073,14,17,1999,5,female,454,462,224,567,370,56,210,511,160
2041461,22,9,1991,7,female,1102,456,278,562,357,0,68,562,289
1531228,65,1,1948,8,female,880,468,345,597,378,0,41,597,337
1200549,34,3,1979,12,female,1414,464,354,602,349,374,284,228,65
1370558,103,23,1910,1,male,1012,468,288,582,236,401,135,181,101
1712122,36,27,1977,3,male,366,441,390,594,79,587,43,7,36
1210948,29,18,1984,11,female,109,457,431,607,168,576,60,31,108
2055229,17,11,1996,5,male,398,457,418,586,861,454,759,132,102
1714760,25,28,1988,2,female,495,468,277,570,1483,474,904,96,579
2047384,46,9,1967,9,female,1767,476,334,592,1329,591,770,1,559
2018874,17,24,1996,11,female,239,472,337,589,248,589,223,0,25
1186449,19,15,1994,12,female,434,471,254,584,254,584,202,0,52
1013764,18,24,1995,1,female,581,473,345,580,114,580,83,0,31
1252934,20,25,1993,11,female,296,443,146,570,512,570,430,0,82
1897020,21,11,1992,4,male,359,451,375,581,751,581,483,0,268
1839455,28,8,1985,9,male,528,447,381,595,374,595,364,0,10
2133246,18,10,1995,4,male,368,461,140,659,82,128,62,531,20
1389100,16,25,1997,10,female,278,474,388,639,780,2,63,637,717
1889307,18,11,1995,10,female,730,453,303,639,146,413,118,226,28
1691800,19,29,1994,9,female,530,460,355,662,240,438,120,224,120
1323326,13,8,2000,2,female,318,475,308,618,457,342,86,276,371
1767784,18,20,1995,9,female,714,470,373,628,715,339,518,289,197
1671207,31,4,1982,10,female,923,459,212,611,445,260,195,351,250
2031232,57,8,1956,3,female,2156,454,184,640,636,342,346,298,290
1632609,20,7,1993,12,female,805,456,182,627,1209,335,850,292,359
1017299,52,14,1961,1,female,1642,460,264,643,1394,372,492,271,902
1586544,23,23,1990,3,female,2016,467,266,654,425,641,407,13,18
1606001,23,19,1990,7,female,1535,465,239,644,663,594,479,50,184
1697320,48,5,1965,1,female,1820,474,367,626,904,495,506,131,398
1652008,19,15,1994,2,male,478,441,175,642,184,642,145,0,39
1475598,23,19,1990,8,male,664,458,352,628,135,628,97,0,38
1036229,100,7,1913,12,female,101,454,142,631,107,631,99,0,8
1013634,25,2,1988,9,male,955,471,326,647,852,647,757,0,95
1186329,108,13,1905,7,female,978,471,245,654,916,654,772,0,144
1474031,20,16,1993,9,male,481,471,330,667,96,0,38,667,58
1951480,56,2,1957,8,female,1447,461,176,697,221,54,93,643,128
1759806,55,23,1958,8,female,1125,473,145,709,548,56,223,653,325
1222296,17,2,1996,1,female,50,455,138,690,412,169,149,521,263
1317940,47,26,1966,6,female,1753,455,189,712,707,457,429,255,278
1700387,14,14,1999,11,female,263,453,399,705,574,653,395,52,179
1681112,48,16,1965,4,male,1993,446,219,717,325,714,283,3,42
1958085,19,15,1994,10,female,66,468,299,666,390,666,363,0,27
1381893,19,8,1994,9,female,679,468,200,670,411,670,384,0,27
1412377,21,14,1992,2,female,177,456,344,678,768,678,563,0,205
1084045,53,17,1960,9,male,734,447,319,782,388,69,109,713,279
1012103,18,3,1995,1,female,520,450,215,749,794,89,217,660,577
1719702,23,12,1990,9,female,1458,448,320,740,482,527,202,213,280
1943464,19,19,1994,6,female,91,472,226,783,1137,740,748,43,389
2156913,22,15,1991,7,female,1340,468,257,765,904,728,691,37,213
1614884,19,5,1994,11,male,592,464,335,730,440,727,196,3,244
1729702,15,6,1998,7,female,392,461,243,739,337,739,336,0,1
1726289,18,2,1995,3,female,112,462,452,763,390,763,250,0,140
1521766,25,29,1988,2,male,255,464,362,779,431,779,385,0,46
1007656,21,8,1992,10,female,695,453,377,780,846,780,764,0,82
2007359,53,22,1960,1,female,368,459,310,808,1,0,0,808,1
1407556,43,18,1970,7,female,464,450,339,832,469,77,73,755,396
1407157,14,11,1999,8,female,101,473,255,862,1320,559,754,303,566
1291675,29,28,1984,12,male,339,469,256,879,1828,189,505,690,1323
1993789,14,9,1999,9,female,465,467,252,851,380,807,219,44,161
1342084,15,15,1998,4,female,159,453,371,877,185,778,132,99,53
1912813,18,14,1995,10,female,258,461,131,811,544,660,458,151,86
1500583,21,23,1992,7,male,19,453,421,874,650,859,432,15,218
1575204,13,14,2000,4,female,567,458,274,842,204,842,52,0,152
2075196,46,14,1967,11,female,489,443,133,814,145,814,107,0,38
2164469,19,17,1994,4,female,502,452,170,875,630,875,609,0,21
1616047,15,12,1998,3,female,282,455,210,934,1216,5,243,929,973
1062640,18,23,1995,11,male,259,466,331,956,163,551,122,405,41
1804188,16,27,1997,7,male,471,472,378,954,948,372,244,582,704
1056065,19,8,1994,10,male,220,472,307,880,1136,510,792,370,344
1721125,23,13,1990,9,female,110,457,403,880,553,359,286,521,267
1604360,31,26,1982,8,male,389,475,433,937,449,787,261,150,188
1030735,21,9,1992,4,male,373,473,409,896,136,895,113,0,23
1532981,19,20,1994,10,female,499,452,223,975,280,975,228,0,52
1007556,35,17,1978,11,female,594,471,425,965,387,965,312,0,75
1749642,20,28,1993,4,female,128,449,92,897,560,897,470,0,90
1936648,108,5,1905,9,female,633,461,126,897,622,897,532,0,90
1130216,22,15,1991,5,male,889,465,304,1099,206,185,47,914,159
1873257,50,31,1963,10,female,1791,448,236,1098,2620,160,495,938,2125
1107140,36,14,1977,4,female,285,445,381,1028,589,761,488,267,101
1859639,50,27,1963,7,female,952,448,158,1127,313,1028,274,99,39
1786302,14,5,1999,12,female,152,453,275,1043,639,773,279,270,360
1861899,20,6,1993,10,female,629,457,396,992,1359,736,748,256,611
2056194,42,18,1971,12,male,350,466,295,1055,864,896,489,159,375
1981109,78,17,1935,6,female,2083,456,243,1093,804,916,214,177,590
1554576,20,7,1993,7,female,425,464,403,998,293,988,266,10,27
1613280,24,22,1989,10,female,256,468,352,1046,330,1044,217,2,113
1901548,16,15,1997,1,female,392,455,213,1080,2012,1077,982,3,1030
1744315,20,18,1993,2,male,490,476,393,1110,137,1110,124,0,13
1160493,14,12,1999,10,female,407,453,296,1101,288,1101,96,0,192
1681955,48,19,1965,11,female,1254,463,269,1056,766,1056,354,0,412
1483026,21,23,1992,3,male,328,453,328,1261,234,89,147,1172,87
1204199,59,19,1954,7,female,73,474,446,1260,1461,201,757,1059,704
2154339,14,11,1999,2,female,165,467,243,1244,1124,709,821,535,303
1975493,23,9,1990,4,female,1624,442,227,1287,1829,492,500,795,1329
2167082,108,21,1905,2,female,945,454,347,1155,316,1045,227,110,89
1933905,27,21,1986,11,female,300,463,65,1147,1297,1007,1089,140,208
1254606,42,3,1971,4,female,778,446,227,1207,1416,886,953,321,463
2089916,108,14,1905,8,male,419,464,379,1190,2301,1174,2120,16,181
1223127,19,21,1994,7,male,202,443,288,1174,124,1174,106,0,18
2176913,96,27,1917,8,male,1060,471,313,1242,1340,1242,977,0,363
2046545,68,7,1945,5,female,680,450,133,1384,1121,0,189,1384,932
1397402,108,7,1905,3,female,1612,474,236,1445,1069,0,156,1445,913
1496276,20,11,1993,11,female,511,444,228,1482,784,1061,611,421,173
1561060,42,25,1971,12,female,446,459,307,1344,687,876,287,468,400
1102143,15,18,1998,10,female,817,475,346,1312,290,1250,177,62,113
1375663,17,28,1996,9,male,391,473,175,1414,452,1378,262,36,190
1541597,42,18,1971,6,female,1770,449,247,1504,556,1435,392,69,164
1609850,16,1,1997,6,female,952,441,239,1294,1219,1255,1073,39,146
2181314,18,22,1995,9,female,249,446,362,1309,1151,1189,878,120,273
2028558,40,21,1973,12,female,550,465,147,1344,799,1340,752,4,47
1563767,27,22,1986,9,female,1297,456,292,1305,685,1305,448,0,237
1858714,34,28,1979,9,male,546,461,230,1382,774,1382,680,0,94
1153969,13,5,2000,1,female,302,458,359,1786,722,1260,481,526,241
1889011,13,27,2000,3,female,70,472,278,1822,797,1101,248,721,549
1083281,24,8,1989,5,female,1518,463,313,1619,825,920,582,699,243
1192461,17,16,1996,12,female,116,465,345,1663,2229,534,1710,1129,519
1663941,17,8,1996,2,female,518,462,279,1607,1461,327,893,1280,568
1907892,16,16,1997,6,female,1565,467,196,1657,1011,1629,388,28,623
1707619,21,11,1992,8,female,1188,446,221,1552,2325,1257,1663,295,662
1960453,39,21,1974,2,female,1641,450,232,1616,2314,1516,1695,100,619
1965957,30,14,1983,10,male,547,442,273,1665,3292,1356,2828,309,464
1962155,21,14,1992,11,female,532,462,88,1916,967,39,127,1877,840
1599774,22,21,1991,5,male,538,444,252,2307,692,54,340,2253,352
1229796,53,30,1960,11,female,1127,450,272,2253,1344,323,736,1930,608
1607568,62,15,1951,10,male,981,461,305,1939,1092,99,406,1840,686
1986469,43,12,1970,9,male,1169,457,193,1926,684,614,312,1312,372
1791783,15,30,1998,11,male,490,446,393,2160,1625,1550,892,610,733
1959579,16,9,1997,1,female,1169,454,150,2375,946,1844,347,531,599
1464725,16,12,1997,7,male,852,468,251,2039,509,1678,291,361,218
1436417,52,19,1961,2,female,734,459,273,2096,866,1781,656,315,210
1337236,15,14,1998,4,female,40,470,414,1969,867,1955,736,14,131
1050005,16,3,1997,4,female,327,464,199,2349,491,2338,319,11,172
1942259,44,5,1969,5,female,1602,469,162,2141,827,2134,527,7,300
1676042,58,15,1955,12,female,1977,470,401,2398,545,0,128,2398,417
1618606,53,29,1960,9,female,1122,471,231,2779,3298,211,991,2568,2307
1309711,51,4,1962,1,male,875,456,282,2550,710,1134,337,1416,373
1149137,41,2,1972,7,female,1592,461,315,2624,2925,1488,1776,1136,1149
1640493,14,27,1999,2,female,85,445,313,2517,2607,2468,1909,49,698
2054882,25,21,1988,1,female,329,444,147,2616,1889,2554,982,62,907
1022079,19,18,1994,2,female,678,462,210,2993,1212,2991,1167,2,45
2146319,37,30,1976,7,female,1690,470,302,2387,1213,2386,1004,1,209
1860425,33,18,1980,8,female,401,447,179,2413,1287,2413,1211,0,76
1420738,21,21,1992,6,male,193,458,201,5631,3462,1081,633,4550,2829
1037937,21,2,1992,5,female,663,474,296,4733,2419,1337,690,3396,1729
2174780,15,30,1998,10,female,652,469,278,3841,1088,3469,709,372,379
1658687,19,13,1994,10,female,544,446,256,4402,2315,4347,1324,55,991
1810685,47,15,1966,9,female,425,452,263,5510,6389,4725,1279,785,5110
1525165,68,17,1945,8,male,225,448,273,4423,889,4419,530,4,359
1766981,68,31,1945,1,female,123,468,282,5233,6266,5231,5729,2,537
1220910,22,25,1991,12,male,584,444,341,3926,2004,3926,1153,0,851
2155179,51,25,1962,11,female,510,463,218,3884,2283,3884,1313,0,970
1272678,29,8,1984,9,female,230,473,293,8172,10125,8172,9027,0,1098
1547210,14,29,1999,4,female,162,484,400,0,0,0,0,0,0
2112388,14,25,1999,6,male,356,507,383,0,1,0,1,0,0
1401126,14,6,1999,7,male,104,502,471,0,23,0,1,0,22
2130679,16,28,1997,12,male,549,484,330,0,0,0,0,0,0
1626622,15,2,1998,5,male,536,517,346,0,0,0,0,0,0
1724773,15,7,1998,9,male,222,482,264,0,21,0,14,0,7
1275310,15,8,1998,10,female,488,494,264,0,0,0,0,0,0
1563744,17,21,1996,11,male,1054,500,421,0,6,0,1,0,5
1560415,16,9,1997,1,male,223,513,502,0,1,0,1,0,0
1041744,16,17,1997,3,female,691,509,74,0,4,0,4,0,0
1286303,16,29,1997,5,male,207,505,426,0,24,0,22,0,2
1795282,16,12,1997,9,female,687,494,57,0,0,0,0,0,0
1030485,18,3,1995,11,male,792,477,325,0,1,0,1,0,0
1727362,18,27,1995,12,male,181,514,236,0,29,0,23,0,6
1094388,17,1,1996,1,male,238,498,437,0,37,0,22,0,15
1410553,17,23,1996,3,male,628,488,312,0,0,0,0,0,0
1638638,17,4,1996,5,male,533,489,426,0,9,0,8,0,1
1194400,17,26,1996,6,male,396,510,459,0,55,0,41,0,14
1628571,17,7,1996,8,male,1343,504,370,0,3,0,0,0,3
1745407,17,16,1996,10,female,345,478,392,0,0,0,0,0,0
1316189,19,5,1994,12,female,181,491,356,0,13,0,10,0,3
1727407,18,23,1995,3,male,622,491,377,0,2,0,2,0,0
1322354,18,12,1995,3,male,192,514,496,0,5,0,0,0,5
2067399,18,13,1995,4,female,272,508,154,0,4,0,2,0,2
1152569,18,10,1995,5,female,397,517,353,0,0,0,0,0,0
1449615,18,19,1995,6,female,593,500,424,0,1,0,1,0,0
2095040,18,21,1995,7,female,289,512,82,0,13,0,6,0,7
1667948,18,14,1995,7,male,300,512,478,0,1,0,1,0,0
1568814,18,1,1995,7,male,448,515,450,0,0,0,0,0,0
2171568,18,6,1995,8,male,370,502,449,0,0,0,0,0,0
1002767,20,19,1993,12,female,469,513,330,0,0,0,0,0,0
1423140,19,7,1994,1,female,717,492,322,0,13,0,8,0,5
2179369,19,9,1994,1,male,520,494,337,0,0,0,0,0,0
2149945,19,25,1994,4,male,529,510,431,0,1,0,1,0,0
2169293,19,26,1994,6,male,548,477,396,0,4,0,4,0,0
1160317,19,9,1994,7,male,710,502,425,0,4,0,4,0,0
2031741,19,17,1994,8,female,505,518,158,0,0,0,0,0,0
1274220,21,18,1992,12,male,635,479,376,0,44,0,29,0,15
1499282,20,1,1993,1,male,244,491,468,0,0,0,0,0,0
1365513,20,5,1993,5,male,390,504,356,0,0,0,0,0,0
1432351,20,11,1993,5,male,295,500,393,0,6,0,5,0,1
1236694,20,10,1993,7,male,879,487,432,0,0,0,0,0,0
1013221,20,17,1993,8,male,1795,495,220,0,1,0,1,0,0
1262760,21,27,1992,7,male,401,488,245,0,0,0,0,0,0
1851575,21,28,1992,8,male,430,510,395,0,41,0,11,0,30
1677704,23,11,1990,11,female,610,481,353,0,23,0,22,0,1
2034802,23,12,1990,11,female,281,482,90,0,1,0,0,0,1
2181651,22,24,1991,2,male,1169,505,375,0,0,0,0,0,0
1264528,22,12,1991,2,male,973,494,353,0,9,0,9,0,0
1560839,22,19,1991,4,male,323,488,185,0,0,0,0,0,0
1391248,22,7,1991,7,male,324,482,378,0,0,0,0,0,0
1908948,23,2,1990,7,male,457,512,422,0,7,0,1,0,6
1083219,23,31,1990,10,male,1225,511,312,0,0,0,0,0,0
2065830,24,11,1989,4,male,1606,515,331,0,1,0,0,0,1
1105284,25,13,1988,8,male,527,477,353,0,1,0,0,0,1
1869089,27,18,1986,11,male,807,495,331,0,0,0,0,0,0
1083187,27,24,1986,5,male,472,495,460,0,0,0,0,0,0
1715743,27,4,1986,8,male,561,498,228,0,6,0,1,0,5
1622665,29,21,1984,12,female,333,502,333,0,0,0,0,0,0
2053061,29,15,1984,3,male,1144,496,376,0,35,0,24,0,11
1108787,30,19,1983,7,male,1029,489,250,0,6,0,2,0,4
2084503,31,5,1982,5,male,476,490,414,0,0,0,0,0,0
1201458,31,13,1982,9,female,1604,481,77,0,1,0,0,0,1
1630785,33,1,1980,1,male,707,499,398,0,0,0,0,0,0
1012803,35,26,1978,1,female,626,481,227,0,0,0,0,0,0
1116772,39,21,1974,11,male,451,513,479,0,13,0,10,0,3
2089626,38,31,1975,5,male,380,496,239,0,10,0,4,0,6
1260662,38,3,1975,10,male,1011,509,252,0,1,0,0,0,1
1855267,44,19,1969,7,female,988,516,89,0,10,0,9,0,1
1875708,66,20,1947,4,male,1710,504,289,0,1,0,1,0,0
1097237,68,12,1945,11,female,1403,498,120,0,1,0,1,0,0
1985589,68,20,1945,1,male,293,495,263,0,0,0,0,0,0
1502669,68,4,1945,2,male,1256,515,442,0,16,0,10,0,6
1633207,68,9,1945,7,male,1392,517,443,0,0,0,0,0,0
1130941,82,1,1931,1,male,807,507,268,0,0,0,0,0,0
2099407,86,9,1927,11,female,1594,491,207,0,0,0,0,0,0
1225861,93,22,1920,2,female,1054,497,292,0,12,0,2,0,10
1187062,103,19,1910,1,male,1327,513,154,0,45,0,35,0,10
1404559,108,22,1905,6,male,1514,484,121,0,0,0,0,0,0
1342289,18,8,1995,10,male,589,511,404,1,0,0,0,1,0
1026885,19,3,1994,1,male,507,490,399,1,0,0,0,1,0
1092949,18,13,1995,3,male,658,497,371,1,1,0,1,1,0
1569344,19,14,1994,9,female,381,495,394,1,1,0,1,1,0
1931015,43,27,1970,3,male,856,514,149,1,1,0,0,1,1
1296264,15,30,1998,6,male,528,494,346,1,2,0,2,1,0
1521576,15,30,1998,7,female,436,499,378,1,5,0,1,1,4
1353156,19,23,1994,12,male,590,514,464,1,13,0,3,1,10
1994095,56,5,1957,9,female,602,494,133,1,3,0,2,1,1
2030863,108,10,1905,5,female,87,518,118,1,2,0,2,1,0
1524237,21,25,1992,11,male,1421,478,331,1,0,1,0,0,0
1710929,21,9,1992,7,male,147,512,468,1,0,1,0,0,0
1102991,25,25,1988,12,female,326,486,287,1,0,1,0,0,0
1423406,32,12,1981,5,male,901,488,377,1,0,1,0,0,0
1290283,68,7,1945,9,male,715,491,419,1,0,1,0,0,0
1666566,18,27,1995,10,male,144,482,461,1,1,1,0,0,1
1596161,105,16,1908,11,male,894,516,461,1,1,1,1,0,0
1463437,15,22,1998,2,female,436,486,318,1,39,1,33,0,6
1034357,16,2,1997,9,male,736,486,279,1,5,1,3,0,2
1728997,18,26,1995,11,female,414,480,24,1,37,1,30,0,7
1357554,17,11,1996,4,male,394,487,164,1,14,1,2,0,12
2064239,18,17,1995,1,male,419,486,359,1,2,1,0,0,2
1225540,21,5,1992,11,male,922,511,222,1,6,1,6,0,0
1855360,21,24,1992,10,male,675,491,434,1,78,1,34,0,44
1097602,21,15,1992,10,male,491,481,418,1,19,1,2,0,17
1563033,23,8,1990,10,male,923,501,330,1,343,1,124,0,219
1269436,25,1,1988,1,female,305,478,187,1,2,1,2,0,0
1153392,62,1,1951,1,male,557,484,54,2,1,0,1,2,0
1493501,21,13,1992,9,male,1164,491,250,2,4,0,0,2,4
1028630,104,14,1909,2,male,1175,478,259,2,4,0,3,2,1
1170497,33,7,1980,10,female,620,482,369,2,1,1,0,1,1
1065132,19,8,1994,10,male,677,484,366,2,8,1,3,1,5
2048361,59,16,1954,10,male,1725,495,88,2,8,1,4,1,4
1521422,108,14,1905,11,male,1988,504,359,2,24,1,10,1,14
2176539,16,9,1997,12,male,1017,506,218,2,0,2,0,0,0
1061248,15,1,1998,4,male,370,510,331,2,0,2,0,0,0
1872192,20,9,1993,6,male,945,515,318,2,0,2,0,0,0
1199830,103,12,1910,7,male,2483,514,339,2,0,2,0,0,0
1847203,16,10,1997,1,male,311,486,330,2,1,2,0,0,1
1056238,108,27,1905,9,male,1617,483,165,2,1,2,1,0,0
1355755,16,16,1997,2,male,658,477,281,2,5,2,5,0,0
1796831,17,3,1996,6,male,599,514,302,2,3,2,2,0,1
2172970,18,12,1995,1,female,342,513,96,2,24,2,18,0,6
1201256,39,21,1974,12,male,347,508,378,2,5,2,4,0,1
2075205,108,21,1905,12,male,1262,509,224,2,3,2,3,0,0
1285820,25,30,1988,10,male,568,486,272,3,0,0,0,3,0
1895332,17,20,1996,9,male,1151,487,410,3,48,0,20,3,28
1055298,49,10,1964,5,male,499,488,427,3,5,0,5,3,0
1688762,93,11,1920,2,male,1333,488,250,3,15,0,8,3,7
1087093,21,13,1992,4,male,844,504,82,3,1,2,0,1,1
1898480,22,25,1991,6,female,825,516,280,3,21,2,12,1,9
1571447,23,13,1990,12,female,894,488,198,3,0,3,0,0,0
1156868,68,18,1945,7,male,983,477,413,3,0,3,0,0,0
1708920,16,17,1997,11,male,347,507,466,3,4,3,3,0,1
1737856,16,3,1997,9,female,545,505,320,3,3,3,3,0,0
1542387,23,30,1990,1,male,711,490,300,3,2,3,0,0,2
1750796,107,23,1906,4,female,867,499,218,3,3,3,1,0,2
1932660,17,18,1996,10,male,315,481,440,3,37,3,28,0,9
1258682,60,31,1953,8,male,1216,480,152,3,17,3,15,0,2
1439682,100,17,1913,8,male,1065,493,124,4,23,0,19,4,4
2065461,108,15,1905,9,male,967,480,231,4,7,0,1,4,6
1753251,28,3,1985,11,female,896,488,208,4,178,1,105,3,73
2138849,21,5,1992,5,male,349,492,368,4,445,3,274,1,171
1572847,18,6,1995,3,male,779,483,402,4,2,4,1,0,1
1038236,31,26,1982,1,male,667,492,338,4,2,4,2,0,0
1847641,108,31,1905,12,male,1628,484,131,4,1,4,1,0,0
1698058,19,1,1994,1,male,479,484,333,4,3,4,2,0,1
1848022,20,21,1993,8,female,779,514,354,4,5,4,4,0,1
1107416,18,10,1995,6,female,525,516,178,4,27,4,17,0,10
2065975,25,17,1988,9,male,912,505,333,4,40,4,35,0,5
1879710,25,19,1988,10,male,603,506,320,4,13,4,7,0,6
1441171,28,17,1985,6,male,562,486,389,4,99,4,87,0,12
1115019,15,28,1998,3,female,628,517,164,5,1,0,0,5,1
1141803,108,1,1905,1,male,1144,511,164,5,63,0,47,5,16
1035695,19,8,1994,7,male,600,493,375,5,0,1,0,4,0
1844522,24,11,1989,7,male,465,516,335,5,2,3,0,2,2
1461940,19,22,1994,2,male,451,504,426,5,6,1,0,4,6
1118743,26,17,1987,8,male,818,498,429,5,1,5,1,0,0
1202857,52,6,1961,4,male,1542,487,372,5,2,5,2,0,0
1524444,18,25,1995,7,male,297,488,383,5,4,5,3,0,1
1709673,24,27,1989,2,male,735,513,312,5,6,5,6,0,0
2125464,17,4,1996,1,female,274,513,229,5,9,5,6,0,3
1082873,17,10,1996,10,female,666,483,56,5,245,5,172,0,73
1303901,20,9,1993,9,male,524,488,60,5,35,5,17,0,18
1270778,24,21,1989,1,male,212,511,427,5,10,5,8,0,2
1567811,14,24,1999,3,male,288,481,427,6,11,4,4,2,7
1918145,15,19,1998,4,female,614,503,258,6,59,4,19,2,40
1103153,20,3,1993,3,male,374,512,465,6,3,6,2,0,1
1281966,108,22,1905,3,female,1403,500,302,6,3,6,3,0,0
2117385,19,1,1994,1,female,384,511,161,6,7,6,6,0,1
1826550,15,22,1998,3,female,209,496,304,6,34,6,32,0,2
1276152,92,25,1921,9,male,1149,483,204,6,58,6,42,0,16
1446449,101,12,1912,12,male,730,478,367,6,16,6,13,0,3
1717707,28,5,1985,7,female,499,479,379,7,2,0,0,7,2
2048247,108,13,1905,8,male,1628,494,209,7,2,0,2,7,0
1850088,18,26,1995,7,female,171,511,213,7,46,5,9,2,37
1045615,36,16,1977,5,male,1264,508,372,7,51,3,23,4,28
1371503,52,12,1961,3,male,1556,479,92,7,22,4,13,3,9
1157822,15,30,1998,4,male,786,492,205,7,21,6,19,1,2
2151575,23,11,1990,10,male,730,503,381,7,1,7,1,0,0
1448640,108,24,1905,12,male,2118,507,364,7,1,7,0,0,1
1150654,19,16,1994,10,female,268,503,264,7,5,7,0,0,5
1611790,33,10,1980,3,male,416,484,430,7,7,7,7,0,0
1118635,102,29,1911,10,female,2223,477,288,7,7,7,3,0,4
2151073,16,26,1997,11,female,336,489,25,7,153,7,96,0,57
1033715,18,8,1995,4,male,358,512,278,7,41,7,38,0,3
1844624,20,6,1993,6,female,251,506,116,7,42,7,41,0,1
1620310,23,1,1990,1,female,552,503,373,7,17,7,14,0,3
2038641,28,19,1985,11,male,478,478,439,7,79,7,39,0,40
2075823,29,27,1984,4,male,299,500,439,7,65,7,55,0,10
2003914,103,12,1910,1,female,1093,481,227,7,78,7,68,0,10
1935821,108,6,1905,3,female,1608,509,82,7,59,7,58,0,1
1822297,103,31,1910,3,female,1536,496,365,8,2,0,1,8,1
1094767,15,15,1998,1,female,230,503,372,8,2,5,1,3,1
1597259,43,15,1970,12,female,632,511,464,8,275,3,102,5,173
1942127,15,30,1998,10,male,523,496,224,8,1,8,1,0,0
1835193,16,14,1997,9,male,279,484,249,8,0,8,0,0,0
1944147,64,24,1949,9,male,1667,502,30,8,0,8,0,0,0
1455369,18,21,1995,3,female,362,512,398,8,3,8,0,0,3
2068796,18,23,1995,3,female,354,495,388,8,3,8,3,0,0
1308173,87,7,1926,7,male,903,513,391,8,4,8,2,0,2
2141265,18,27,1995,3,male,629,510,453,8,11,8,11,0,0
1596637,33,3,1980,2,male,303,508,428,8,5,8,4,0,1
2115619,14,10,1999,5,male,465,487,133,8,61,8,49,0,12
1058247,15,7,1998,2,male,755,495,121,8,16,8,6,0,10
1843865,25,21,1988,8,female,813,505,213,8,29,8,21,0,8
2081696,63,29,1950,11,female,997,491,208,8,28,8,13,0,15
1922154,22,8,1991,7,male,512,486,274,9,5,0,3,9,2
1632892,94,14,1919,4,male,739,483,396,9,9,7,7,2,2
1407914,23,24,1990,12,male,676,511,345,9,0,9,0,0,0
1233232,108,23,1905,9,male,451,488,435,9,1,9,1,0,0
1112326,23,2,1990,5,male,531,514,402,9,2,9,2,0,0
1690639,16,15,1997,8,male,574,502,453,9,10,9,7,0,3
1433730,15,15,1998,5,female,498,513,248,9,272,9,149,0,123
1539844,32,4,1981,9,male,588,516,383,9,16,9,10,0,6
1243112,20,1,1993,8,male,529,500,284,10,125,0,40,10,85
1708594,22,9,1991,11,male,1198,490,359,10,9,6,5,4,4
1556078,64,10,1949,5,male,1654,497,223,10,132,3,11,7,121
1844445,16,9,1997,4,male,452,490,372,10,6,9,4,1,2
1622890,25,22,1988,10,male,486,502,404,10,9,10,9,0,0
1707269,108,5,1905,10,female,519,492,297,10,7,10,7,0,0
1414537,19,6,1994,4,male,104,490,362,10,37,10,26,0,11
1060247,44,17,1969,2,male,1608,481,164,10,19,10,18,0,1
2016963,103,1,1910,1,male,457,517,392,10,32,10,22,0,10
1072830,17,6,1996,10,male,456,479,413,11,3,0,3,11,0
1593372,30,19,1983,5,male,380,483,431,11,2,1,2,10,0
1797433,68,7,1945,9,male,543,495,399,11,10,2,6,9,4
1916651,20,23,1993,4,male,1594,505,127,11,26,10,14,1,12
1717610,27,12,1986,7,male,593,493,423,11,1,11,1,0,0
1892783,103,25,1910,8,female,284,504,476,11,2,11,2,0,0
1806520,68,26,1945,11,female,1619,487,107,11,16,11,10,0,6
1234424,20,25,1993,5,male,324,486,413,11,110,11,84,0,26
1847381,18,20,1995,11,female,783,487,325,12,10,3,7,9,3
1711266,18,24,1995,10,female,894,500,211,12,17,8,11,4,6
2003738,18,25,1995,12,male,1532,496,279,12,47,8,10,4,37
1439970,108,15,1905,5,male,1686,496,400,12,23,8,17,4,6
1981272,53,10,1960,4,female,974,514,202,12,1,11,0,1,1
1494753,19,4,1994,12,male,467,513,426,12,25,12,23,0,2
1324072,18,5,1995,5,male,592,499,323,12,40,12,17,0,23
1144638,26,4,1987,3,female,172,502,11,13,89,8,40,5,49
1671879,22,28,1991,12,male,175,505,201,13,384,12,100,1,284
1979784,23,22,1990,11,male,706,478,317,13,10,13,8,0,2
1916197,18,9,1995,5,male,705,511,369,13,23,13,19,0,4
1642832,21,11,1992,1,female,392,509,215,13,39,13,22,0,17
1002632,113,8,1900,1,male,1692,485,228,14,0,0,0,14,0
2034582,22,7,1991,3,male,326,479,431,14,14,0,4,14,10
1597542,40,23,1973,6,female,496,514,390,14,13,0,4,14,9
1258045,106,18,1907,2,female,2712,514,120,14,1,9,1,5,0
1439209,103,7,1910,7,male,1381,486,139,14,5,14,2,0,3
1013385,23,1,1990,1,male,246,499,345,14,147,14,90,0,57
2128053,15,6,1998,11,female,474,485,336,15,41,0,7,15,34
1484720,17,23,1996,9,female,958,500,359,15,90,6,12,9,78
1292071,16,7,1997,10,male,514,489,403,15,13,15,9,0,4
1821895,20,14,1993,1,female,292,494,352,15,49,15,17,0,32
1419091,15,27,1998,5,female,502,512,361,16,69,3,39,13,30
1111721,25,7,1988,4,male,407,492,427,16,20,12,19,4,1
1816036,16,29,1997,3,female,232,504,387,16,0,16,0,0,0
1378605,36,10,1977,4,male,435,496,486,16,7,16,5,0,2
1471431,16,6,1997,2,male,657,493,403,16,10,16,10,0,0
1821094,24,17,1989,2,male,339,491,382,16,11,16,11,0,0
2135665,53,1,1960,8,male,801,507,306,16,16,16,14,0,2
1811903,29,29,1984,11,female,312,505,356,16,338,16,305,0,33
1681059,23,17,1990,7,female,1408,498,274,17,1,0,0,17,1
2018740,108,21,1905,7,male,1729,505,221,17,2,0,1,17,1
1976945,14,20,1999,1,male,388,515,380,17,8,1,0,16,8
1838795,23,9,1990,6,male,1535,497,302,17,3,3,0,14,3
1293047,16,27,1997,11,male,745,495,376,17,6,9,3,8,3
1081289,28,15,1985,2,male,511,498,400,17,14,17,13,0,1
1707969,25,7,1988,6,male,235,483,438,17,55,17,48,0,7
1427270,21,2,1992,9,female,364,517,460,18,19,9,7,9,12
1614326,55,24,1958,5,male,1215,488,184,18,44,15,24,3,20
1764498,27,1,1986,1,male,360,514,449,18,0,18,0,0,0
1036689,95,22,1918,6,male,1437,486,251,18,15,18,12,0,3
2155693,108,13,1905,8,male,949,509,285,18,35,18,25,0,10
1105033,16,3,1997,12,male,351,515,285,19,85,19,39,0,46
2006766,16,12,1997,1,female,556,487,148,19,46,19,39,0,7
1329175,37,15,1976,6,male,540,483,388,19,34,19,26,0,8
1732425,16,7,1997,12,female,335,498,380,20,0,14,0,6,0
1186722,20,27,1993,9,female,775,494,168,20,14,17,12,3,2
1238653,101,10,1912,4,male,1204,478,323,20,62,20,35,0,27
1480359,17,8,1996,3,male,919,512,279,21,20,2,10,19,10
1109371,100,18,1913,11,male,1545,495,174,21,58,1,21,20,37
1491272,68,20,1945,8,male,1755,488,60,21,0,21,0,0,0
1871977,16,8,1997,8,male,560,511,435,21,7,21,6,0,1
1897473,54,19,1959,2,female,190,508,228,21,9,21,4,0,5
1462640,39,29,1974,1,male,388,507,436,21,49,21,33,0,16
1031142,19,20,1994,12,male,655,478,255,22,36,0,9,22,27
2119786,53,12,1960,7,male,739,490,280,22,178,0,39,22,139
1894276,28,8,1985,8,male,534,494,458,22,3,22,3,0,0
1929681,103,9,1910,7,female,484,503,165,22,22,22,20,0,2
1628248,19,3,1994,11,female,483,500,94,22,68,22,59,0,9
1912130,23,6,1990,9,male,391,516,91,22,185,22,127,0,58
1379940,75,17,1938,3,male,264,517,310,23,416,0,233,23,183
1037176,24,13,1989,7,female,1092,485,297,23,54,20,38,3,16
2057901,16,28,1997,8,female,232,481,206,23,30,23,26,0,4
1249403,18,12,1995,12,female,472,503,216,23,36,23,28,0,8
1610185,30,5,1983,5,male,543,487,460,23,68,23,63,0,5
1670629,21,7,1992,10,male,95,502,465,24,60,1,38,23,22
1182408,61,17,1952,11,male,414,484,302,24,77,17,68,7,9
1592499,21,14,1992,7,male,507,478,397,24,13,19,3,5,10
1236451,21,16,1992,2,female,437,507,19,24,22,23,20,1,2
1849937,19,25,1994,6,male,230,486,362,24,35,24,32,0,3
1070379,25,28,1988,4,female,397,488,441,24,22,24,17,0,5
1651162,17,27,1996,12,female,244,517,99,24,72,24,63,0,9
1785592,19,24,1994,3,male,207,500,408,24,110,24,90,0,20
1881926,21,14,1992,10,female,375,508,37,24,334,24,269,0,65
1405905,23,28,1990,6,male,930,498,220,24,70,24,58,0,12
1785893,24,14,1989,6,male,362,490,449,24,340,24,298,0,42
1279998,14,5,1999,12,male,67,505,492,25,1,0,0,25,1
1430356,23,9,1990,12,male,430,480,385,25,73,17,41,8,32
1343559,29,26,1984,11,male,757,508,283,26,10,0,6,26,4
2061358,14,26,1999,8,male,567,510,154,26,23,0,13,26,10
2117406,22,10,1991,7,male,248,496,389,26,34,2,18,24,16
1063395,67,7,1946,5,female,1020,515,211,26,27,0,20,26,7
1848723,17,23,1996,2,male,516,488,170,26,100,11,77,15,23
1939017,24,8,1989,12,male,1635,493,131,26,55,11,33,15,22
1020076,110,2,1903,3,NA,2219,503,167,26,4,25,2,1,2
1390632,24,25,1989,12,female,514,480,212,26,124,23,105,3,19
2079104,103,26,1910,9,male,1309,493,259,26,0,26,0,0,0
1127061,54,19,1959,9,male,1655,486,217,26,156,26,129,0,27
1772498,15,27,1998,5,male,313,485,337,27,5,0,4,27,1
1677855,19,7,1994,2,male,409,484,141,27,6,0,3,27,3
1733492,22,2,1991,4,male,409,485,393,27,5,0,2,27,3
1422294,25,7,1988,12,female,442,486,405,27,13,0,0,27,13
1740685,106,24,1907,8,male,1763,514,276,27,14,23,8,4,6
1648761,19,7,1994,12,male,364,510,423,27,21,26,15,1,6
1865705,18,8,1995,5,female,75,498,435,27,25,25,16,2,9
1784853,13,17,2000,5,female,167,491,367,27,60,27,56,0,4
1941628,19,15,1994,6,female,832,483,214,28,8,2,4,26,4
1752893,42,27,1971,12,male,347,477,449,28,28,0,4,28,24
1115151,19,10,1994,4,female,745,510,234,28,584,13,170,15,414
2185618,17,28,1996,5,female,265,497,186,28,296,27,243,1,53
1071400,25,8,1988,8,female,281,504,367,28,230,22,162,6,68
2117288,18,9,1995,1,male,1021,505,313,28,3,28,2,0,1
1772898,108,17,1905,1,female,464,482,369,28,54,28,20,0,34
1843213,28,13,1985,5,female,310,478,118,29,9,29,9,0,0
1887312,64,27,1949,10,male,1342,509,237,29,29,29,27,0,2
1496867,20,13,1993,6,female,559,503,361,29,66,29,50,0,16
1419074,43,22,1970,5,male,385,501,433,31,3,0,1,31,2
1240220,28,4,1985,1,male,432,477,299,31,137,0,25,31,112
1928530,100,13,1913,4,male,2178,503,219,30,16,11,8,19,8
1850060,16,14,1997,2,male,786,505,50,30,249,20,160,10,89
1290514,22,6,1991,12,male,1344,505,143,30,109,16,36,14,73
1208514,43,25,1970,11,male,573,496,330,30,128,18,38,12,90
2032565,101,29,1912,5,male,1321,517,299,30,13,30,11,0,2
1316412,95,2,1918,2,male,2030,500,301,31,45,31,34,0,11
1886912,18,9,1995,12,female,246,487,264,31,171,31,120,0,51
1913651,20,4,1993,4,male,342,507,433,31,101,31,90,0,11
1079642,23,21,1990,3,female,1283,518,165,30,55,30,46,0,9
1146228,19,15,1994,3,male,264,509,196,32,15,11,15,21,0
1894694,15,20,1998,4,female,673,482,192,32,106,20,57,12,49
1292462,17,28,1996,5,male,370,511,450,32,4,28,1,4,3
2163280,15,12,1998,3,male,432,494,441,32,29,31,8,1,21
1353108,108,5,1905,8,male,995,485,210,32,13,32,11,0,2
1921230,94,19,1919,6,male,1152,482,374,32,27,32,20,0,7
1705757,94,9,1919,5,male,454,506,346,33,18,4,11,29,7
1963581,22,24,1991,7,female,421,485,230,33,65,0,43,33,22
1428994,108,7,1905,2,male,1734,497,59,33,95,4,40,29,55
1103255,107,3,1906,8,male,1284,503,327,33,2,33,2,0,0
1725010,108,22,1905,11,male,1442,513,425,33,6,33,6,0,0
1006422,27,18,1986,8,female,232,498,78,33,62,33,27,0,35
1281219,16,13,1997,7,male,360,489,259,34,17,20,6,14,11
2165182,16,7,1997,8,male,259,483,424,34,13,16,12,18,1
1740799,19,28,1994,5,male,1201,487,166,34,9,8,3,26,6
1639602,24,17,1989,7,male,259,504,455,34,10,34,10,0,0
2129092,16,3,1997,3,female,349,490,203,34,32,34,29,0,3
1860105,15,4,1998,12,male,868,512,390,35,5,11,5,24,0
1487360,25,17,1988,1,male,803,490,338,35,25,35,19,0,6
1557610,18,14,1995,5,male,816,512,433,37,109,37,51,0,58
1617033,21,7,1992,7,male,392,484,419,39,51,35,50,4,1
1708479,94,19,1919,8,male,1451,489,450,38,73,36,31,2,42
2027774,26,18,1987,8,male,338,518,474,38,0,38,0,0,0
1601547,68,17,1945,8,male,330,515,413,38,2,38,1,0,1
2029181,108,4,1905,4,male,1414,497,356,39,6,39,6,0,0
1302234,14,12,1999,10,male,293,512,447,39,32,39,28,0,4
2161526,19,9,1994,7,female,394,477,373,39,126,39,72,0,54
1637797,103,28,1910,3,female,1257,507,140,40,5,7,3,33,2
1775937,18,11,1995,3,female,476,505,237,40,153,35,88,5,65
1206308,15,15,1998,7,male,327,486,218,42,10,0,3,42,7
2117758,74,12,1939,12,female,1023,494,168,41,22,0,6,41,16
2043664,23,12,1990,12,male,813,506,363,41,53,6,19,35,34
2187171,14,20,1999,9,female,71,513,109,42,289,40,233,2,56
1955029,23,15,1990,6,male,946,506,333,41,47,41,42,0,5
2095445,39,1,1974,1,female,383,487,309,42,56,42,48,0,8
2050528,108,8,1905,9,female,868,505,135,43,4,18,4,25,0
1050650,25,25,1988,6,female,964,485,370,43,35,29,9,14,26
1579450,18,27,1995,5,male,558,492,316,43,68,26,61,17,7
1790745,20,15,1993,1,male,1384,477,269,44,69,44,52,0,17
1938346,43,11,1970,7,male,168,505,458,45,54,26,44,19,10
1726925,23,1,1990,1,male,688,506,313,45,48,41,33,4,15
2106083,108,1,1905,10,male,1208,479,330,45,21,45,15,0,6
1674474,108,24,1905,2,male,1671,499,258,47,7,28,3,19,4
1665165,17,5,1996,9,male,1026,498,329,47,55,21,29,26,26
2102959,17,25,1996,9,male,735,516,349,47,36,37,16,10,20
1047262,20,7,1993,8,male,655,504,449,47,137,41,126,6,11
1827526,17,3,1996,11,male,190,487,392,46,165,46,64,0,101
1260971,20,17,1993,7,female,97,485,36,46,158,46,124,0,34
1668232,66,23,1947,1,male,1061,504,392,46,561,46,513,0,48
1101748,19,8,1994,2,male,682,510,239,48,81,0,14,48,67
1454594,33,5,1980,6,female,166,491,260,48,96,0,61,48,35
2062048,108,1,1905,1,female,2271,511,280,48,168,1,113,47,55
1108072,23,7,1990,11,male,284,513,385,49,17,12,1,37,16
1572022,15,14,1998,10,female,19,485,112,48,101,13,24,35,77
1274146,53,28,1960,8,male,344,515,101,49,178,23,107,26,71
1008426,16,21,1997,3,male,288,477,316,49,8,49,5,0,3
1431708,25,6,1988,8,male,632,483,222,48,35,48,30,0,5
2188929,15,19,1998,7,male,565,481,383,51,145,7,72,44,73
1481780,27,5,1986,7,female,1554,512,346,50,159,27,99,23,60
2183939,70,10,1943,7,male,221,505,318,50,31,43,23,7,8
1140945,20,12,1993,7,female,550,496,389,50,74,50,57,0,17
1627081,103,25,1910,12,female,718,487,306,51,38,51,36,0,2
1154461,17,17,1996,4,male,241,513,271,52,107,18,11,34,96
1808135,15,11,1998,9,female,631,482,356,52,58,51,43,1,15
2188537,17,9,1996,9,male,186,503,330,52,230,47,36,5,194
1874950,28,15,1985,10,male,451,482,365,53,86,44,25,9,61
1127356,20,25,1993,7,male,1039,478,362,52,45,52,35,0,10
2090979,24,21,1989,1,male,584,481,380,53,60,53,49,0,11
1839536,25,28,1988,5,male,450,506,421,52,62,52,39,0,23
1485859,16,14,1997,11,female,246,515,284,52,176,52,168,0,8
1666630,47,24,1966,6,female,304,480,394,52,497,52,360,0,137
1090884,58,27,1955,4,female,2223,510,243,54,126,1,43,53,83
1497438,16,6,1997,1,female,553,485,214,54,51,46,32,8,19
2135953,92,25,1921,12,male,1913,517,226,58,15,8,8,50,7
1213955,24,9,1989,6,female,536,509,386,56,163,6,113,50,50
1978703,20,26,1993,1,male,822,510,447,58,35,26,23,32,12
1547651,14,1,1999,12,male,225,488,310,57,46,16,30,41,16
1444832,19,31,1994,8,female,310,481,438,58,94,33,78,25,16
1144761,108,8,1905,8,male,2035,477,292,56,190,19,136,37,54
1973019,15,28,1998,12,female,497,501,366,58,196,45,87,13,109
1420306,68,8,1945,8,male,170,481,442,58,12,58,10,0,2
1702148,32,27,1981,3,male,604,493,292,57,45,57,40,0,5
1913110,22,6,1991,1,male,565,486,362,58,149,58,131,0,18
1174706,52,15,1961,3,male,2229,497,177,57,149,57,85,0,64
1650420,14,7,1999,10,male,337,517,365,59,43,0,7,59,36
1586029,58,9,1955,2,female,326,480,387,59,163,13,61,46,102
1155663,22,22,1991,12,male,675,495,268,60,4,60,4,0,0
1763145,16,16,1997,2,male,426,517,492,60,14,60,12,0,2
1275198,16,2,1997,10,female,621,482,94,59,118,59,111,0,7
2122701,17,1,1996,8,female,53,477,68,59,415,59,336,0,79
1394088,18,18,1995,3,male,631,512,344,61,253,28,101,33,152
1431246,16,15,1997,12,female,392,490,342,61,236,60,207,1,29
1307724,16,9,1997,6,male,671,478,258,62,5,62,4,0,1
1658897,103,6,1910,6,male,865,483,139,63,17,63,16,0,1
1637992,94,9,1919,9,female,388,500,407,61,50,61,40,0,10
1938838,20,28,1993,7,female,182,482,132,61,249,61,197,0,52
2048400,13,17,2000,1,male,578,508,347,65,44,16,14,49,30
1772769,100,20,1913,3,female,1139,484,302,65,75,40,62,25,13
1317613,30,13,1983,7,male,625,477,357,64,50,62,25,2,25
1152696,23,6,1990,11,male,278,499,385,65,689,65,596,0,93
2097514,14,26,1999,6,female,315,490,343,68,64,12,37,56,27
1849149,75,15,1938,10,female,2298,510,245,66,237,4,113,62,124
1861011,18,16,1995,3,female,398,481,294,66,98,23,58,43,40
1535287,33,1,1980,11,male,533,504,346,66,48,40,30,26,18
1477421,33,22,1980,5,male,390,477,449,68,4,68,2,0,2
1027730,17,18,1996,11,male,390,517,388,67,38,67,27,0,11
2017741,18,4,1995,12,female,446,511,401,67,25,67,19,0,6
1614986,26,3,1987,9,male,798,482,336,67,19,67,11,0,8
2163895,92,23,1921,3,male,913,508,73,66,21,66,21,0,0
2108312,18,9,1995,2,male,482,497,423,67,161,67,151,0,10
1474300,19,27,1994,8,male,135,516,448,68,124,68,116,0,8
2112835,33,2,1980,11,female,1439,478,281,69,321,46,164,23,157
1087672,20,2,1993,4,female,338,510,133,71,8,62,5,9,3
1505736,14,7,1999,7,female,376,501,411,71,235,66,152,5,83
2135811,103,18,1910,1,female,1492,488,141,69,198,68,132,1,66
1210603,17,14,1996,7,female,353,511,467,71,76,71,68,0,8
2135292,68,17,1945,8,male,1276,484,268,71,118,71,108,0,10
1357011,88,29,1925,1,male,1299,489,259,73,25,72,24,1,1
1859259,19,3,1994,8,male,805,500,267,73,107,67,91,6,16
1289067,20,1,1993,10,male,499,484,316,72,64,57,48,15,16
1956298,18,5,1995,2,female,482,502,282,72,58,72,36,0,22
1593386,108,14,1905,11,male,1463,506,119,77,32,4,18,73,14
1979261,54,28,1959,8,male,375,517,394,77,103,0,10,77,93
1339491,16,3,1997,7,female,396,482,171,77,172,75,78,2,94
1531419,23,22,1990,5,male,542,477,327,76,4,76,4,0,0
1247993,86,9,1927,11,male,1193,500,124,77,13,77,11,0,2
2016473,19,7,1994,4,male,222,502,423,75,134,75,101,0,33
2120079,20,18,1993,2,male,612,499,339,77,187,77,101,0,86
1597480,23,25,1990,12,female,613,517,217,75,137,75,119,0,18
2108401,19,2,1994,11,male,473,480,377,78,30,0,2,78,28
1336204,21,3,1992,4,male,1000,507,119,78,32,28,19,50,13
2102911,16,1,1997,8,male,664,494,157,79,59,58,41,21,18
1552207,103,21,1910,4,male,1049,486,296,79,50,68,31,11,19
1609928,31,1,1982,9,male,439,479,116,78,116,78,83,0,33
1699347,17,10,1996,7,female,94,506,355,78,273,78,201,0,72
1941477,19,4,1994,4,male,582,492,435,79,899,79,828,0,71
1371323,16,26,1997,9,male,901,497,154,83,23,1,7,82,16
1036662,18,6,1995,2,male,252,493,424,84,28,1,11,83,17
1475779,23,10,1990,2,female,392,505,403,82,99,5,32,77,67
1034660,18,3,1995,10,female,197,504,275,84,48,41,39,43,9
1730152,94,1,1919,1,male,1379,507,281,83,43,45,26,38,17
1137008,100,6,1913,9,male,2280,486,291,82,96,53,79,29,17
1111485,100,22,1913,2,female,1731,481,323,82,172,76,79,6,93
1191603,21,31,1992,7,male,380,483,204,81,31,81,14,0,17
1788342,51,22,1962,7,male,854,490,32,82,29,82,10,0,19
1480876,18,25,1995,12,male,198,495,272,83,57,83,44,0,13
1508601,22,3,1991,9,male,616,481,158,81,69,81,67,0,2
1903142,87,6,1926,9,male,1793,479,249,82,57,82,44,0,13
1768142,19,7,1994,4,male,240,491,184,84,139,84,136,0,3
1633038,79,30,1934,10,female,688,491,334,87,181,0,57,87,124
1525820,14,1,1999,4,female,191,513,130,86,199,43,171,43,28
1913719,108,5,1905,6,female,1896,510,225,85,160,25,79,60,81
1822029,85,6,1928,10,female,2057,493,183,85,124,73,69,12,55
1385318,108,9,1905,2,male,1001,485,300,88,7,10,2,78,5
2001958,108,21,1905,12,male,1012,490,206,89,43,0,4,89,39
1221274,15,14,1998,2,male,532,507,352,88,54,4,25,84,29
1213659,19,3,1994,8,female,795,488,109,89,145,64,88,25,57
1245499,100,18,1913,5,female,2173,483,238,88,9,72,2,16,7
2065786,18,25,1995,9,male,282,486,270,91,159,75,100,16,59
2104374,25,16,1988,10,male,409,501,312,90,73,90,65,0,8
1742188,62,15,1951,8,female,1836,504,273,95,65,48,31,47,34
1867897,18,23,1995,11,male,139,504,453,93,94,93,84,0,10
2024629,18,1,1995,2,female,604,505,401,95,130,95,97,0,33
2182270,45,10,1968,1,female,1957,477,297,94,69,94,39,0,30
1347830,18,20,1995,7,female,261,503,325,93,199,93,153,0,46
1646483,24,7,1989,1,female,360,498,342,94,212,94,158,0,54
1772044,46,30,1967,10,male,472,514,478,97,21,13,17,84,4
1455054,18,20,1995,1,female,352,493,194,99,142,0,63,99,79
2061175,100,22,1913,2,NA,2147,512,320,99,73,2,27,97,46
2119253,23,13,1990,12,female,242,481,387,97,59,23,35,74,24
1230632,44,18,1969,9,female,737,482,407,96,138,37,70,59,68
1088368,18,5,1995,9,female,156,518,216,98,341,93,157,5,184
1866729,23,7,1990,11,male,21,481,343,97,91,97,86,0,5
1146019,33,29,1980,11,female,1383,478,213,97,253,97,233,0,20
1988963,18,23,1995,9,male,608,502,326,101,5,13,0,88,5
1867108,85,22,1928,11,male,631,490,289,100,50,7,13,93,37
1721951,22,23,1991,4,male,501,501,411,104,134,14,88,90,46
1585875,17,7,1996,2,female,170,484,411,104,97,50,72,54,25
1757605,41,15,1972,11,male,1363,496,206,102,15,99,14,3,1
1448011,43,12,1970,9,male,572,516,258,102,253,95,117,7,136
1266976,17,28,1996,12,female,374,487,266,102,19,102,13,0,6
1215753,19,12,1994,8,male,392,512,402,102,82,102,68,0,14
1940063,83,11,1930,11,male,864,490,201,102,887,102,708,0,179
2149129,62,16,1951,2,female,358,484,345,106,173,0,60,106,113
1149378,99,14,1914,7,female,2140,494,270,105,28,34,20,71,8
1749936,33,3,1980,3,female,624,495,215,105,177,23,120,82,57
1425728,44,1,1969,8,female,1137,505,212,105,231,34,109,71,122
1432973,15,20,1998,3,female,615,488,207,107,12,107,10,0,2
1202123,20,30,1993,9,male,558,498,226,105,113,105,108,0,5
1599527,19,7,1994,7,female,643,494,229,109,192,109,182,0,10
1862120,41,17,1972,6,male,413,509,412,111,59,0,7,111,52
1772104,16,20,1997,12,female,581,511,363,111,93,0,19,111,74
2107087,73,2,1940,4,female,1852,489,248,110,332,0,182,110,150
1851621,46,17,1967,10,female,880,480,352,111,16,71,8,40,8
1512915,25,1,1988,9,male,384,495,476,110,43,66,23,44,20
1029405,60,29,1953,10,female,1609,505,139,110,118,76,99,34,19
2142533,90,27,1923,7,female,1691,516,365,111,6,107,6,4,0
2022591,28,24,1985,9,female,542,485,448,113,307,104,271,9,36
2142901,17,16,1996,5,male,449,496,426,112,13,112,13,0,0
1660270,92,1,1921,6,male,506,501,264,110,3,110,0,0,3
1380830,16,20,1997,9,female,156,499,358,110,89,110,88,0,1
1346427,28,9,1985,11,male,1182,501,358,113,74,113,73,0,1
1007325,25,12,1988,4,female,834,499,342,112,252,112,113,0,139
1087709,65,14,1948,2,male,1687,505,87,113,181,113,89,0,92
1652307,14,1,1999,1,female,235,480,240,114,109,68,52,46,57
1178652,33,23,1980,7,female,2279,489,199,115,227,69,198,46,29
1075555,30,15,1983,10,male,542,503,373,119,68,110,42,9,26
1036245,48,10,1965,7,female,1373,502,354,118,64,105,17,13,47
1538713,70,26,1943,2,female,1082,505,289,114,121,106,74,8,47
1237980,30,1,1983,3,male,1691,510,226,119,456,101,204,18,252
2108366,15,26,1998,3,male,653,488,300,115,9,115,8,0,1
1469401,23,1,1990,1,male,489,488,395,119,40,119,34,0,6
1149943,15,16,1998,3,female,414,488,399,117,105,117,84,0,21
1603414,103,16,1910,10,male,1801,508,292,116,98,116,82,0,16
1421270,16,10,1997,10,female,73,498,432,119,637,119,213,0,424
1371925,20,29,1993,1,female,274,508,61,115,452,115,358,0,94
2162956,22,31,1991,12,female,99,486,382,115,396,115,276,0,120
2110046,21,9,1992,7,female,639,489,98,114,451,114,333,0,118
1508905,21,18,1992,10,female,326,493,338,116,273,116,223,0,50
1690429,103,18,1910,1,female,373,488,118,115,195,115,173,0,22
1463144,16,28,1997,8,male,265,478,447,120,15,4,7,116,8
1500830,16,15,1997,8,male,295,514,295,121,121,58,110,63,11
1988691,15,3,1998,3,female,447,512,278,124,84,117,61,7,23
1279005,15,3,1998,3,female,991,503,240,122,293,117,93,5,200
1070631,29,28,1984,6,female,531,482,291,122,102,122,73,0,29
1801981,16,2,1997,6,male,396,509,360,128,19,38,10,90,9
1163996,75,22,1938,4,male,2397,499,327,127,77,29,42,98,35
1468006,17,27,1996,11,female,224,512,304,126,156,26,66,100,90
1046504,21,1,1992,4,female,455,489,266,129,85,27,35,102,50
1351203,14,16,1999,3,female,466,497,391,127,16,98,13,29,3
1271571,21,2,1992,11,female,438,511,392,125,54,123,27,2,27
1502713,25,12,1988,3,male,442,490,293,129,78,121,26,8,52
2108565,18,5,1995,4,female,245,500,336,127,137,111,75,16,62
1418401,31,20,1982,6,female,1813,495,255,125,519,93,267,32,252
1775867,20,31,1993,12,male,251,479,301,125,49,125,43,0,6
1197126,68,1,1945,7,male,1426,516,364,129,60,129,57,0,3
1227303,82,27,1931,5,male,1233,480,346,131,5,0,3,131,2
1039519,16,25,1997,1,male,411,490,437,134,80,85,34,49,46
1736107,19,3,1994,7,female,418,482,285,133,68,93,46,40,22
2103398,25,13,1988,9,male,487,495,386,133,34,58,25,75,9
1316593,17,22,1996,4,male,617,502,322,133,260,56,135,77,125
1437460,19,14,1994,3,male,485,493,443,134,23,108,12,26,11
1277270,47,22,1966,5,female,1723,507,150,132,47,100,21,32,26
1363667,18,27,1995,9,female,165,491,423,135,86,130,16,5,70
1809350,35,4,1978,9,female,556,516,313,135,159,131,127,4,32
1221406,20,2,1993,2,male,687,480,405,132,34,132,28,0,6
1541179,25,25,1988,5,female,1693,493,75,135,70,135,60,0,10
1086253,28,17,1985,9,female,1690,507,201,132,284,132,184,0,100
1402698,19,26,1994,11,female,273,493,266,140,39,24,23,116,16
2088542,80,8,1933,5,female,1704,501,221,138,65,99,55,39,9
1091201,21,9,1992,9,male,1071,517,250,137,141,38,36,99,105
1618226,33,21,1980,6,male,612,512,422,137,55,132,30,5,25
1060707,16,19,1997,1,male,619,513,407,140,112,133,50,7,62
1188269,33,1,1980,2,female,1684,505,144,142,1897,128,1490,14,407
2056368,17,29,1996,8,male,258,503,304,138,121,138,114,0,7
1913599,103,7,1910,1,male,950,505,291,141,267,141,193,0,74
1284874,26,12,1987,10,male,270,511,94,150,576,65,433,85,143
2139595,19,19,1994,10,male,364,479,410,144,145,141,85,3,60
1969004,44,1,1969,3,male,1758,480,243,150,186,137,128,13,58
1862421,108,12,1905,8,female,664,495,314,147,191,145,175,2,16
1032219,18,8,1995,8,female,305,489,296,145,331,136,234,9,97
2026302,20,2,1993,9,female,232,500,181,146,765,118,470,28,295
1147056,30,10,1983,4,female,745,484,255,150,783,143,388,7,395
1542476,34,10,1979,4,female,480,479,77,150,148,149,107,1,41
2091576,19,18,1994,1,male,460,499,388,144,133,144,115,0,18
1879338,18,25,1995,1,female,350,500,48,148,222,148,165,0,57
1963338,28,22,1985,4,female,656,506,299,149,354,149,138,0,216
1090350,43,22,1970,2,female,1266,485,157,151,71,67,46,84,25
1921144,62,11,1951,8,female,668,513,399,153,40,91,13,62,27
1698245,113,7,1900,4,female,1497,479,267,152,188,85,102,67,86
1346416,17,23,1996,1,female,158,497,377,153,233,34,211,119,22
1013340,15,14,1998,8,female,331,491,294,153,5,136,2,17,3
2033032,25,29,1988,5,male,1177,513,327,154,100,152,62,2,38
1897497,26,26,1987,1,male,1234,510,124,155,125,153,82,2,43
1624464,39,20,1974,5,male,207,515,438,151,194,142,144,9,50
1721658,21,29,1992,7,male,628,505,359,156,284,145,224,11,60
1534021,19,23,1994,11,male,259,500,433,157,72,157,66,0,6
1805252,57,16,1956,10,male,325,513,434,156,209,156,187,0,22
1770074,51,29,1962,7,female,771,503,295,164,86,0,22,164,64
2173551,23,15,1990,12,female,1496,502,235,162,1044,24,522,138,522
2077010,62,11,1951,3,male,1097,512,114,159,41,37,6,122,35
1633257,20,22,1993,7,female,456,481,215,164,97,158,49,6,48
1577391,63,6,1950,12,female,1568,514,184,160,41,160,31,0,10
2108545,108,3,1905,5,female,551,493,270,159,77,159,64,0,13
1684363,18,12,1995,2,male,682,516,344,163,150,163,125,0,25
1360248,25,5,1988,4,female,2050,498,292,161,145,161,126,0,19
1735021,21,17,1992,8,female,689,491,273,160,364,160,258,0,106
2144510,108,12,1905,10,male,1360,510,290,171,141,0,58,171,83
1980911,21,6,1992,6,female,191,510,274,166,442,94,202,72,240
1888852,21,27,1992,2,male,893,487,224,167,187,133,103,34,84
1820338,20,9,1993,3,female,601,508,298,168,392,132,201,36,191
1213876,63,2,1950,12,male,1223,492,388,165,242,165,185,0,57
1404854,77,1,1936,8,male,581,492,77,176,315,0,55,176,260
2076594,18,25,1995,11,female,677,479,279,173,24,45,18,128,6
2036606,18,5,1995,6,female,218,510,313,177,139,74,106,103,33
1569441,17,27,1996,5,female,584,507,330,178,428,106,341,72,87
1302174,20,23,1993,6,male,468,488,177,181,313,93,81,88,232
1575208,18,22,1995,3,male,420,493,293,177,71,163,29,14,42
1983697,50,11,1963,2,female,1738,489,383,179,156,176,113,3,43
1228816,18,5,1995,9,female,301,504,372,176,174,176,162,0,12
2070362,16,1,1997,5,female,424,484,282,186,57,55,21,131,36
1575276,25,23,1988,10,female,386,490,310,188,199,133,62,55,137
1361372,17,26,1996,7,male,438,483,205,184,292,42,86,142,206
1489711,13,6,2000,2,female,96,493,179,186,151,139,93,47,58
1519983,19,6,1994,6,female,163,496,197,184,139,157,96,27,43
1807848,19,16,1994,7,female,784,486,358,190,253,187,131,3,122
1477954,100,21,1913,8,male,390,495,385,187,261,187,206,0,55
2152904,31,31,1982,1,female,397,505,472,198,207,108,123,90,84
1007149,23,5,1990,10,female,701,492,237,191,1123,72,474,119,649
1214262,103,9,1910,4,male,1572,480,346,197,60,175,45,22,15
1912261,21,20,1992,8,female,752,488,170,191,477,190,457,1,20
1442344,20,28,1993,11,male,448,484,442,198,25,198,20,0,5
2136213,66,8,1947,4,female,1667,488,184,195,256,195,180,0,76
2115962,94,22,1919,4,female,1525,498,221,194,150,194,74,0,76
1427641,17,11,1996,2,female,701,507,174,204,58,20,38,184,20
1304300,15,15,1998,1,female,384,496,298,210,161,0,67,210,94
1071848,108,6,1905,9,male,978,485,112,208,155,26,45,182,110
1330909,19,25,1994,5,male,600,492,360,211,210,127,187,84,23
2096204,53,16,1960,1,female,2232,518,322,201,205,130,112,71,93
1760799,75,27,1938,7,female,851,495,246,203,2,203,2,0,0
1765102,18,15,1995,2,male,311,479,266,210,80,210,71,0,9
1767625,21,7,1992,6,male,162,500,461,206,425,206,414,0,11
1019749,15,23,1998,6,female,467,507,375,221,61,14,4,207,57
1150491,19,10,1994,5,male,370,497,429,219,14,207,11,12,3
1588560,22,25,1991,4,female,1157,490,147,220,94,203,28,17,66
2116086,17,3,1996,6,female,64,505,396,212,793,202,215,10,578
2072062,25,29,1988,3,female,1058,496,310,217,332,201,182,16,150
1057762,25,8,1988,11,female,492,479,313,220,326,220,275,0,51
2112849,28,24,1985,3,female,418,512,413,216,236,216,161,0,75
1091235,63,3,1950,1,female,125,490,448,216,198,216,82,0,116
1085872,24,12,1989,1,male,471,479,296,228,148,81,33,147,115
1058304,18,26,1995,6,female,538,516,306,223,103,203,31,20,72
1895253,24,27,1989,11,female,416,503,207,224,212,215,142,9,70
1294510,26,13,1987,12,female,929,490,275,225,305,192,94,33,211
1577324,19,5,1994,4,female,506,512,139,233,73,233,73,0,0
2129244,23,3,1990,3,male,314,514,384,222,125,222,117,0,8
1136093,18,25,1995,6,female,218,488,370,223,143,223,104,0,39
2070005,97,4,1916,6,male,1660,478,325,228,174,228,130,0,44
1465760,21,3,1992,6,male,723,478,326,240,75,1,44,239,31
1727800,106,18,1907,12,male,2058,502,129,235,208,4,56,231,152
1644635,18,3,1995,7,female,59,499,97,246,587,160,239,86,348
1949545,18,27,1995,5,male,247,477,364,235,55,201,35,34,20
2039264,17,28,1996,6,male,296,487,206,236,160,226,129,10,31
1395458,20,25,1993,2,male,270,507,281,246,326,198,178,48,148
1415298,68,5,1945,6,male,1121,502,268,244,12,244,12,0,0
1509088,17,21,1996,9,male,431,502,254,235,80,235,76,0,4
1913070,18,24,1995,11,female,467,480,214,251,133,31,56,220,77
1841627,49,24,1964,1,female,157,509,302,256,694,181,584,75,110
1403738,19,8,1994,2,female,276,500,320,254,328,250,226,4,102
1339774,24,22,1989,11,male,695,503,207,250,360,212,201,38,159
1855227,17,26,1996,8,female,511,507,221,247,68,246,52,1,16
1112369,15,13,1998,2,female,595,501,276,271,177,101,102,170,75
1270387,16,22,1997,1,female,566,505,232,271,177,70,33,201,144
1506487,22,26,1991,5,male,110,484,457,268,174,178,61,90,113
1962628,108,18,1905,10,male,1282,499,393,264,25,238,17,26,8
1297159,31,19,1982,1,female,273,480,392,266,155,227,59,39,96
1884288,23,21,1990,8,female,333,514,158,270,378,245,114,25,264
1071670,17,18,1996,12,female,683,514,291,271,520,238,390,33,130
2129686,49,29,1964,7,male,617,478,413,270,134,269,71,1,63
1946347,68,5,1945,5,male,1149,501,422,268,26,268,21,0,5
1999717,23,30,1990,3,male,667,505,260,267,143,267,107,0,36
1533738,36,6,1977,11,female,290,498,54,264,333,264,158,0,175
1727788,15,7,1998,8,female,130,514,354,264,478,264,429,0,49
1897370,25,22,1988,5,female,246,497,244,273,761,273,496,0,265
1758410,27,19,1986,2,male,608,515,365,290,184,18,39,272,145
1431046,22,28,1991,2,female,1049,477,388,287,54,85,12,202,42
1862850,61,23,1952,3,female,1361,503,262,291,115,94,77,197,38
1512314,19,20,1994,12,female,115,479,366,284,560,198,227,86,333
1224356,24,30,1989,5,female,598,504,246,277,495,142,154,135,341
1318180,40,8,1973,5,female,1706,517,413,279,390,254,95,25,295
2187800,50,12,1963,2,female,1163,496,227,286,488,250,176,36,312
1748710,41,10,1972,5,male,480,508,464,279,16,279,14,0,2
2028245,18,20,1995,12,female,304,515,475,283,128,283,125,0,3
1005470,18,5,1995,1,male,304,496,402,292,85,292,43,0,42
1315330,26,9,1987,12,male,559,482,264,288,175,288,96,0,79
1974671,94,3,1919,12,male,2223,498,281,292,115,292,86,0,29
1773883,21,21,1992,3,female,288,492,126,277,408,277,233,0,175
1035246,25,19,1988,5,female,542,502,167,283,237,283,218,0,19
1848864,108,13,1905,2,male,1984,505,242,303,210,25,81,278,129
1324849,23,22,1990,4,male,216,485,180,302,114,155,37,147,77
1169146,23,20,1990,6,female,1507,509,194,308,512,149,176,159,336
1456268,14,25,1999,8,male,177,498,428,308,160,229,135,79,25
1515966,17,4,1996,5,male,354,502,357,296,98,295,36,1,62
2039844,23,21,1990,7,male,506,486,339,294,49,294,39,0,10
1558128,18,13,1995,2,male,283,509,354,322,94,0,52,322,42
1572459,83,23,1930,4,male,1750,505,267,313,67,6,13,307,54
1116720,23,8,1990,9,male,431,495,379,319,166,127,53,192,113
1394096,18,5,1995,1,female,658,509,335,317,975,116,281,201,694
1911653,69,25,1944,11,male,871,491,295,310,513,218,425,92,88
1862504,19,30,1994,5,female,352,485,225,319,127,284,98,35,29
2109850,25,6,1988,7,male,293,482,209,321,131,313,120,8,11
1250536,28,2,1985,5,male,851,496,303,309,547,254,205,55,342
1090439,19,26,1994,12,female,437,515,306,312,164,312,127,0,37
1807495,26,20,1987,3,male,468,483,394,311,183,311,150,0,33
2008011,102,1,1911,6,male,560,505,262,345,124,39,65,306,59
2047626,59,18,1954,3,female,1720,483,384,338,171,235,76,103,95
2018350,19,1,1994,1,female,599,490,304,338,306,331,112,7,194
1864790,103,30,1910,8,male,616,490,438,341,238,287,213,54,25
1588076,22,14,1991,8,female,1791,484,333,333,659,322,423,11,236
1269420,37,20,1976,11,male,614,491,319,338,1368,332,1250,6,118
1490525,21,4,1992,12,male,847,513,151,344,61,344,39,0,22
1421308,22,30,1991,11,female,1210,510,77,339,428,339,283,0,145
1714875,66,4,1947,4,male,750,516,220,349,135,1,48,348,87
1930301,18,15,1995,3,female,529,514,264,361,299,11,54,350,245
2002208,33,2,1980,2,NA,2016,493,291,357,886,85,601,272,285
1715139,20,26,1993,5,female,421,485,227,349,339,268,137,81,202
1127556,21,4,1992,3,female,494,514,202,367,290,349,206,18,84
1360603,27,3,1986,1,female,2174,505,293,360,416,295,301,65,115
2051649,45,11,1968,9,male,574,495,336,358,428,308,271,50,157
1871233,23,1,1990,1,male,689,498,441,362,49,362,49,0,0
1250054,14,22,1999,2,male,194,483,293,367,204,367,156,0,48
1185393,17,31,1996,5,female,352,517,214,360,239,360,120,0,119
1719679,53,30,1960,3,male,1285,486,347,357,262,357,204,0,58
2053883,51,30,1962,3,male,1559,482,170,376,473,7,172,369,301
1195126,23,8,1990,6,female,659,514,332,370,21,201,8,169,13
2121204,18,20,1995,7,female,395,500,434,376,253,104,160,272,93
1500324,28,4,1985,11,female,257,509,443,392,403,252,322,140,81
2079370,26,27,1987,7,female,84,500,251,382,242,334,118,48,124
1288985,14,11,1999,8,male,306,496,355,373,198,373,110,0,88
1207505,17,1,1996,6,male,321,480,307,382,231,382,196,0,35
1154743,20,23,1993,6,female,167,479,32,372,449,372,354,0,95
1499623,30,15,1983,1,female,620,499,292,382,377,382,324,0,53
1884640,63,10,1950,5,female,1776,481,94,380,630,380,337,0,293
1650216,19,10,1994,1,female,347,488,363,420,468,91,93,329,375
2187814,20,18,1993,10,female,474,517,382,397,515,154,115,243,400
1217176,34,14,1979,5,female,945,487,267,417,969,190,669,227,300
1007350,15,12,1998,8,female,128,486,268,404,464,334,249,70,215
1731682,16,26,1997,8,male,523,513,302,409,569,366,276,43,293
2188174,14,21,1999,1,male,350,505,399,415,92,415,47,0,45
1941218,24,8,1989,12,female,552,509,175,395,68,395,56,0,12
1375909,16,3,1997,2,male,290,483,274,403,386,403,270,0,116
1203544,18,21,1995,11,female,241,482,168,404,329,404,282,0,47
1401608,17,30,1996,6,male,511,500,376,417,355,417,235,0,120
1005719,35,12,1978,3,female,625,508,373,402,400,402,305,0,95
1869468,50,24,1963,12,male,783,498,202,401,257,401,147,0,110
1822334,68,6,1945,9,female,915,505,186,405,478,405,341,0,137
1444565,103,30,1910,3,female,534,513,155,408,431,408,407,0,24
1962193,49,21,1964,11,female,512,488,364,445,478,14,138,431,340
1765719,57,18,1956,12,female,1678,497,261,446,1121,85,710,361,411
1600136,61,17,1952,10,female,1578,502,159,442,818,1,452,441,366
1285102,18,11,1995,6,female,763,488,323,439,235,349,169,90,66
1991560,28,20,1985,8,male,1760,496,121,436,513,333,108,103,405
1512468,48,18,1965,2,male,1372,489,261,440,667,374,368,66,299
1561986,18,15,1995,9,male,285,508,363,444,134,444,116,0,18
1521608,22,10,1991,1,female,427,481,138,425,526,425,307,0,219
1520515,53,15,1960,4,female,1583,490,327,452,278,0,22,452,256
1645121,103,26,1910,12,male,869,495,370,454,479,10,147,444,332
2162098,23,18,1990,9,male,518,511,295,460,294,207,160,253,134
1252264,15,14,1998,8,male,388,513,432,461,935,224,421,237,514
1714065,21,5,1992,5,female,1327,512,281,466,204,455,99,11,105
1432852,20,7,1993,5,female,426,493,232,481,516,449,117,32,399
1778349,23,22,1990,12,female,555,486,242,478,424,403,137,75,287
1916135,24,23,1989,3,female,577,495,306,465,528,403,180,62,348
2088231,15,3,1998,3,male,415,477,293,507,658,0,313,507,345
1132475,15,18,1998,11,female,572,479,291,514,346,163,147,351,199
1870848,31,13,1982,8,female,975,505,218,514,955,283,410,231,545
1128465,14,18,1999,7,female,985,491,86,513,323,438,113,75,210
1371797,29,8,1984,9,female,615,503,355,484,553,424,395,60,158
1558934,48,10,1965,8,female,733,499,197,505,1089,501,246,4,843
2167420,18,10,1995,10,female,272,498,95,509,358,509,244,0,114
1860094,22,8,1991,3,female,1039,495,123,486,659,486,478,0,181
1108465,23,13,1990,7,female,607,480,173,501,336,501,312,0,24
1651097,15,10,1998,3,male,653,487,338,556,416,43,55,513,361
1843567,26,12,1987,2,male,584,495,374,555,2029,69,702,486,1327
2042855,21,18,1992,9,female,579,490,296,545,1448,367,1231,178,217
1765464,13,10,2000,3,female,545,515,274,560,326,436,222,124,104
1443077,19,21,1994,1,male,802,492,369,554,93,522,84,32,9
1680987,19,29,1994,1,female,824,515,429,561,170,511,112,50,58
1924104,24,8,1989,9,female,935,498,393,521,206,486,143,35,63
2042749,40,8,1973,2,female,55,500,437,524,418,504,376,20,42
1604355,108,26,1905,4,male,1110,516,373,555,431,435,292,120,139
1320627,52,8,1961,11,female,1401,491,204,526,163,522,99,4,64
1768024,106,22,1907,12,male,309,480,288,551,414,551,288,0,126
1355593,22,26,1991,6,female,653,502,339,568,342,35,133,533,209
1723828,68,1,1945,1,female,1005,483,258,593,764,6,405,587,359
2132761,94,26,1919,2,female,517,489,141,586,444,29,277,557,167
2071644,97,13,1916,4,male,2319,504,257,567,672,0,178,567,494
1774336,50,9,1963,12,male,276,490,199,587,299,262,56,325,243
1015194,19,29,1994,11,female,1167,515,228,590,720,309,281,281,439
1033126,27,26,1986,6,male,200,487,297,603,463,247,157,356,306
1652920,54,25,1959,2,male,1936,485,153,600,261,474,101,126,160
1352993,19,8,1994,5,male,301,512,261,588,461,569,291,19,170
1756051,18,5,1995,3,female,569,489,235,567,227,567,199,0,28
1405662,19,5,1994,3,female,334,486,121,601,239,601,154,0,85
1776442,29,3,1984,4,male,373,516,327,603,646,603,605,0,41
1314160,16,9,1997,7,male,328,507,312,647,134,124,49,523,85
1197534,48,20,1965,10,female,310,496,215,659,1083,16,533,643,550
2144036,15,22,1998,5,male,446,481,447,626,159,267,116,359,43
1001643,18,1,1995,4,female,607,479,199,638,865,330,514,308,351
1267953,18,30,1995,6,female,917,510,352,640,482,441,262,199,220
1774781,19,15,1994,5,female,390,490,248,638,462,456,298,182,164
2007970,25,26,1988,9,female,555,500,144,655,1967,459,1454,196,513
1682478,31,8,1982,5,male,291,484,393,637,72,637,69,0,3
1367290,29,10,1984,10,female,1238,515,236,612,443,612,351,0,92
2088347,18,4,1995,3,female,511,482,267,709,294,17,128,692,166
1017862,22,3,1991,6,male,466,481,300,710,376,63,110,647,266
2076788,25,22,1988,12,male,406,485,401,716,284,220,177,496,107
1607158,57,20,1956,11,female,1028,492,382,711,691,345,196,366,495
1315421,29,4,1984,3,female,132,490,372,703,1091,500,99,203,992
2139583,17,19,1996,6,male,257,484,326,707,74,602,46,105,28
1137948,47,11,1966,4,male,572,505,393,725,28,704,6,21,22
2038241,15,1,1998,4,male,656,489,387,688,216,572,133,116,83
1451354,16,1,1997,5,male,449,483,375,673,182,655,109,18,73
1312201,24,21,1989,11,female,531,509,355,697,304,626,99,71,205
1909730,63,8,1950,8,female,2012,517,385,682,265,596,117,86,148
1427648,14,19,1999,10,female,249,502,309,678,482,582,247,96,235
1191722,19,10,1994,2,female,172,480,159,716,439,700,399,16,40
1910224,18,7,1995,8,male,360,487,334,685,15,685,8,0,7
2006420,31,11,1982,11,female,661,491,268,707,123,707,120,0,3
1282725,46,25,1967,5,female,590,489,295,674,716,674,416,0,300
1484262,21,22,1992,12,female,362,480,187,760,579,20,227,740,352
1858755,19,6,1994,6,female,403,517,107,792,186,159,127,633,59
1483761,23,7,1990,4,female,55,494,198,756,747,315,384,441,363
1036645,60,17,1953,8,female,2431,512,308,744,486,354,304,390,182
1177518,14,24,1999,7,male,605,490,235,760,179,624,100,136,79
1791127,21,6,1992,2,female,139,500,151,779,986,777,411,2,575
1929744,27,15,1986,7,male,232,478,424,770,80,770,76,0,4
1077470,65,23,1948,11,female,602,477,166,760,289,760,261,0,28
1003485,23,19,1990,3,male,158,509,433,841,1272,519,445,322,827
2156424,23,14,1990,4,male,516,481,383,829,166,706,145,123,21
1481008,108,23,1905,10,male,167,480,267,821,323,664,207,157,116
1628478,18,20,1995,4,female,442,479,204,805,490,630,324,175,166
1114385,19,20,1994,10,male,615,518,426,862,874,750,344,112,530
2018383,18,1,1995,9,female,660,478,265,869,741,867,557,2,184
1000714,51,11,1962,8,female,1228,483,186,797,49,797,25,0,24
1450554,22,18,1991,5,female,337,515,247,833,1275,833,954,0,321
1192535,108,2,1905,8,male,1761,485,316,905,140,0,47,905,93
2042944,20,8,1993,4,female,213,509,269,926,561,165,253,761,308
1893435,21,28,1992,10,female,308,517,174,957,557,102,319,855,238
1494021,60,19,1953,7,male,1397,502,293,915,364,88,186,827,178
1991240,58,4,1955,5,female,844,485,191,884,600,615,341,269,259
2038896,16,9,1997,9,male,128,504,351,932,1034,892,935,40,99
1967441,25,8,1988,12,female,1792,478,288,901,1009,878,744,23,265
1629204,15,28,1998,7,female,283,517,265,985,1815,876,903,109,912
1441658,19,18,1994,11,female,253,491,114,904,432,904,360,0,72
1178292,20,15,1993,5,female,444,504,386,994,782,99,134,895,648
1797904,20,28,1993,10,female,517,503,159,1121,564,308,220,813,344
1772132,60,10,1953,8,female,1483,483,165,1114,693,323,266,791,427
1762869,17,20,1996,4,female,127,516,459,1008,527,971,229,37,298
1277214,17,24,1996,9,female,19,499,483,1004,926,753,535,251,391
1746848,30,10,1983,2,female,779,486,259,1086,1608,1074,1253,12,355
1512165,47,6,1966,1,female,2268,494,304,992,905,944,493,48,412
1911739,16,18,1997,10,female,89,514,452,1022,1897,798,1342,224,555
1613266,34,6,1979,4,female,719,497,372,1113,262,1112,167,1,95
1413220,40,6,1973,12,female,491,497,238,1054,527,1048,388,6,139
1402105,19,29,1994,11,female,679,510,345,1038,126,1038,84,0,42
1692822,16,6,1997,2,female,533,495,161,1081,453,1081,436,0,17
1560683,24,3,1989,12,female,345,508,262,1121,310,1121,207,0,103
2062572,23,16,1990,6,female,560,511,158,1045,883,1045,832,0,51
2077135,15,13,1998,12,female,126,507,357,1016,2053,1016,1308,0,745
1255871,20,9,1993,7,female,492,505,375,1160,185,262,64,898,121
1822956,20,8,1993,1,female,186,495,430,1236,310,1003,220,233,90
2002795,14,27,1999,7,female,207,484,128,1141,1095,965,797,176,298
1116881,17,30,1996,1,female,482,480,286,1247,957,1079,846,168,111
1394922,21,5,1992,2,female,807,489,448,1231,1171,989,720,242,451
1510361,22,10,1991,4,female,82,478,369,1263,798,1195,485,68,313
1235480,42,26,1971,5,female,891,492,234,1177,4622,993,3172,184,1450
1894181,14,1,1999,7,male,52,495,462,1285,584,1285,490,0,94
1121397,25,14,1988,8,female,336,510,363,1265,1457,1265,1437,0,20
1084077,15,30,1998,1,female,388,483,152,1378,571,832,445,546,126
2058560,15,19,1998,4,female,458,518,380,1372,731,726,381,646,350
2035931,50,2,1963,4,female,1116,494,394,1415,874,963,674,452,200
1898814,25,13,1988,8,male,499,487,392,1443,664,1203,360,240,304
1570245,18,1,1995,2,female,369,509,320,1305,1435,1144,1039,161,396
2128944,18,6,1995,5,female,647,511,228,1424,872,1362,695,62,177
2032570,18,30,1995,9,male,460,486,130,1474,2148,1352,1206,122,942
1708629,20,4,1993,11,male,1147,486,190,1402,1516,1284,1420,118,96
1566967,27,8,1986,12,female,766,485,354,1438,900,1332,574,106,326
1125437,15,8,1998,3,male,533,516,338,1515,217,1515,171,0,46
1215968,23,15,1990,2,male,378,496,400,1524,466,1524,274,0,192
2050576,16,4,1997,11,female,534,506,331,1412,1734,1412,951,0,783
2011801,20,7,1993,10,male,431,489,297,1368,1793,1368,1576,0,217
1541752,20,24,1993,1,female,557,478,210,1651,1089,263,479,1388,610
1781327,17,17,1996,3,female,103,503,129,1559,2410,283,1372,1276,1038
1359027,51,4,1962,5,female,1595,485,298,1622,722,1007,413,615,309
1654499,100,1,1913,1,female,1545,510,312,1569,827,397,371,1172,456
2176879,14,5,1999,1,female,127,486,375,1565,1118,1124,551,441,567
1325855,25,31,1988,12,male,57,500,443,1794,1384,752,400,1042,984
2002459,25,8,1988,8,male,502,516,455,1831,144,1603,96,228,48
1575270,23,1,1990,1,female,137,497,339,1648,478,1367,269,281,209
1166799,14,9,1999,8,female,525,486,315,1528,1178,1150,368,378,810
2111668,15,16,1998,4,female,512,501,323,1851,1935,1684,1050,167,885
2112948,22,10,1991,8,female,424,483,177,1829,1372,1376,652,453,720
1424987,18,13,1995,8,male,259,506,386,2231,1164,262,550,1969,614
1408748,14,1,1999,10,female,282,518,291,2164,1702,0,746,2164,956
1381379,61,7,1952,9,male,813,488,390,1913,2264,28,1407,1885,857
1738616,93,26,1920,3,female,973,483,185,1926,2019,373,1314,1553,705
1098258,21,16,1992,1,male,418,508,248,2035,987,1456,431,579,556
1002801,21,12,1992,10,female,430,485,420,1977,989,1409,518,568,471
1063064,49,25,1964,10,female,1757,477,168,2314,1324,1386,672,928,652
1238268,16,10,1997,10,female,284,488,336,2070,1328,1155,1142,915,186
2145745,17,19,1996,3,female,203,489,382,2223,2366,1494,1410,729,956
1989151,19,5,1994,1,female,140,494,394,1875,2280,405,447,1470,1833
1235453,22,5,1991,7,male,515,488,310,2181,2203,1081,1798,1100,405
1492307,26,24,1987,8,female,891,481,229,2143,2275,1443,2068,700,207
1758036,19,4,1994,8,male,259,484,206,2300,985,2253,792,47,193
1779388,26,3,1987,9,female,1528,512,174,2094,944,2006,454,88,490
1984860,19,16,1994,3,female,1124,481,250,1889,1287,1842,549,47,738
1547052,22,1,1991,6,female,781,488,210,2133,5061,2102,2243,31,2818
1575364,18,17,1995,5,female,501,493,177,2039,729,2037,636,2,93
2068688,104,18,1909,1,male,419,510,394,2009,816,2009,638,0,178
1665954,14,4,1999,1,female,149,487,366,3382,4282,335,1873,3047,2409
1462929,16,14,1997,8,female,438,511,441,2441,1321,1734,820,707,501
1202894,19,13,1994,10,female,420,495,421,2679,1069,1422,425,1257,644
1688477,36,4,1977,11,female,1244,488,333,2666,1334,1097,752,1569,582
1499550,48,20,1965,1,female,1613,498,262,2733,1381,1730,1146,1003,235
1884107,60,15,1953,10,female,1592,486,258,2792,892,828,428,1964,464
1606181,61,12,1952,3,female,1414,489,258,3383,1564,2199,1003,1184,561
1104016,108,18,1905,10,female,1820,493,303,2919,1168,1138,940,1781,228
1744132,36,17,1977,2,NA,2130,515,292,3372,3168,2348,1812,1024,1356
1416668,23,15,1990,9,female,227,510,388,2622,354,2473,345,149,9
1355320,44,30,1969,6,female,1389,487,290,3442,1872,2553,1511,889,361
1841969,47,11,1966,1,male,592,491,393,2872,1135,2463,626,409,509
1910895,57,13,1956,4,female,950,491,172,2846,1212,2722,388,124,824
2066553,24,26,1989,10,female,363,481,375,3295,4170,2831,3053,464,1117
1257398,37,26,1976,7,male,688,485,366,2705,12799,2250,7668,455,5131
1235613,17,28,1996,12,female,248,502,160,2604,409,2604,111,0,298
2127196,22,17,1991,5,female,447,495,129,3572,329,3572,286,0,43
1187624,23,2,1990,1,male,665,493,156,2765,1736,2765,1580,0,156
1105987,17,17,1996,6,male,52,480,447,7587,1246,799,723,6788,523
1235270,15,24,1998,4,male,89,516,381,6180,1779,1191,1453,4989,326
2163418,17,15,1996,5,female,52,477,261,6866,1683,303,543,6563,1140
2114215,18,15,1995,3,male,412,518,262,4952,2907,73,2013,4879,894
1910291,19,5,1994,1,female,63,497,324,5768,6467,219,2188,5549,4279
1383646,64,19,1949,12,male,606,507,307,5992,10933,626,8544,5366,2389
1166489,63,14,1950,1,male,975,505,412,5751,677,4135,228,1616,449
1673612,19,1,1994,6,female,726,490,71,4288,1243,2112,401,2176,842
1836871,44,11,1969,5,female,1681,510,280,4271,752,1136,329,3135,423
1581226,21,22,1992,10,female,69,488,404,3740,5000,2699,3764,1041,1236
1380438,18,5,1995,6,female,663,493,388,7309,1089,6688,647,621,442
1147518,23,17,1990,12,male,314,491,421,9755,1201,9338,954,417,247
1833243,21,5,1992,2,female,318,510,244,4897,1955,3919,1174,978,781
2176502,22,18,1991,5,male,281,490,346,4450,1236,3615,924,835,312
1255324,36,3,1977,12,female,1349,480,273,3920,1012,3163,802,757,210
1684286,24,19,1989,10,female,1919,500,400,4174,2929,4088,2854,86,75
1164450,29,11,1984,3,male,384,502,278,6082,10758,5434,9465,648,1293
2035687,13,14,2000,5,female,139,495,34,6060,1134,6060,916,0,218
1842960,25,16,1988,5,female,77,509,54,10674,4440,10674,4280,0,160
1364321,31,1,1982,7,female,711,485,188,5921,9183,5921,8709,0,474
1607234,16,29,1997,11,male,448,530,120,0,1,0,0,0,1
1280510,16,27,1997,12,female,353,570,291,0,5,0,5,0,0
1522354,15,25,1998,7,male,241,531,404,0,0,0,0,0,0
1928959,16,31,1997,5,male,283,565,336,0,33,0,24,0,9
1941912,16,18,1997,6,male,619,566,504,0,0,0,0,0,0
1018734,16,24,1997,7,female,486,538,440,0,0,0,0,0,0
1197133,16,15,1997,9,male,658,571,447,0,30,0,17,0,13
1361150,17,31,1996,1,male,513,553,461,0,0,0,0,0,0
1466911,17,16,1996,1,male,449,528,386,0,0,0,0,0,0
2147124,17,20,1996,6,male,478,525,469,0,1,0,0,0,1
1300274,17,3,1996,7,male,381,526,476,0,80,0,61,0,19
1580931,17,16,1996,9,male,715,560,359,0,2,0,0,0,2
1759151,17,1,1996,9,female,341,528,440,0,1,0,1,0,0
1528944,18,15,1995,4,female,762,562,364,0,2,0,2,0,0
2092027,18,3,1995,10,male,1390,540,180,0,1,0,0,0,1
1705230,18,11,1995,10,male,459,542,464,0,2,0,2,0,0
1283812,19,3,1994,3,male,482,554,523,0,1,0,1,0,0
1814427,19,2,1994,5,female,565,537,378,0,1,0,0,0,1
1223441,19,17,1994,10,male,1323,556,384,0,4,0,3,0,1
1747977,20,19,1993,1,male,988,535,392,0,0,0,0,0,0
1109726,20,12,1993,1,male,964,522,404,0,2,0,2,0,0
1565919,20,5,1993,2,male,642,570,539,0,1,0,1,0,0
1235827,20,15,1993,4,female,1514,546,271,0,0,0,0,0,0
2156372,20,1,1993,4,male,1320,525,274,0,24,0,16,0,8
1173611,20,16,1993,6,male,433,571,476,0,0,0,0,0,0
1345930,20,23,1993,9,male,557,549,322,0,15,0,5,0,10
1131850,22,16,1991,11,female,522,527,403,0,38,0,25,0,13
1139238,21,5,1992,3,male,289,537,276,0,0,0,0,0,0
1648599,21,22,1992,4,female,397,559,39,0,1,0,1,0,0
1202560,21,10,1992,7,male,457,531,329,0,4,0,1,0,3
1081333,21,16,1992,8,female,171,563,134,0,0,0,0,0,0
1925161,23,13,1990,11,male,490,542,439,0,20,0,3,0,17
2026662,22,1,1991,1,male,398,544,399,0,0,0,0,0,0
1179148,22,6,1991,2,male,539,521,443,0,0,0,0,0,0
1975270,23,20,1990,3,male,538,539,436,0,3,0,0,0,3
1350919,23,26,1990,10,female,646,542,256,0,2,0,2,0,0
1562890,25,21,1988,11,male,945,544,340,0,0,0,0,0,0
2090675,25,10,1988,7,male,424,529,499,0,0,0,0,0,0
1281618,26,16,1987,6,female,1290,554,296,0,62,0,40,0,22
1806404,28,14,1985,11,male,552,566,538,0,7,0,5,0,2
2135827,28,23,1985,10,male,800,571,318,0,0,0,0,0,0
1974491,29,30,1984,4,male,1083,557,86,0,0,0,0,0,0
1537187,32,9,1981,1,male,1367,538,520,0,1,0,0,0,1
1378315,32,15,1981,6,male,721,532,514,0,33,0,33,0,0
1835979,32,17,1981,7,male,797,533,429,0,40,0,31,0,9
1032499,32,10,1981,10,male,274,531,463,0,30,0,24,0,6
1823101,33,3,1980,9,male,256,553,507,0,4,0,0,0,4
1831042,34,13,1979,2,female,191,551,376,0,1,0,1,0,0
1634213,34,18,1979,5,male,1063,540,303,0,1,0,1,0,0
1959403,35,17,1978,7,male,288,536,444,0,1,0,1,0,0
1484436,47,22,1966,1,male,671,519,430,0,1,0,1,0,0
1642732,53,9,1960,3,male,1294,565,238,0,20,0,18,0,2
1839673,56,2,1957,6,male,491,559,444,0,0,0,0,0,0
1949508,68,31,1945,8,male,949,547,474,0,3,0,2,0,1
1464978,86,18,1927,2,male,2318,553,107,0,2,0,0,0,2
1723102,91,2,1922,12,male,1524,561,217,0,2,0,1,0,1
2175245,99,3,1914,6,female,1074,555,137,0,1,0,1,0,0
1980028,103,12,1910,9,male,1083,520,278,0,0,0,0,0,0
1148975,108,19,1905,6,male,721,531,398,0,2,0,1,0,1
1538727,108,31,1905,10,male,1292,566,451,0,0,0,0,0,0
1703560,113,18,1900,1,male,1395,519,434,0,14,0,12,0,2
1835282,17,28,1996,10,female,668,555,414,1,0,0,0,1,0
1979118,21,3,1992,12,female,365,571,53,1,14,0,12,1,2
1617256,20,28,1993,8,male,411,566,279,1,17,0,6,1,11
1112027,23,15,1990,8,female,1068,525,206,1,6,0,2,1,4
1329519,24,19,1989,5,male,243,525,333,1,4,0,3,1,1
1634697,27,6,1986,9,male,1428,533,206,1,10,0,5,1,5
1644211,35,2,1978,7,male,707,556,506,1,27,0,6,1,21
1120592,41,4,1972,2,male,580,565,219,1,16,0,4,1,12
1025836,102,7,1911,7,female,1317,532,133,1,46,0,36,1,10
1565024,15,6,1998,6,male,644,537,417,1,0,1,0,0,0
2111507,22,18,1991,2,male,493,521,448,1,0,1,0,0,0
2075862,24,23,1989,5,male,540,527,419,1,0,1,0,0,0
1478368,26,1,1987,1,male,644,522,452,1,0,1,0,0,0
1878000,28,10,1985,12,male,356,573,507,1,0,1,0,0,0
1697820,38,15,1975,9,male,472,544,506,1,0,1,0,0,0
2049851,16,17,1997,6,male,528,527,463,1,1,1,1,0,0
1775109,18,26,1995,5,female,365,522,342,1,1,1,1,0,0
2182075,19,6,1994,9,male,510,537,401,1,1,1,1,0,0
1305403,16,6,1997,10,male,588,559,471,1,21,1,18,0,3
1823714,19,3,1994,11,female,186,526,166,1,30,1,27,0,3
1793388,18,5,1995,5,male,750,540,310,1,14,1,13,0,1
2092940,18,19,1995,5,male,320,524,61,1,4,1,1,0,3
1682632,19,15,1994,7,male,639,539,405,1,11,1,5,0,6
1453840,21,23,1992,12,male,397,525,494,1,2,1,1,0,1
1893894,23,7,1990,1,male,398,534,489,1,13,1,7,0,6
1706173,23,25,1990,8,female,209,553,272,1,138,1,86,0,52
1802550,23,28,1990,9,male,949,530,362,1,28,1,24,0,4
1040230,23,2,1990,10,male,622,531,345,1,44,1,32,0,12
1902077,26,15,1987,5,male,828,560,474,1,3,1,2,0,1
1053507,27,10,1986,7,male,690,526,354,1,35,1,21,0,14
1348811,28,6,1985,6,male,932,563,270,1,5,1,4,0,1
2079715,39,13,1974,11,male,570,550,127,1,10,1,2,0,8
1544223,47,26,1966,6,male,713,535,237,1,3,1,1,0,2
1425416,50,17,1963,12,male,1349,539,139,1,5,1,3,0,2
1783051,53,24,1960,1,female,645,520,305,1,5,1,3,0,2
2105288,103,29,1910,12,female,891,529,279,1,6,1,3,0,3
1619206,108,22,1905,7,female,1205,551,284,1,2,1,2,0,0
1498980,108,22,1905,10,male,1157,525,142,1,3,1,3,0,0
1006227,20,21,1993,5,female,610,552,287,2,0,0,0,2,0
1448905,27,20,1986,5,male,206,540,69,2,0,0,0,2,0
1549292,14,12,1999,12,male,323,560,221,2,11,0,1,2,10
2095378,13,9,2000,2,female,1271,555,228,2,3,0,1,2,2
1505124,15,25,1998,4,male,444,536,460,2,32,0,1,2,31
1896657,26,15,1987,11,male,489,536,361,2,1,1,1,1,0
1278282,18,7,1995,3,male,574,563,384,2,5,1,4,1,1
1207082,15,23,1998,9,male,421,549,473,2,0,2,0,0,0
1296223,17,8,1996,11,male,797,561,426,2,0,2,0,0,0
1047520,19,15,1994,9,female,610,551,318,2,0,2,0,0,0
1264601,22,17,1991,7,male,629,520,452,2,0,2,0,0,0
1377004,16,19,1997,9,female,512,529,194,2,1,2,1,0,0
1199711,14,10,1999,1,female,505,520,254,2,2,2,2,0,0
2138238,17,12,1996,6,female,459,552,407,2,2,2,2,0,0
1980108,19,24,1994,6,male,264,541,470,2,2,2,2,0,0
1122018,21,31,1992,3,female,827,533,311,2,2,2,2,0,0
1538320,103,6,1910,11,female,1001,564,184,2,2,2,2,0,0
2081360,106,22,1907,12,female,851,553,49,2,2,2,1,0,1
1676004,16,19,1997,9,male,1433,542,100,2,30,2,22,0,8
1317014,17,1,1996,4,male,937,549,253,2,44,2,40,0,4
2182353,20,17,1993,11,female,279,529,66,2,9,2,6,0,3
1800235,22,18,1991,5,male,532,572,476,2,7,2,6,0,1
1497111,23,5,1990,1,male,270,521,377,2,133,2,84,0,49
2178994,23,12,1990,6,male,420,543,462,2,5,2,2,0,3
1174681,23,28,1990,7,female,750,569,266,2,3,2,3,0,0
1930989,68,20,1945,11,female,1403,553,308,2,4,2,4,0,0
1747308,101,7,1912,6,male,538,554,477,2,29,2,27,0,2
1510467,103,6,1910,3,male,1227,555,155,2,1213,2,720,0,493
2008057,107,6,1906,5,male,1578,570,435,2,20,2,8,0,12
1380122,16,17,1997,8,male,453,525,470,3,0,0,0,3,0
1657050,97,15,1916,12,female,1819,570,216,3,5,0,2,3,3
1788696,15,31,1998,12,male,175,563,60,3,34,1,1,2,33
1397457,17,10,1996,10,male,202,540,451,3,26,2,13,1,13
1957925,23,28,1990,4,male,511,527,466,3,14,1,4,2,10
1481354,24,3,1989,10,female,605,572,333,3,27,2,18,1,9
1082488,29,10,1984,1,male,668,563,116,3,6,2,6,1,0
1956808,88,20,1925,6,female,839,523,247,3,1,3,1,0,0
1251606,19,9,1994,1,male,1234,529,418,3,4,3,3,0,1
2053580,27,20,1986,12,male,750,530,337,3,4,3,1,0,3
1986555,29,10,1984,4,male,1481,555,380,3,3,3,3,0,0
1593573,16,25,1997,11,male,578,529,326,3,28,3,28,0,0
1220986,15,23,1998,2,male,271,555,339,3,64,3,46,0,18
1340837,18,19,1995,2,male,433,552,468,3,11,3,5,0,6
1166005,18,9,1995,5,male,521,525,448,3,16,3,15,0,1
1334423,21,12,1992,12,male,368,545,514,3,15,3,9,0,6
1517488,22,5,1991,1,male,573,545,436,3,21,3,17,0,4
1612642,26,24,1987,11,male,1003,555,438,3,11,3,7,0,4
1899473,25,25,1988,4,male,1247,534,358,3,110,3,72,0,38
1479615,33,24,1980,6,male,703,559,353,3,10,3,10,0,0
1022166,36,14,1977,8,female,486,528,419,3,32,3,25,0,7
1306106,93,26,1920,3,male,1085,528,238,3,7,3,6,0,1
1846436,16,16,1997,4,male,525,565,414,4,3,0,0,4,3
2077985,22,2,1991,8,male,425,531,418,4,6,0,3,4,3
1536730,74,11,1939,11,male,1938,551,418,4,135,0,115,4,20
1615031,113,1,1900,1,male,1173,542,332,4,130,0,27,4,103
1647012,70,11,1943,4,male,341,531,431,4,9,1,1,3,8
1394972,17,28,1996,1,female,305,534,363,4,179,3,56,1,123
1831003,18,22,1995,12,female,336,559,465,4,0,4,0,0,0
1381360,18,24,1995,6,male,241,547,503,4,0,4,0,0,0
1393668,20,15,1993,7,male,566,528,461,4,2,4,1,0,1
1018194,24,15,1989,4,male,371,555,424,4,4,4,3,0,1
1804463,19,25,1994,11,female,323,562,229,4,123,4,88,0,35
1222453,19,31,1994,12,male,490,532,410,4,102,4,76,0,26
2053874,18,11,1995,1,male,75,527,62,4,20,4,7,0,13
1825356,28,3,1985,11,male,421,540,338,4,95,4,50,0,45
1491421,33,15,1980,5,male,497,542,287,5,53,0,37,5,16
2141754,26,1,1987,1,male,502,561,483,5,10,3,5,2,5
2129985,15,23,1998,9,female,294,551,341,5,2,5,0,0,2
1255715,30,1,1983,3,male,726,532,447,5,2,5,1,0,1
1060182,18,13,1995,2,male,943,546,358,5,5,5,4,0,1
1978690,18,25,1995,12,male,455,547,445,5,194,5,188,0,6
1967894,23,12,1990,12,male,750,528,306,5,8,5,7,0,1
1505880,88,12,1925,5,male,1898,536,357,6,3,0,0,6,3
1228050,103,23,1910,5,female,2180,522,189,6,13,0,11,6,2
1300926,15,30,1998,5,male,383,545,480,6,0,6,0,0,0
1299168,19,7,1994,8,male,806,553,286,6,2,6,2,0,0
2127034,83,8,1930,12,female,1521,567,203,6,2,6,2,0,0
1931035,15,15,1998,3,male,483,545,389,6,46,6,39,0,7
1618504,15,13,1998,6,male,434,519,304,6,62,6,45,0,17
1351339,19,19,1994,10,male,1024,528,346,6,9,6,7,0,2
1083289,20,21,1993,9,male,714,564,265,6,43,6,38,0,5
1791129,49,31,1964,12,male,756,536,381,7,2,1,0,6,2
1605943,108,10,1905,5,male,1092,525,436,7,19,0,0,7,19
1006646,68,28,1945,1,male,365,532,145,7,8,3,6,4,2
1334088,17,19,1996,1,female,361,567,327,7,22,4,20,3,2
1808919,20,31,1993,12,female,480,544,349,7,26,7,20,0,6
1288895,27,4,1986,12,female,333,553,285,7,99,7,49,0,50
2126268,68,15,1945,7,female,1370,545,70,7,165,7,92,0,73
1461802,20,11,1993,5,male,421,553,438,8,10,1,0,7,10
1823202,103,12,1910,6,male,1029,534,316,8,12,0,7,8,5
1814033,19,14,1994,8,male,464,519,278,8,18,8,11,0,7
2053429,22,3,1991,4,male,511,571,513,8,16,8,11,0,5
1723087,68,24,1945,11,male,1171,520,395,8,28,8,28,0,0
2005008,14,14,1999,9,male,391,521,435,9,7,0,1,9,6
1465289,23,7,1990,4,female,1242,525,366,9,32,1,20,8,12
1167537,77,18,1936,4,male,1382,527,301,9,9,3,5,6,4
1571930,67,9,1946,6,female,474,546,366,9,0,8,0,1,0
1903388,15,11,1998,3,male,602,566,286,9,126,8,39,1,87
1644684,26,2,1987,11,female,1312,550,214,9,207,8,122,1,85
1857615,20,30,1993,4,male,543,573,389,9,0,9,0,0,0
2021376,17,19,1996,6,male,427,557,484,9,7,9,3,0,4
1229811,20,1,1993,1,male,646,545,427,9,6,9,4,0,2
1149037,103,9,1910,7,male,938,549,451,9,10,9,8,0,2
2178983,16,4,1997,4,female,408,565,486,9,19,9,5,0,14
1286232,28,27,1985,7,male,391,546,492,9,118,9,84,0,34
1556633,108,11,1905,5,female,979,551,233,9,16,9,11,0,5
1565553,21,8,1992,12,male,776,552,405,10,6,10,3,0,3
1855093,20,25,1993,11,male,951,541,343,10,11,10,9,0,2
2023054,15,1,1998,5,male,141,561,486,10,54,10,47,0,7
1474053,18,27,1995,1,male,753,528,108,10,149,10,87,0,62
1667182,24,20,1989,2,male,487,542,481,10,17,10,14,0,3
1443027,21,4,1992,4,female,546,531,146,11,0,0,0,11,0
1198007,18,30,1995,9,male,839,554,408,11,65,0,37,11,28
1882533,103,8,1910,12,male,1949,534,245,11,41,0,9,11,32
1587321,113,21,1900,11,male,1257,523,361,11,5,11,2,0,3
1119113,113,14,1900,2,female,1873,561,281,11,10,11,5,0,5
1359602,15,2,1998,4,male,348,562,38,11,39,11,24,0,15
1009230,53,28,1960,12,female,1700,537,293,11,58,11,25,0,33
1602407,80,14,1933,3,female,787,562,125,11,54,11,53,0,1
1927198,17,14,1996,6,male,174,571,524,12,5,0,0,12,5
2160702,23,3,1990,6,male,601,552,404,12,29,7,14,5,15
1367812,102,1,1911,4,female,2214,530,275,12,62,6,20,6,42
1983281,113,9,1900,8,male,1458,519,118,12,34,3,22,9,12
1519463,31,10,1982,3,male,593,558,467,12,7,10,6,2,1
1847130,103,6,1910,1,male,1237,527,232,12,35,11,33,1,2
1397217,23,15,1990,7,male,394,540,485,12,0,12,0,0,0
2100829,103,24,1910,8,male,860,554,299,12,4,12,2,0,2
1620529,108,5,1905,4,female,1088,528,192,12,7,12,6,0,1
1838662,17,17,1996,10,male,715,555,309,12,12,12,12,0,0
1209588,22,24,1991,3,male,755,573,367,12,13,12,13,0,0
1733783,49,3,1964,1,male,812,566,370,12,41,12,29,0,12
2088741,108,16,1905,12,female,1165,525,247,12,72,12,65,0,7
2150831,18,21,1995,7,male,1462,562,227,13,277,0,103,13,174
1265339,51,9,1962,2,female,298,523,360,13,91,0,34,13,57
1572839,113,27,1900,2,male,1282,571,28,13,34,0,20,13,14
2039740,15,6,1998,7,female,214,560,261,13,0,13,0,0,0
1185604,21,4,1992,4,male,613,519,415,13,4,13,3,0,1
1780117,19,28,1994,9,male,762,538,443,14,8,14,8,0,0
1879562,18,1,1995,4,female,909,539,278,14,19,14,10,0,9
1894476,20,11,1993,7,male,869,541,384,14,77,14,32,0,45
1905989,22,23,1991,9,male,683,549,235,15,0,0,0,15,0
1709183,23,8,1990,2,male,629,537,499,15,29,14,24,1,5
1121786,18,12,1995,9,female,401,562,505,15,13,15,10,0,3
2187737,19,18,1994,11,female,495,565,178,15,57,15,40,0,17
1880835,50,10,1963,6,male,279,536,7,16,26,15,13,1,13
1756591,28,19,1985,4,male,321,546,490,16,9,16,7,0,2
1302313,20,13,1993,7,male,1435,533,234,16,101,16,87,0,14
1809629,23,29,1990,10,male,560,522,301,16,279,16,75,0,204
1520135,16,12,1997,12,male,271,519,392,17,19,1,6,16,13
1697451,68,8,1945,2,male,1382,531,306,17,55,16,40,1,15
1765720,108,17,1905,10,male,716,527,209,17,11,17,6,0,5
2037370,16,1,1997,5,male,159,556,411,17,87,17,31,0,56
1346987,26,27,1987,4,female,616,520,284,17,90,17,74,0,16
1362069,57,5,1956,6,male,1388,549,56,17,37,17,12,0,25
1418112,19,6,1994,10,female,325,556,280,18,9,4,3,14,6
1470697,22,21,1991,2,male,531,542,424,19,5,1,1,18,4
1458378,33,5,1980,9,female,1284,558,369,19,143,2,108,17,35
1222886,21,20,1992,4,female,1618,559,346,19,68,19,52,0,16
1266085,57,21,1956,2,female,542,553,158,19,513,19,468,0,45
1840371,70,1,1943,1,male,991,525,285,20,1,0,1,20,0
2142923,20,23,1993,6,female,895,564,209,20,40,11,16,9,24
1924438,46,28,1967,10,female,511,550,262,20,149,13,45,7,104
1167058,52,14,1961,12,male,462,521,323,20,2,20,2,0,0
1591633,16,10,1997,11,female,634,557,453,20,32,20,13,0,19
1196474,20,5,1993,11,male,398,547,417,20,47,20,15,0,32
1767357,43,27,1970,4,male,1628,521,152,20,71,20,59,0,12
1502639,14,18,1999,2,female,525,544,367,21,22,19,10,2,12
2032866,14,1,1999,1,male,495,563,404,21,1,21,0,0,1
1591074,18,9,1995,12,female,755,542,233,21,13,21,11,0,2
1371186,28,27,1985,6,male,630,539,469,21,17,21,11,0,6
1189903,18,20,1995,2,female,223,557,301,21,67,21,56,0,11
2168686,17,1,1996,1,male,686,547,354,22,0,0,0,22,0
1471586,99,2,1914,8,male,1194,521,305,22,19,0,1,22,18
1943336,21,1,1992,10,female,462,549,238,22,27,11,20,11,7
1124302,94,23,1919,12,male,1716,528,386,22,11,19,4,3,7
1407454,16,17,1997,6,female,179,543,62,22,437,20,335,2,102
1847579,18,1,1995,5,male,562,540,470,22,7,22,6,0,1
1518352,103,30,1910,9,male,1277,553,485,22,8,22,8,0,0
1920174,88,16,1925,12,male,1472,545,247,22,17,22,9,0,8
1851574,26,1,1987,1,male,520,549,446,22,115,22,81,0,34
1026544,15,22,1998,7,male,541,530,367,23,1,16,0,7,1
1470464,19,14,1994,10,female,942,564,47,23,79,11,31,12,48
1376647,18,24,1995,8,male,511,560,435,23,22,23,14,0,8
1918137,108,23,1905,9,male,905,561,175,23,14,23,14,0,0
1808300,75,12,1938,9,male,1814,565,310,24,26,19,15,5,11
1426018,23,3,1990,2,male,683,548,312,24,2,24,2,0,0
1118917,16,19,1997,8,male,130,561,231,24,23,24,14,0,9
1755139,22,11,1991,6,female,1740,552,288,24,17,24,15,0,2
2112867,14,14,1999,10,female,123,535,325,24,173,24,122,0,51
2060315,21,20,1992,4,male,1145,531,366,24,44,24,27,0,17
1414128,42,23,1971,8,male,1460,554,297,24,56,24,24,0,32
2105836,20,17,1993,1,male,983,557,186,25,14,0,2,25,12
1701638,29,11,1984,12,female,657,539,441,25,91,0,66,25,25
1741461,17,27,1996,9,male,777,540,416,25,17,25,13,0,4
1081578,19,17,1994,2,female,491,549,396,25,50,25,49,0,1
1976500,23,18,1990,9,female,343,534,214,25,734,25,475,0,259
2037271,31,29,1982,4,male,321,520,379,25,68,25,17,0,51
1106824,18,16,1995,5,female,240,564,417,26,5,7,0,19,5
2189755,23,17,1990,8,male,490,552,472,26,58,26,40,0,18
1905162,27,10,1986,10,female,433,549,372,26,231,26,220,0,11
1689228,28,8,1985,5,male,651,519,413,26,156,26,155,0,1
2143259,83,8,1930,3,male,1614,534,155,26,305,26,293,0,12
1690792,103,24,1910,1,male,1590,521,209,27,43,14,21,13,22
2019886,35,12,1978,4,male,1884,567,366,27,19,24,14,3,5
1964376,15,8,1998,5,female,823,558,263,27,95,26,41,1,54
1601519,25,18,1988,5,male,498,551,514,27,3,27,3,0,0
1712079,21,29,1992,2,male,612,542,376,27,46,27,38,0,8
1460935,13,1,2000,3,male,282,543,391,28,27,10,11,18,16
1892110,20,27,1993,5,female,698,540,260,28,26,28,16,0,10
1745015,103,1,1910,4,male,1372,544,309,29,4,0,1,29,3
1173160,108,25,1905,5,male,1278,520,409,29,26,0,5,29,21
1573876,26,25,1987,4,male,1633,528,392,29,122,3,11,26,111
1178444,14,31,1999,1,female,479,539,309,29,96,23,26,6,70
1913497,103,3,1910,7,male,1617,570,180,29,9,29,4,0,5
1685605,16,1,1997,1,male,215,532,473,31,56,25,29,6,27
1632207,56,29,1957,10,female,783,532,484,30,8,30,5,0,3
1230893,100,2,1913,5,female,1900,534,277,31,11,31,9,0,2
1670502,21,1,1992,10,male,472,529,437,31,25,31,14,0,11
1683321,15,1,1998,10,male,194,558,335,30,116,30,56,0,60
1004837,19,16,1994,3,female,633,519,224,31,87,31,78,0,9
1330275,19,2,1994,6,female,998,525,148,30,591,30,533,0,58
1114069,20,25,1993,10,male,1385,547,314,30,60,30,46,0,14
1759962,31,9,1982,9,male,704,544,294,30,51,30,32,0,19
1503436,47,4,1966,5,male,610,523,243,32,20,0,5,32,15
1528672,15,26,1998,5,female,582,545,260,32,143,19,51,13,92
1724817,21,17,1992,1,male,475,553,370,32,27,31,17,1,10
1999152,25,10,1988,8,male,438,548,473,32,15,32,13,0,2
1213178,18,3,1995,2,female,328,565,217,32,48,32,30,0,18
1449396,21,1,1992,11,male,734,568,346,32,109,32,45,0,64
1748463,103,1,1910,6,male,1463,551,330,33,67,5,57,28,10
1366968,16,13,1997,3,female,410,537,398,33,4,21,3,12,1
1320046,102,1,1911,4,male,1847,552,342,33,5,11,2,22,3
1198202,18,29,1995,3,female,201,569,161,33,126,33,105,0,21
1962751,96,23,1917,4,male,1066,558,220,34,69,5,13,29,56
1694248,18,20,1995,1,male,202,519,384,34,55,20,21,14,34
1237854,17,21,1996,1,female,499,532,200,34,14,34,6,0,8
2006428,19,19,1994,3,female,674,543,449,34,14,34,7,0,7
1522870,108,26,1905,3,female,1041,568,145,34,63,34,63,0,0
1180529,17,25,1996,10,male,403,555,493,36,45,7,17,29,28
1521404,72,9,1941,9,female,1926,564,79,36,251,8,124,28,127
1622419,20,9,1993,8,male,847,538,386,35,65,29,29,6,36
1462644,21,2,1992,2,female,540,539,190,35,60,31,15,4,45
1958001,113,21,1900,11,male,1708,542,401,35,1,35,0,0,1
1865663,17,15,1996,8,male,334,527,469,36,72,36,28,0,44
1411390,21,11,1992,2,female,378,534,300,36,88,36,60,0,28
1963412,108,2,1905,1,male,1121,522,216,37,80,21,23,16,57
1776165,21,18,1992,8,female,639,545,416,37,3,37,3,0,0
1188099,22,28,1991,2,male,750,560,471,37,2,37,2,0,0
2034291,13,3,2000,1,female,255,545,62,37,37,37,13,0,24
1718911,22,16,1991,12,male,937,566,331,37,69,37,46,0,23
1804800,24,16,1989,9,female,249,546,355,37,113,37,102,0,11
1344248,18,12,1995,6,male,405,573,481,38,0,33,0,5,0
1991589,15,16,1998,12,male,775,528,393,38,14,37,8,1,6
2068907,22,20,1991,4,female,501,542,443,39,14,39,10,0,4
1387196,17,8,1996,10,female,349,524,317,39,42,39,32,0,10
1414505,19,14,1994,1,female,417,536,429,38,101,38,91,0,10
1422078,101,27,1912,12,female,489,525,359,41,11,0,1,41,10
1463029,108,30,1905,1,male,413,548,320,42,81,22,34,20,47
1512905,23,10,1990,4,male,1154,547,245,42,9,41,5,1,4
1778234,95,16,1918,4,female,1386,538,317,42,8,33,3,9,5
1854134,19,11,1994,11,male,487,519,304,41,176,39,120,2,56
1487017,48,21,1965,1,male,732,532,128,42,90,31,24,11,66
1697358,21,9,1992,7,male,1265,550,386,42,7,42,6,0,1
2064160,108,4,1905,9,female,1079,555,319,42,31,42,20,0,11
1936670,14,16,1999,9,female,300,547,350,42,272,42,218,0,54
1494619,18,6,1995,3,female,266,544,171,42,648,42,544,0,104
1641874,23,1,1990,1,female,1488,534,131,41,184,41,152,0,32
2048440,24,13,1989,7,male,1570,531,192,43,49,28,41,15,8
1136298,16,11,1997,11,male,339,525,461,43,8,41,3,2,5
1094990,86,20,1927,12,male,2154,559,286,43,8,34,4,9,4
2167039,25,16,1988,6,male,744,541,407,43,34,42,17,1,17
2149866,18,21,1995,6,female,664,566,412,44,17,44,12,0,5
1373218,18,25,1995,8,female,1915,544,237,44,79,44,31,0,48
1520157,26,30,1987,7,male,500,528,385,44,71,44,51,0,20
1965024,23,2,1990,7,female,563,529,295,45,103,39,45,6,58
2086554,19,22,1994,3,female,604,563,375,45,201,45,91,0,110
2187206,55,9,1958,1,male,1190,546,206,47,58,2,17,45,41
2115059,81,9,1932,4,female,1380,569,192,47,19,12,4,35,15
1670056,20,31,1993,8,male,605,520,481,47,41,16,30,31,11
1435069,30,17,1983,3,male,662,532,255,46,60,44,42,2,18
1821939,18,8,1995,2,male,966,539,72,46,75,37,35,9,40
1750586,32,13,1981,1,male,636,567,443,46,7,46,6,0,1
1555059,84,29,1929,9,male,1167,540,425,47,13,47,11,0,2
1666042,16,15,1997,7,female,902,527,415,47,30,47,19,0,11
1602416,28,28,1985,9,female,342,544,405,46,63,46,18,0,45
1179493,31,16,1982,10,male,689,535,407,47,70,47,64,0,6
2146477,20,10,1993,1,female,540,540,227,47,78,47,50,0,28
1028701,108,29,1905,7,female,2396,564,236,47,272,47,237,0,35
1822928,21,13,1992,2,female,952,567,321,48,107,6,91,42,16
1835755,18,1,1995,4,female,531,535,190,49,87,10,43,39,44
1278036,18,13,1995,3,male,440,565,459,49,12,41,4,8,8
1019534,20,8,1993,4,female,643,548,215,49,66,49,27,0,39
1870006,23,3,1990,7,male,608,543,406,50,10,20,6,30,4
1993843,27,15,1986,1,female,567,554,160,50,38,24,19,26,19
2130694,108,1,1905,4,male,1535,528,321,50,142,26,57,24,85
2009060,20,12,1993,4,female,661,530,251,51,35,48,23,3,12
2152926,16,2,1997,3,female,540,558,95,50,158,49,108,1,50
1701056,20,7,1993,9,female,1135,531,109,50,112,38,79,12,33
1069256,15,14,1998,4,male,337,534,389,52,11,46,7,6,4
2032520,18,6,1995,1,male,769,572,389,52,27,46,7,6,20
1072177,15,7,1998,11,female,248,546,384,53,44,51,23,2,21
1067787,68,4,1945,11,female,1744,523,269,53,54,49,12,4,42
2080283,113,22,1900,7,male,1558,533,271,53,203,51,148,2,55
2178459,16,12,1997,1,male,481,519,461,53,4,53,4,0,0
1344213,14,28,1999,2,male,283,524,256,55,61,4,26,51,35
1448959,46,12,1967,9,male,535,572,402,54,289,18,106,36,183
1545997,33,1,1980,1,male,570,557,295,55,270,55,199,0,71
1396527,17,12,1996,1,male,210,528,453,58,31,4,19,54,12
2185915,20,25,1993,1,male,549,532,507,56,9,24,4,32,5
1977491,16,23,1997,6,female,137,551,467,56,137,55,99,1,38
2012333,23,2,1990,2,male,617,541,455,56,0,56,0,0,0
2074389,23,14,1990,9,male,690,522,395,58,80,58,71,0,9
1137920,103,4,1910,10,female,1421,530,56,57,48,57,38,0,10
1347602,57,12,1956,4,female,1701,540,434,57,320,57,221,0,99
1494165,20,30,1993,7,female,111,540,499,59,136,16,28,43,108
1304210,19,26,1994,4,female,363,558,409,59,50,59,47,0,3
1353648,17,24,1996,7,female,437,550,127,59,249,59,149,0,100
1668390,18,17,1995,4,female,393,547,268,60,108,60,79,0,29
1055829,92,10,1921,9,male,1068,527,259,63,200,0,15,63,185
1489809,17,21,1996,9,male,353,545,363,61,149,38,37,23,112
1862266,65,12,1948,7,male,1819,570,383,61,389,42,93,19,296
1163271,58,6,1955,4,male,710,521,461,63,127,56,56,7,71
2057630,16,5,1997,10,male,700,566,377,62,13,62,12,0,1
1243234,23,17,1990,8,male,566,533,273,63,26,63,20,0,6
1201123,20,6,1993,3,female,547,525,297,63,47,63,42,0,5
1891356,23,17,1990,7,male,1445,539,330,62,266,62,232,0,34
1737084,27,12,1986,12,female,833,535,99,61,253,61,173,0,80
2015961,26,21,1987,8,male,584,531,493,65,125,16,106,49,19
1942869,60,6,1953,4,male,610,536,442,67,149,1,34,66,115
1077535,19,16,1994,3,female,320,565,147,66,59,66,47,0,12
1694295,18,18,1995,5,male,366,527,446,68,541,68,311,0,230
1568651,108,13,1905,4,male,1760,560,52,71,0,0,0,71,0
2126232,103,17,1910,8,male,1264,554,174,71,16,1,5,70,11
1274951,19,7,1994,3,male,280,523,161,69,9,14,5,55,4
2002259,15,26,1998,10,male,418,572,368,70,184,21,92,49,92
1253968,16,12,1997,2,male,431,542,326,69,185,49,126,20,59
1779472,18,28,1995,4,female,271,533,289,70,122,26,42,44,80
1022071,18,23,1995,1,female,219,534,369,71,105,71,95,0,10
1926110,22,20,1991,6,female,1466,542,83,69,97,69,54,0,43
1290461,108,25,1905,2,male,2318,563,242,69,89,69,72,0,17
1679386,25,26,1988,2,male,707,521,405,69,232,69,163,0,69
1023904,108,21,1905,12,male,1710,565,309,72,89,0,44,72,45
1209178,23,13,1990,5,male,250,551,266,73,190,3,64,70,126
1911661,19,23,1994,10,male,529,554,499,74,9,17,4,57,5
1904155,108,22,1905,8,male,959,542,174,74,37,74,17,0,20
1801595,20,4,1993,9,female,613,542,301,74,304,74,194,0,110
1870034,42,15,1971,4,male,1029,527,341,72,157,72,108,0,49
1322244,24,6,1989,9,male,778,530,191,75,90,46,9,29,81
1510636,58,9,1955,7,female,1765,551,289,75,74,23,19,52,55
1196380,18,19,1995,10,female,456,551,310,80,105,16,60,64,45
1055776,23,8,1990,8,male,334,569,30,80,27,63,19,17,8
2058292,89,17,1924,5,male,2076,572,249,79,27,66,5,13,22
2119117,26,3,1987,12,female,852,573,257,80,248,59,210,21,38
2072855,26,21,1987,8,male,1472,536,220,78,124,73,76,5,48
2097642,56,7,1957,3,female,823,539,170,79,144,64,54,15,90
1778956,19,10,1994,12,male,631,541,481,80,44,80,41,0,3
1749100,19,25,1994,5,male,476,529,510,79,61,79,50,0,11
1277905,108,1,1905,12,male,1116,527,304,80,392,80,361,0,31
1488553,15,17,1998,5,male,575,523,369,83,11,14,9,69,2
2123271,108,19,1905,11,female,1267,522,456,84,19,9,10,75,9
1954600,16,21,1997,5,female,122,543,431,82,35,27,14,55,21
2176903,100,21,1913,4,male,1258,523,280,82,26,49,13,33,13
1749840,19,10,1994,12,male,764,535,364,83,119,22,85,61,34
1326082,45,25,1968,8,female,2223,553,214,84,191,21,61,63,130
1371889,68,29,1945,11,female,970,562,199,83,391,83,259,0,132
1359329,19,20,1994,11,female,477,540,441,85,48,1,5,84,43
1599194,23,19,1990,12,female,234,557,366,86,24,0,7,86,17
2159961,17,12,1996,8,female,431,535,179,85,171,7,119,78,52
1658023,18,10,1995,1,male,788,571,383,86,132,26,80,60,52
2191906,24,8,1989,12,male,624,551,209,86,171,31,66,55,105
1831926,108,26,1905,5,male,382,565,520,87,150,79,139,8,11
1146597,23,19,1990,2,male,1085,524,211,87,32,87,30,0,2
1268137,15,12,1998,9,female,322,540,463,87,70,87,65,0,5
1903739,22,17,1991,8,male,268,545,300,90,20,12,13,78,7
1915787,47,1,1966,11,male,781,553,323,88,71,8,35,80,36
2182127,19,13,1994,3,male,373,568,452,89,93,33,67,56,26
2141081,21,3,1992,1,male,633,522,274,90,708,86,500,4,208
1721841,21,17,1992,8,male,840,544,214,91,188,91,152,0,36
1085380,17,23,1996,5,female,207,545,428,93,12,10,1,83,11
2024882,113,25,1900,12,male,1809,538,219,93,143,61,73,32,70
1868182,108,7,1905,11,female,1088,552,203,92,43,88,20,4,23
2139257,23,1,1990,1,male,636,526,459,95,60,83,29,12,31
1904183,100,8,1913,2,female,1714,547,176,94,126,77,68,17,58
1566335,20,7,1993,7,female,1460,553,141,95,188,94,101,1,87
1755741,103,1,1910,1,male,871,545,173,96,207,0,51,96,156
1620081,22,2,1991,10,male,1030,554,295,98,45,33,4,65,41
1934412,24,9,1989,3,male,1207,528,338,99,216,52,54,47,162
1908542,35,7,1978,3,female,1826,530,322,97,223,90,69,7,154
1043480,108,5,1905,10,female,2304,565,209,97,105,97,85,0,20
2182512,17,26,1996,10,male,991,571,266,96,293,96,255,0,38
2040040,22,3,1991,3,male,493,560,232,97,179,97,138,0,41
1030102,14,14,1999,6,female,460,570,303,104,91,5,14,99,77
1605327,94,13,1919,5,male,496,573,261,104,51,38,25,66,26
2074210,18,12,1995,4,male,272,525,186,103,27,93,18,10,9
1066217,21,7,1992,4,male,582,527,481,101,26,80,21,21,5
2051541,38,16,1975,7,female,432,521,251,100,133,97,104,3,29
2110486,46,3,1967,11,female,2050,538,400,104,116,99,104,5,12
1456299,88,25,1925,12,female,960,569,417,100,98,96,27,4,71
1839159,108,14,1905,12,male,1185,524,210,102,65,76,29,26,36
2182477,53,29,1960,12,male,363,573,449,103,446,101,278,2,168
1876766,16,22,1997,5,female,384,573,340,102,22,102,11,0,11
1723665,22,16,1991,10,male,572,542,441,103,45,103,43,0,2
1424178,89,15,1924,1,female,1728,535,298,103,433,103,310,0,123
1886281,100,12,1913,2,female,2295,532,219,109,14,99,9,10,5
1769978,23,30,1990,7,male,226,568,427,107,163,82,116,25,47
1954118,24,5,1989,12,female,764,547,234,105,195,105,156,0,39
1920218,22,7,1991,2,male,583,559,246,113,41,98,41,15,0
2008402,73,7,1940,9,male,1263,522,223,111,269,110,162,1,107
1590939,19,31,1994,8,female,461,523,371,112,477,112,436,0,41
1742480,21,6,1992,2,male,324,525,268,117,144,7,38,110,106
1582973,55,30,1958,11,female,232,527,456,118,308,0,30,118,278
1739837,95,31,1918,1,female,1560,540,313,117,352,62,274,55,78
1728828,103,31,1910,5,male,1053,560,163,116,32,111,24,5,8
2025806,15,2,1998,5,female,289,532,341,116,445,99,326,17,119
1253503,100,28,1913,12,male,1723,524,138,116,399,104,265,12,134
2014061,20,16,1993,6,male,488,542,472,117,23,116,13,1,10
1575070,23,25,1990,1,female,173,550,499,115,128,115,118,0,10
1059330,108,8,1905,3,male,1202,528,244,122,106,88,44,34,62
1615254,22,24,1991,9,male,300,524,302,120,260,64,125,56,135
1579332,33,21,1980,9,male,424,570,491,120,422,69,266,51,156
1946512,26,7,1987,7,female,1602,568,251,124,129,98,81,26,48
1368372,23,13,1990,6,female,783,547,387,123,466,89,244,34,222
2025911,23,25,1990,10,female,558,554,211,120,323,108,100,12,223
1551169,98,19,1915,2,male,1586,562,281,124,108,123,76,1,32
1868143,26,16,1987,4,male,213,529,195,123,139,123,133,0,6
1370306,90,2,1923,2,male,1437,564,112,122,95,122,91,0,4
1038220,100,14,1913,3,male,2273,559,205,121,167,121,131,0,36
1544588,24,28,1989,9,male,393,549,494,122,282,122,268,0,14
1905434,98,25,1915,12,female,1394,570,189,125,147,0,77,125,70
1181674,103,1,1910,2,male,1172,526,329,128,97,0,47,128,50
1446949,57,16,1956,12,female,1565,542,182,128,633,22,267,106,366
1733942,19,29,1994,1,female,478,519,452,127,240,49,85,78,155
1769244,17,19,1996,4,female,148,549,480,126,17,117,10,9,7
1012915,25,7,1988,10,female,485,571,197,130,222,129,180,1,42
1109042,23,16,1990,9,female,615,552,271,128,132,128,92,0,40
1793123,38,19,1975,5,female,819,547,331,129,187,129,132,0,55
1963358,14,1,1999,1,female,184,550,141,126,284,126,212,0,72
1567230,26,23,1987,2,male,1131,538,279,132,13,130,9,2,4
1025255,17,27,1996,9,female,369,541,356,131,46,103,15,28,31
2085034,108,9,1905,7,female,2223,519,291,132,137,125,72,7,65
1912582,15,11,1998,1,female,549,548,390,132,227,132,207,0,20
1750122,25,27,1988,2,female,42,525,277,136,278,136,211,0,67
1046109,58,22,1955,7,male,1116,542,355,141,71,8,2,133,69
1649153,17,26,1996,6,female,692,554,231,140,118,9,43,131,75
1535306,80,29,1933,10,male,396,559,466,138,177,25,104,113,73
1314375,16,24,1997,1,male,375,548,380,139,81,89,23,50,58
1980781,16,9,1997,12,female,406,563,291,137,187,37,77,100,110
2099095,103,1,1910,7,female,757,540,266,143,117,50,30,93,87
1741527,24,29,1989,6,female,778,566,385,143,306,63,141,80,165
1543495,49,11,1964,2,male,2264,560,410,137,627,59,508,78,119
1026091,20,5,1993,7,male,664,553,262,142,241,142,198,0,43
1401526,26,4,1987,7,male,432,537,470,138,229,138,212,0,17
1767722,58,22,1955,6,male,562,542,230,138,279,138,52,0,227
1670863,60,25,1953,10,female,759,520,295,138,278,138,201,0,77
2110487,37,13,1976,3,male,362,522,449,144,51,23,33,121,18
1657501,14,25,1999,5,female,160,548,241,144,422,134,332,10,90
1318475,103,3,1910,3,female,771,520,282,145,185,145,113,0,72
1313859,22,15,1991,11,female,129,539,102,149,503,149,210,0,293
2004002,20,20,1993,1,male,326,541,378,155,56,0,6,155,50
1637030,94,25,1919,12,female,1800,531,235,153,85,29,15,124,70
1582964,17,6,1996,1,male,595,534,94,157,537,19,210,138,327
1801899,62,5,1951,10,male,321,570,284,151,228,0,70,151,158
1083679,23,6,1990,7,female,572,538,400,154,2,58,0,96,2
1097371,23,20,1990,7,male,722,536,381,151,0,127,0,24,0
1827706,18,28,1995,12,male,351,570,411,154,114,154,88,0,26
1236798,20,27,1993,9,male,172,549,369,153,139,153,115,0,24
1830798,18,30,1995,11,female,630,540,395,154,430,154,363,0,67
1356203,19,3,1994,4,male,414,531,464,158,80,122,37,36,43
1324100,32,7,1981,5,female,559,523,279,159,108,150,25,9,83
1968526,34,10,1979,11,female,1506,542,248,161,470,142,293,19,177
2160226,16,5,1997,6,male,257,563,505,158,26,158,13,0,13
1096548,18,24,1995,3,female,293,549,348,159,14,159,12,0,2
1873637,21,23,1992,7,female,1141,542,120,161,293,161,180,0,113
1527497,38,5,1975,1,male,239,547,440,163,333,163,262,0,71
1842459,19,10,1994,9,female,584,537,374,166,184,74,26,92,158
1903722,56,31,1957,8,male,1842,522,309,168,342,105,116,63,226
1811960,16,7,1997,3,male,826,520,346,170,23,140,15,30,8
1932867,19,9,1994,5,male,544,560,329,165,656,131,535,34,121
1511791,24,3,1989,3,male,658,569,159,170,619,159,231,11,388
1804338,15,19,1998,6,female,373,524,296,168,52,168,35,0,17
1169562,16,21,1997,3,female,405,520,253,166,95,166,54,0,41
1316263,48,27,1965,5,male,1666,552,114,167,449,167,174,0,275
2056173,17,5,1996,11,female,373,539,412,174,33,5,19,169,14
2115626,17,10,1996,5,male,411,553,396,174,38,4,8,170,30
1427003,108,28,1905,2,male,1399,556,260,174,49,1,8,173,41
1470756,22,6,1991,2,female,285,534,365,180,317,82,197,98,120
1176785,24,5,1989,3,female,1033,544,313,181,79,132,39,49,40
1732244,19,24,1994,2,male,232,533,363,177,250,157,152,20,98
1556326,23,28,1990,12,female,526,565,234,179,111,177,103,2,8
2053153,22,4,1991,2,male,533,552,182,180,198,171,79,9,119
1058510,23,1,1990,1,male,171,521,486,181,17,181,12,0,5
1141704,26,15,1987,8,female,730,557,435,174,220,174,120,0,100
1036015,42,4,1971,12,male,940,555,261,179,136,179,54,0,82
1941937,66,30,1947,6,female,1239,542,359,189,207,17,49,172,158
2050705,74,29,1939,5,male,705,546,292,190,203,24,57,166,146
1922231,51,7,1962,4,male,1420,530,397,187,43,80,26,107,17
1411900,22,9,1991,7,male,473,519,339,189,281,108,180,81,101
1566424,55,9,1958,4,male,983,520,135,187,247,62,139,125,108
2120219,51,8,1962,2,male,652,538,270,184,21,163,20,21,1
1639898,108,7,1905,3,female,1576,573,264,188,31,185,4,3,27
1835725,18,12,1995,2,female,270,537,479,185,120,161,84,24,36
2048322,17,24,1996,8,female,278,535,51,183,22,183,11,0,11
1358959,18,14,1995,1,male,150,532,463,185,86,185,82,0,4
2085716,20,8,1993,7,female,627,542,154,183,285,183,274,0,11
1265369,22,5,1991,9,male,970,561,134,198,219,0,69,198,150
1351656,103,3,1910,2,male,646,571,333,193,226,14,67,179,159
1387428,21,23,1992,12,male,241,535,363,200,193,67,96,133,97
1714005,21,11,1992,4,female,991,562,267,196,192,48,81,148,111
1660835,91,10,1922,12,male,2301,535,62,197,278,114,161,83,117
1234590,89,1,1924,4,male,1898,563,297,194,558,92,207,102,351
2109126,19,20,1994,12,female,237,540,377,191,273,179,166,12,107
1783661,19,5,1994,3,female,649,535,333,191,277,168,263,23,14
1915458,68,24,1945,5,male,481,533,452,191,68,191,60,0,8
1043067,14,13,1999,2,female,252,557,325,193,174,193,83,0,91
1299575,68,13,1945,11,male,1031,557,361,192,443,192,365,0,78
1421280,103,1,1910,12,male,2328,531,459,210,299,0,249,210,50
1390175,24,5,1989,10,female,165,553,491,203,60,112,20,91,40
1271998,105,29,1908,2,female,1426,549,113,210,101,95,83,115,18
1629649,108,20,1905,2,female,2166,558,232,209,304,67,189,142,115
1285348,18,10,1995,2,male,463,538,252,201,197,201,102,0,95
1677086,33,14,1980,11,male,866,529,436,217,94,47,75,170,19
1960373,95,6,1918,10,male,1720,535,302,221,256,106,176,115,80
1430096,16,16,1997,5,male,399,532,305,221,420,62,218,159,202
2105173,22,27,1991,4,female,203,563,427,221,1140,131,582,90,558
1661997,100,13,1913,5,female,1474,573,263,213,384,145,237,68,147
1354616,18,2,1995,4,male,532,524,301,212,90,174,64,38,26
1136424,18,16,1995,5,female,526,563,210,217,132,210,89,7,43
1199833,21,21,1992,7,female,968,531,335,215,229,212,184,3,45
1682477,33,8,1980,1,female,155,573,258,215,209,206,162,9,47
1715567,47,27,1966,10,female,1944,546,129,220,650,159,363,61,287
1070269,18,1,1995,4,male,279,521,232,221,31,221,25,0,6
1875113,17,16,1996,12,male,101,562,436,217,57,217,21,0,36
1700877,20,9,1993,6,female,285,555,406,213,54,213,44,0,10
1151345,16,10,1997,11,male,42,530,507,215,339,215,238,0,101
1530344,18,14,1995,5,male,225,573,511,228,64,0,28,228,36
1903753,63,16,1950,6,female,1948,551,358,232,279,27,88,205,191
1042588,40,18,1973,10,male,893,543,364,230,353,41,143,189,210
1630797,16,17,1997,7,female,663,519,341,224,268,86,157,138,111
1998890,59,10,1954,4,female,1534,569,334,223,149,68,68,155,81
2044941,75,9,1938,10,male,2171,569,267,223,163,159,116,64,47
1697701,15,18,1998,3,male,272,548,396,232,190,170,38,62,152
1888588,16,3,1997,3,female,152,527,353,229,485,208,174,21,311
1233726,53,20,1960,8,female,1578,550,323,233,580,218,288,15,292
1083714,16,12,1997,5,male,530,545,473,226,0,225,0,1,0
1273641,72,20,1941,10,female,1760,553,243,237,292,8,57,229,235
2128695,61,1,1952,6,female,1354,557,266,245,500,19,253,226,247
1792422,15,30,1998,9,female,319,550,256,240,129,131,33,109,96
1806173,19,30,1994,5,female,808,523,406,237,158,59,66,178,92
1123156,18,30,1995,8,female,236,535,271,236,804,86,525,150,279
2011826,16,12,1997,5,female,610,548,373,236,94,188,29,48,65
1684940,19,17,1994,5,female,583,532,357,237,173,223,150,14,23
1701148,21,3,1992,10,male,203,548,398,242,864,205,794,37,70
1514581,26,21,1987,2,male,543,535,471,245,122,245,83,0,39
2102413,18,9,1995,2,female,538,571,269,242,184,242,117,0,67
1777911,21,11,1992,1,female,471,531,54,246,323,246,178,0,145
1644512,21,15,1992,9,male,567,521,412,249,649,32,44,217,605
1979436,17,20,1996,12,female,690,524,386,256,35,166,26,90,9
1653304,18,7,1995,8,male,564,557,423,256,65,185,31,71,34
1386939,19,23,1994,6,female,1228,560,254,253,172,222,119,31,53
2067300,29,5,1984,9,male,678,524,317,249,282,190,168,59,114
1230289,14,4,1999,4,female,220,548,364,258,433,243,338,15,95
2111757,15,13,1998,10,female,229,546,424,249,901,217,581,32,320
2068114,19,9,1994,3,male,573,549,386,256,77,256,74,0,3
1162860,26,1,1987,1,male,561,569,503,260,92,260,81,0,11
1246434,20,23,1993,1,female,457,569,358,247,283,247,149,0,134
1370317,32,16,1981,3,male,703,548,378,248,325,248,295,0,30
1264608,103,10,1910,11,female,1339,522,88,252,364,252,127,0,237
1448799,93,24,1920,1,female,16,571,22,266,342,4,172,262,170
1627165,13,2,2000,1,female,176,551,403,265,492,173,223,92,269
1832548,16,25,1997,8,male,601,526,374,269,186,248,165,21,21
1342664,18,6,1995,10,male,56,527,464,273,476,272,342,1,134
1610858,22,17,1991,8,male,167,538,437,269,100,269,97,0,3
2059475,19,19,1994,2,male,455,546,376,262,463,262,260,0,203
1558158,17,23,1996,12,male,802,565,384,290,139,0,105,290,34
1963366,77,23,1936,9,male,1451,521,365,280,128,4,85,276,43
2163365,18,20,1995,7,female,330,561,203,281,139,107,71,174,68
1128900,18,30,1995,7,male,268,521,423,279,156,123,98,156,58
2123575,25,22,1988,8,female,545,524,264,281,235,150,115,131,120
1981715,47,21,1966,11,female,1593,550,206,279,301,218,168,61,133
2172891,67,6,1946,5,male,208,532,306,277,11,277,7,0,4
1236032,14,27,1999,7,female,459,536,302,285,324,285,195,0,129
1447141,17,20,1996,11,male,470,553,346,287,218,287,184,0,34
1844318,105,8,1908,7,female,1007,562,356,306,165,0,25,306,140
1563857,15,2,1998,4,female,608,559,496,306,67,199,59,107,8
1047011,14,25,1999,1,female,555,543,305,305,263,141,133,164,130
1786219,57,22,1956,8,female,173,542,454,303,222,113,84,190,138
1826785,103,15,1910,12,female,707,570,293,302,370,141,138,161,232
1977768,22,17,1991,1,male,183,560,445,298,267,224,147,74,120
1740221,103,14,1910,1,female,2277,563,435,295,213,256,84,39,129
1324555,17,17,1996,10,female,218,537,469,301,548,277,470,24,78
1067304,22,23,1991,10,male,403,561,496,303,192,303,144,0,48
1802722,32,2,1981,4,male,759,519,200,297,440,297,343,0,97
1836727,49,25,1964,3,female,958,528,345,298,515,298,469,0,46
1306276,21,7,1992,1,female,47,556,285,311,204,57,121,254,83
1151983,20,30,1993,10,male,593,529,392,321,100,164,63,157,37
1358060,15,9,1998,10,female,470,536,319,327,204,211,127,116,77
2057581,16,27,1997,10,female,549,548,279,310,234,218,209,92,25
1385644,20,30,1993,5,female,258,555,268,309,449,82,204,227,245
1627318,21,1,1992,6,female,510,560,105,315,612,91,290,224,322
1145927,17,30,1996,6,female,707,544,391,319,117,286,78,33,39
1532574,21,30,1992,1,female,746,560,463,313,122,311,98,2,24
2060266,108,29,1905,4,male,1359,520,314,320,306,320,185,0,121
2104903,16,5,1997,4,female,331,562,56,327,509,327,418,0,91
1297141,28,1,1985,3,female,644,521,210,326,969,326,599,0,370
2153012,17,3,1996,1,male,698,559,372,332,60,36,14,296,46
1527633,20,25,1993,5,female,172,541,50,342,127,54,23,288,104
1761080,18,24,1995,4,male,709,542,434,330,50,153,43,177,7
1242646,15,8,1998,8,male,476,530,342,342,375,138,181,204,194
1744711,22,16,1991,12,male,735,535,180,346,768,304,488,42,280
2084547,26,3,1987,3,female,85,541,402,332,689,294,230,38,459
1877283,96,1,1917,1,female,568,556,79,337,550,337,495,0,55
1296729,19,30,1994,12,female,559,519,131,351,1068,40,346,311,722
1629859,17,31,1996,7,male,567,555,460,369,253,106,94,263,159
1783995,83,10,1930,7,male,887,521,226,369,237,253,160,116,77
1200120,108,29,1905,8,male,17,569,551,366,550,216,475,150,75
1928269,23,19,1990,10,female,187,564,506,363,407,275,140,88,267
1401840,33,4,1980,9,female,575,546,446,356,269,265,188,91,81
1188095,57,2,1956,2,female,1844,519,233,351,360,342,312,9,48
2096213,20,7,1993,12,male,137,537,451,352,964,308,357,44,607
1412900,63,18,1950,6,female,1669,527,276,352,508,349,326,3,182
1200434,21,13,1992,7,female,363,548,476,394,204,26,27,368,177
1033795,17,24,1996,3,female,265,530,428,386,189,115,89,271,100
1419356,89,12,1924,5,male,1282,523,296,386,117,224,29,162,88
1538352,21,10,1992,12,female,705,523,245,377,462,236,84,141,378
1065117,31,6,1982,7,female,1619,571,314,390,558,129,239,261,319
1348279,16,10,1997,7,female,380,533,348,373,312,338,112,35,200
2090862,19,26,1994,4,female,306,555,351,388,245,360,121,28,124
1586821,20,2,1993,3,female,466,520,397,392,429,370,264,22,165
1908142,108,23,1905,10,female,1496,565,427,389,247,372,167,17,80
1347828,13,21,2000,7,female,357,552,349,390,815,374,550,16,265
1076509,18,19,1995,3,male,607,525,344,394,493,393,194,1,299
1127605,18,3,1995,3,female,316,548,342,379,284,379,248,0,36
1123772,15,26,1998,10,male,559,527,351,410,99,187,48,223,51
1788134,15,21,1998,11,female,925,564,355,410,341,215,99,195,242
1465731,23,12,1990,11,female,940,547,298,396,351,241,167,155,184
1798970,28,17,1985,10,male,964,539,312,400,275,259,132,141,143
1978687,18,27,1995,1,female,283,549,344,395,1246,182,820,213,426
1588459,20,21,1993,2,female,546,569,472,397,204,339,146,58,58
2033835,16,20,1997,1,female,324,559,366,404,299,388,207,16,92
1668944,15,22,1998,6,male,474,565,492,418,146,415,88,3,58
1754294,16,18,1997,11,female,395,570,183,398,244,396,104,2,140
1283203,31,2,1982,4,female,236,553,212,411,926,411,864,0,62
2127335,65,30,1948,9,male,872,538,407,448,89,257,64,191,25
1054000,18,30,1995,3,female,491,535,365,436,295,95,93,341,202
1159724,17,18,1996,11,female,713,528,319,424,903,278,545,146,358
1604013,16,24,1997,6,female,470,550,184,431,858,281,254,150,604
1467565,18,25,1995,7,male,393,553,409,429,1245,166,561,263,684
1030768,24,23,1989,12,female,796,551,376,428,652,100,291,328,361
1106006,14,13,1999,5,female,275,567,312,422,208,373,146,49,62
1905874,18,23,1995,3,male,239,533,374,447,447,352,312,95,135
1823593,19,18,1994,3,female,178,548,442,427,311,413,115,14,196
1950491,15,7,1998,6,female,98,571,293,428,793,389,193,39,600
1618619,20,14,1993,12,male,219,538,469,440,1386,382,1162,58,224
1617569,14,25,1999,7,female,408,532,424,442,53,440,24,2,29
1360667,41,15,1972,2,female,693,567,301,423,803,420,387,3,416
1680230,19,12,1994,5,male,375,567,451,431,328,431,315,0,13
2108675,18,23,1995,11,female,351,560,297,439,990,439,788,0,202
1983446,17,5,1996,3,male,604,536,378,479,305,250,129,229,176
1203596,34,3,1979,9,female,796,566,99,469,665,262,197,207,468
1840325,49,19,1964,6,female,318,562,388,474,445,473,220,1,225
1871809,26,13,1987,8,female,188,570,448,458,247,458,222,0,25
2003551,27,9,1986,12,female,693,537,359,454,402,454,207,0,195
1634110,23,22,1990,12,male,274,557,299,459,749,459,650,0,99
1152125,100,1,1913,1,female,1195,525,131,480,934,480,710,0,224
2016176,20,19,1993,12,male,857,567,353,508,228,245,135,263,93
1220723,19,12,1994,7,male,624,571,278,511,207,153,107,358,100
1150658,18,6,1995,10,female,366,566,142,500,422,238,80,262,342
1171922,24,17,1989,12,female,808,530,225,491,492,205,195,286,297
2100005,15,3,1998,8,female,522,559,226,502,1348,123,248,379,1100
2036805,24,28,1989,8,female,211,540,436,490,555,468,388,22,167
1612158,43,4,1970,12,male,1014,531,369,490,677,482,253,8,424
1845141,41,16,1972,9,female,1607,549,131,500,231,499,126,1,105
1133471,50,2,1963,9,female,568,541,390,517,85,517,58,0,27
1446422,16,10,1997,4,male,397,561,336,515,185,515,143,0,42
1300012,21,16,1992,7,male,187,550,474,485,503,485,441,0,62
1196740,25,19,1988,9,female,176,562,464,494,442,494,391,0,51
1877803,16,24,1997,10,female,175,558,410,556,718,68,244,488,474
1485162,69,6,1944,2,female,73,564,440,539,703,0,119,539,584
1104970,14,31,1999,1,female,41,531,410,547,540,299,212,248,328
1023709,20,8,1993,10,male,1362,538,292,524,350,231,266,293,84
2095612,32,15,1981,5,female,1321,541,303,560,723,183,230,377,493
1746305,20,14,1993,8,female,795,566,336,525,892,301,409,224,483
1542362,43,10,1970,12,female,815,534,391,560,1011,301,529,259,482
1894697,15,15,1998,11,male,541,557,413,546,323,524,123,22,200
1798724,19,15,1994,2,male,659,568,259,531,474,524,293,7,181
1687509,23,20,1990,5,female,284,528,478,552,749,491,649,61,100
1847727,50,19,1963,9,female,1732,532,126,535,654,439,97,96,557
1536840,63,20,1950,11,female,894,545,293,539,770,515,478,24,292
2042289,93,14,1920,6,male,506,548,450,547,1058,414,649,133,409
1682022,13,23,2000,3,male,153,539,430,546,186,546,158,0,28
1330734,22,5,1991,6,male,798,567,460,537,349,537,316,0,33
2184455,30,29,1983,8,female,632,565,308,559,500,559,381,0,119
1802680,58,12,1955,7,male,1185,530,382,602,209,1,13,601,196
1264049,16,25,1997,11,female,626,572,401,578,542,34,216,544,326
2087962,40,10,1973,7,female,283,528,352,569,569,15,206,554,363
1090632,50,6,1963,3,female,284,526,402,579,262,409,94,170,168
1372643,20,5,1993,1,male,307,534,473,579,480,141,194,438,286
1014064,25,18,1988,8,female,504,532,331,562,535,265,217,297,318
1818793,52,12,1961,5,female,1861,525,439,565,396,398,270,167,126
1686457,64,4,1949,2,male,1721,540,329,597,375,159,176,438,199
1845647,64,25,1949,10,male,1817,555,341,586,654,305,496,281,158
2154645,26,27,1987,12,male,1393,523,279,574,1102,303,965,271,137
1717710,17,5,1996,10,male,494,531,420,601,574,508,507,93,67
1947947,14,14,1999,5,female,272,528,255,583,128,583,117,0,11
1838887,100,25,1913,3,male,1060,552,417,578,298,578,268,0,30
1593001,18,28,1995,6,male,710,524,361,572,573,572,297,0,276
1492819,62,11,1951,5,female,1399,519,233,640,372,30,132,610,240
1072158,13,13,2000,1,female,579,572,418,649,934,1,87,648,847
1388560,15,14,1998,12,female,372,522,360,647,481,60,147,587,334
1748999,102,1,1911,1,male,938,526,314,663,511,131,174,532,337
2039163,15,10,1998,5,female,34,566,533,639,157,174,51,465,106
1584810,65,28,1948,10,male,1880,566,394,622,119,235,29,387,90
1211645,23,30,1990,7,female,585,554,218,646,541,447,211,199,330
1815226,18,17,1995,8,female,516,540,353,647,1062,446,529,201,533
1344853,39,10,1974,6,female,1425,519,246,648,1048,211,443,437,605
1517869,18,24,1995,7,male,336,533,280,654,845,623,336,31,509
1979780,32,13,1981,11,male,560,527,433,653,569,503,130,150,439
1815638,20,24,1993,6,male,706,556,456,655,404,654,367,1,37
1204874,23,11,1990,5,male,232,558,520,654,51,654,36,0,15
1713212,19,7,1994,5,female,335,544,133,631,149,631,89,0,60
2086245,19,7,1994,11,male,256,561,497,660,527,660,464,0,63
1366359,22,26,1991,8,female,435,531,159,662,498,662,433,0,65
1010745,43,10,1970,3,female,1775,524,246,618,445,618,297,0,148
1627007,68,17,1945,8,female,200,538,58,621,653,621,386,0,267
1013425,100,3,1913,5,male,1243,553,298,615,446,615,386,0,60
1437977,25,9,1988,10,female,341,543,445,627,1043,627,880,0,163
2020733,59,30,1954,4,male,1476,540,205,697,366,31,132,666,234
1299869,85,13,1928,12,male,970,560,363,698,187,475,166,223,21
1585405,22,24,1991,4,male,855,537,345,725,1012,270,777,455,235
1165867,21,21,1992,11,male,333,563,340,725,390,656,226,69,164
1258113,21,15,1992,8,female,485,573,415,711,183,694,102,17,81
1458834,16,20,1997,9,female,256,566,388,721,998,538,524,183,474
1590499,104,10,1909,3,female,1115,568,177,681,458,664,320,17,138
1406067,18,19,1995,6,female,264,549,450,715,1620,685,959,30,661
1550540,20,21,1993,8,female,686,523,402,712,27,711,12,1,15
1276693,75,14,1938,5,male,1051,531,194,673,176,673,87,0,89
1143405,25,8,1988,6,male,271,535,353,716,572,716,531,0,41
1748853,39,27,1974,11,female,699,532,404,671,621,671,509,0,112
1399753,20,21,1993,7,female,85,543,461,703,1824,703,1463,0,361
1249808,52,24,1961,12,female,513,549,122,727,1847,39,509,688,1338
1598445,20,7,1993,9,female,922,564,242,733,401,261,184,472,217
1239098,25,22,1988,12,female,2065,567,236,752,817,528,462,224,355
1972455,46,7,1967,3,female,1555,555,101,796,1181,332,471,464,710
1729920,113,30,1900,1,female,1873,556,114,775,871,558,737,217,134
1114387,15,22,1998,10,female,562,557,493,743,216,720,174,23,42
1057523,20,22,1993,6,female,1545,542,229,795,1066,742,983,53,83
1651476,19,10,1994,6,female,731,550,390,733,601,729,491,4,110
2191779,16,16,1997,5,female,171,551,334,729,58,729,49,0,9
2040816,20,8,1993,11,male,518,567,496,784,241,784,169,0,72
1418524,56,10,1957,10,female,1019,537,119,791,945,791,659,0,286
1948490,23,8,1990,11,female,309,529,159,738,1755,738,1666,0,89
1381363,16,31,1997,7,male,207,553,291,854,356,570,223,284,133
1481316,18,24,1995,11,female,723,526,367,808,790,352,264,456,526
1123175,18,29,1995,11,female,274,538,212,812,902,469,623,343,279
1269874,17,22,1996,1,male,241,558,334,803,1003,298,688,505,315
1664920,20,4,1993,3,female,258,569,343,804,526,360,304,444,222
1634779,22,14,1991,1,female,1387,521,149,867,869,576,659,291,210
2168063,23,22,1990,6,female,888,559,378,829,1066,516,545,313,521
1806789,19,3,1994,10,female,323,563,277,816,3137,466,819,350,2318
1896796,20,2,1993,2,female,295,550,286,851,1323,611,666,240,657
1399804,51,5,1962,6,female,1366,538,311,849,1273,784,851,65,422
1882273,19,27,1994,4,female,384,563,147,873,215,873,160,0,55
2164573,15,15,1998,5,female,120,551,484,860,722,860,703,0,19
1459690,15,4,1998,6,female,310,537,101,869,586,869,476,0,110
1500486,19,16,1994,2,female,313,524,449,806,797,806,570,0,227
1645162,15,30,1998,7,female,326,546,365,874,1461,874,1319,0,142
1350501,20,13,1993,1,female,515,563,243,848,2798,848,2156,0,642
1987946,25,10,1988,2,female,377,538,185,816,1268,816,1198,0,70
1798781,16,13,1997,6,male,192,521,383,986,107,705,69,281,38
1119486,24,21,1989,1,female,599,564,322,906,433,583,263,323,170
1352874,94,29,1919,3,female,834,558,222,938,372,448,160,490,212
1285781,15,14,1998,7,male,109,554,485,978,1478,441,646,537,832
1503557,52,24,1961,8,male,1717,565,315,967,3014,378,1778,589,1236
2111876,19,24,1994,4,female,536,551,310,918,328,666,228,252,100
1733709,108,17,1905,10,male,258,570,396,928,436,896,258,32,178
1139544,68,6,1945,5,female,779,558,341,881,595,810,463,71,132
2134352,113,19,1900,11,female,1391,521,212,899,482,896,371,3,111
1882160,29,17,1984,1,male,512,569,412,919,859,911,641,8,218
1461902,57,18,1956,5,female,158,573,507,914,682,911,297,3,385
1207999,101,18,1912,11,female,1829,550,253,970,155,970,105,0,50
1788575,20,1,1993,1,male,216,564,508,913,370,913,331,0,39
1474769,21,8,1992,9,male,761,572,191,959,285,959,247,0,38
1010010,21,22,1992,2,female,506,555,305,946,679,946,401,0,278
1835592,25,28,1988,12,female,650,548,292,967,1137,967,1058,0,79
2052236,66,15,1947,8,male,818,554,326,921,635,921,434,0,201
1478527,107,10,1906,7,female,2249,561,454,1087,1051,0,587,1087,464
1035533,20,7,1993,3,female,103,528,129,1101,1708,0,381,1101,1327
1405711,17,8,1996,6,female,605,562,424,1128,176,714,46,414,130
1596004,16,15,1997,10,male,416,553,393,1068,510,709,141,359,369
1934217,24,1,1989,11,female,1381,549,359,1000,551,709,394,291,157
1237071,26,3,1987,9,female,1661,558,243,1042,231,268,65,774,166
1506735,45,6,1968,3,female,1316,525,344,1023,768,608,221,415,547
1286400,14,20,1999,8,female,392,527,105,1005,543,904,388,101,155
1150712,15,16,1998,8,female,1337,555,198,1053,722,1030,607,23,115
1066474,25,10,1988,6,female,686,548,391,1111,757,852,373,259,384
1519931,15,16,1998,7,female,233,520,140,1128,2391,973,1222,155,1169
1687469,20,10,1993,8,female,519,546,180,1056,633,1056,404,0,229
1239544,14,21,1999,6,male,181,550,457,1237,317,0,58,1237,259
1952756,48,11,1965,2,female,763,556,394,1162,641,61,144,1101,497
1170458,62,23,1951,12,female,797,536,267,1274,596,46,264,1228,332
1579747,14,5,1999,9,female,343,553,407,1147,805,71,405,1076,400
1660982,18,21,1995,10,female,688,553,262,1203,862,80,421,1123,441
2152531,23,6,1990,11,female,1853,519,324,1177,1542,88,589,1089,953
1534026,47,13,1966,8,female,210,556,501,1214,642,830,193,384,449
1825393,49,6,1964,2,female,532,539,181,1277,268,608,136,669,132
1185247,15,8,1998,6,female,523,564,429,1163,956,448,271,715,685
1323712,24,17,1989,7,female,400,571,362,1184,1138,466,756,718,382
1938318,27,1,1986,8,male,755,537,340,1182,351,1153,94,29,257
1971740,20,22,1993,4,female,862,522,303,1276,1463,1233,822,43,641
2089537,22,13,1991,4,female,357,554,384,1192,1563,1179,1432,13,131
1255881,46,17,1967,5,female,2577,547,216,1251,2112,989,1527,262,585
1778147,17,17,1996,1,female,626,541,219,1168,1453,1168,1321,0,132
2000521,23,1,1990,1,male,394,553,453,1421,281,24,210,1397,71
1790575,16,6,1997,1,male,817,532,264,1303,1453,220,288,1083,1165
2103853,23,26,1990,10,female,804,557,488,1515,2021,157,1360,1358,661
1580783,24,10,1989,2,male,1451,520,375,1331,585,590,119,741,466
1657662,103,26,1910,1,female,1505,533,322,1354,485,546,293,808,192
1082871,14,4,1999,8,female,866,569,409,1395,318,1215,233,180,85
1770533,16,25,1997,3,female,397,522,323,1500,373,1461,220,39,153
1088456,18,9,1995,4,male,457,550,459,1506,476,1291,427,215,49
1294765,16,8,1997,2,female,484,526,374,1332,452,1331,151,1,301
1896660,55,13,1958,12,female,286,522,328,1384,299,1380,118,4,181
1653152,23,27,1990,1,female,844,557,132,1326,940,1326,900,0,40
1390519,25,14,1988,2,male,673,562,433,1301,1095,1301,918,0,177
1167532,19,17,1994,10,female,546,533,374,1609,895,242,200,1367,695
1761307,67,17,1946,6,female,355,539,257,1698,1929,83,487,1615,1442
1700831,25,8,1988,9,female,814,550,285,1868,2676,674,1319,1194,1357
2013203,53,19,1960,8,female,2256,568,423,1815,1224,996,733,819,491
1935681,39,14,1974,12,female,998,526,157,1790,4135,449,1504,1341,2631
1764304,16,15,1997,11,male,571,549,234,1648,610,1606,500,42,110
1575927,28,31,1985,3,female,519,573,361,1717,823,1683,543,34,280
1040708,22,16,1991,8,female,672,565,394,1636,2429,1580,2284,56,145
1239074,35,1,1978,10,male,108,521,438,1545,1203,1400,664,145,539
2117173,23,18,1990,9,male,537,550,486,1528,21,1528,17,0,4
1494446,33,18,1980,10,female,301,558,513,1679,285,1679,212,0,73
1172062,57,4,1956,9,female,1101,533,414,1539,671,1539,427,0,244
1180270,24,26,1989,2,female,419,536,205,1671,1108,1671,936,0,172
1046102,108,13,1905,11,female,110,554,310,2356,352,0,92,2356,260
1522711,17,8,1996,1,female,163,526,369,2016,817,42,554,1974,263
1749233,19,25,1994,11,female,658,569,363,2132,1147,0,777,2132,370
1739422,32,17,1981,5,female,768,555,133,2307,1281,149,428,2158,853
1586157,19,16,1994,8,female,235,557,253,2023,746,1324,363,699,383
2046105,14,8,1999,9,female,445,529,263,2063,1787,791,1102,1272,685
1580551,18,8,1995,6,female,469,538,419,2023,2629,637,1834,1386,795
1914686,15,10,1998,8,female,280,529,341,2172,1227,1587,510,585,717
2013219,21,16,1992,12,female,1305,537,310,2237,469,2208,362,29,107
1124124,15,11,1998,1,male,184,557,406,2288,2071,1887,1883,401,188
1623118,34,26,1979,8,male,1280,530,155,2026,2623,1895,1462,131,1161
1701871,42,24,1971,7,female,560,561,226,2081,267,2081,140,0,127
1650012,22,12,1991,12,male,709,573,490,2197,2057,2197,1981,0,76
1442272,15,8,1998,6,male,189,547,440,2944,1376,299,500,2645,876
2154985,17,17,1996,2,female,270,524,419,2477,1122,44,485,2433,637
1042532,55,5,1958,10,female,274,563,393,2844,1777,10,440,2834,1337
2166732,59,25,1954,1,female,988,519,306,3068,3002,0,153,3068,2849
1701804,19,3,1994,3,female,624,565,433,2925,1115,1863,693,1062,422
1643884,14,30,1999,6,female,1070,543,298,3503,1306,2994,760,509,546
1057185,42,10,1971,10,female,1034,539,236,2850,2630,2797,1244,53,1386
1593253,19,14,1994,1,female,312,552,373,2765,4393,2696,2151,69,2242
1369573,39,24,1974,11,female,583,539,404,2497,1517,2497,1216,0,301
1105585,18,14,1995,10,female,701,568,399,2471,1891,2471,794,0,1097
1605614,20,9,1993,5,male,374,542,367,3087,1919,3087,1632,0,287
2159521,75,1,1938,6,female,1370,557,225,7484,3483,269,1196,7215,2287
1038359,23,1,1990,2,female,769,573,402,3931,2620,336,471,3595,2149
1275323,17,19,1996,7,female,467,522,285,4728,715,4313,418,415,297
1372868,16,3,1997,2,female,648,545,307,3612,982,3142,320,470,662
1320732,25,11,1988,5,male,196,543,320,10498,2910,7701,1601,2797,1309
1697304,26,14,1987,4,female,527,524,362,7083,3698,5913,1830,1170,1868
2175695,57,5,1956,6,female,1425,537,351,7145,1330,6064,539,1081,791
1745507,18,24,1995,9,female,192,530,275,3799,3977,3539,1603,260,2374
2064754,18,12,1995,5,female,309,521,313,3968,1725,3953,1405,15,320
1375917,24,9,1989,8,male,435,527,340,4058,661,4058,583,0,78
1993980,29,15,1984,1,male,251,521,406,6612,369,6612,334,0,35
1943692,13,14,2000,1,female,243,556,209,9446,5344,9446,4945,0,399
2099884,25,10,1988,1,female,171,555,61,3876,1769,3876,1428,0,341
2025325,33,1,1980,8,male,47,525,506,6119,1439,6119,1323,0,116
1296101,56,17,1957,8,male,120,545,469,9304,5463,9304,5109,0,354
1620976,68,17,1945,8,male,1080,562,457,5159,2751,5159,2728,0,23
1359381,25,4,1988,4,female,99,547,316,4005,5513,4005,3167,0,2346
1231310,15,10,1998,12,female,516,582,232,0,8,0,7,0,1
1833897,14,21,1999,7,female,389,576,391,0,2,0,1,0,1
2021141,16,27,1997,12,male,527,610,518,0,0,0,0,0,0
2023567,15,19,1998,1,female,481,586,487,0,0,0,0,0,0
1922413,15,21,1998,1,male,416,603,504,0,12,0,11,0,1
2073914,15,3,1998,3,female,343,611,67,0,8,0,6,0,2
1610409,15,2,1998,8,female,228,625,575,0,0,0,0,0,0
1059997,17,20,1996,11,male,622,597,283,0,39,0,9,0,30
1075238,17,26,1996,12,male,767,623,443,0,7,0,7,0,0
1035522,16,7,1997,7,female,690,610,492,0,41,0,30,0,11
2128496,16,6,1997,7,female,483,587,295,0,1,0,1,0,0
2138919,16,11,1997,7,female,201,579,49,0,7,0,6,0,1
1126093,16,11,1997,10,female,533,598,372,0,5,0,3,0,2
1017932,18,11,1995,11,male,260,586,572,0,0,0,0,0,0
1383910,17,12,1996,9,female,346,576,462,0,0,0,0,0,0
1937420,19,2,1994,11,female,432,621,492,0,10,0,10,0,0
1616973,19,13,1994,12,male,225,620,548,0,7,0,6,0,1
2120110,18,7,1995,1,female,172,617,442,0,0,0,0,0,0
2151010,18,15,1995,2,male,209,634,341,0,1,0,0,0,1
1146696,18,27,1995,3,male,438,638,580,0,0,0,0,0,0
2112292,18,3,1995,5,female,365,614,487,0,2,0,0,0,2
1357087,18,4,1995,5,female,321,581,478,0,0,0,0,0,0
2019152,18,30,1995,9,male,836,593,411,0,0,0,0,0,0
1212303,18,10,1995,10,male,532,585,408,0,69,0,55,0,14
1003293,19,11,1994,4,male,1238,577,429,0,0,0,0,0,0
1058691,19,20,1994,4,male,945,600,533,0,18,0,12,0,6
1485729,19,14,1994,7,male,525,598,575,0,0,0,0,0,0
1721377,21,9,1992,12,male,497,635,491,0,0,0,0,0,0
1951446,20,21,1993,3,female,1242,580,38,0,7,0,7,0,0
2168284,20,19,1993,5,female,892,630,145,0,3,0,3,0,0
1069616,20,10,1993,10,female,318,604,115,0,25,0,18,0,7
1075009,22,28,1991,12,male,319,574,417,0,3,0,0,0,3
2131722,21,11,1992,3,male,802,610,232,0,0,0,0,0,0
1556154,21,25,1992,5,male,316,593,501,0,0,0,0,0,0
1061999,23,24,1990,11,male,826,600,373,0,3,0,2,0,1
1672317,22,13,1991,4,male,351,586,504,0,2,0,1,0,1
2061579,22,14,1991,8,male,453,605,557,0,5,0,4,0,1
1969068,23,1,1990,1,male,473,636,573,0,0,0,0,0,0
2015776,23,6,1990,2,male,1057,601,518,0,0,0,0,0,0
1967747,23,9,1990,4,female,327,586,55,0,10,0,10,0,0
1994283,23,1,1990,5,male,485,627,575,0,2,0,1,0,1
1256299,23,6,1990,6,female,747,591,382,0,0,0,0,0,0
1464161,24,2,1989,1,male,1152,588,261,0,0,0,0,0,0
1700162,24,1,1989,1,male,563,605,537,0,1,0,1,0,0
1960960,25,5,1988,5,female,479,599,551,0,0,0,0,0,0
1963836,25,17,1988,9,male,1359,610,338,0,22,0,14,0,8
1102907,26,3,1987,1,female,371,620,547,0,0,0,0,0,0
2143587,27,20,1986,5,female,775,607,322,0,0,0,0,0,0
1755769,28,20,1985,1,female,1437,603,361,0,0,0,0,0,0
2017473,28,5,1985,4,male,1247,582,480,0,0,0,0,0,0
1114428,30,14,1983,9,female,1125,610,493,0,0,0,0,0,0
1628128,32,2,1981,2,male,875,615,552,0,5,0,5,0,0
1065087,35,4,1978,1,female,399,575,430,0,0,0,0,0,0
1797791,44,14,1969,5,male,427,621,453,0,0,0,0,0,0
1346127,60,25,1953,8,female,374,581,426,0,0,0,0,0,0
1292255,63,20,1950,12,male,246,581,524,0,0,0,0,0,0
1862042,64,3,1949,6,male,1135,581,165,0,0,0,0,0,0
1517048,68,31,1945,1,female,1497,577,213,0,0,0,0,0,0
1728855,76,13,1937,3,male,1464,590,452,0,2,0,2,0,0
2070074,80,7,1933,4,male,961,574,340,0,27,0,20,0,7
1658844,91,4,1922,7,male,397,601,230,0,0,0,0,0,0
1938685,93,17,1920,3,female,826,576,23,0,12,0,12,0,0
1687868,94,5,1919,4,female,1043,623,254,0,0,0,0,0,0
2011915,103,24,1910,4,female,937,609,203,0,0,0,0,0,0
1428233,103,5,1910,7,male,1369,584,314,0,1,0,0,0,1
2106309,103,27,1910,9,male,1053,632,528,0,1,0,1,0,0
2136366,108,8,1905,3,male,1019,604,571,0,5,0,4,0,1
1989744,17,15,1996,3,male,529,626,579,1,0,0,0,1,0
1561327,57,28,1956,10,male,1638,609,319,1,5,0,0,1,5
1164160,108,13,1905,4,male,1016,614,372,1,57,0,9,1,48
1792890,17,25,1996,8,male,610,584,539,1,0,1,0,0,0
1546591,21,5,1992,8,male,906,620,170,1,0,1,0,0,0
1820205,103,28,1910,8,male,649,588,450,1,0,1,0,0,0
1524704,20,7,1993,7,female,1161,639,380,1,1,1,1,0,0
1095202,21,28,1992,7,male,1311,620,364,1,1,1,1,0,0
1794930,21,2,1992,10,male,606,627,514,1,1,1,1,0,0
2187194,16,7,1997,5,female,487,578,393,1,7,1,6,0,1
2037593,17,3,1996,3,male,1109,627,510,1,12,1,8,0,4
1591323,17,10,1996,7,female,539,578,426,1,17,1,7,0,10
1332828,19,13,1994,11,male,739,621,442,1,12,1,7,0,5
1282089,19,17,1994,12,male,619,583,424,1,3,1,3,0,0
1558223,18,4,1995,7,female,557,611,211,1,12,1,10,0,2
1080285,20,10,1993,12,female,442,616,454,1,7,1,2,0,5
1558802,19,15,1994,2,male,425,621,524,1,6,1,5,0,1
1640826,19,25,1994,3,male,267,620,571,1,5,1,5,0,0
2066095,19,8,1994,8,male,494,586,499,1,2,1,2,0,0
1244641,21,11,1992,11,male,767,583,487,1,10,1,7,0,3
1300914,22,2,1991,8,male,354,612,551,1,5,1,5,0,0
1873839,23,27,1990,9,male,551,582,329,1,8,1,4,0,4
1627619,15,26,1998,7,female,408,589,219,2,9,0,3,2,6
1098532,18,25,1995,3,female,779,639,353,2,12,0,5,2,7
2081798,75,27,1938,4,male,796,608,300,2,8,0,5,2,3
1269231,28,1,1985,12,male,1593,601,389,2,1,1,0,1,1
1118615,17,21,1996,7,female,861,627,190,2,31,1,15,1,16
1618169,15,17,1998,8,female,472,613,284,2,0,2,0,0,0
1783406,17,4,1996,3,male,393,638,537,2,0,2,0,0,0
1903856,26,4,1987,3,male,309,577,467,2,0,2,0,0,0
1351553,21,14,1992,2,male,2304,591,179,2,1,2,1,0,0
1692725,26,8,1987,7,male,1661,591,510,2,1,2,1,0,0
1725192,103,5,1910,1,male,377,575,489,2,1,2,1,0,0
1187987,23,6,1990,9,male,864,588,423,2,2,2,2,0,0
1843234,19,25,1994,11,male,181,614,556,2,8,2,7,0,1
1001312,18,23,1995,2,male,402,614,551,2,3,2,3,0,0
1371864,19,9,1994,1,male,769,621,300,2,5,2,4,0,1
1589869,21,18,1992,5,male,635,625,488,2,12,2,6,0,6
1965172,23,4,1990,6,male,842,580,444,2,54,2,15,0,39
1637452,26,13,1987,10,female,666,593,333,2,11,2,8,0,3
1491469,53,24,1960,12,male,1431,622,534,2,45,2,41,0,4
2142905,38,5,1975,12,male,636,582,474,3,0,0,0,3,0
1360335,15,26,1998,9,female,279,624,325,3,62,1,17,2,45
1975888,21,11,1992,12,male,999,639,354,3,50,2,36,1,14
1950335,28,12,1985,5,male,1493,576,294,3,24,1,14,2,10
2144043,33,31,1980,3,male,594,580,539,3,0,3,0,0,0
1235430,17,1,1996,2,male,1022,605,406,3,2,3,2,0,0
1604035,21,14,1992,2,male,765,602,403,3,2,3,0,0,2
1293952,16,12,1997,11,female,1518,593,165,3,113,3,83,0,30
1708128,17,17,1996,3,male,563,585,510,3,10,3,8,0,2
2068900,19,28,1994,12,male,368,583,464,3,10,3,2,0,8
1561261,18,20,1995,5,female,444,593,461,3,44,3,33,0,11
1619140,20,10,1993,1,female,548,609,160,3,128,3,99,0,29
1211240,20,11,1993,8,female,602,620,155,3,5,3,5,0,0
1416955,23,12,1990,12,male,330,629,585,3,40,3,36,0,4
1620155,22,29,1991,7,female,618,612,154,3,72,3,49,0,23
1006087,24,27,1989,2,female,992,612,444,3,147,3,47,0,100
1083684,27,13,1986,7,male,328,594,489,3,145,3,128,0,17
1860866,33,17,1980,7,male,1970,589,396,3,79,3,16,0,63
1388849,33,12,1980,8,male,1470,582,301,3,8,3,8,0,0
1895441,68,24,1945,6,female,1281,599,160,3,93,3,70,0,23
1094725,68,12,1945,7,male,497,623,576,4,3,0,3,4,0
1984998,23,9,1990,7,male,397,627,489,4,22,0,11,4,11
1473053,25,12,1988,6,female,629,578,209,4,93,0,72,4,21
1333135,26,6,1987,5,female,191,582,238,4,12,0,4,4,8
2034942,20,25,1993,12,male,475,578,520,4,47,3,34,1,13
1427686,20,14,1993,6,male,807,579,232,4,25,3,15,1,10
2162348,19,23,1994,5,male,776,597,478,4,1,4,1,0,0
1997903,19,17,1994,6,female,305,577,177,4,2,4,1,0,1
1933153,108,22,1905,2,male,1624,599,271,4,1,4,1,0,0
1883501,15,17,1998,7,male,674,596,472,4,31,4,23,0,8
1300243,16,16,1997,7,male,469,620,482,4,7,4,2,0,5
1924110,18,16,1995,12,male,537,589,510,4,110,4,102,0,8
1700668,18,4,1995,7,female,245,587,159,4,157,4,121,0,36
1964477,25,16,1988,1,male,208,637,33,4,26,4,24,0,2
1744513,27,29,1986,11,male,652,637,480,4,11,4,7,0,4
1019140,27,3,1986,1,male,825,600,507,4,6,4,3,0,3
2165890,27,10,1986,2,male,241,635,583,4,16,4,15,0,1
1630497,31,11,1982,6,female,225,598,516,4,7,4,7,0,0
1595854,100,18,1913,1,female,2483,581,183,4,42,4,28,0,14
1853948,108,9,1905,5,male,1521,610,491,4,8,4,7,0,1
1948524,108,31,1905,7,male,153,588,581,4,170,4,149,0,21
2074955,108,20,1905,9,male,1669,614,260,5,0,0,0,5,0
1556505,30,17,1983,5,male,660,579,496,5,5,0,1,5,4
1205758,43,1,1970,1,male,182,601,167,5,173,0,140,5,33
1834045,33,20,1980,10,male,251,619,529,5,4,2,2,3,2
2013207,18,24,1995,1,male,722,616,555,5,9,2,7,3,2
1599808,18,9,1995,9,male,335,578,521,5,4,4,1,1,3
1504484,34,13,1979,1,male,1221,595,205,5,0,5,0,0,0
1351388,18,15,1995,8,male,446,638,597,5,3,5,3,0,0
1708792,18,23,1995,12,female,110,594,124,5,6,5,6,0,0
1768042,27,28,1986,2,male,339,624,484,5,5,5,5,0,0
1870058,25,10,1988,3,male,938,637,413,5,90,5,31,0,59
1496941,32,1,1981,9,female,377,586,454,5,17,5,5,0,12
1812101,14,9,1999,9,male,267,585,317,6,0,0,0,6,0
2116430,108,2,1905,2,male,159,608,537,6,0,0,0,6,0
1989328,24,25,1989,11,male,621,589,437,6,1,0,0,6,1
1613980,23,2,1990,3,male,615,576,495,6,30,4,24,2,6
1274494,15,20,1998,6,male,195,616,412,6,4,6,4,0,0
1273881,18,14,1995,9,female,556,601,417,6,4,6,0,0,4
1593714,36,3,1977,6,male,1333,597,209,6,6,6,4,0,2
1929719,17,10,1996,1,male,669,625,337,6,29,6,28,0,1
2113102,21,1,1992,10,female,506,580,83,6,12,6,5,0,7
2107671,108,4,1905,9,male,1298,625,340,6,272,6,212,0,60
1510900,108,31,1905,8,female,1256,599,348,7,0,0,0,7,0
2108564,14,25,1999,11,male,266,606,517,7,2,0,0,7,2
1586137,92,13,1921,12,male,1846,636,337,7,3,0,0,7,3
1936154,35,11,1978,5,male,849,611,525,7,9,0,4,7,5
1973960,15,27,1998,3,male,493,583,452,7,20,2,13,5,7
1843044,19,28,1994,10,male,573,580,469,7,0,6,0,1,0
1647384,53,25,1960,1,male,750,578,271,7,6,7,2,0,4
2078200,70,3,1943,8,female,1078,591,195,7,9,7,9,0,0
1349274,19,20,1994,12,male,1408,627,235,7,14,7,13,0,1
1485559,19,11,1994,7,male,470,625,556,7,36,7,29,0,7
1992272,95,26,1918,8,male,1448,594,426,7,15,7,5,0,10
1066541,108,16,1905,7,female,849,598,115,7,22,7,20,0,2
1492615,43,10,1970,3,female,484,616,420,8,4,0,0,8,4
1972570,73,29,1940,3,female,1938,613,166,8,17,0,7,8,10
1921594,24,13,1989,7,male,417,623,563,8,24,2,6,6,18
1695504,16,10,1997,11,female,576,609,191,8,15,8,12,0,3
2071277,61,16,1952,4,male,1046,632,427,8,24,8,22,0,2
1432362,18,14,1995,2,male,255,634,596,9,0,0,0,9,0
1033495,59,16,1954,3,male,765,634,207,9,4,0,0,9,4
1530921,20,13,1993,3,male,722,574,382,9,5,2,2,7,3
1394440,27,1,1986,6,male,1598,594,151,9,0,9,0,0,0
1465517,19,6,1994,1,male,564,623,522,9,3,9,2,0,1
1133207,18,8,1995,3,female,511,575,127,9,199,9,175,0,24
1794729,20,28,1993,2,female,261,593,193,9,106,9,95,0,11
2031583,21,28,1992,7,female,1439,607,206,9,50,9,39,0,11
1199771,18,20,1995,1,male,382,576,433,10,19,4,12,6,7
1042746,103,1,1910,1,male,1028,629,510,10,33,7,23,3,10
2126864,61,14,1952,3,female,855,602,306,10,12,10,11,0,1
1175454,21,26,1992,12,female,796,611,152,10,20,10,19,0,1
1023520,23,4,1990,4,male,499,579,486,10,121,10,98,0,23
2020092,103,13,1910,12,male,918,576,443,11,3,0,3,11,0
1020925,15,12,1998,4,male,539,617,534,11,14,0,9,11,5
1724272,108,25,1905,12,male,1475,600,319,11,16,0,8,11,8
2137291,17,1,1996,1,male,569,586,448,11,7,7,5,4,2
1360994,46,1,1967,10,male,965,616,369,11,2,11,2,0,0
1447685,20,25,1993,1,female,350,600,256,11,11,11,6,0,5
1746770,15,13,1998,8,male,167,631,617,11,42,11,40,0,2
1352980,64,23,1949,12,female,759,601,444,11,47,11,47,0,0
2043796,68,11,1945,12,female,1256,622,245,11,27,11,24,0,3
1244435,103,25,1910,5,female,1426,590,31,12,14,0,5,12,9
2111571,17,12,1996,8,male,430,610,528,12,61,4,38,8,23
1806961,84,12,1929,7,male,1151,592,340,12,44,5,9,7,35
1266499,108,11,1905,10,male,1482,577,467,12,51,9,24,3,27
1042292,26,11,1987,5,male,415,632,529,12,7,12,7,0,0
1398915,17,17,1996,10,male,484,630,515,12,15,12,14,0,1
1580279,27,26,1986,5,male,181,630,227,12,71,12,33,0,38
1542760,33,28,1980,5,female,1800,638,345,12,18,12,18,0,0
2191303,19,10,1994,3,male,881,580,379,13,4,5,2,8,2
1258336,18,22,1995,5,male,441,579,494,13,34,4,14,9,20
1750537,16,7,1997,3,male,344,579,469,13,92,12,58,1,34
2039568,22,23,1991,5,male,356,601,547,13,0,13,0,0,0
1180890,18,18,1995,1,male,905,622,347,13,3,13,3,0,0
2155106,103,21,1910,9,female,678,593,315,13,7,13,5,0,2
1963769,17,16,1996,8,female,188,598,14,13,63,13,62,0,1
1105621,63,19,1950,3,female,1249,639,151,13,33,13,33,0,0
1330625,62,2,1951,1,male,1111,612,375,14,26,0,5,14,21
1056852,21,4,1992,5,male,496,628,542,14,4,14,4,0,0
2113570,28,2,1985,1,male,429,622,87,14,3,14,2,0,1
1081176,17,19,1996,1,female,105,638,477,14,61,14,51,0,10
1506905,20,9,1993,8,male,825,589,498,15,10,2,3,13,7
1341447,28,23,1985,5,male,417,597,560,15,10,3,6,12,4
1374466,40,11,1973,12,male,688,592,378,15,16,9,11,6,5
1213186,32,7,1981,2,male,1721,578,158,15,212,10,140,5,72
1951957,19,15,1994,9,male,535,599,304,15,10,15,6,0,4
2116245,18,8,1995,12,female,584,587,350,15,183,15,66,0,117
1535767,20,25,1993,5,male,687,628,357,15,59,15,46,0,13
1537375,20,4,1993,6,female,462,638,386,15,146,15,43,0,103
1458562,22,12,1991,1,male,466,630,333,15,32,15,30,0,2
1550050,24,18,1989,8,male,272,600,314,16,0,0,0,16,0
1798475,25,1,1988,8,male,593,626,477,16,159,1,89,15,70
1131051,24,12,1989,12,male,909,592,445,16,15,6,14,10,1
2017492,15,28,1998,1,female,488,576,240,16,0,16,0,0,0
1388117,26,22,1987,12,male,1153,635,572,16,8,16,4,0,4
1488911,18,27,1995,3,female,877,610,477,16,12,16,12,0,0
2048500,24,15,1989,8,male,756,634,500,16,10,16,8,0,2
1539550,108,30,1905,5,male,342,596,505,16,18,16,17,0,1
1083626,16,1,1997,9,female,164,574,411,16,38,16,35,0,3
1343028,20,1,1993,7,male,236,637,617,16,172,16,99,0,73
1021042,19,20,1994,1,male,1200,623,336,17,3,2,2,15,1
1942651,21,12,1992,7,female,168,607,400,17,84,11,47,6,37
1654182,21,8,1992,8,female,360,614,316,17,23,17,18,0,5
1849432,111,17,1902,12,male,1802,620,376,17,24,17,1,0,23
1679028,53,25,1960,12,male,1000,602,210,17,29,17,5,0,24
1118915,102,20,1911,10,female,1785,596,231,17,53,17,39,0,14
1285950,22,31,1991,3,female,338,637,444,18,46,0,22,18,24
1852335,16,26,1997,3,male,663,590,482,18,11,6,5,12,6
2112838,54,17,1959,8,female,1781,583,121,18,464,11,124,7,340
1312242,18,15,1995,6,male,711,599,466,18,0,16,0,2,0
1969966,17,12,1996,5,female,137,625,543,18,62,17,31,1,31
1836837,103,12,1910,6,male,941,626,445,18,5,18,5,0,0
1977639,15,21,1998,2,female,753,620,432,18,233,18,196,0,37
1976905,18,28,1995,9,female,126,604,572,18,59,18,55,0,4
1743836,74,1,1939,9,male,1314,596,333,19,10,1,2,18,8
1661840,103,19,1910,10,male,1918,575,436,19,9,0,1,19,8
2145237,20,28,1993,10,male,438,612,440,19,22,17,17,2,5
1306520,16,1,1997,4,male,520,631,235,19,2,19,0,0,2
1960801,91,7,1922,5,female,1531,576,127,19,149,19,123,0,26
2079405,108,2,1905,10,female,1600,596,352,19,189,19,186,0,3
1623897,14,10,1999,12,female,214,603,178,20,8,1,0,19,8
1254457,68,5,1945,8,female,1431,628,302,20,481,0,107,20,374
1161019,104,30,1909,4,female,2017,575,106,20,11,7,6,13,5
1675020,18,27,1995,4,male,477,606,473,20,2,16,0,4,2
1369909,21,3,1992,5,male,341,612,542,20,14,20,12,0,2
1446725,42,30,1971,8,male,1035,609,363,20,34,20,24,0,10
1400188,63,7,1950,11,male,1554,639,487,20,32,20,15,0,17
1719832,48,13,1965,5,male,433,629,546,21,4,0,4,21,0
2098857,15,17,1998,2,male,188,583,565,21,3,20,3,1,0
2120500,108,30,1905,9,male,703,584,170,21,17,21,10,0,7
1514755,20,5,1993,11,male,760,586,434,21,58,21,24,0,34
1482331,66,15,1947,11,female,1202,584,321,22,909,1,88,21,821
1214418,17,4,1996,4,male,558,586,530,22,50,13,36,9,14
2180399,29,25,1984,6,male,870,590,438,22,240,22,218,0,22
1761509,108,17,1905,10,male,1766,620,171,23,42,10,22,13,20
1867833,19,20,1994,1,female,214,597,69,23,930,22,478,1,452
1691464,19,12,1994,11,male,753,574,262,23,7,23,4,0,3
2175193,16,11,1997,10,male,597,596,478,23,28,23,21,0,7
1839975,24,5,1989,8,male,357,586,531,23,55,23,46,0,9
1722526,18,14,1995,11,male,414,598,504,24,24,13,14,11,10
1381058,21,2,1992,8,female,255,584,327,24,195,21,105,3,90
2002410,108,4,1905,7,female,1351,581,229,24,38,20,19,4,19
1445580,19,21,1994,8,male,327,578,398,24,0,24,0,0,0
1588913,15,10,1998,11,female,319,585,73,24,34,24,18,0,16
1638746,108,5,1905,10,male,1429,593,192,25,22,1,8,24,14
2003003,28,4,1985,5,female,407,593,448,25,12,25,12,0,0
1528786,18,2,1995,4,male,131,580,511,25,67,25,59,0,8
1583806,20,5,1993,9,male,880,618,267,25,514,25,453,0,61
1518588,95,5,1918,1,male,2506,616,149,26,10,2,4,24,6
1184379,103,24,1910,1,male,1132,639,243,26,37,14,22,12,15
1867559,15,20,1998,6,female,590,580,287,26,94,24,56,2,38
1369811,32,25,1981,1,female,1350,592,323,26,317,22,250,4,67
1375735,23,10,1990,4,female,470,608,456,26,7,26,4,0,3
1073152,29,10,1984,10,male,374,594,497,26,20,26,20,0,0
1557255,16,22,1997,1,male,331,579,60,27,5,14,2,13,3
1416182,17,24,1996,7,female,569,615,232,27,395,15,140,12,255
2133877,17,22,1996,6,female,630,608,564,27,11,27,10,0,1
1652782,108,14,1905,6,male,1359,599,129,27,37,27,32,0,5
1954041,18,2,1995,6,female,637,578,352,27,117,27,77,0,40
1684469,22,20,1991,8,female,614,621,207,27,85,27,82,0,3
1676034,17,12,1996,9,female,688,611,275,28,4,0,0,28,4
1555980,68,12,1945,11,male,1498,612,533,28,71,6,36,22,35
1938194,104,18,1909,9,female,349,618,303,28,4,28,2,0,2
1430653,17,15,1996,3,female,271,625,169,28,87,28,59,0,28
1941955,18,7,1995,4,male,600,591,428,28,167,28,84,0,83
1382372,20,10,1993,10,female,179,637,275,28,130,28,125,0,5
1899391,68,18,1945,7,female,331,622,108,28,63,28,50,0,13
1411001,27,6,1986,6,male,1248,610,387,29,23,28,16,1,7
1908861,20,14,1993,12,female,726,593,118,29,168,29,147,0,21
1503975,16,28,1997,12,male,787,624,325,31,49,1,7,30,42
2001219,21,10,1992,4,female,458,585,434,30,92,11,50,19,42
1296765,43,1,1970,11,male,665,599,372,31,395,9,100,22,295
1248219,108,21,1905,6,male,878,624,470,31,15,31,15,0,0
1990606,21,15,1992,4,female,353,612,254,31,35,31,31,0,4
1852944,18,29,1995,10,female,284,626,21,30,67,30,64,0,3
1293076,24,12,1989,12,male,389,621,555,31,171,31,153,0,18
2154488,106,7,1907,3,male,1339,599,357,32,23,0,8,32,15
1988424,25,16,1988,4,male,1394,574,367,32,86,27,68,5,18
1755405,103,16,1910,5,female,861,580,151,32,6,32,4,0,2
1943157,23,27,1990,8,female,621,629,320,32,145,32,118,0,27
1791523,103,17,1910,9,female,1037,634,246,33,17,0,9,33,8
1306365,17,22,1996,10,female,393,576,405,33,32,0,0,33,32
1841433,21,25,1992,8,male,349,637,419,33,4,33,4,0,0
1052206,60,1,1953,1,male,643,595,408,34,10,0,3,34,7
1535299,14,4,1999,9,male,235,603,478,34,15,7,6,27,9
1502944,36,23,1977,3,female,172,639,555,34,98,7,32,27,66
2042675,20,11,1993,6,male,488,592,494,34,13,28,13,6,0
1654095,58,21,1955,2,male,725,597,342,34,6,34,4,0,2
2104962,19,10,1994,10,female,289,579,401,34,619,34,385,0,234
1178016,15,4,1998,9,male,268,637,245,35,4,3,0,32,4
1988968,14,22,1999,8,female,308,620,226,36,97,13,69,23,28
1948949,16,8,1997,3,female,18,576,32,35,1110,12,586,23,524
1104058,21,2,1992,4,female,799,635,466,36,157,26,145,10,12
1811448,108,7,1905,3,male,947,576,304,36,140,20,58,16,82
1665367,15,15,1998,8,male,238,592,462,36,83,33,20,3,63
2078768,16,2,1997,5,male,509,612,198,36,133,30,78,6,55
1657976,26,14,1987,8,female,622,605,212,35,6,35,6,0,0
1301704,103,2,1910,1,male,880,607,438,35,18,35,15,0,3
1460545,19,1,1994,1,male,603,637,519,35,48,35,31,0,17
1227052,108,5,1905,5,female,461,584,162,35,28,35,25,0,3
1533751,20,16,1993,6,female,578,600,312,37,40,1,7,36,33
1705745,17,28,1996,8,female,485,603,530,37,0,9,0,28,0
1454608,20,1,1993,5,male,468,612,528,37,14,24,8,13,6
2081850,23,24,1990,1,male,840,594,379,37,20,32,0,5,20
2057235,18,15,1995,6,female,595,626,480,37,34,37,29,0,5
1341254,108,23,1905,6,male,494,590,359,37,29,37,26,0,3
1845293,17,6,1996,9,male,458,630,566,37,99,37,81,0,18
1104555,17,16,1996,12,male,647,585,353,38,46,19,35,19,11
1039159,108,25,1905,1,female,2040,579,291,39,0,39,0,0,0
2057346,24,28,1989,11,male,440,614,506,38,21,38,13,0,8
2065671,15,13,1998,9,male,63,615,547,38,147,38,70,0,77
1463980,18,21,1995,7,female,423,603,305,38,156,38,151,0,5
1559586,19,27,1994,1,female,237,607,419,39,78,39,72,0,6
1360415,21,2,1992,10,male,617,624,444,38,236,38,175,0,61
1464293,108,20,1905,11,female,884,605,128,38,238,38,198,0,40
1281918,18,12,1995,3,female,1038,588,201,40,76,20,26,20,50
1468592,22,5,1991,2,female,1045,603,284,40,140,19,92,21,48
2095986,30,26,1983,1,male,507,606,225,40,3,40,1,0,2
2121804,18,14,1995,6,female,463,595,343,40,185,40,167,0,18
1331722,37,8,1976,1,female,271,596,313,40,110,40,78,0,32
1673679,23,19,1990,9,female,830,581,417,41,23,2,9,39,14
1969441,30,4,1983,5,male,562,598,552,42,27,7,23,35,4
2097481,50,5,1963,8,female,802,617,109,42,202,41,151,1,51
2112238,22,26,1991,5,male,561,625,580,41,29,41,21,0,8
1786432,108,22,1905,5,male,947,586,421,42,89,42,57,0,32
1519058,63,29,1950,6,male,1409,613,376,44,2,2,1,42,1
1543541,74,30,1939,9,female,965,620,80,43,25,5,21,38,4
1986083,24,27,1989,12,male,676,582,414,44,7,17,2,27,5
1539478,20,6,1993,2,female,1198,625,363,44,56,21,14,23,42
2001725,29,13,1984,5,female,925,619,364,44,87,43,74,1,13
1390233,16,3,1997,3,male,647,626,360,43,32,43,30,0,2
1963400,22,24,1991,1,male,830,615,436,44,36,44,29,0,7
1243918,41,6,1972,8,male,1144,601,411,43,136,43,78,0,58
1146253,17,19,1996,4,male,499,628,526,45,2,45,1,0,1
1148747,15,21,1998,3,female,249,635,421,45,214,45,46,0,168
1036253,21,20,1992,2,male,172,574,253,46,14,10,4,36,10
1183165,80,17,1933,6,female,2325,615,194,46,6,46,6,0,0
1982995,15,20,1998,2,female,208,604,516,47,52,47,47,0,5
1532055,17,21,1996,11,male,906,590,442,46,34,46,23,0,11
1403594,14,15,1999,5,male,149,629,564,46,98,46,70,0,28
1745992,99,3,1914,8,female,2822,599,16,47,94,47,79,0,15
1665354,111,16,1902,8,male,1471,585,245,48,47,2,19,46,28
1928314,15,1,1998,4,female,212,629,131,48,58,29,43,19,15
2185727,29,19,1984,9,female,1241,617,307,48,138,18,75,30,63
1790590,37,31,1976,3,male,1594,621,329,48,31,43,17,5,14
1455027,100,7,1913,5,male,1444,608,101,49,10,49,9,0,1
2108444,14,31,1999,1,male,273,634,263,50,74,25,33,25,41
1341624,100,15,1913,5,male,1100,620,226,51,21,37,12,14,9
1403730,18,27,1995,3,male,318,600,464,51,58,47,53,4,5
1348067,20,15,1993,9,female,668,577,94,51,111,51,105,0,6
1002891,103,15,1910,12,male,763,593,447,53,21,3,14,50,7
1152676,18,17,1995,4,male,869,594,312,53,153,18,93,35,60
1416583,21,2,1992,4,male,1712,578,262,53,2,43,2,10,0
1800831,18,4,1995,7,male,439,592,532,52,11,41,6,11,5
1556105,19,13,1994,3,female,675,638,226,52,44,52,43,0,1
1460658,24,1,1989,1,male,286,615,312,52,44,52,41,0,3
1262506,26,21,1987,1,male,382,597,555,53,66,53,44,0,22
1150455,105,2,1908,4,male,1726,574,294,54,3,19,2,35,1
1201170,19,3,1994,1,male,638,604,415,55,58,55,23,0,35
1885646,27,16,1986,3,female,723,638,565,55,77,55,71,0,6
1110676,103,15,1910,9,male,1474,637,370,54,79,54,43,0,36
1660269,26,15,1987,11,male,412,620,474,56,154,10,111,46,43
1844134,19,2,1994,2,female,590,584,176,57,116,46,85,11,31
1301999,18,23,1995,12,male,249,584,310,58,23,58,15,0,8
1878108,24,1,1989,12,male,294,633,510,57,61,57,36,0,25
1598879,24,12,1989,8,male,443,609,496,58,59,58,53,0,6
1382885,22,5,1991,10,female,419,626,432,56,370,56,324,0,46
1743811,71,19,1942,8,female,563,607,292,58,97,58,79,0,18
1597365,103,15,1910,5,female,1617,628,307,57,144,57,106,0,38
1361811,19,2,1994,3,female,1455,612,189,60,63,30,30,30,33
1107190,18,29,1995,3,female,411,612,219,60,208,34,184,26,24
1227577,99,4,1914,8,male,2045,608,319,60,249,23,114,37,135
2085371,18,1,1995,4,male,502,610,544,60,31,60,24,0,7
1396628,25,4,1988,2,male,574,591,327,61,26,0,6,61,20
1404045,99,2,1914,2,male,1512,618,293,62,30,54,18,8,12
1064133,17,12,1996,10,male,420,607,412,62,25,62,21,0,4
2086039,22,17,1991,8,female,643,612,297,61,65,61,60,0,5
1029920,25,21,1988,2,female,667,574,506,63,65,63,44,0,21
1065502,19,14,1994,9,female,416,624,360,62,317,62,270,0,47
1310351,19,9,1994,10,male,1247,600,369,65,90,65,60,0,30
1575656,20,13,1993,9,female,1451,585,291,64,77,64,61,0,16
1041231,100,12,1913,12,male,1528,604,291,68,46,36,16,32,30
1182132,103,20,1910,8,male,1463,588,189,66,100,26,35,40,65
1206366,28,25,1985,4,female,1527,636,195,67,161,66,87,1,74
1409594,26,25,1987,4,male,348,612,540,68,19,68,9,0,10
2145703,23,7,1990,2,female,1077,580,203,66,127,66,89,0,38
1002003,100,14,1913,5,male,2273,593,438,70,41,3,6,67,35
1780620,18,14,1995,2,female,671,607,249,71,981,69,475,2,506
1883385,31,22,1982,8,male,829,622,446,69,27,69,26,0,1
1773291,14,8,1999,5,male,203,598,421,70,54,70,50,0,4
2033478,102,1,1911,1,male,1246,637,533,70,44,70,35,0,9
1033164,18,7,1995,12,female,372,596,44,69,354,69,213,0,141
1677300,15,13,1998,1,male,607,599,500,73,1,41,0,32,1
1965030,79,19,1934,7,female,897,634,101,72,105,28,79,44,26
1097050,18,3,1995,5,female,876,605,404,74,59,70,48,4,11
1870204,23,14,1990,5,female,394,584,416,73,97,63,41,10,56
1927928,19,22,1994,2,female,287,606,329,73,114,73,97,0,17
1656058,103,31,1910,8,female,1151,625,358,74,115,74,106,0,9
2051657,17,17,1996,4,female,399,611,485,75,87,12,42,63,45
1763368,17,16,1996,1,female,902,609,319,75,338,35,162,40,176
2088273,26,11,1987,6,male,1418,632,233,75,753,60,694,15,59
1709220,34,22,1979,9,male,1303,592,402,75,175,69,126,6,49
1464482,98,12,1915,12,male,1606,613,212,77,79,77,60,0,19
2116728,33,1,1980,1,male,487,596,537,79,35,79,29,0,6
1073710,20,3,1993,2,male,764,631,390,79,305,79,224,0,81
1690172,101,28,1912,7,male,426,638,574,79,329,79,290,0,39
2011466,18,29,1995,9,male,124,611,486,82,37,14,26,68,11
1630923,23,2,1990,6,male,1543,631,343,82,102,64,51,18,51
2005274,68,3,1945,2,female,564,586,220,84,74,84,64,0,10
2047486,17,16,1996,12,male,892,602,386,82,268,82,217,0,51
1792260,19,11,1994,7,male,588,582,414,81,176,81,162,0,14
1190351,32,26,1981,12,male,292,609,525,86,5,3,0,83,5
1283108,26,12,1987,7,male,290,601,209,85,291,0,135,85,156
1934031,21,2,1992,3,male,1504,601,340,86,83,35,49,51,34
1969385,101,13,1912,10,female,2254,593,312,86,211,37,157,49,54
1108163,16,27,1997,6,male,342,607,258,87,30,78,16,9,14
1664842,16,14,1997,12,female,370,579,458,86,25,86,18,0,7
1657669,18,27,1995,1,male,340,607,557,88,4,0,0,88,4
2073449,17,20,1996,11,female,506,589,195,88,245,7,187,81,58
1211556,18,10,1995,5,female,559,614,317,91,121,33,61,58,60
1660981,100,3,1913,4,male,1330,580,198,88,100,39,30,49,70
1717765,20,5,1993,10,female,1116,610,174,88,195,61,69,27,126
1258874,16,15,1997,12,female,108,611,461,90,48,89,36,1,12
1074678,18,10,1995,2,female,277,575,469,88,61,72,24,16,37
1095085,32,7,1981,8,male,636,592,381,89,198,83,135,6,63
1753801,57,15,1956,1,male,1587,630,457,88,145,75,51,13,94
1530465,103,17,1910,10,male,1161,634,233,91,268,79,179,12,89
1032187,19,13,1994,4,female,366,581,439,90,109,90,50,0,59
1720953,103,14,1910,11,male,706,593,287,90,230,90,212,0,18
1406019,91,30,1922,10,male,159,591,443,93,39,17,33,76,6
1070851,86,21,1927,10,male,902,602,415,92,46,19,26,73,20
1504596,22,13,1991,4,male,550,616,487,92,72,58,41,34,31
1219769,22,6,1991,1,female,715,629,425,93,188,67,167,26,21
1574139,100,6,1913,6,male,2397,593,256,92,137,85,82,7,55
1905043,20,7,1993,5,male,1451,584,298,92,192,89,86,3,106
1308642,19,7,1994,10,female,193,618,244,95,17,95,17,0,0
2003976,26,16,1987,11,male,277,633,582,92,101,92,69,0,32
1541745,42,30,1971,6,female,546,626,563,96,59,0,39,96,20
2034334,15,21,1998,2,male,412,625,403,98,87,27,52,71,35
2060297,107,3,1906,8,female,2459,583,279,98,112,67,88,31,24
1220761,24,27,1989,5,female,1450,610,375,98,205,86,116,12,89
2092166,15,6,1998,1,female,340,634,127,98,73,98,54,0,19
1680227,19,1,1994,1,male,747,589,430,98,174,98,157,0,17
1772372,48,9,1965,9,female,767,618,466,98,296,98,260,0,36
1086332,16,25,1997,9,female,673,574,378,104,232,54,148,50,84
1426368,21,5,1992,10,male,1380,635,329,101,58,83,46,18,12
1328028,15,25,1998,9,female,192,585,96,103,164,90,123,13,41
1915027,34,17,1979,2,female,1264,628,293,103,268,101,197,2,71
1754430,43,23,1970,10,female,687,637,487,102,35,102,27,0,8
1075203,100,2,1913,6,female,1746,588,157,101,47,101,37,0,10
1469929,16,2,1997,1,female,358,605,379,107,439,21,227,86,212
1060000,20,30,1993,4,male,266,630,590,109,77,51,58,58,19
1644582,22,6,1991,12,female,1062,592,171,105,259,74,141,31,118
1544589,103,20,1910,3,female,186,594,366,107,291,64,118,43,173
1501390,15,4,1998,10,male,398,626,299,105,165,88,134,17,31
1214927,46,8,1967,9,female,1701,599,306,107,94,106,54,1,40
1523239,19,29,1994,9,female,461,585,300,105,138,105,75,0,63
1228835,28,18,1985,6,female,442,605,469,108,131,108,126,0,5
1460197,16,13,1997,11,male,1076,588,255,110,40,3,26,107,14
1017904,18,11,1995,11,female,409,630,506,113,54,30,21,83,33
1028493,22,26,1991,3,male,1675,604,383,110,363,69,315,41,48
1359911,40,20,1973,6,female,1958,608,337,112,69,96,23,16,46
2057226,15,18,1998,2,male,382,639,548,112,50,112,29,0,21
1499486,18,26,1995,2,male,274,574,319,111,75,111,52,0,23
1296665,17,15,1996,9,female,425,627,119,112,209,112,203,0,6
1437931,16,27,1997,8,male,270,609,417,116,3,0,1,116,2
2184424,23,31,1990,7,male,1159,597,284,118,40,5,19,113,21
1881961,14,18,1999,8,male,497,639,489,119,127,1,59,118,68
2100710,16,7,1997,4,female,617,616,334,119,74,1,15,118,59
1861852,22,7,1991,8,male,640,591,415,116,267,22,181,94,86
1971135,20,18,1993,5,female,308,592,273,115,30,90,18,25,12
1207825,20,13,1993,6,male,464,596,468,115,71,115,68,0,3
1992653,99,14,1914,2,male,1163,585,368,116,103,116,84,0,19
1207628,108,1,1905,9,female,1154,602,377,120,53,0,12,120,41
1436945,108,15,1905,9,female,1031,583,291,120,123,0,53,120,70
1623755,27,4,1986,4,female,920,579,267,123,691,87,647,36,44
1841751,29,14,1984,9,female,1546,609,505,121,240,117,156,4,84
1087766,26,10,1987,5,male,543,574,460,124,42,124,32,0,10
2033934,21,4,1992,10,female,1101,576,371,123,213,123,144,0,69
1567362,22,16,1991,7,female,92,620,532,121,493,121,463,0,30
2147376,21,2,1992,8,female,284,620,327,127,298,83,198,44,100
2012461,25,9,1988,12,female,309,621,270,125,194,44,80,81,114
1619468,25,6,1988,10,female,158,627,547,128,283,43,168,85,115
2181913,15,24,1998,5,female,84,624,523,125,183,124,102,1,81
1413660,108,6,1905,12,NA,1988,599,234,130,81,129,62,1,19
1083634,64,22,1949,3,male,832,610,462,130,14,130,14,0,0
1790926,15,6,1998,6,female,333,594,393,126,52,126,48,0,4
1850876,16,23,1997,7,female,262,626,467,130,84,130,63,0,21
1320030,19,16,1994,5,male,683,621,474,129,87,129,74,0,13
1847177,21,25,1992,12,female,422,581,104,125,113,125,99,0,14
1078201,103,10,1910,10,male,1162,579,317,131,29,16,18,115,11
1774224,50,6,1963,8,male,967,574,103,133,502,26,123,107,379
1037611,21,4,1992,6,female,1524,633,276,132,113,92,89,40,24
1235261,18,20,1995,8,male,203,583,419,134,130,130,123,4,7
1969727,71,10,1942,3,male,1513,598,334,134,261,124,149,10,112
1290770,16,16,1997,4,female,435,633,386,131,38,131,22,0,16
1772714,17,27,1996,7,female,390,616,445,134,63,134,50,0,13
2074609,103,7,1910,5,male,426,597,278,133,775,133,664,0,111
2154033,19,5,1994,10,male,175,613,455,143,15,0,1,143,14
1880088,60,1,1953,12,female,2124,639,157,139,12,100,7,39,5
1891722,19,27,1994,1,female,602,616,354,142,75,106,40,36,35
1350720,23,6,1990,12,female,614,595,227,141,55,114,19,27,36
1082316,20,21,1993,3,female,373,589,278,142,188,135,117,7,71
1734252,24,27,1989,10,female,1193,615,332,139,173,110,116,29,57
1505660,23,24,1990,8,male,1869,581,253,139,239,136,183,3,56
1524551,93,12,1920,2,female,1327,636,232,140,569,136,400,4,169
1864147,21,23,1992,8,female,267,633,136,140,14,140,13,0,1
2073328,29,14,1984,4,female,747,620,310,139,35,139,26,0,9
1978432,26,10,1987,6,female,334,574,123,139,187,139,116,0,71
1897840,108,30,1905,12,female,1358,584,401,141,145,141,104,0,41
1350689,24,15,1989,4,male,374,624,549,143,364,143,282,0,82
1877172,103,20,1910,4,male,1463,604,432,147,70,0,7,147,63
1588457,19,8,1994,5,male,455,596,504,144,25,34,16,110,9
1544496,21,10,1992,5,female,491,612,549,148,363,44,173,104,190
1170756,23,9,1990,4,male,669,623,456,147,482,95,247,52,235
1456149,30,2,1983,10,male,651,632,155,145,604,73,304,72,300
1381621,18,7,1995,8,male,654,612,464,144,51,133,38,11,13
1553439,19,2,1994,1,female,387,580,136,148,380,128,170,20,210
1158635,24,16,1989,10,male,736,578,481,144,132,144,127,0,5
1691147,15,20,1998,4,female,375,627,289,156,82,36,42,120,40
1278272,16,9,1997,5,female,128,621,251,157,207,109,120,48,87
1123861,18,22,1995,8,female,284,629,432,155,142,104,105,51,37
1792604,25,13,1988,4,female,1563,579,284,157,155,37,105,120,50
2147697,15,20,1998,1,female,221,629,366,152,439,34,132,118,307
2056307,102,28,1911,11,male,935,578,391,155,17,141,13,14,4
1860999,19,12,1994,10,female,548,595,290,153,126,119,83,34,43
1204197,16,8,1997,2,male,567,616,364,152,410,113,308,39,102
1089347,18,27,1995,7,female,155,635,316,152,249,149,112,3,137
1672322,23,15,1990,5,male,882,626,521,156,8,156,8,0,0
1994544,16,16,1997,6,male,237,628,472,157,64,157,41,0,23
1213678,24,23,1989,11,male,310,636,568,156,114,156,110,0,4
1216650,108,1,1905,1,female,647,579,80,157,121,157,95,0,26
1633596,113,22,1900,6,male,1711,610,92,155,156,155,103,0,53
1230362,23,10,1990,5,female,228,616,382,159,132,128,80,31,52
2187935,108,25,1905,1,male,1885,607,188,158,128,148,77,10,51
1506290,14,5,1999,2,male,313,587,531,162,593,148,539,14,54
1539915,54,7,1959,3,female,1755,605,345,164,3,164,3,0,0
1177586,61,26,1952,2,male,1182,617,484,158,24,158,13,0,11
1452308,20,3,1993,9,male,282,621,505,166,93,47,82,119,11
1508346,17,2,1996,2,male,672,603,458,169,188,95,89,74,99
1793042,41,23,1972,7,female,267,605,377,172,181,68,45,104,136
1733638,108,17,1905,3,male,975,604,360,170,192,72,34,98,158
1119710,108,12,1905,2,male,1261,589,348,172,296,47,90,125,206
2029016,24,23,1989,10,female,1443,595,284,165,81,164,68,1,13
1135231,20,24,1993,8,female,309,630,338,165,376,164,316,1,60
2174341,16,28,1997,7,female,487,605,394,168,84,168,56,0,28
2000274,23,9,1990,2,male,866,595,281,174,95,107,76,67,19
1561896,108,21,1905,2,female,1830,624,350,177,125,61,51,116,74
2063513,35,15,1978,6,female,1443,635,427,180,136,178,85,2,51
1175757,49,18,1964,10,male,1093,633,381,177,246,177,179,0,67
1103842,84,11,1929,6,male,1642,600,159,176,123,176,116,0,7
2132226,19,25,1994,8,female,164,614,37,180,276,180,217,0,59
1216914,27,21,1986,4,female,1764,629,414,178,685,178,618,0,67
1977703,22,25,1991,10,male,492,587,515,184,105,52,65,132,40
1892557,27,13,1986,3,male,381,610,380,190,103,75,44,115,59
1673911,19,28,1994,7,male,309,598,203,187,217,81,147,106,70
1196009,17,10,1996,4,male,520,598,483,190,70,151,42,39,28
1439406,106,20,1907,4,male,867,635,389,190,303,150,135,40,168
1594332,30,16,1983,10,male,1363,610,392,183,38,183,33,0,5
2119524,17,28,1996,10,female,258,611,374,184,192,184,100,0,92
1143318,18,20,1995,2,female,595,595,239,185,192,185,110,0,82
1423878,42,25,1971,8,female,1461,620,220,184,336,184,200,0,136
1406821,22,9,1991,6,male,395,602,427,194,648,8,454,186,194
1975659,54,14,1959,8,male,2177,587,335,192,398,36,66,156,332
1550062,108,22,1905,9,female,2257,618,301,198,46,121,37,77,9
2153833,16,24,1997,5,female,182,577,440,194,120,111,99,83,21
1972784,16,15,1997,10,male,465,616,359,192,154,132,96,60,58
1589769,25,2,1988,12,female,363,586,488,191,147,131,63,60,84
1107815,108,6,1905,10,male,2332,574,232,200,252,139,178,61,74
2162801,16,10,1997,12,female,348,593,92,194,341,132,127,62,214
1508687,15,13,1998,10,female,56,598,317,193,311,130,243,63,68
1192148,27,5,1986,3,male,1688,637,253,195,320,111,267,84,53
2114847,23,27,1990,4,female,522,611,366,200,238,195,120,5,118
1654754,103,4,1910,12,female,1109,615,262,198,13,198,12,0,1
1028279,15,25,1998,11,female,221,597,320,196,138,196,93,0,45
1359003,19,4,1994,1,female,203,624,194,192,132,192,112,0,20
1837787,21,19,1992,10,male,317,607,538,196,747,196,691,0,56
1487048,68,12,1945,11,male,1112,574,254,195,451,195,440,0,11
1082973,103,29,1910,10,female,725,576,454,196,313,196,232,0,81
2158975,15,4,1998,3,female,296,595,282,209,61,41,20,168,41
1035309,20,23,1993,7,female,187,635,477,201,230,33,129,168,101
2124284,25,12,1988,8,female,668,586,350,204,623,135,444,69,179
1314984,22,18,1991,3,female,902,626,191,210,277,192,67,18,210
1004162,94,16,1919,7,female,729,634,315,204,212,156,108,48,104
1424489,108,14,1905,12,male,2368,574,242,206,324,196,264,10,60
2132908,24,22,1989,11,female,771,603,393,205,430,203,303,2,127
1557315,29,21,1984,4,male,483,619,548,203,58,203,55,0,3
1607369,94,7,1919,10,female,806,579,229,209,177,209,164,0,13
1115453,19,27,1994,5,male,284,613,343,211,681,211,468,0,213
1037588,107,10,1906,10,male,97,636,336,204,469,204,172,0,297
1121443,101,15,1912,2,female,2367,582,262,213,100,41,48,172,52
1635723,32,13,1981,4,male,1820,580,228,220,153,16,93,204,60
1872590,16,8,1997,6,male,386,606,445,219,92,155,42,64,50
1000602,26,7,1987,9,male,631,622,411,213,213,129,119,84,94
1530818,103,28,1910,9,female,1247,594,270,213,254,95,98,118,156
1156075,20,27,1993,7,female,1056,576,205,218,519,132,415,86,104
1525627,103,11,1910,2,female,1057,609,133,221,118,218,86,3,32
1372784,15,10,1998,10,male,334,586,435,212,158,197,86,15,72
1265994,17,7,1996,10,male,130,639,297,216,480,206,387,10,93
1181215,20,8,1993,7,male,141,582,492,213,390,175,296,38,94
1141042,18,11,1995,11,female,531,621,458,221,353,221,179,0,174
1216850,19,5,1994,2,female,567,597,369,215,407,215,397,0,10
1337058,39,19,1974,11,female,464,589,282,221,533,221,482,0,51
1965113,16,16,1997,5,male,543,575,342,222,29,41,19,181,10
1703050,55,5,1958,10,male,418,624,573,226,15,11,2,215,13
2033280,108,22,1905,6,male,1496,628,341,223,126,28,40,195,86
1068780,17,4,1996,2,female,354,627,320,227,231,122,142,105,89
1761861,15,23,1998,4,female,96,587,267,231,356,86,192,145,164
1887325,21,20,1992,7,female,111,576,492,228,295,228,209,0,86
1623506,28,29,1985,10,male,1285,635,465,226,138,226,119,0,19
1974837,18,2,1995,9,female,51,590,228,226,376,226,274,0,102
1700905,18,26,1995,6,female,892,601,556,243,119,9,33,234,86
2055898,18,11,1995,9,female,1040,584,454,234,104,0,36,234,68
2039892,24,11,1989,1,female,1817,635,225,245,340,13,168,232,172
1974678,103,6,1910,12,female,1092,616,276,236,300,0,114,236,186
1247133,16,8,1997,10,female,443,609,427,235,104,129,68,106,36
1742621,17,23,1996,6,female,1056,624,349,237,404,125,205,112,199
2042164,60,29,1953,12,female,404,580,505,245,22,241,18,4,4
1414527,16,28,1997,8,female,543,625,386,242,211,228,156,14,55
1639197,17,10,1996,3,male,111,593,538,238,245,210,190,28,55
1231562,18,18,1995,9,male,968,597,314,243,29,243,25,0,4
1913174,28,4,1985,3,female,1454,613,172,246,1149,246,1108,0,41
1316461,103,26,1910,1,male,765,614,302,240,468,240,283,0,185
1838078,108,26,1905,5,female,2197,616,438,255,129,13,38,242,91
1191326,19,9,1994,7,male,713,585,389,253,259,152,23,101,236
1008511,49,3,1964,2,female,777,605,441,258,357,146,263,112,94
1226051,56,28,1957,8,NA,2244,621,266,257,210,156,150,101,60
1769166,61,8,1952,8,female,1843,614,275,251,243,93,124,158,119
1196318,103,14,1910,4,female,1492,586,317,253,251,239,188,14,63
1077124,22,19,1991,11,female,455,639,285,253,572,244,223,9,349
1593201,18,9,1995,11,male,183,629,182,258,227,256,101,2,126
1941792,19,1,1994,5,male,729,582,130,248,240,247,172,1,68
1841597,104,12,1909,2,male,438,581,328,263,61,87,41,176,20
1826265,24,30,1989,4,male,523,622,421,269,391,140,163,129,228
1372794,48,12,1965,6,male,1539,600,188,266,202,110,41,156,161
1539001,17,18,1996,2,male,259,605,493,262,489,143,299,119,190
2163126,18,19,1995,10,female,491,582,276,265,221,223,85,42,136
1061609,18,13,1995,5,female,328,596,463,274,826,222,305,52,521
1600890,19,14,1994,12,male,644,601,497,261,98,261,67,0,31
1222946,102,31,1911,3,male,2093,626,253,265,86,265,46,0,40
1387333,16,9,1997,8,female,385,574,450,283,55,49,25,234,30
1332660,106,22,1907,3,male,1563,589,276,281,309,3,94,278,215
1012816,15,23,1998,8,male,279,634,388,281,90,141,46,140,44
1345240,17,22,1996,8,female,1408,586,347,288,282,205,166,83,116
2086288,29,9,1984,11,male,644,576,451,279,299,92,61,187,238
1411710,22,15,1991,4,male,380,601,396,281,455,158,306,123,149
1527544,100,1,1913,3,male,2072,620,335,279,534,151,186,128,348
2183259,16,27,1997,1,female,552,627,334,286,295,268,88,18,207
1882529,22,7,1991,6,male,308,579,374,282,183,217,107,65,76
1228413,51,9,1962,10,male,1234,633,477,284,378,221,211,63,167
1253773,102,29,1911,9,female,738,588,415,280,250,206,85,74,165
1524730,26,1,1987,1,male,354,593,341,281,465,251,350,30,115
1757295,19,25,1994,9,male,544,600,273,286,157,286,75,0,82
1127510,29,14,1984,2,female,113,579,97,292,57,292,52,0,5
1315350,68,10,1945,5,male,1173,612,429,282,165,282,147,0,18
1743292,55,16,1958,9,female,1623,623,353,304,342,24,167,280,175
1623050,20,23,1993,8,female,1620,581,233,306,202,191,119,115,83
1670692,84,12,1929,7,female,2285,606,243,296,164,251,138,45,26
1896634,103,29,1910,12,male,1209,612,286,295,124,295,100,0,24
2142022,20,17,1993,4,female,574,631,369,300,321,300,186,0,135
1763493,68,2,1945,7,female,777,595,345,297,444,297,373,0,71
1631422,108,18,1905,2,male,318,588,451,314,155,30,132,284,23
1651847,21,28,1992,7,male,441,579,516,312,240,48,143,264,97
2017786,22,10,1991,10,female,739,592,335,318,733,50,140,268,593
1706157,26,6,1987,9,female,1032,577,162,313,146,286,78,27,68
1160706,15,27,1998,1,male,303,578,336,309,197,268,147,41,50
1821442,19,3,1994,1,female,342,636,341,322,452,257,131,65,321
1894246,16,17,1997,3,female,795,622,122,317,562,296,310,21,252
2049993,18,12,1995,2,female,578,611,228,318,198,318,168,0,30
1181964,66,10,1947,4,male,1098,607,410,336,202,0,75,336,127
2036734,17,14,1996,12,female,574,617,331,337,309,54,67,283,242
1872612,22,24,1991,10,female,504,620,154,331,297,7,129,324,168
1370152,21,28,1992,10,female,398,589,110,328,404,199,259,129,145
1566949,20,5,1993,10,male,569,609,284,330,1029,150,510,180,519
1033046,15,31,1998,8,female,503,591,331,343,408,333,127,10,281
1496442,19,23,1994,7,female,541,597,404,337,476,303,293,34,183
1288312,18,2,1995,11,female,523,603,408,330,765,315,643,15,122
1040006,24,9,1989,3,female,530,634,475,342,190,342,71,0,119
1493653,103,22,1910,6,male,1138,611,297,328,158,328,120,0,38
1262454,18,5,1995,8,female,635,637,333,346,298,346,189,0,109
1347180,20,15,1993,6,male,440,584,541,338,206,338,183,0,23
1296809,20,31,1993,8,female,427,576,69,339,647,339,595,0,52
1012479,53,6,1960,4,female,493,585,388,365,496,0,85,365,411
2061094,17,31,1996,10,female,529,619,239,355,451,256,340,99,111
1327800,17,31,1996,10,male,357,602,471,350,979,102,558,248,421
1717061,14,1,1999,1,female,265,588,285,351,298,336,177,15,121
1495071,18,21,1995,8,female,527,608,308,365,354,362,180,3,174
1100152,16,7,1997,6,male,436,585,432,367,185,367,164,0,21
1403056,18,27,1995,9,male,730,579,407,368,155,368,120,0,35
1910094,20,28,1993,9,male,433,582,464,368,141,368,129,0,12
1863000,15,19,1998,2,female,437,627,445,368,391,368,320,0,71
2141146,17,21,1996,4,female,171,602,336,357,277,357,140,0,137
1683439,103,18,1910,6,male,1297,639,32,379,961,0,313,379,648
2051407,17,28,1996,1,male,720,630,392,377,220,206,118,171,102
1108162,14,12,1999,7,female,311,593,169,373,313,138,236,235,77
1765290,25,23,1988,1,female,946,601,387,390,510,87,127,303,383
1624376,58,14,1955,1,female,1836,588,307,374,498,225,194,149,304
1922607,21,7,1992,10,female,864,595,169,389,188,370,70,19,118
1184535,16,27,1997,12,male,654,577,173,394,400,394,114,0,286
1042845,16,14,1997,4,female,348,605,213,374,486,374,396,0,90
1621485,21,20,1992,5,female,629,612,402,389,485,389,451,0,34
2140007,30,21,1983,5,female,796,595,262,387,348,387,265,0,83
2065515,32,1,1981,10,female,525,575,298,385,868,385,495,0,373
1095533,18,13,1995,12,male,629,604,289,409,395,17,160,392,235
1377269,17,27,1996,5,male,384,623,519,396,538,73,443,323,95
1713185,19,31,1994,5,female,1042,592,350,403,356,35,291,368,65
1655968,59,13,1954,6,female,1798,574,433,414,412,28,206,386,206
2123763,16,23,1997,9,female,27,615,432,402,980,55,365,347,615
1341681,28,19,1985,12,male,1655,626,287,418,472,181,384,237,88
1204057,18,23,1995,6,female,412,612,360,418,1008,239,452,179,556
1639384,33,21,1980,6,male,1360,586,392,413,1353,84,1179,329,174
1687270,18,30,1995,5,female,1137,580,317,402,37,376,9,26,28
1252344,30,20,1983,7,male,417,621,483,402,217,342,66,60,151
1566583,17,30,1996,4,male,630,624,516,418,62,418,17,0,45
1423527,17,28,1996,4,male,345,613,568,395,98,395,94,0,4
1454672,21,9,1992,6,male,264,603,261,415,136,415,76,0,60
2100574,17,25,1996,9,male,275,628,401,396,334,396,270,0,64
1282977,45,25,1968,12,female,1719,616,390,447,422,7,184,440,238
1780314,66,24,1947,5,female,1298,575,364,422,578,0,119,422,459
1137626,103,14,1910,5,female,803,590,385,446,1545,6,518,440,1027
1422391,14,19,1999,1,female,400,583,417,442,115,135,21,307,94
2138644,63,27,1950,3,male,1311,638,485,445,134,286,100,159,34
1302898,19,22,1994,9,female,219,580,313,432,544,143,309,289,235
2022839,30,23,1983,2,female,732,591,257,440,459,316,264,124,195
1492546,24,6,1989,5,male,1421,637,488,441,103,435,94,6,9
1213840,15,17,1998,5,female,511,625,250,446,501,402,189,44,312
1995545,20,26,1993,3,female,800,577,137,432,541,398,275,34,266
2143980,18,22,1995,9,female,380,607,198,437,838,419,404,18,434
1996617,101,17,1912,4,female,520,599,335,450,49,450,47,0,2
1422464,113,1,1900,1,male,1286,621,413,424,72,424,53,0,19
1137542,23,14,1990,12,male,212,624,435,438,375,438,362,0,13
1684538,26,23,1987,6,female,789,621,307,422,924,422,794,0,130
1164325,15,12,1998,9,female,575,607,312,452,103,53,33,399,70
2081890,16,21,1997,7,male,783,595,344,473,211,143,68,330,143
2020993,17,15,1996,3,female,742,582,339,472,496,106,250,366,246
1009651,22,16,1991,11,female,355,602,328,476,321,134,141,342,180
2097166,31,22,1982,5,female,2152,620,360,469,752,188,306,281,446
1864437,14,15,1999,9,male,560,630,450,468,264,431,237,37,27
1101254,18,29,1995,11,female,1370,618,251,479,251,462,97,17,154
2020454,43,7,1970,11,male,768,597,408,466,293,419,169,47,124
1204947,103,22,1910,5,male,1377,613,350,481,618,444,383,37,235
1838231,18,6,1995,2,female,398,584,319,476,1106,390,369,86,737
1870056,20,2,1993,6,female,676,591,408,458,1001,454,599,4,402
1943625,19,17,1994,2,female,357,596,282,474,533,474,250,0,283
1263165,21,6,1992,6,female,352,584,396,481,456,481,378,0,78
1372334,23,18,1990,8,male,557,626,530,455,287,455,282,0,5
1110524,33,12,1980,5,male,608,590,380,452,363,452,307,0,56
1118099,76,23,1937,4,male,155,590,495,494,57,43,33,451,24
1857687,93,12,1920,9,male,1940,581,403,503,423,96,196,407,227
1102266,15,9,1998,3,female,116,581,325,506,324,282,120,224,204
1629584,18,20,1995,12,female,514,575,363,507,551,255,101,252,450
1781440,44,20,1969,9,female,293,574,376,517,606,107,154,410,452
1282438,90,7,1923,2,male,984,609,274,515,592,175,306,340,286
1168877,108,9,1905,7,female,1364,609,131,512,1217,287,789,225,428
1138762,25,11,1988,7,male,379,611,75,514,477,502,344,12,133
1364886,20,1,1993,1,male,505,613,510,514,70,514,62,0,8
1695303,25,26,1988,10,female,411,592,183,507,713,507,577,0,136
2114407,27,21,1986,10,female,441,633,524,500,346,500,202,0,144
1975936,18,8,1995,5,female,28,614,32,485,830,485,686,0,144
1884805,61,23,1952,10,male,1736,608,253,501,1444,501,942,0,502
1625782,19,8,1994,4,female,1119,606,384,553,410,167,111,386,299
1144806,88,26,1925,8,female,1829,634,424,521,661,347,300,174,361
1339048,19,11,1994,1,female,945,580,217,530,448,424,244,106,204
2076611,14,21,1999,11,female,444,591,402,525,841,507,462,18,379
1890574,25,18,1988,5,female,443,583,268,549,1797,472,926,77,871
1188438,21,17,1992,7,female,632,601,394,538,419,537,380,1,39
1074872,29,11,1984,4,female,1396,605,179,529,979,524,873,5,106
1869130,18,19,1995,10,male,366,622,457,520,292,520,241,0,51
1691792,62,21,1951,8,female,1653,591,205,558,751,558,284,0,467
1471128,19,28,1994,5,male,502,615,434,529,946,529,834,0,112
1242989,45,26,1968,9,female,1485,589,319,526,2046,526,1132,0,914
1517681,15,14,1998,6,female,321,610,462,567,284,68,199,499,85
2122485,19,12,1994,11,male,379,630,485,584,472,33,291,551,181
1189420,68,1,1945,1,female,1228,599,374,606,195,192,167,414,28
1503924,49,14,1964,11,female,2023,601,387,568,555,240,344,328,211
2007117,21,10,1992,3,female,389,595,265,588,1053,127,255,461,798
1235962,16,18,1997,10,female,783,589,240,608,672,560,440,48,232
1522347,17,8,1996,8,female,419,605,277,598,709,458,295,140,414
1263328,25,23,1988,5,female,1102,632,380,582,421,463,102,119,319
1966251,18,12,1995,3,female,578,607,451,594,1320,584,1120,10,200
1892004,16,10,1997,7,female,435,621,272,571,367,570,312,1,55
1704085,105,8,1908,6,male,563,607,452,594,101,594,86,0,15
1902127,17,1,1996,1,male,85,576,547,576,394,576,149,0,245
1559579,18,15,1995,3,male,602,615,372,563,641,563,587,0,54
2121965,17,24,1996,6,female,197,599,529,602,1125,602,925,0,200
1191962,60,18,1953,9,female,1472,599,463,642,806,0,189,642,617
1501605,68,10,1945,12,male,364,596,285,645,669,6,612,639,57
1719960,108,4,1905,1,female,1008,582,245,639,778,22,423,617,355
1454860,16,15,1997,9,female,250,584,466,631,291,283,172,348,119
1967816,19,22,1994,5,male,809,602,91,651,282,359,265,292,17
1775925,16,9,1997,4,male,427,634,483,629,475,244,190,385,285
1615998,16,5,1997,5,female,236,613,536,649,865,347,640,302,225
1510190,25,6,1988,2,female,484,580,126,661,687,300,552,361,135
1132966,14,21,1999,4,male,307,628,398,652,1092,409,374,243,718
1218708,19,19,1994,8,female,418,604,416,610,102,561,74,49,28
1151722,18,15,1995,4,female,894,584,337,635,676,525,217,110,459
1266704,18,23,1995,8,female,422,584,265,615,775,575,667,40,108
1342169,20,7,1993,10,female,434,630,468,648,1634,641,846,7,788
1022476,21,25,1992,11,female,709,590,434,649,303,649,254,0,49
1159624,49,28,1964,11,female,404,591,469,665,265,45,128,620,137
1585755,108,18,1905,9,male,1562,575,279,705,264,0,71,705,193
1734018,66,21,1947,10,male,313,589,187,678,850,1,240,677,610
1685858,17,13,1996,5,female,1379,583,401,712,2560,44,601,668,1959
1511449,15,10,1998,1,female,518,600,222,702,617,269,365,433,252
1412737,20,30,1993,11,female,353,629,398,725,469,360,262,365,207
1481553,19,15,1994,6,female,195,612,402,669,432,192,156,477,276
1206405,19,23,1994,9,male,383,597,381,669,470,261,234,408,236
1199991,22,11,1991,10,female,1256,596,139,710,737,179,507,531,230
1754033,65,17,1948,8,female,1810,617,509,716,747,476,324,240,423
1729222,108,18,1905,5,female,96,584,428,667,745,188,513,479,232
1068611,16,24,1997,4,female,539,638,511,704,404,685,343,19,61
1535619,103,14,1910,7,male,2190,625,309,688,514,676,305,12,209
1408780,16,13,1997,2,female,698,609,214,716,1084,527,753,189,331
1053910,49,20,1964,3,male,1443,579,265,673,1465,558,1111,115,354
1305633,26,2,1987,7,male,102,605,566,699,170,693,133,6,37
2103631,36,16,1977,8,female,1701,625,327,716,288,715,205,1,83
2126474,25,13,1988,1,male,774,603,468,712,947,708,810,4,137
1067234,17,27,1996,7,female,218,614,451,741,417,316,197,425,220
1943849,19,28,1994,5,female,749,595,326,759,943,407,161,352,782
1489988,23,27,1990,8,female,1572,629,215,784,1087,684,885,100,202
1493379,34,5,1979,8,female,911,634,356,785,994,622,524,163,470
1034283,18,13,1995,12,female,326,627,399,755,1762,672,1008,83,754
1654462,63,17,1950,7,female,2333,623,192,744,1318,578,696,166,622
1464691,18,11,1995,2,male,1047,605,328,793,361,790,178,3,183
1999189,20,6,1993,5,female,364,627,468,763,178,763,153,0,25
1635788,21,29,1992,6,male,248,608,489,790,305,790,244,0,61
1803200,33,5,1980,8,female,1220,597,236,793,637,793,441,0,196
1575556,19,9,1994,12,male,105,589,401,733,1433,733,1312,0,121
1808816,18,11,1995,7,female,589,631,206,755,2405,755,2403,0,2
2148661,23,12,1990,12,female,81,627,514,781,3050,781,2743,0,307
1913969,18,14,1995,11,female,520,583,439,825,247,149,56,676,191
1451520,20,10,1993,11,female,168,586,311,850,466,481,411,369,55
1650923,23,27,1990,1,male,420,628,294,812,201,344,115,468,86
1699212,17,20,1996,4,female,1249,586,247,851,1263,475,557,376,706
1326672,19,29,1994,10,male,179,579,511,842,600,429,461,413,139
1487554,20,18,1993,7,female,862,627,519,841,834,387,321,454,513
1894529,21,30,1992,1,female,498,626,197,805,754,495,219,310,535
2116727,14,15,1999,11,female,78,624,414,844,148,834,113,10,35
2100020,18,2,1995,4,male,825,620,478,807,401,751,304,56,97
1544769,30,14,1983,3,male,936,605,488,830,262,670,220,160,42
1350593,17,30,1996,12,male,455,635,479,800,709,768,356,32,353
1113549,106,18,1907,2,female,1868,604,308,858,812,837,506,21,306
1968060,17,23,1996,4,male,720,591,331,853,1510,657,1285,196,225
1214044,17,30,1996,11,male,417,585,226,859,1417,857,1386,2,31
1628892,106,7,1907,7,male,640,595,470,798,408,798,327,0,81
1002178,51,11,1962,10,male,488,591,213,815,2118,815,1846,0,272
1095762,15,28,1998,4,female,476,630,344,903,662,142,152,761,510
1334218,17,30,1996,8,female,1096,615,276,977,847,29,402,948,445
1829135,20,26,1993,4,female,537,578,277,921,878,14,420,907,458
1046466,28,10,1985,12,female,213,606,186,957,867,17,148,940,719
1310810,60,12,1953,11,male,1592,586,194,980,1164,97,510,883,654
1223421,16,20,1997,12,female,665,582,417,977,673,297,454,680,219
1839625,15,8,1998,4,female,244,633,228,986,993,641,732,345,261
1894783,17,25,1996,2,female,967,637,365,885,675,453,472,432,203
2025685,18,4,1995,9,male,599,628,444,923,591,550,406,373,185
1563021,24,27,1989,3,male,359,587,402,972,396,799,233,173,163
1231549,18,26,1995,3,female,236,588,268,892,764,852,538,40,226
1231668,22,17,1991,5,female,459,617,378,923,770,897,396,26,374
1378491,24,23,1989,7,female,837,579,431,944,764,873,372,71,392
1012535,38,1,1975,7,female,1731,635,419,933,991,768,662,165,329
1101041,29,13,1984,9,female,353,595,369,916,793,907,660,9,133
1500861,68,17,1945,8,male,100,602,572,946,104,946,98,0,6
1589556,24,27,1989,7,female,1056,583,400,919,438,919,366,0,72
2105175,90,19,1923,2,NA,2288,608,403,971,338,971,179,0,159
1928579,22,17,1991,12,female,302,584,45,908,709,908,661,0,48
1109733,102,12,1911,8,male,775,583,438,945,683,945,584,0,99
1058331,88,19,1925,10,female,2145,603,66,992,384,0,247,992,137
1145097,18,23,1995,9,female,359,590,202,1018,450,596,307,422,143
1314476,19,28,1994,10,male,511,596,318,1102,590,365,198,737,392
1692916,22,11,1991,3,female,470,625,340,1028,270,609,124,419,146
2191136,100,4,1913,9,female,1772,636,327,1092,635,405,563,687,72
1914836,103,3,1910,9,female,1672,582,355,1091,444,663,204,428,240
1010975,29,7,1984,3,male,760,631,448,1099,2271,614,1216,485,1055
1091012,61,10,1952,11,male,1047,609,472,1006,105,946,85,60,20
2110657,18,31,1995,8,male,280,575,415,1053,527,883,130,170,397
1594948,16,19,1997,9,female,383,577,188,1006,1287,994,1270,12,17
1467266,66,5,1947,4,female,1797,610,410,1077,1205,877,707,200,498
1949803,30,25,1983,10,male,457,627,469,1089,239,1081,215,8,24
1878769,23,16,1990,10,female,490,594,399,1122,1216,1121,842,1,374
2163680,25,19,1988,6,male,1320,607,423,1097,334,1097,300,0,34
1104115,26,16,1987,7,female,577,635,434,1103,1082,1103,852,0,230
1108607,108,13,1905,11,female,197,588,123,1048,1221,1048,1098,0,123
1674183,108,4,1905,4,male,896,634,162,1196,349,2,117,1194,232
1293520,18,12,1995,8,female,94,574,240,1185,792,0,88,1185,704
1565308,64,1,1949,1,female,1569,579,324,1214,1427,226,558,988,869
1966976,14,2,1999,9,male,246,599,367,1139,1857,107,1367,1032,490
1382633,17,20,1996,4,male,531,611,403,1178,1947,143,653,1035,1294
1303996,108,28,1905,8,male,185,598,444,1189,2629,70,1680,1119,949
1146987,18,18,1995,5,male,262,638,509,1203,198,450,148,753,50
1511067,18,3,1995,6,female,317,622,234,1182,1427,810,487,372,940
1858429,22,18,1991,12,female,927,609,443,1136,852,648,397,488,455
2145081,69,2,1944,10,female,1906,630,232,1132,1096,362,257,770,839
1675283,15,26,1998,5,female,714,627,415,1216,875,971,679,245,196
1272847,19,8,1994,4,female,341,598,335,1146,1094,842,757,304,337
2008936,19,21,1994,6,female,1349,615,262,1265,842,1017,563,248,279
1055448,24,20,1989,10,female,1703,597,193,1204,1128,1116,1023,88,105
2172946,20,20,1993,11,female,522,611,90,1198,807,1188,357,10,450
1464595,21,10,1992,12,female,1046,576,338,1278,1706,1268,1311,10,395
2155461,23,5,1990,6,male,545,620,444,1269,324,1269,287,0,37
1973903,94,2,1919,6,female,1778,581,179,1245,1124,1245,795,0,329
1138266,18,11,1995,12,female,315,610,349,1249,2322,1249,2092,0,230
1115549,29,8,1984,2,female,609,602,364,1445,603,171,62,1274,541
1090130,16,13,1997,12,male,207,584,282,1390,1609,875,1114,515,495
1845590,18,4,1995,7,male,557,579,300,1301,864,426,423,875,441
1352374,25,1,1988,4,female,1317,600,345,1344,1291,604,586,740,705
1967803,25,21,1988,9,male,577,624,459,1438,1344,797,776,641,568
2034467,108,8,1905,7,NA,1651,634,454,1362,1886,757,722,605,1164
1139184,33,17,1980,5,female,522,604,509,1467,226,1442,127,25,99
1318231,17,25,1996,11,female,1358,591,395,1335,288,1316,223,19,65
1428153,21,30,1992,7,female,94,637,420,1485,523,1458,455,27,68
1777104,21,21,1992,8,female,74,610,351,1353,1399,1317,1280,36,119
1535515,23,2,1990,1,female,510,629,440,1298,1522,1216,1172,81,350
1573494,25,1,1988,1,male,63,602,452,1299,1843,1242,1634,57,209
1831820,19,4,1994,4,male,483,584,320,1423,544,1423,508,0,36
2187837,29,26,1984,4,female,896,629,190,1321,621,1321,312,0,309
1744179,103,6,1910,3,male,661,627,534,1338,260,1338,242,0,18
1186760,22,19,1991,11,female,1278,639,316,1674,2192,0,585,1674,1607
2072145,37,17,1976,1,female,560,574,388,1606,2107,260,1222,1346,885
1373348,15,23,1998,2,male,276,606,303,1626,1205,1103,1018,523,187
1170563,18,18,1995,5,female,238,580,168,1663,1890,389,1102,1274,788
2088760,20,4,1993,10,female,409,592,475,1761,1373,704,762,1057,611
1488991,15,7,1998,2,male,667,611,460,1652,840,1619,576,33,264
2100097,15,28,1998,8,female,591,629,453,1793,473,1479,152,314,321
1243990,18,10,1995,11,female,449,576,304,1816,1955,1722,1815,94,140
1198028,28,18,1985,3,female,355,611,378,1597,1329,1544,548,53,781
1870111,29,28,1984,7,female,424,615,282,1563,608,1563,564,0,44
1758221,51,28,1962,2,female,1765,584,272,1738,2443,1738,2026,0,417
1939868,30,15,1983,10,female,1021,626,469,1981,1108,1383,375,598,733
1923210,14,14,1999,11,female,329,579,342,2345,3455,1601,2179,744,1276
1164352,18,29,1995,9,male,482,576,400,1929,294,1867,237,62,57
1512796,13,13,2000,2,female,845,582,369,2178,990,2145,796,33,194
1212093,14,5,1999,2,female,350,586,320,2190,442,2033,289,157,153
1339706,17,25,1996,3,female,335,598,248,1918,1061,1819,296,99,765
1107201,19,30,1994,10,male,229,595,387,2302,940,2292,648,10,292
1242435,18,5,1995,6,female,660,599,371,1953,1207,1952,1046,1,161
1841091,25,12,1988,7,male,387,631,441,2140,328,2140,311,0,17
1541871,28,4,1985,8,male,283,598,372,2179,235,2179,172,0,63
2137609,19,28,1994,12,male,194,583,410,2065,540,2065,501,0,39
1492394,18,22,1995,1,female,456,602,461,2133,1056,2133,990,0,66
1708755,26,1,1987,10,male,534,603,491,2248,1128,2248,583,0,545
1275431,14,12,1999,11,female,355,628,448,2662,859,1840,459,822,400
1101734,14,16,1999,12,female,327,628,72,3240,1480,1311,342,1929,1138
1314990,23,15,1990,11,female,793,591,365,2775,1610,1721,899,1054,711
1784942,15,19,1998,11,male,617,608,384,2593,2240,1498,1928,1095,312
1653134,33,15,1980,7,female,1832,620,133,2656,2816,545,1224,2111,1592
1450609,19,21,1994,9,female,1545,630,177,2664,4253,1724,2665,940,1588
1444084,17,16,1996,8,male,205,628,581,2472,192,2366,133,106,59
2071670,28,30,1985,3,female,179,609,585,2850,435,2733,294,117,141
1241151,15,1,1998,9,female,888,628,386,2844,1115,2221,606,623,509
1872512,17,13,1996,8,female,328,597,370,2797,1007,2527,760,270,247
2153716,21,12,1992,12,female,530,609,292,3504,1749,3159,775,345,974
1632098,21,30,1992,1,female,732,574,426,3257,1261,3139,1037,118,224
2153221,17,31,1996,12,male,161,637,362,2402,2922,2399,1416,3,1506
1156054,16,27,1997,5,male,253,585,509,2945,460,2945,395,0,65
1854942,21,24,1992,4,male,248,606,326,2767,880,2767,675,0,205
1012110,27,22,1986,11,male,218,618,224,3224,1409,3224,1011,0,398
1453969,68,23,1945,1,male,569,620,412,2956,1679,2956,1480,0,199
1659382,13,3,2000,8,male,332,618,246,3764,2125,2660,1724,1104,401
1615848,18,1,1995,11,female,45,591,490,7419,4354,2208,2419,5211,1935
1206709,17,16,1996,8,female,449,589,475,4348,3446,2021,1983,2327,1463
1476798,20,14,1993,4,male,510,575,38,8032,2653,6144,1108,1888,1545
1061472,61,7,1952,4,female,1914,598,281,4749,1806,3507,970,1242,836
1764574,26,30,1987,6,male,111,601,283,8942,6575,8776,4216,166,2359
1914640,14,25,1999,4,male,173,597,387,8200,1386,8140,862,60,524
1289193,23,15,1990,3,male,457,598,497,4576,1536,4576,1251,0,285
1609509,24,26,1989,3,female,421,617,291,9552,1704,9552,1536,0,168
1412849,31,1,1982,10,female,133,582,133,14039,3274,14039,3077,0,197
1921677,50,14,1963,11,female,432,585,94,13529,6287,13529,5856,0,431
1656477,68,12,1945,3,male,550,584,347,21652,10220,21652,8584,0,1636
1219794,14,3,1999,12,male,324,640,484,0,0,0,0,0,0
1506495,13,27,2000,4,female,180,683,124,0,1,0,1,0,0
1159372,14,7,1999,2,male,168,655,537,0,0,0,0,0,0
1986526,14,3,1999,4,female,251,696,534,0,37,0,37,0,0
2044322,17,12,1996,12,male,696,711,548,0,0,0,0,0,0
1983523,16,13,1997,1,female,468,683,585,0,0,0,0,0,0
1232355,16,7,1997,2,male,537,665,560,0,1,0,1,0,0
1610894,16,2,1997,2,male,191,675,635,0,0,0,0,0,0
2017717,16,5,1997,9,male,381,708,641,0,3,0,1,0,2
1227307,18,19,1995,11,female,252,697,291,0,0,0,0,0,0
1493551,17,16,1996,4,male,419,696,591,0,0,0,0,0,0
1330901,17,14,1996,5,male,1236,668,175,0,207,0,76,0,131
1201470,17,30,1996,8,female,390,680,489,0,3,0,1,0,2
1892050,19,3,1994,12,male,418,667,610,0,0,0,0,0,0
1297392,19,16,1994,12,male,285,668,536,0,3,0,2,0,1
2029885,18,13,1995,1,male,589,711,508,0,1,0,1,0,0
2061381,18,5,1995,3,female,1340,644,375,0,0,0,0,0,0
1274441,18,21,1995,4,male,1482,661,315,0,15,0,11,0,4
1888760,18,4,1995,5,female,293,663,443,0,6,0,6,0,0
1830386,18,4,1995,6,male,510,648,548,0,0,0,0,0,0
1179248,18,3,1995,10,male,328,641,576,0,31,0,20,0,11
1728716,18,8,1995,10,male,289,664,450,0,3,0,0,0,3
1757825,19,9,1994,3,male,925,674,291,0,3,0,3,0,0
1493778,19,10,1994,5,male,1410,640,459,0,2,0,2,0,0
1885509,19,23,1994,9,male,538,666,454,0,1,0,0,0,1
1624731,19,1,1994,9,female,349,707,84,0,4,0,3,0,1
1203913,19,10,1994,10,male,1377,702,279,0,0,0,0,0,0
1170517,19,10,1994,10,male,648,640,505,0,1,0,1,0,0
1286827,20,3,1993,2,male,211,699,671,0,0,0,0,0,0
1481879,20,2,1993,3,male,530,646,580,0,56,0,47,0,9
1971122,20,24,1993,6,female,656,707,576,0,1,0,0,0,1
1053870,20,7,1993,7,male,810,673,505,0,0,0,0,0,0
1548512,22,24,1991,11,female,1688,686,200,0,3,0,0,0,3
1604575,21,14,1992,1,male,203,667,583,0,0,0,0,0,0
1186093,21,25,1992,6,male,695,652,311,0,1,0,1,0,0
2130225,21,10,1992,10,female,204,687,16,0,0,0,0,0,0
2019691,23,25,1990,11,male,762,697,678,0,1,0,1,0,0
1010339,22,15,1991,7,male,376,695,490,0,12,0,8,0,4
1595181,23,20,1990,2,male,1434,646,211,0,0,0,0,0,0
1306292,24,4,1989,5,male,1078,709,595,0,5,0,5,0,0
1374999,24,6,1989,6,female,759,660,188,0,1,0,0,0,1
1565742,24,16,1989,8,male,589,667,579,0,1,0,1,0,0
1599008,26,2,1987,12,female,1364,708,473,0,11,0,10,0,1
1160935,25,22,1988,5,male,623,659,589,0,0,0,0,0,0
1644832,26,10,1987,8,male,578,686,491,0,0,0,0,0,0
1818500,29,8,1984,11,male,436,702,550,0,0,0,0,0,0
1873315,28,27,1985,8,male,766,649,599,0,0,0,0,0,0
1144069,30,8,1983,11,male,308,647,603,0,0,0,0,0,0
1307193,36,26,1977,1,male,673,710,577,0,7,0,2,0,5
1301873,48,17,1965,10,male,689,662,148,0,3,0,3,0,0
1219094,55,10,1958,8,male,321,679,194,0,158,0,104,0,54
1415579,68,7,1945,8,male,951,678,443,0,1,0,0,0,1
2085132,68,15,1945,9,male,1021,710,396,0,4,0,4,0,0
1490287,94,9,1919,3,female,932,675,176,0,10,0,7,0,3
1751575,98,10,1915,4,male,984,718,657,0,17,0,15,0,2
1820713,103,12,1910,11,female,1554,649,74,0,2,0,1,0,1
1208088,103,31,1910,12,male,1529,641,477,0,0,0,0,0,0
1306349,103,12,1910,3,male,1464,649,357,0,0,0,0,0,0
1082136,103,4,1910,3,male,638,663,320,0,5,0,5,0,0
2186035,108,5,1905,5,male,1259,670,352,0,0,0,0,0,0
1342872,108,16,1905,6,male,1148,689,153,0,0,0,0,0,0
1673353,108,30,1905,7,male,2059,679,113,0,32,0,19,0,13
2182655,19,30,1994,5,female,320,660,267,1,0,0,0,1,0
1197366,15,7,1998,11,male,583,704,598,1,1,0,0,1,1
1397744,26,14,1987,1,male,777,707,547,1,1,0,0,1,1
1604331,108,9,1905,10,male,1128,701,62,1,1,0,0,1,1
2132965,14,14,1999,6,female,92,698,81,1,5,0,0,1,5
1103144,16,11,1997,10,male,979,645,335,1,35,0,12,1,23
1800370,23,26,1990,11,male,1101,716,584,1,2,0,1,1,1
2034894,22,28,1991,4,male,412,668,562,1,8,0,7,1,1
1839915,63,10,1950,1,male,977,658,320,1,7,0,3,1,4
1114624,16,21,1997,12,female,457,646,532,1,0,1,0,0,0
1118598,16,13,1997,9,male,1458,673,444,1,0,1,0,0,0
1241126,23,4,1990,7,male,411,674,626,1,0,1,0,0,0
2104083,24,1,1989,10,male,462,683,639,1,0,1,0,0,0
1159524,26,17,1987,4,male,952,678,513,1,0,1,0,0,0
1528140,30,8,1983,4,male,521,718,598,1,0,1,0,0,0
1974256,103,28,1910,7,male,597,666,579,1,0,1,0,0,0
1151821,20,12,1993,10,male,593,663,560,1,1,1,0,0,1
1481167,22,1,1991,4,female,605,662,581,1,1,1,0,0,1
1724914,16,6,1997,9,male,621,677,294,1,2,1,2,0,0
2132310,18,5,1995,3,female,281,691,653,1,20,1,18,0,2
2116798,18,3,1995,5,female,388,698,130,1,9,1,1,0,8
1649314,18,17,1995,8,male,342,712,674,1,8,1,6,0,2
1342832,19,22,1994,7,female,647,655,303,1,2,1,2,0,0
1148368,20,27,1993,1,male,497,645,576,1,9,1,0,0,9
1520307,20,21,1993,6,female,638,665,431,1,200,1,161,0,39
2066598,21,24,1992,9,male,874,682,532,1,22,1,12,0,10
2166124,22,8,1991,7,female,505,712,309,1,5,1,5,0,0
1908730,25,23,1988,9,male,1691,670,70,1,10,1,8,0,2
1392688,53,18,1960,6,female,714,695,184,1,93,1,39,0,54
1282360,108,10,1905,12,male,1310,713,514,1,17,1,13,0,4
1748134,108,30,1905,1,male,1575,669,138,1,10,1,8,0,2
1191983,16,18,1997,6,male,575,646,239,2,0,0,0,2,0
1772876,108,3,1905,6,male,1512,656,353,2,1,0,1,2,0
1611060,26,13,1987,8,male,432,680,610,2,2,0,2,2,0
1007349,16,12,1997,1,male,164,647,591,2,3,0,1,2,2
1414008,18,23,1995,7,male,318,661,491,2,27,0,18,2,9
1801569,19,21,1994,3,male,1689,683,230,2,0,2,0,0,0
1282989,16,4,1997,10,male,305,697,330,2,1,2,1,0,0
1310108,16,19,1997,4,male,784,656,145,2,8,2,8,0,0
1149209,16,14,1997,4,male,680,643,414,2,7,2,6,0,1
1035107,17,30,1996,9,male,374,714,623,2,5,2,2,0,3
1136815,18,1,1995,10,female,305,650,42,2,20,2,19,0,1
1680021,19,28,1994,4,male,774,657,571,2,23,2,15,0,8
1090343,20,29,1993,7,male,835,652,360,2,5,2,3,0,2
2071658,21,17,1992,6,male,484,661,430,2,3,2,3,0,0
1298825,23,13,1990,10,male,1485,696,389,2,55,2,48,0,7
1553858,25,6,1988,6,male,261,694,543,2,3,2,1,0,2
1760870,27,1,1986,7,male,654,706,580,2,31,2,30,0,1
1303342,30,1,1983,4,male,1560,651,363,2,10,2,10,0,0
1334333,31,10,1982,10,male,696,660,630,2,19,2,10,0,9
1647556,14,31,1999,3,male,174,661,231,3,0,0,0,3,0
1678829,17,1,1996,6,male,488,674,355,3,16,0,2,3,14
1432240,18,8,1995,1,male,527,659,538,3,2,1,2,2,0
1909006,18,10,1995,5,male,1286,681,440,3,4,1,1,2,3
1011748,18,7,1995,3,male,240,701,627,3,0,3,0,0,0
1244292,18,15,1995,9,male,506,683,588,3,0,3,0,0,0
1119971,93,15,1920,10,male,917,717,503,3,2,3,0,0,2
1625469,14,1,1999,8,male,281,680,364,3,21,3,5,0,16
2132963,15,1,1998,7,female,133,647,165,3,44,3,21,0,23
2128948,17,10,1996,12,male,1047,643,288,3,225,3,66,0,159
1759840,20,21,1993,2,male,289,648,356,3,77,3,61,0,16
2003933,20,1,1993,6,male,593,702,293,3,46,3,45,0,1
1933965,25,28,1988,6,male,294,719,597,3,62,3,57,0,5
1830120,68,17,1945,8,female,1311,658,85,3,5,3,4,0,1
1779671,108,12,1905,4,male,940,671,170,3,8,3,5,0,3
1572547,69,17,1944,3,male,1877,650,79,4,2,0,0,4,2
2174373,63,15,1950,9,female,511,703,447,4,57,0,37,4,20
2157012,108,12,1905,3,male,1486,675,305,4,1,2,1,2,0
1038791,14,13,1999,7,male,439,648,586,4,0,4,0,0,0
1606551,58,27,1955,9,male,1367,693,452,4,1,4,0,0,1
2088769,27,30,1986,11,male,330,704,578,4,4,4,4,0,0
1968500,16,11,1997,8,male,812,653,529,4,30,4,5,0,25
1317099,16,5,1997,9,female,392,717,55,4,46,4,43,0,3
1350290,19,1,1994,1,female,376,691,302,4,250,4,100,0,150
1577201,19,20,1994,9,male,463,674,202,4,11,4,11,0,0
1421941,21,23,1992,10,male,580,685,322,4,11,4,11,0,0
2163353,23,15,1990,3,male,218,685,349,4,99,4,83,0,16
1652663,108,18,1905,9,male,1178,678,192,4,52,4,45,0,7
1464778,99,1,1914,12,male,1172,681,404,5,2,0,0,5,2
1574244,53,29,1960,10,male,1429,695,319,5,3,3,2,2,1
1043745,28,10,1985,1,male,989,704,647,5,0,5,0,0,0
1752949,103,6,1910,8,female,359,706,418,5,2,5,1,0,1
1490869,21,14,1992,7,male,520,692,621,5,7,5,4,0,3
1378382,16,2,1997,2,female,386,651,70,5,84,5,70,0,14
1844046,24,19,1989,12,female,685,643,241,5,28,5,14,0,14
1932038,24,22,1989,6,male,346,671,590,5,125,5,72,0,53
2043839,24,5,1989,2,male,381,689,549,6,30,1,14,5,16
2153666,48,14,1965,5,male,986,690,470,6,0,4,0,2,0
1882281,98,3,1915,8,male,1196,654,170,6,1,3,1,3,0
1254268,18,23,1995,11,female,715,650,511,6,50,3,22,3,28
1422240,19,7,1994,10,male,572,683,475,6,16,3,13,3,3
1135398,68,31,1945,1,male,854,645,490,6,27,6,24,0,3
1666216,99,14,1914,3,male,1482,688,294,6,12,6,10,0,2
1771442,15,8,1998,3,male,668,711,571,7,0,0,0,7,0
1019596,32,1,1981,11,male,620,670,602,7,2,1,2,6,0
1852239,60,4,1953,1,female,1186,650,368,7,8,0,1,7,7
1465136,60,3,1953,6,female,357,640,131,7,384,0,42,7,342
1103232,98,17,1915,3,male,997,697,547,7,2,3,1,4,1
1962274,68,27,1945,9,male,364,642,510,7,25,3,19,4,6
2184139,102,24,1911,3,male,1123,702,271,7,1,6,1,1,0
1559499,16,8,1997,6,female,217,657,55,7,7,7,5,0,2
2088718,20,11,1993,11,female,354,642,69,7,6,7,3,0,3
1955904,18,15,1995,5,male,396,671,374,7,26,7,17,0,9
1830910,19,31,1994,1,female,381,685,232,7,11,7,10,0,1
1054139,20,25,1993,5,male,758,676,522,7,15,7,11,0,4
1017667,27,22,1986,12,male,887,673,478,7,48,7,40,0,8
1657401,50,18,1963,10,male,704,646,506,7,21,7,11,0,10
1483646,103,29,1910,6,male,814,640,300,7,28,7,18,0,10
1433948,22,27,1991,12,female,723,651,436,8,1,1,0,7,1
1016964,20,19,1993,5,male,560,648,362,8,38,0,7,8,31
1626170,19,10,1994,4,male,1287,669,327,8,2,6,0,2,2
1242108,68,14,1945,11,male,347,662,563,8,13,6,11,2,2
2159394,105,28,1908,12,male,1816,680,400,8,4,8,3,0,1
1146107,16,20,1997,2,male,642,671,438,8,6,8,5,0,1
1736347,49,22,1964,5,female,505,715,571,8,5,8,4,0,1
1593451,17,14,1996,6,female,557,641,446,8,27,8,15,0,12
1339768,24,10,1989,11,male,190,661,92,8,14,8,4,0,10
1078092,23,11,1990,1,male,831,689,473,8,32,8,23,0,9
1755905,59,3,1954,12,male,1549,647,424,8,22,8,17,0,5
2167104,17,5,1996,8,male,343,694,414,9,26,4,11,5,15
1389932,21,22,1992,11,male,660,655,420,9,3,9,2,0,1
1520999,22,8,1991,2,male,323,643,574,9,8,9,6,0,2
1690743,15,19,1998,3,female,244,701,215,9,39,9,36,0,3
2185454,17,8,1996,1,male,817,670,452,9,86,9,64,0,22
1102531,18,1,1995,10,female,309,712,607,9,35,9,30,0,5
1490785,20,25,1993,5,male,508,696,569,9,14,9,11,0,3
1460126,68,17,1945,8,male,461,684,629,9,62,9,31,0,31
1142162,81,13,1932,2,female,1607,700,276,9,133,9,78,0,55
1961168,17,26,1996,3,female,1204,688,272,10,33,0,12,10,21
1969227,27,30,1986,7,male,190,704,653,10,2,5,0,5,2
2021763,15,6,1998,12,male,356,715,656,10,1,10,1,0,0
1303669,14,25,1999,6,female,734,656,287,10,5,10,5,0,0
1087059,19,10,1994,10,male,1116,645,476,10,5,10,2,0,3
2104701,18,3,1995,11,male,498,653,514,10,41,10,40,0,1
1454408,21,5,1992,5,male,755,697,621,10,35,10,25,0,10
1792710,21,21,1992,7,male,623,646,527,10,32,10,21,0,11
1189703,108,20,1905,1,male,1519,701,299,11,3,0,0,11,3
2147713,18,17,1995,7,female,588,673,297,11,69,5,50,6,19
1455154,18,16,1995,3,male,452,691,569,11,30,11,25,0,5
1484684,103,31,1910,7,female,1614,655,381,12,11,0,9,12,2
2124770,71,30,1942,8,female,667,658,433,12,86,12,74,0,12
1927892,39,19,1974,11,female,663,695,445,13,679,11,176,2,503
2082555,20,12,1993,8,male,820,652,564,13,12,13,10,0,2
2192780,103,27,1910,9,male,1209,714,196,13,19,13,13,0,6
1463404,68,11,1945,12,female,930,705,255,13,101,13,55,0,46
1601859,19,28,1994,3,male,387,652,557,14,0,1,0,13,0
2089344,108,9,1905,7,male,315,675,505,14,5,0,2,14,3
1973940,73,18,1940,6,male,1390,672,200,14,35,0,6,14,29
1797044,67,21,1946,9,male,1811,647,275,14,26,10,2,4,24
1786939,108,9,1905,1,male,1227,641,68,14,56,13,46,1,10
1614963,108,13,1905,4,male,1993,707,335,14,1,14,1,0,0
2068858,18,30,1995,12,female,720,644,271,14,15,14,15,0,0
1778548,20,14,1993,2,male,823,694,593,14,65,14,55,0,10
1715753,23,16,1990,8,male,212,711,642,14,43,14,42,0,1
1859318,64,4,1949,4,male,304,707,627,15,0,0,0,15,0
2178232,14,14,1999,6,female,345,669,553,15,21,6,12,9,9
1243111,108,29,1905,10,female,985,692,525,15,11,6,9,9,2
1028479,16,26,1997,4,female,296,707,337,15,115,11,43,4,72
1522394,15,25,1998,4,male,531,694,329,15,2,15,2,0,0
1283305,20,30,1993,5,male,713,653,399,15,1,15,1,0,0
1677957,97,4,1916,5,male,1575,663,285,15,8,15,8,0,0
1512007,101,31,1912,7,female,1531,713,228,15,6,15,1,0,5
2142487,18,3,1995,1,male,871,710,537,15,13,15,9,0,4
1300611,21,14,1992,3,male,628,718,404,15,16,15,1,0,15
1373614,25,13,1988,8,male,608,720,478,16,371,2,299,14,72
1865569,33,3,1980,6,male,792,672,322,16,57,7,32,9,25
1051714,15,29,1998,10,male,217,714,579,16,1,16,1,0,0
1253979,104,9,1909,5,male,1851,702,305,16,3,16,0,0,3
1038994,31,15,1982,11,male,808,695,393,16,17,16,8,0,9
1492529,20,2,1993,8,male,382,696,631,16,103,16,86,0,17
1271023,19,22,1994,4,male,567,691,678,17,3,0,2,17,1
2138163,23,3,1990,3,female,552,650,460,17,8,17,7,0,1
1018318,14,24,1999,6,female,305,660,455,17,72,17,45,0,27
1426491,18,3,1995,5,female,600,707,351,17,117,17,71,0,46
2173126,22,3,1991,7,male,842,644,440,18,2,0,0,18,2
1537686,97,1,1916,1,female,2036,667,211,18,10,0,6,18,4
1275917,16,28,1997,3,male,525,672,537,18,0,5,0,13,0
1095445,108,4,1905,10,male,1778,661,487,18,19,16,11,2,8
1056066,18,28,1995,5,male,757,657,491,19,103,12,93,7,10
1436567,17,6,1996,10,male,378,675,574,20,4,1,1,19,3
2128706,20,29,1993,6,male,731,648,289,20,19,3,4,17,15
1200188,23,6,1990,6,female,717,664,369,20,25,19,6,1,19
1759950,15,10,1998,6,male,484,662,513,20,36,17,15,3,21
2016539,23,4,1990,12,female,332,654,150,20,84,18,70,2,14
1616552,108,9,1905,11,male,956,657,435,20,8,20,6,0,2
2055884,23,12,1990,12,male,465,682,555,20,89,20,54,0,35
1845353,105,8,1908,12,male,1718,682,339,21,132,0,53,21,79
2191156,16,19,1997,6,male,322,699,649,21,25,16,19,5,6
1603820,29,10,1984,6,male,1515,665,501,21,301,19,220,2,81
1442539,22,5,1991,12,female,169,652,267,21,17,21,17,0,0
1373802,28,20,1985,11,male,1057,688,402,21,21,21,16,0,5
1941224,15,9,1998,3,female,431,674,229,21,355,21,167,0,188
1712043,18,21,1995,6,female,331,660,505,21,41,21,34,0,7
1337080,22,29,1991,5,male,1492,663,466,21,45,21,34,0,11
2138890,16,30,1997,1,male,1104,680,182,22,65,0,16,22,49
1518506,20,18,1993,6,female,334,651,83,22,182,19,146,3,36
2092948,108,24,1905,8,female,912,668,88,22,8,22,8,0,0
1314256,16,17,1997,9,male,204,687,565,23,13,9,12,14,1
1265205,23,30,1990,10,male,536,665,337,23,139,20,54,3,85
1194930,18,27,1995,9,male,468,668,430,23,93,23,57,0,36
1314788,25,28,1988,12,male,375,665,527,24,3,16,1,8,2
1555627,16,10,1997,8,male,468,706,534,24,160,17,84,7,76
1491263,20,25,1993,11,male,582,683,43,24,15,22,0,2,15
1153616,17,27,1996,2,female,422,641,345,24,256,18,192,6,64
1109223,25,22,1988,12,male,756,664,463,24,55,21,38,3,17
1133578,27,8,1986,5,female,1507,719,335,24,26,24,20,0,6
2047922,103,1,1910,1,male,1072,712,679,25,33,18,27,7,6
2049011,22,18,1991,12,male,1018,692,537,25,34,25,26,0,8
2138375,17,24,1996,11,female,614,663,381,26,5,26,4,0,1
2125989,98,30,1915,5,female,1379,677,150,26,13,26,10,0,3
1269694,16,6,1997,4,female,530,647,353,26,46,26,45,0,1
1779903,25,9,1988,2,female,370,641,132,26,174,26,138,0,36
1283363,14,16,1999,6,female,198,648,50,27,36,1,25,26,11
1080971,103,1,1910,1,male,229,715,649,27,83,5,25,22,58
1889909,17,3,1996,11,male,206,700,579,27,12,27,2,0,10
1301511,102,26,1911,12,male,1112,684,405,27,38,27,29,0,9
1429424,19,18,1994,12,female,296,679,410,27,193,27,101,0,92
2105244,103,18,1910,11,female,365,642,224,28,66,28,61,0,5
2191289,14,15,1999,7,male,232,712,639,29,13,0,1,29,12
1109355,106,19,1907,10,male,1662,689,191,29,22,0,11,29,11
1227331,33,1,1980,9,male,611,669,208,29,421,28,116,1,305
1856565,67,24,1946,11,female,1416,657,201,29,21,29,18,0,3
1055021,18,23,1995,2,female,636,699,392,31,1,0,0,31,1
1945854,14,3,1999,7,male,446,668,197,31,10,2,4,29,6
1059742,92,15,1921,1,male,2036,682,172,31,77,0,29,31,48
1398255,18,27,1995,4,male,806,657,456,30,503,19,246,11,257
2068419,23,9,1990,5,female,1402,682,147,31,74,13,67,18,7
2157853,108,11,1905,4,female,1029,702,209,30,344,10,206,20,138
1060243,17,3,1996,10,female,487,641,427,31,159,25,55,6,104
2186745,17,1,1996,12,male,761,716,546,31,17,31,16,0,1
1161244,15,28,1998,2,male,375,641,542,30,54,30,41,0,13
1738511,103,7,1910,2,female,669,712,404,30,57,30,52,0,5
1341660,75,9,1938,9,female,1580,641,221,32,11,4,5,28,6
1794431,28,2,1985,3,female,153,707,108,32,174,20,52,12,122
1808079,18,8,1995,8,male,546,671,546,32,15,31,14,1,1
1177259,108,12,1905,10,male,882,663,278,33,7,0,0,33,7
1393433,41,10,1972,9,male,1417,697,426,33,35,26,4,7,31
1157302,108,1,1905,1,female,1661,670,278,34,20,0,14,34,6
1605565,17,4,1996,3,female,436,662,207,34,489,12,345,22,144
1748018,19,10,1994,9,female,427,656,337,34,311,31,234,3,77
1406318,103,10,1910,9,male,1407,716,169,34,153,34,117,0,36
1904287,20,17,1993,2,male,536,704,589,36,7,10,3,26,4
2108482,23,10,1990,10,female,1116,650,448,36,12,15,4,21,8
2176824,53,14,1960,7,female,638,673,318,36,1510,8,302,28,1208
1067337,24,27,1989,11,male,304,706,622,36,557,31,381,5,176
2094295,15,13,1998,8,male,461,713,522,35,52,35,44,0,8
1014853,16,17,1997,10,female,190,640,187,35,26,35,21,0,5
1364769,18,12,1995,12,male,341,649,372,37,45,2,9,35,36
1683551,100,2,1913,2,male,1237,707,278,37,27,32,7,5,20
1369986,23,3,1990,7,female,322,671,349,37,134,35,75,2,59
1894128,22,11,1991,9,male,1494,676,154,37,28,37,15,0,13
2077511,113,21,1900,11,female,1747,643,555,38,149,0,46,38,103
1684849,108,1,1905,5,male,1309,717,388,39,53,38,24,1,29
1553099,17,27,1996,11,female,833,654,366,39,10,39,9,0,1
1894253,17,4,1996,2,female,294,690,392,38,288,38,256,0,32
1915887,14,24,1999,10,male,249,708,283,40,81,0,64,40,17
1571114,108,31,1905,8,male,2248,701,300,40,211,35,123,5,88
1324232,17,12,1996,7,male,509,650,519,41,4,0,1,41,3
1455979,15,29,1998,3,male,693,648,173,42,100,1,41,41,59
1630915,17,15,1996,7,female,408,706,399,41,176,31,88,10,88
2166813,28,17,1985,5,male,650,719,382,41,1,41,0,0,1
1599469,23,22,1990,6,female,641,655,135,41,61,41,28,0,33
2060527,20,29,1993,9,male,843,666,501,44,27,6,13,38,14
1866498,15,5,1998,5,female,353,683,473,44,17,10,6,34,11
1677662,22,25,1991,8,male,510,670,513,43,20,28,14,15,6
1082904,47,25,1966,8,male,457,684,587,44,49,23,30,21,19
1136473,17,29,1996,8,male,535,704,459,44,103,20,59,24,44
1897508,18,27,1995,11,male,123,675,658,43,11,41,8,2,3
1531035,26,1,1987,1,male,1402,655,344,43,18,43,17,0,1
1786946,28,3,1985,5,male,1038,676,560,44,15,44,11,0,4
2071988,17,30,1996,6,male,1436,685,453,45,98,7,46,38,52
2089909,14,10,1999,7,female,132,675,243,45,0,30,0,15,0
2115470,21,19,1992,6,male,1852,679,527,45,1,11,1,34,0
1608501,20,17,1993,11,male,471,673,590,45,4,45,4,0,0
1481768,18,25,1995,12,female,169,718,546,45,180,45,159,0,21
1588944,85,7,1928,9,male,1827,691,441,47,25,0,16,47,9
1969106,69,24,1944,3,male,763,692,47,46,21,16,6,30,15
1860807,39,24,1974,6,male,419,707,505,46,279,17,217,29,62
1960656,42,10,1971,12,male,1804,648,389,47,5,46,2,1,3
1309648,28,1,1985,3,male,1425,677,367,47,23,45,9,2,14
2101768,23,23,1990,4,male,514,654,568,46,30,41,28,5,2
2193200,16,15,1997,11,male,509,662,549,49,0,17,0,32,0
1194629,15,28,1998,12,male,493,700,556,48,13,18,3,30,10
2015247,16,1,1997,1,female,579,651,320,48,38,27,31,21,7
1792922,16,14,1997,2,female,458,689,302,48,13,48,10,0,3
1310453,20,8,1993,8,female,590,651,203,48,167,48,157,0,10
1481379,22,1,1991,1,female,495,642,108,49,852,49,557,0,295
1063277,93,1,1920,11,male,905,721,525,50,40,0,5,50,35
1409699,14,3,1999,8,female,86,683,113,50,60,43,22,7,38
1126282,108,2,1905,1,male,1091,661,462,50,79,45,43,5,36
2111677,105,4,1908,9,male,1438,675,364,51,44,51,43,0,1
1384818,16,31,1997,5,female,197,642,60,51,84,51,67,0,17
1815503,18,17,1995,4,male,505,645,599,51,150,51,115,0,35
1012409,21,29,1992,11,female,674,673,452,50,178,50,136,0,42
1449187,18,11,1995,7,male,833,692,597,53,27,9,15,44,12
1666220,22,10,1991,10,male,1109,661,527,53,6,53,6,0,0
1547178,113,15,1900,7,male,1294,643,350,54,2,0,0,54,2
1310770,19,11,1994,1,female,497,656,333,55,143,30,66,25,77
1150351,18,17,1995,2,female,97,663,559,54,53,54,47,0,6
1100569,22,26,1991,8,female,826,713,166,55,71,55,54,0,17
1342837,20,1,1993,12,female,659,694,226,55,148,55,137,0,11
1180364,23,7,1990,10,male,338,699,631,55,268,55,161,0,107
1475755,113,14,1900,2,male,1260,657,529,57,8,5,2,52,6
2003030,91,9,1922,2,female,942,701,471,57,23,5,14,52,9
1888485,20,13,1993,9,male,361,656,577,56,84,8,79,48,5
1463945,25,14,1988,4,female,1073,693,265,57,60,12,46,45,14
1319559,44,22,1969,2,male,907,651,431,58,42,12,34,46,8
1226790,17,30,1996,5,female,456,720,531,58,246,57,194,1,52
1659385,21,14,1992,9,female,832,673,144,56,168,50,67,6,101
1483005,15,4,1998,3,female,677,679,65,58,28,58,26,0,2
1259478,32,18,1981,6,male,290,687,542,57,35,57,31,0,4
1770227,108,26,1905,1,male,1888,717,421,56,43,56,32,0,11
1849256,18,21,1995,12,female,423,681,127,57,182,57,62,0,120
1700151,18,1,1995,1,female,872,653,159,57,95,57,81,0,14
1859165,26,15,1987,8,female,566,678,501,56,100,56,80,0,20
1246913,29,4,1984,8,female,468,694,284,57,161,57,140,0,21
1026160,36,4,1977,5,female,279,716,519,56,300,56,202,0,98
1647887,19,12,1994,4,male,777,658,474,60,0,4,0,56,0
2085591,21,18,1992,8,male,448,709,677,59,19,5,15,54,4
1165509,23,15,1990,2,male,1044,707,321,59,100,6,38,53,62
1467088,20,3,1993,7,female,577,664,200,60,65,18,14,42,51
1069734,21,10,1992,4,female,382,721,479,60,71,42,27,18,44
1233037,18,8,1995,8,female,408,716,501,59,30,58,28,1,2
1611861,16,28,1997,5,male,200,652,457,59,58,59,48,0,10
1479383,19,8,1994,8,male,196,647,470,60,75,60,43,0,32
1406122,15,30,1998,12,female,823,684,349,63,229,0,93,63,136
1580754,108,14,1905,10,male,1961,647,316,63,394,0,262,63,132
1907721,113,1,1900,1,female,2302,688,538,61,138,1,24,60,114
1006132,18,19,1995,1,female,598,705,414,63,52,24,44,39,8
1777132,103,18,1910,6,female,593,682,82,62,72,21,39,41,33
1722083,17,20,1996,5,male,274,681,542,62,14,62,13,0,1
1562056,18,22,1995,8,female,309,652,322,62,462,62,377,0,85
1862549,21,15,1992,5,female,412,648,540,63,161,63,97,0,64
2158865,102,9,1911,8,male,1445,690,131,61,149,61,98,0,51
1375976,107,24,1906,10,female,1577,644,131,65,186,8,94,57,92
1266083,16,2,1997,5,female,353,673,358,64,10,18,5,46,5
1825638,21,19,1992,6,male,322,721,592,64,14,59,11,5,3
1610696,108,1,1905,1,male,2259,642,367,64,30,48,14,16,16
2170243,14,15,1999,5,female,77,647,173,64,108,57,96,7,12
2121826,18,15,1995,10,male,87,702,586,64,116,64,94,0,22
1428656,24,4,1989,11,male,841,650,522,68,86,34,17,34,69
1792782,28,2,1985,3,female,1408,663,361,67,267,31,164,36,103
1862108,17,12,1996,6,male,832,691,575,67,88,51,68,16,20
1104876,19,3,1994,6,female,188,644,243,66,246,65,210,1,36
1943407,68,17,1945,12,male,951,651,585,67,0,67,0,0,0
1817592,19,18,1994,9,male,592,693,375,66,18,66,11,0,7
1013553,21,8,1992,10,female,150,650,492,67,111,67,87,0,24
1264284,27,26,1986,10,female,190,651,503,66,298,66,188,0,110
1108752,108,25,1905,5,NA,2041,706,178,69,435,2,113,67,322
1350813,18,2,1995,2,male,523,708,431,70,192,47,122,23,70
1484659,18,1,1995,5,male,560,717,592,71,34,57,25,14,9
1312191,14,9,1999,3,female,290,642,273,69,137,52,76,17,61
1753516,18,20,1995,11,female,1193,660,326,69,587,62,383,7,204
1926434,18,22,1995,1,female,196,643,200,69,157,64,138,5,19
1649287,20,28,1993,9,female,390,648,471,69,122,64,57,5,65
1208344,31,22,1982,12,male,474,659,600,69,99,69,51,0,48
1750280,102,13,1911,7,male,1449,680,210,69,65,69,65,0,0
1369206,104,1,1909,11,female,1057,650,140,69,83,69,70,0,13
1960771,18,2,1995,10,male,142,712,592,69,116,69,102,0,14
1089178,93,30,1920,12,male,730,702,291,74,63,40,30,34,33
1669497,18,7,1995,7,male,578,677,332,74,125,15,55,59,70
1155745,100,10,1913,6,female,1197,675,159,73,83,73,70,0,13
1244976,20,12,1993,2,female,354,699,140,74,241,74,99,0,142
1328619,26,27,1987,8,female,1054,676,395,74,179,74,136,0,43
1589929,101,29,1912,2,male,995,685,571,77,10,0,4,77,6
1369192,108,31,1905,12,male,933,688,440,77,111,0,21,77,90
1282326,45,11,1968,2,female,407,648,435,75,167,25,78,50,89
1688126,26,10,1987,4,male,385,684,537,77,85,77,79,0,6
1248305,18,3,1995,12,female,508,651,93,75,284,75,277,0,7
1635370,14,11,1999,12,male,301,714,486,80,6,0,1,80,5
1888996,108,1,1905,1,male,1839,711,486,78,24,33,12,45,12
1147593,16,7,1997,11,female,197,643,385,80,12,78,11,2,1
1388844,19,10,1994,9,female,590,704,168,79,217,74,63,5,154
1177683,30,13,1983,3,male,824,711,135,80,3,80,2,0,1
1519260,24,5,1989,4,female,1856,651,438,79,47,79,25,0,22
1846816,23,21,1990,4,female,599,681,292,79,482,79,331,0,151
1470539,23,30,1990,7,female,1337,720,240,79,134,79,86,0,48
1694257,103,20,1910,12,male,705,711,646,81,24,65,19,16,5
1981661,16,8,1997,11,female,23,677,38,82,188,80,152,2,36
1236444,20,20,1993,12,male,884,694,401,82,186,65,141,17,45
2129294,93,30,1920,4,male,1635,707,507,85,101,1,74,84,27
1256622,108,5,1905,6,male,378,649,579,87,34,44,25,43,9
1587770,20,14,1993,6,female,118,669,37,87,365,87,325,0,40
1256061,50,15,1963,6,female,910,665,525,91,4,0,0,91,4
1500285,29,16,1984,6,male,631,721,684,90,16,0,14,90,2
1365937,21,13,1992,5,female,1309,673,210,90,366,5,188,85,178
1992057,16,8,1997,12,female,324,701,470,91,5,29,2,62,3
1805193,20,8,1993,12,female,1810,691,503,89,220,73,114,16,106
1523708,46,5,1967,10,male,663,666,414,88,248,82,207,6,41
1701563,23,15,1990,3,male,561,721,582,89,117,89,91,0,26
1014141,23,1,1990,6,male,476,684,540,88,216,88,155,0,61
1962183,26,2,1987,10,female,711,695,283,90,154,90,145,0,9
1755428,27,9,1986,8,male,600,653,553,91,578,91,471,0,107
1558716,18,18,1995,2,male,405,640,467,92,86,4,43,88,43
1045870,101,30,1912,3,male,2427,716,332,93,7,76,3,17,4
1184476,63,26,1950,5,female,1135,676,474,94,45,83,29,11,16
1869830,27,22,1986,6,female,259,649,209,92,109,91,60,1,49
1435785,28,16,1985,6,male,1395,653,517,95,106,91,87,4,19
1119618,18,9,1995,5,female,462,701,71,95,560,93,370,2,190
2155183,16,18,1997,6,female,246,699,387,92,54,92,40,0,14
1049647,20,21,1993,5,female,835,640,334,94,16,94,14,0,2
1281696,16,14,1997,10,male,487,686,615,93,71,93,70,0,1
1909133,21,22,1992,2,male,460,718,619,95,133,95,127,0,6
1904672,16,9,1997,12,female,773,688,615,97,108,10,30,87,78
1990663,102,26,1911,5,male,2361,709,236,96,25,56,15,40,10
1107172,22,16,1991,8,female,737,655,335,96,249,96,197,0,52
1620463,23,20,1990,3,female,284,648,202,102,719,13,292,89,427
2011997,23,9,1990,9,male,289,654,618,101,29,70,23,31,6
1771206,14,15,1999,11,male,211,686,420,103,464,38,72,65,392
2086749,35,12,1978,4,female,551,706,533,104,233,73,179,31,54
1459181,17,15,1996,4,female,523,677,494,100,18,100,11,0,7
1744612,104,2,1909,1,male,1757,678,189,101,32,101,17,0,15
1051861,29,16,1984,8,female,831,680,444,101,109,101,42,0,67
2153431,31,12,1982,6,female,597,671,171,102,379,102,337,0,42
2093454,108,12,1905,8,male,1227,715,455,105,56,48,31,57,25
1708726,17,28,1996,11,male,578,671,408,106,527,52,286,54,241
1048132,23,10,1990,11,male,801,642,501,107,50,105,44,2,6
1761801,19,23,1994,7,female,481,684,460,106,101,95,41,11,60
1643925,14,10,1999,5,female,321,659,325,106,167,80,85,26,82
1897479,19,23,1994,12,female,578,688,237,105,257,102,182,3,75
1619669,32,9,1981,6,male,571,680,408,108,208,96,102,12,106
1484917,75,10,1938,3,female,2214,674,96,106,52,106,41,0,11
1594058,94,3,1919,2,male,950,709,323,109,73,109,58,0,15
1556914,103,23,1910,5,male,400,669,548,107,66,107,36,0,30
1797193,21,21,1992,11,male,438,646,278,109,215,109,73,0,142
1656621,20,12,1993,4,male,170,641,544,105,229,105,187,0,42
1611536,84,30,1929,9,male,1116,659,355,112,57,0,7,112,50
1501136,23,30,1990,7,male,1380,641,458,113,118,74,91,39,27
2092807,25,13,1988,9,female,913,696,136,111,401,82,350,29,51
1422810,35,16,1978,4,female,1864,666,487,110,306,108,79,2,227
1864521,108,31,1905,12,male,258,700,605,111,42,111,33,0,9
1342921,23,10,1990,8,male,1056,715,436,113,97,113,78,0,19
1096726,82,1,1931,5,male,1352,691,295,112,596,112,488,0,108
2029733,14,18,1999,8,male,176,690,640,115,32,18,10,97,22
1840742,16,14,1997,1,male,609,701,444,119,67,42,25,77,42
1929816,15,8,1998,4,female,211,671,528,118,104,75,77,43,27
1280480,18,13,1995,4,male,564,683,459,114,215,64,80,50,135
1342809,19,13,1994,6,male,239,670,468,115,538,55,195,60,343
1602844,24,4,1989,1,male,894,649,605,118,16,118,15,0,1
1996305,17,26,1996,1,male,215,680,608,116,604,116,275,0,329
1181047,18,10,1995,8,female,309,671,263,114,476,114,448,0,28
1417969,108,10,1905,6,female,1458,691,361,121,117,0,75,121,42
1501164,103,23,1910,11,male,975,713,466,123,147,89,123,34,24
1264782,19,12,1994,10,male,667,682,395,121,256,121,173,0,83
1646802,97,24,1916,12,female,363,640,566,129,138,0,37,129,101
2176665,27,12,1986,2,male,721,676,354,126,415,12,168,114,247
2172777,19,4,1994,4,male,530,660,557,126,165,126,151,0,14
1104426,23,13,1990,1,male,435,662,555,130,97,130,87,0,10
1212524,24,14,1989,4,female,1465,644,340,127,130,127,67,0,63
1213415,20,3,1993,2,female,639,688,323,130,474,130,275,0,199
1866371,37,6,1976,11,female,473,702,608,126,1246,126,768,0,478
1839028,18,6,1995,7,female,52,668,68,132,442,74,377,58,65
1925495,23,30,1990,6,male,1890,696,430,132,85,118,61,14,24
1274776,15,15,1998,8,female,19,641,128,134,44,134,42,0,2
1034947,17,15,1996,7,female,454,656,461,132,185,132,91,0,94
2157945,63,1,1950,7,male,312,706,321,141,49,0,14,141,35
1847553,15,1,1998,1,male,22,670,611,137,98,9,47,128,51
2098578,20,16,1993,3,female,621,692,441,143,173,27,77,116,96
1416740,15,21,1998,4,female,448,653,402,141,295,8,47,133,248
1331695,17,26,1996,1,female,1160,712,554,140,120,73,86,67,34
1054083,20,2,1993,2,female,633,674,324,138,260,61,92,77,168
1389266,107,6,1906,8,female,1829,720,264,139,73,104,34,35,39
1687710,19,19,1994,3,female,1571,713,164,140,458,119,164,21,294
1871114,40,26,1973,2,female,1617,660,371,139,609,110,533,29,76
1949971,80,12,1933,8,male,1294,658,291,142,30,142,30,0,0
2100809,105,10,1908,5,male,234,691,601,137,71,137,49,0,22
1838370,68,17,1945,8,male,643,658,504,137,100,137,82,0,18
1588033,70,29,1943,3,male,1368,680,454,139,201,139,175,0,26
1986438,19,25,1994,7,female,574,714,462,140,242,140,188,0,54
1812443,113,10,1900,10,male,1418,655,172,148,542,43,337,105,205
1354818,25,12,1988,9,male,577,677,486,146,158,136,107,10,51
1609208,50,17,1963,7,female,1880,682,490,149,91,146,64,3,27
1981113,39,27,1974,3,female,611,657,477,148,423,126,139,22,284
1085842,16,19,1997,9,male,428,710,535,150,3,150,3,0,0
1586142,21,3,1992,6,male,747,649,491,144,20,144,14,0,6
1567006,26,10,1987,1,male,462,681,223,149,84,149,79,0,5
1443623,108,12,1905,9,male,1507,693,355,155,75,3,20,152,55
2093536,57,19,1956,3,female,108,669,501,154,262,0,49,154,213
1934663,19,24,1994,8,female,813,713,350,152,95,102,55,50,40
1922364,27,18,1986,1,female,986,640,366,155,213,71,78,84,135
2044180,22,21,1991,7,male,254,707,545,157,345,100,264,57,81
1341205,18,21,1995,1,male,629,644,527,155,63,133,44,22,19
1864775,16,16,1997,11,female,653,695,518,152,151,125,144,27,7
2001158,23,9,1990,6,female,721,692,353,151,173,145,63,6,110
1951532,94,5,1919,2,female,1532,684,431,157,134,153,110,4,24
1359951,43,27,1970,7,female,1904,675,198,154,296,153,166,1,130
1632074,13,4,2000,2,male,285,688,428,153,56,153,50,0,6
1743245,108,1,1905,1,male,1054,718,528,152,77,152,42,0,35
1757551,105,23,1908,8,female,2237,685,388,162,21,0,12,162,9
1697163,19,18,1994,3,male,141,656,597,159,57,0,33,159,24
2128357,18,17,1995,1,female,1397,673,287,162,370,145,121,17,249
1827504,17,17,1996,4,female,607,705,385,158,189,158,121,0,68
1053851,20,10,1993,10,female,610,694,243,163,317,163,247,0,70
2094663,103,11,1910,9,male,1373,704,372,165,349,5,69,160,280
1971699,22,3,1991,3,female,39,656,298,166,377,79,167,87,210
1360449,35,10,1978,11,female,548,673,157,166,527,98,191,68,336
1356926,100,10,1913,4,female,2488,662,345,165,615,84,428,81,187
1300669,20,19,1993,10,female,244,686,202,171,848,155,589,16,259
1951732,69,11,1944,1,female,922,666,106,165,69,165,62,0,7
1258431,22,13,1991,4,male,933,651,162,170,205,170,151,0,54
1138765,15,29,1998,4,female,831,683,157,180,133,40,23,140,110
1510553,16,5,1997,7,female,135,672,568,178,22,169,20,9,2
1978771,103,6,1910,10,male,905,671,237,174,124,172,103,2,21
1467401,21,5,1992,3,male,545,646,550,176,117,175,100,1,17
2147727,23,2,1990,8,male,244,661,617,176,82,176,67,0,15
1696449,23,25,1990,10,male,1091,687,531,176,88,176,71,0,17
1095765,15,10,1998,2,female,103,696,298,174,276,174,188,0,88
1462969,89,31,1924,5,male,1379,669,367,178,978,178,563,0,415
1985427,16,2,1997,7,male,500,662,565,185,110,96,31,89,79
1431770,15,27,1998,1,male,730,684,544,187,214,78,126,109,88
1063197,19,9,1994,7,male,507,652,403,186,133,143,74,43,59
1442189,108,20,1905,1,female,1742,699,539,184,164,158,86,26,78
1363860,23,20,1990,6,female,206,700,321,187,383,137,259,50,124
2018233,24,9,1989,2,male,601,708,536,186,584,186,500,0,84
1708229,34,9,1979,7,female,1043,645,202,186,534,186,513,0,21
1593558,101,30,1912,3,male,1441,703,416,197,25,1,11,196,14
1345843,25,10,1988,4,male,594,641,513,191,93,87,48,104,45
1544409,108,28,1905,10,male,1180,700,416,198,84,98,76,100,8
1827677,23,3,1990,7,female,1421,643,243,200,156,169,64,31,92
1512991,18,2,1995,2,male,96,670,541,199,354,188,309,11,45
1326696,22,20,1991,4,male,719,652,610,196,43,196,29,0,14
1612855,15,26,1998,6,female,380,674,199,194,199,194,52,0,147
1831177,25,6,1988,4,male,372,694,282,191,292,191,230,0,62
1772812,103,25,1910,12,male,586,709,544,206,43,0,33,206,10
1633101,18,15,1995,6,male,614,644,478,210,195,132,110,78,85
1263044,108,28,1905,3,male,1448,655,319,201,368,100,280,101,88
2110374,17,13,1996,6,female,560,665,391,202,299,200,183,2,116
1718322,18,6,1995,8,female,792,659,259,210,29,210,17,0,12
1897092,27,3,1986,4,female,536,669,441,203,83,203,37,0,46
1193381,22,28,1991,10,male,291,665,535,205,138,205,122,0,16
2090087,88,25,1925,8,male,674,668,565,204,179,204,129,0,50
1784264,14,16,1999,8,female,100,655,301,203,603,203,445,0,158
1255794,18,11,1995,10,female,439,641,171,217,103,100,46,117,57
1030696,22,22,1991,5,female,524,719,524,219,816,49,439,170,377
2123753,29,20,1984,10,male,38,684,544,212,1008,139,777,73,231
1236147,18,20,1995,2,female,1469,684,340,214,348,210,278,4,70
2034253,19,16,1994,10,female,195,688,165,221,403,175,250,46,153
1386722,83,28,1930,11,male,1028,718,507,212,142,211,93,1,49
1641981,17,21,1996,2,female,612,653,264,220,647,220,424,0,223
1888740,14,31,1999,8,female,268,662,315,222,47,48,20,174,27
1734935,22,20,1991,2,female,557,663,515,229,326,102,124,127,202
1485687,16,14,1997,5,male,758,714,249,222,938,52,463,170,475
1261772,17,5,1996,5,male,1006,654,403,229,1224,160,786,69,438
2108567,83,19,1930,1,female,1518,693,352,224,399,141,130,83,269
1290457,18,16,1995,1,female,532,661,340,231,111,226,78,5,33
1154280,24,17,1989,3,female,596,656,502,224,197,187,86,37,111
1972589,110,15,1903,12,female,2192,718,336,227,310,203,253,24,57
1237095,15,15,1998,1,female,743,687,518,222,61,221,50,1,11
2145760,43,12,1970,2,male,411,666,414,230,531,229,164,1,367
1862669,53,20,1960,3,female,895,651,96,226,2391,225,1798,1,593
2075076,23,2,1990,6,male,549,656,473,227,132,227,116,0,16
2063953,19,12,1994,9,female,344,690,208,238,176,17,110,221,66
1089973,24,17,1989,3,male,386,654,585,241,227,0,44,241,183
1351300,15,7,1998,8,male,237,701,579,243,219,132,131,111,88
1986209,108,1,1905,4,male,1698,653,350,235,203,102,110,133,93
1375870,16,2,1997,3,female,427,682,210,238,561,65,245,173,316
1062138,46,22,1967,10,female,536,672,245,235,288,178,186,57,102
1076560,23,3,1990,6,male,1992,699,379,236,392,171,262,65,130
2021341,16,17,1997,5,female,407,654,528,241,285,241,243,0,42
1744811,21,18,1992,12,male,184,696,650,247,63,0,13,247,50
2136867,72,14,1941,11,female,831,708,565,250,76,21,51,229,25
2162452,53,27,1960,1,female,637,647,119,248,173,23,118,225,55
1092289,45,1,1968,2,female,107,665,8,250,579,36,228,214,351
1250794,19,26,1994,6,male,641,664,350,247,443,82,135,165,308
2109182,19,4,1994,8,female,162,711,449,249,387,171,129,78,258
1069426,24,15,1989,2,male,679,716,285,252,62,252,50,0,12
1504013,24,30,1989,7,female,541,655,371,257,137,257,68,0,69
1116106,68,1,1945,2,male,1327,707,408,247,63,247,58,0,5
1102651,18,5,1995,8,male,333,644,539,249,249,249,158,0,91
1504734,68,3,1945,8,male,573,659,434,258,189,258,179,0,10
1076736,16,19,1997,9,female,236,714,445,274,7,184,5,90,2
1448088,15,5,1998,2,male,512,689,630,264,103,217,84,47,19
2150961,23,10,1990,10,female,235,648,93,272,85,259,50,13,35
1023145,19,30,1994,4,male,486,697,523,263,139,263,99,0,40
2013164,29,13,1984,4,female,661,710,301,266,368,266,347,0,21
1443330,27,2,1986,8,female,1199,714,475,264,1009,264,903,0,106
2046278,22,6,1991,3,male,388,706,526,277,190,7,139,270,51
1139498,14,18,1999,2,female,224,692,542,290,289,193,204,97,85
1285437,20,25,1993,2,male,627,676,459,277,83,271,74,6,9
1621226,19,4,1994,7,female,349,648,139,278,268,273,267,5,1
1978608,16,7,1997,1,male,745,715,405,278,90,278,50,0,40
2101088,30,13,1983,7,male,628,690,429,288,144,288,137,0,7
2053306,21,17,1992,9,male,518,649,317,287,250,287,212,0,38
1295718,19,17,1994,6,female,242,694,213,278,469,278,371,0,98
1284551,48,28,1965,11,male,1191,711,535,291,675,291,584,0,91
1375724,15,21,1998,2,male,557,640,387,304,34,3,5,301,29
1943237,99,22,1914,11,male,2416,708,208,296,317,17,152,279,165
1998757,18,7,1995,4,female,333,692,339,294,400,197,237,97,163
1820724,20,28,1993,11,male,752,696,191,305,398,163,146,142,252
1265126,24,27,1989,7,male,1068,671,293,294,328,154,149,140,179
1924016,60,25,1953,10,female,578,702,441,298,242,155,145,143,97
1880610,18,28,1995,4,male,573,720,464,298,207,276,180,22,27
1435422,16,6,1997,3,female,197,663,353,302,878,288,378,14,500
1749501,24,13,1989,12,male,892,704,556,302,555,238,512,64,43
1776062,18,4,1995,5,male,221,661,629,306,124,306,77,0,47
1584208,27,4,1986,8,male,274,651,548,306,296,306,208,0,88
1075098,16,24,1997,8,female,790,680,429,324,395,11,148,313,247
1503665,19,27,1994,10,female,414,673,479,321,196,58,53,263,143
1330225,25,16,1988,11,male,842,675,492,314,249,153,112,161,137
1321450,36,4,1977,7,female,390,661,425,309,559,129,410,180,149
1833955,18,7,1995,1,female,1547,663,313,321,228,288,91,33,137
1492569,18,9,1995,8,female,263,671,168,325,602,270,301,55,301
1475527,31,10,1982,6,female,235,693,12,327,1407,284,432,43,975
1676906,45,28,1968,5,female,1174,703,287,312,667,292,500,20,167
1315235,16,14,1997,9,male,492,662,546,309,22,309,15,0,7
1118596,14,24,1999,5,female,425,710,200,316,86,316,64,0,22
1932934,80,3,1933,4,male,1615,706,205,315,290,315,184,0,106
2048149,18,19,1995,11,male,648,680,506,338,11,0,4,338,7
1294174,108,28,1905,7,NA,2238,689,487,330,41,17,10,313,31
1378853,17,15,1996,3,male,639,695,508,344,378,38,222,306,156
1371381,18,3,1995,3,female,433,701,230,332,475,296,419,36,56
1280992,25,2,1988,11,female,539,678,477,334,253,248,122,86,131
1217083,19,28,1994,7,female,531,640,80,335,869,328,620,7,249
1547457,16,5,1997,6,male,65,660,631,346,24,346,21,0,3
1115293,17,22,1996,4,male,230,699,587,344,127,344,78,0,49
1802954,52,23,1961,6,female,347,650,501,335,176,335,166,0,10
1028211,107,4,1906,4,male,812,697,485,335,145,335,139,0,6
2191391,19,25,1994,3,male,475,716,486,331,312,331,279,0,33
1901929,20,19,1993,10,female,470,650,309,347,187,56,147,291,40
2170810,108,24,1905,1,male,813,659,395,359,158,12,45,347,113
1477937,15,23,1998,10,female,192,640,472,355,487,62,293,293,194
2164001,100,3,1913,6,male,271,690,597,366,414,62,183,304,231
1968677,15,6,1998,7,female,164,692,417,352,462,128,254,224,208
2030973,17,21,1996,12,female,673,697,459,347,479,283,110,64,369
1167082,18,20,1995,3,male,596,657,288,347,315,255,182,92,133
1993267,19,18,1994,10,female,463,695,366,366,362,284,175,82,187
1076507,16,16,1997,5,female,472,658,403,352,602,333,463,19,139
1934714,16,21,1997,2,female,597,667,527,365,374,362,99,3,275
1950783,23,18,1990,4,male,641,718,448,360,155,360,139,0,16
1669121,18,8,1995,3,male,583,675,493,368,423,368,390,0,33
1862103,104,2,1909,2,female,179,642,552,360,289,360,234,0,55
1742777,16,10,1997,4,male,658,645,244,379,95,0,36,379,59
1993159,15,12,1998,3,female,476,678,425,385,344,49,109,336,235
1221253,70,14,1943,7,male,1128,720,63,380,2172,0,285,380,1887
1984301,18,16,1995,10,female,536,647,379,378,143,267,80,111,63
2046187,18,3,1995,4,female,637,716,351,394,493,266,145,128,348
1328197,14,7,1999,5,female,54,671,247,383,724,104,420,279,304
1911770,15,10,1998,2,male,509,652,256,388,863,193,646,195,217
1291853,19,3,1994,5,female,450,697,253,373,625,98,392,275,233
1805277,23,4,1990,11,male,1706,660,276,370,919,266,564,104,355
1574114,16,22,1997,4,male,433,692,289,378,145,302,73,76,72
1512327,19,15,1994,8,male,611,648,511,381,237,309,219,72,18
1298134,16,17,1997,9,female,442,708,425,370,677,364,513,6,164
2168484,19,6,1994,11,female,602,686,258,377,1407,331,624,46,783
1103869,16,21,1997,9,male,611,654,617,370,17,370,14,0,3
1474177,18,25,1995,12,male,940,713,518,388,551,388,511,0,40
1628242,19,20,1994,12,male,871,640,329,406,229,242,119,164,110
1608015,24,1,1989,12,female,1073,676,497,412,407,166,265,246,142
2137369,108,4,1905,10,female,3129,720,282,421,439,176,296,245,143
2051697,30,20,1983,4,male,1115,640,342,410,728,278,293,132,435
1505342,68,21,1945,6,male,242,667,469,408,345,391,207,17,138
1032261,18,8,1995,1,female,308,661,327,417,655,410,506,7,149
1698158,22,26,1991,5,female,414,700,165,411,617,395,526,16,91
1380701,40,17,1973,2,female,812,706,316,397,1100,389,507,8,593
1023385,66,2,1947,8,male,896,692,514,402,976,355,883,47,93
1634094,104,13,1909,7,female,1420,662,283,417,1749,405,1234,12,515
1514498,22,12,1991,5,male,697,707,624,418,89,418,59,0,30
2087812,22,16,1991,5,male,158,646,591,421,468,421,394,0,74
2121194,29,29,1984,2,female,776,660,409,405,365,405,179,0,186
1106707,16,13,1997,12,female,1019,715,530,425,152,0,73,425,79
1773073,14,11,1999,3,female,505,697,208,445,777,82,554,363,223
1291487,17,17,1996,10,female,260,663,385,438,326,232,78,206,248
1141603,30,12,1983,11,female,208,698,191,438,400,168,84,270,316
1247887,16,30,1997,4,female,404,681,383,439,1471,308,943,131,528
1846052,16,29,1997,11,female,300,694,305,438,569,374,284,64,285
2134339,16,1,1997,7,male,482,661,507,429,431,357,235,72,196
1225014,18,7,1995,3,female,900,720,197,427,301,324,93,103,208
1444943,64,5,1949,12,female,1605,672,342,435,325,321,166,114,159
2111555,19,7,1994,9,male,428,663,499,427,1208,417,839,10,369
1078334,32,25,1981,5,male,605,671,554,449,35,448,24,1,11
2184248,15,12,1998,9,female,625,650,450,432,225,432,81,0,144
1516259,16,9,1997,7,female,560,684,402,422,174,422,127,0,47
1974869,27,24,1986,5,female,674,717,512,444,267,444,90,0,177
1462221,16,3,1997,3,female,169,655,261,432,458,432,182,0,276
2142758,34,1,1979,2,male,654,703,494,438,354,438,191,0,163
2087409,66,12,1947,12,female,1870,702,416,423,288,423,209,0,79
1521795,100,16,1913,4,male,733,645,471,426,311,426,218,0,93
2046382,19,15,1994,5,female,664,688,355,446,1562,446,1510,0,52
1974879,17,5,1996,3,female,449,671,177,476,504,49,118,427,386
1722706,50,26,1963,1,male,1326,683,497,475,331,15,177,460,154
1908004,23,4,1990,10,male,270,640,391,455,275,291,69,164,206
1568087,15,6,1998,10,male,404,678,514,479,502,119,278,360,224
1728805,16,18,1997,1,female,733,712,340,466,383,215,186,251,197
1171529,28,23,1985,12,female,179,705,606,454,427,272,258,182,169
1827703,27,23,1986,4,female,403,669,596,475,701,234,556,241,145
1521558,31,28,1982,2,female,1720,645,368,481,853,177,683,304,170
1167512,17,15,1996,6,male,722,682,394,474,149,456,98,18,51
1477547,29,13,1984,9,female,1346,681,621,465,511,374,378,91,133
1459476,52,7,1961,8,male,340,692,340,469,725,413,350,56,375
2027196,16,18,1997,10,male,249,698,611,463,40,463,37,0,3
1103340,21,11,1992,7,female,315,648,58,475,179,475,129,0,50
1839146,24,22,1989,5,male,647,709,395,482,572,482,527,0,45
1997954,28,13,1985,3,female,286,669,403,482,1195,482,1074,0,121
2108016,50,27,1963,6,female,998,679,508,513,717,16,258,497,459
1938873,104,10,1909,7,female,1667,672,207,503,408,78,128,425,280
2177713,18,26,1995,7,female,543,649,281,509,1452,90,986,419,466
2026133,54,14,1959,7,female,696,660,342,518,1099,0,226,518,873
1920598,14,9,1999,7,male,286,656,513,497,25,196,16,301,9
1053684,26,23,1987,10,male,217,697,425,512,210,144,77,368,133
1463119,14,20,1999,4,female,710,704,405,514,512,370,236,144,276
1719302,21,19,1992,2,male,622,685,551,492,783,309,464,183,319
1521754,18,20,1995,7,female,609,701,509,492,534,438,288,54,246
1050127,22,10,1991,8,female,530,651,288,490,311,457,262,33,49
1189018,36,12,1977,12,female,1242,694,276,497,584,413,239,84,345
1277120,19,20,1994,1,male,477,689,324,489,1092,486,1030,3,62
1954263,16,6,1997,1,male,206,644,368,540,1269,45,1014,495,255
1739616,25,27,1988,5,male,18,689,624,549,1677,78,392,471,1285
1408739,25,6,1988,3,female,1453,642,231,543,766,253,253,290,513
1919832,18,2,1995,8,male,410,690,567,541,284,523,131,18,153
1951128,24,3,1989,9,female,638,641,404,557,129,483,106,74,23
1249708,19,12,1994,11,female,533,688,366,556,678,501,548,55,130
2180393,57,30,1956,9,male,273,653,368,552,430,536,211,16,219
1411402,73,5,1940,12,male,184,657,503,545,358,545,245,0,113
1962226,25,26,1988,2,male,93,674,565,534,1252,534,1138,0,114
1243542,14,9,1999,4,female,271,713,300,567,981,51,287,516,694
1700616,20,11,1993,5,male,1106,706,480,607,129,376,79,231,50
2123544,18,1,1995,1,male,860,689,440,585,385,237,201,348,184
1216419,108,14,1905,9,male,2160,656,167,606,402,317,66,289,336
2072165,21,4,1992,10,male,405,668,421,593,1642,267,1070,326,572
1716822,16,26,1997,12,female,915,657,413,592,131,478,39,114,92
1318327,18,9,1995,8,female,486,661,527,581,286,524,256,57,30
1540270,46,30,1967,4,female,165,715,345,606,277,458,155,148,122
1755134,15,19,1998,11,female,827,675,440,591,536,450,191,141,345
2162451,16,16,1997,4,male,285,705,289,590,397,556,88,34,309
1094415,24,24,1989,8,male,602,644,551,564,627,563,498,1,129
1844361,30,15,1983,4,female,1643,713,355,609,587,606,450,3,137
1388358,25,21,1988,9,female,552,711,581,572,319,572,199,0,120
1876243,31,7,1982,3,male,725,652,446,583,859,583,801,0,58
1739930,35,5,1978,1,female,860,704,64,582,461,582,445,0,16
1676804,73,1,1940,11,female,2283,717,170,645,301,85,103,560,198
2147619,60,9,1953,1,female,555,656,316,623,937,49,209,574,728
1892465,48,21,1965,3,female,1739,659,480,613,99,412,76,201,23
1954328,48,12,1965,7,female,499,645,514,616,153,409,44,207,109
1301922,27,28,1986,7,female,1860,703,473,642,771,250,414,392,357
2096743,24,13,1989,1,male,196,683,659,614,195,484,134,130,61
1027111,21,16,1992,8,male,231,640,532,642,614,607,385,35,229
1576875,27,14,1986,9,female,586,692,534,613,762,603,602,10,160
1017036,38,1,1975,12,male,356,683,499,640,455,469,298,171,157
1091115,47,9,1966,9,female,280,709,623,656,191,656,156,0,35
1337842,20,27,1993,5,male,407,694,632,692,368,0,116,692,252
1466312,113,30,1900,9,female,1562,705,366,664,189,132,170,532,19
2062291,20,6,1993,5,female,258,703,490,710,629,13,401,697,228
2093774,19,2,1994,5,female,885,692,238,719,115,507,58,212,57
1712424,18,19,1995,7,female,467,647,499,683,129,294,92,389,37
1320354,22,22,1991,7,male,419,710,656,685,133,403,74,282,59
1844903,16,7,1997,7,male,627,659,448,723,638,417,297,306,341
1788221,17,9,1996,8,male,583,698,410,674,537,337,262,337,275
1900872,23,27,1990,12,female,482,720,439,670,517,220,162,450,355
1814458,24,5,1989,1,female,584,659,521,666,535,287,240,379,295
1894211,25,21,1988,2,female,695,710,587,718,598,416,409,302,189
1847803,20,2,1993,6,female,211,662,212,714,3133,394,1011,320,2122
1458527,20,6,1993,5,female,508,675,534,665,123,653,114,12,9
1500797,19,8,1994,12,female,225,691,500,705,974,605,809,100,165
1178752,25,23,1988,11,male,540,708,623,676,956,615,311,61,645
1173230,30,27,1983,9,female,775,649,362,687,557,676,422,11,135
1662111,19,12,1994,9,female,193,650,352,715,1678,642,1008,73,670
1104289,61,22,1952,3,female,1776,715,392,673,1056,626,686,47,370
1000382,16,23,1997,1,male,465,703,310,665,888,665,672,0,216
2179339,17,10,1996,4,female,262,703,213,714,528,714,328,0,200
1916970,19,18,1994,5,male,409,717,510,714,729,714,573,0,156
1822917,68,1,1945,10,male,788,658,484,727,831,0,293,727,538
1580701,98,7,1915,1,male,1169,718,371,791,1171,0,216,791,955
1585746,19,17,1994,8,male,598,665,358,745,351,506,248,239,103
1756647,103,15,1910,2,male,1490,683,501,729,258,358,240,371,18
1926997,23,30,1990,9,female,700,678,425,765,1040,216,679,549,361
2037147,18,5,1995,9,female,800,716,455,796,1328,193,576,603,752
2005494,18,21,1995,1,female,411,703,276,770,564,583,220,187,344
1212208,19,23,1994,1,female,379,667,453,755,667,707,609,48,58
1658702,19,7,1994,8,male,299,664,292,793,686,776,471,17,215
1579356,15,28,1998,1,female,222,643,233,791,2500,717,1424,74,1076
1327782,55,3,1958,7,female,1338,690,264,793,2644,585,1867,208,777
2046806,15,22,1998,6,female,468,720,350,758,797,752,526,6,271
1411272,24,5,1989,6,female,365,652,225,758,736,752,293,6,443
1839404,15,25,1998,8,female,345,702,91,740,365,740,239,0,126
1373319,16,21,1997,12,male,251,642,248,794,669,794,500,0,169
1467431,18,25,1995,11,female,99,691,292,742,490,742,469,0,21
1823289,25,24,1988,1,female,494,716,165,778,534,778,401,0,133
1872582,55,14,1958,10,female,1669,693,426,779,778,779,531,0,247
1972927,15,24,1998,7,female,503,670,429,871,218,0,112,871,106
1382241,38,8,1975,9,female,1327,656,473,816,436,239,253,577,183
2080720,14,27,1999,7,female,172,681,404,870,754,478,464,392,290
1872507,15,26,1998,1,female,92,694,269,857,1170,287,181,570,989
1133539,21,23,1992,4,female,407,712,358,811,787,245,173,566,614
1658460,46,23,1967,6,female,1406,642,235,825,534,465,322,360,212
1124373,23,26,1990,2,female,1091,648,240,878,1591,303,912,575,679
1272813,16,27,1997,12,male,385,674,407,835,800,624,556,211,244
1359096,23,9,1990,12,female,280,675,622,857,589,743,374,114,215
1985586,19,6,1994,1,female,107,676,541,821,1854,696,1304,125,550
1834641,15,10,1998,1,female,531,700,407,806,771,804,476,2,295
1146791,16,2,1997,2,female,82,685,563,870,155,870,117,0,38
1455527,16,28,1997,3,female,358,653,351,841,407,841,360,0,47
1592881,32,23,1981,6,male,412,671,611,823,310,823,232,0,78
1716877,20,25,1993,4,female,327,708,201,844,1629,844,1575,0,54
1044825,23,27,1990,2,male,76,704,676,871,1628,871,1326,0,302
2009918,19,13,1994,5,male,337,659,586,954,418,121,266,833,152
2166003,19,19,1994,8,female,987,670,271,937,1123,528,697,409,426
2114608,20,16,1993,6,female,684,676,381,891,794,613,470,278,324
1363324,49,25,1964,2,female,986,668,387,881,763,298,107,583,656
1849425,26,12,1987,8,female,1733,657,301,891,1529,368,888,523,641
1027350,18,1,1995,2,male,796,644,236,884,451,864,344,20,107
1190719,23,17,1990,10,male,222,692,424,884,533,653,217,231,316
1753790,14,30,1999,11,female,502,654,301,962,1025,712,415,250,610
2045855,13,19,2000,1,female,278,651,471,937,1131,857,625,80,506
2156427,18,3,1995,12,female,190,640,160,880,1977,657,1087,223,890
1877776,15,10,1998,6,female,516,642,258,922,1015,914,553,8,462
1820850,16,14,1997,8,female,307,652,277,897,713,895,159,2,554
1536933,33,19,1980,5,female,1777,660,306,967,632,958,417,9,215
1958062,20,7,1993,4,male,178,707,536,931,225,931,188,0,37
1222273,16,4,1997,12,female,598,670,224,1063,513,144,197,919,316
1054483,30,10,1983,9,female,718,710,260,1084,324,0,150,1084,174
1007921,17,18,1996,10,female,467,683,270,1051,930,96,293,955,637
1876725,19,26,1994,3,female,484,695,391,1125,1311,97,469,1028,842
1482396,19,19,1994,3,female,330,672,350,1037,1339,168,301,869,1038
1357913,29,28,1984,5,female,517,654,457,1053,909,137,182,916,727
1787302,108,3,1905,11,male,1913,701,524,1042,152,608,59,434,93
1893571,15,15,1998,6,female,179,644,405,1033,611,457,249,576,362
1602478,26,10,1987,11,female,1082,686,470,1019,222,683,54,336,168
2094668,16,22,1997,1,female,866,647,449,1000,640,495,374,505,266
1438917,23,6,1990,12,female,1604,654,232,1089,1037,579,589,510,448
1162607,21,16,1992,2,female,375,643,391,1122,2046,493,967,629,1079
1941947,19,21,1994,3,male,720,665,491,1036,451,762,409,274,42
1910004,18,11,1995,11,male,888,701,346,1050,903,994,384,56,519
1852567,18,23,1995,2,female,59,714,593,1016,922,957,442,59,480
2103341,31,18,1982,9,male,838,719,342,1036,1043,972,922,64,121
1156122,18,18,1995,8,female,137,665,315,1054,2494,794,713,260,1781
2148259,40,21,1973,2,female,1926,670,317,1046,1572,907,1295,139,277
1959966,14,22,1999,2,male,210,694,369,1111,89,1109,74,2,15
1025804,108,25,1905,1,male,1164,651,368,1039,34,1039,29,0,5
2096383,18,12,1995,12,female,575,646,444,1014,660,1014,489,0,171
1259573,19,9,1994,7,female,1181,672,348,1045,1445,1045,1254,0,191
1085532,31,6,1982,2,female,608,711,68,1030,643,1030,399,0,244
1819529,68,22,1945,9,female,591,694,471,1128,705,1128,558,0,147
1684362,64,17,1949,4,male,660,712,359,1174,428,45,216,1129,212
1821608,18,5,1995,5,male,88,649,640,1162,1155,214,153,948,1002
1943540,23,26,1990,5,female,482,706,442,1273,1903,106,346,1167,1557
1686794,27,23,1986,9,male,1498,648,497,1187,1578,0,412,1187,1166
1974719,53,31,1960,8,female,2400,715,503,1193,1692,172,766,1021,926
1596407,16,28,1997,8,female,351,658,512,1185,509,279,218,906,291
1405400,103,12,1910,4,female,1934,706,348,1279,583,871,270,408,313
1905432,108,4,1905,5,male,2408,692,423,1195,556,332,358,863,198
1612868,20,5,1993,3,female,466,651,586,1161,773,254,594,907,179
1087995,63,27,1950,4,female,1164,674,337,1283,1241,293,267,990,974
1083338,17,26,1996,4,female,31,652,45,1138,2913,426,858,712,2055
1030228,20,27,1993,10,female,81,701,409,1189,2069,378,1257,811,812
2168439,16,16,1997,1,female,790,685,266,1162,263,1096,206,66,57
1720535,17,27,1996,1,female,369,718,509,1195,441,1000,191,195,250
1375789,19,10,1994,8,female,1246,660,428,1139,257,968,121,171,136
2029723,15,28,1998,2,female,164,718,424,1149,2024,1064,1052,85,972
1560123,29,28,1984,8,female,1849,716,269,1175,2336,849,1717,326,619
1743019,15,2,1998,6,male,529,643,390,1263,544,1262,335,1,209
1138789,50,4,1963,10,male,1332,700,246,1147,607,1147,418,0,189
1889579,50,31,1963,1,male,536,709,602,1215,1166,1215,820,0,346
1027240,20,1,1993,9,female,165,655,521,1133,3018,1133,2787,0,231
2067061,34,18,1979,5,female,1340,659,368,1524,793,625,502,899,291
1962794,20,7,1993,6,female,677,671,420,1296,1641,455,447,841,1194
1058107,20,20,1993,9,female,324,721,357,1422,2080,790,627,632,1453
1018074,22,19,1991,11,female,261,665,297,1423,1794,453,747,970,1047
1913205,23,12,1990,4,female,624,700,332,1480,2149,890,612,590,1537
1226989,34,2,1979,4,female,73,695,594,1338,948,354,700,984,248
1874651,15,25,1998,3,female,458,669,559,1474,204,1454,123,20,81
1590032,17,19,1996,1,female,218,702,595,1291,507,1051,312,240,195
1987932,20,18,1993,9,female,604,647,438,1289,781,1161,179,128,602
1802319,19,7,1994,6,male,515,657,472,1436,914,1290,574,146,340
1977478,45,4,1968,11,male,488,704,219,1357,3213,1056,1999,301,1214
2114364,16,13,1997,1,female,536,721,414,1434,984,1432,939,2,45
2080835,15,24,1998,3,male,435,676,403,1291,265,1291,225,0,40
1987060,18,26,1995,6,female,389,690,378,1394,1019,1394,992,0,27
2123959,32,11,1981,11,female,749,696,453,1578,893,0,333,1578,560
1499478,57,30,1956,9,female,552,720,283,1739,263,453,205,1286,58
1654590,22,1,1991,1,female,395,681,523,1816,835,1214,497,602,338
1177221,52,19,1961,5,female,1556,669,592,1641,588,601,506,1040,82
1707406,15,8,1998,2,female,339,681,288,1719,1145,513,437,1206,708
1068924,24,13,1989,7,female,118,644,526,1599,1635,524,748,1075,887
1654785,48,3,1965,1,female,300,699,599,1866,1425,448,964,1418,461
2140941,64,21,1949,10,female,2202,696,495,1803,1621,1226,950,577,671
1636859,108,16,1905,7,female,1464,693,311,1556,1738,449,987,1107,751
1619856,14,16,1999,4,female,494,651,400,1652,361,1566,244,86,117
2070802,15,6,1998,7,male,177,662,395,1814,390,1660,183,154,207
1399855,43,15,1970,5,female,751,674,448,1842,856,1397,438,445,418
1810953,17,6,1996,11,female,128,695,395,1723,2062,1638,1869,85,193
1227189,23,11,1990,4,female,1369,685,285,1728,2170,1363,1579,365,591
1416700,32,24,1981,10,female,592,692,400,1630,1003,1189,574,441,429
1022825,108,31,1905,8,male,448,646,324,1842,2119,1739,1297,103,822
1937572,16,26,1997,3,female,125,657,546,1561,710,1561,454,0,256
1216586,31,15,1982,7,female,298,658,554,1550,425,1550,387,0,38
1391040,18,26,1995,3,female,151,652,280,1552,1017,1552,805,0,212
1341665,44,22,1969,9,female,1309,690,298,1793,1699,1793,1334,0,365
1803607,23,12,1990,9,female,375,645,127,1669,2772,1669,2419,0,353
1276261,18,12,1995,4,male,873,701,376,2218,991,1361,808,857,183
1731629,55,27,1958,4,female,1606,707,198,2070,355,584,180,1486,175
1941353,77,13,1936,8,female,301,680,534,1997,715,938,447,1059,268
1082716,18,3,1995,11,female,592,715,260,2022,2495,1443,1411,579,1084
1344510,18,12,1995,11,female,14,652,312,2083,2104,693,1241,1390,863
1149531,41,18,1972,8,female,983,716,349,2089,2700,982,1491,1107,1209
1700565,18,19,1995,12,male,816,716,523,2236,3858,691,1685,1545,2173
1411114,40,8,1973,7,female,1718,645,356,2342,3530,1537,2852,805,678
2015705,43,5,1970,10,female,1656,662,486,2264,3400,1035,2168,1229,1232
2061684,14,14,1999,2,female,420,700,370,1937,626,1793,425,144,201
1427539,15,18,1998,6,female,779,720,441,2093,382,2002,224,91,158
1014918,17,27,1996,8,female,800,682,568,2130,1237,1855,522,275,715
1747864,18,31,1995,8,male,261,656,521,2054,477,1965,446,89,31
1817569,14,10,1999,12,female,277,673,178,2190,2334,1588,1062,602,1272
2066065,16,28,1997,9,female,614,672,342,2105,2892,1552,2056,553,836
1051038,22,28,1991,10,female,403,667,261,2344,2646,2255,1657,89,989
1144932,24,1,1989,3,male,151,719,496,2101,1787,1753,1035,348,752
1068552,25,5,1988,2,female,112,662,497,2194,1035,2192,879,2,156
1185177,20,24,1993,7,female,377,718,522,2081,2241,2080,2148,1,93
1404679,26,24,1987,6,male,1109,698,518,1919,996,1919,929,0,67
1622994,17,5,1996,3,female,565,715,488,2917,1497,160,562,2757,935
1717159,21,1,1992,8,male,550,661,457,3160,1404,935,617,2225,787
2113356,20,2,1993,7,female,504,682,552,3038,169,2921,61,117,108
1310318,17,5,1996,7,female,713,702,352,2721,593,2682,229,39,364
2080950,18,12,1995,2,female,237,693,343,2872,535,2754,339,118,196
1730880,23,13,1990,3,male,313,668,625,2691,647,2120,401,571,246
1236325,63,19,1950,7,female,1576,652,261,3338,581,2892,536,446,45
1565140,21,6,1992,8,female,1659,643,384,2870,2408,2220,2031,650,377
1850075,15,24,1998,11,female,291,650,193,3098,164,3081,144,17,20
1990397,21,16,1992,2,male,446,691,521,3067,348,3058,271,9,77
1370944,18,3,1995,9,female,437,652,356,3518,1631,3517,1051,1,580
1060338,22,18,1991,11,female,633,717,285,2594,761,2579,409,15,352
1237386,103,31,1910,1,female,999,710,491,2983,983,2983,690,0,293
1147777,22,4,1991,10,male,1295,708,286,5358,8712,31,3872,5327,4840
1829040,21,18,1992,2,female,331,686,510,5421,3135,3885,2196,1536,939
1916859,25,17,1988,1,female,62,685,498,4293,2816,1537,548,2756,2268
2000165,30,27,1983,1,female,700,642,373,4188,3671,2084,2384,2104,1287
1815162,47,9,1966,9,female,2084,665,485,4520,5218,2787,2191,1733,3027
1923063,59,29,1954,6,female,425,644,226,4981,9233,1442,4072,3539,5161
2043030,26,2,1987,10,male,278,650,310,8802,1332,8571,921,231,411
1173522,16,18,1997,12,female,735,695,525,8104,3276,7090,2200,1014,1076
1232906,15,30,1998,8,male,177,691,51,9804,3763,9321,1758,483,2005
2175941,18,25,1995,2,male,2,640,299,5640,2542,4251,1587,1389,955
1220122,30,5,1983,1,female,871,680,233,7654,2478,6654,1365,1000,1113
1917123,17,20,1996,4,male,633,697,413,3901,2721,3622,2082,279,639
1548566,41,17,1972,5,female,1583,642,521,3818,2570,3800,1538,18,1032
1699211,50,19,1963,4,female,1558,704,461,4314,429,4314,364,0,65
1799582,17,28,1996,8,female,586,660,56,10849,5122,10849,4692,0,430
1602106,18,14,1995,3,female,709,652,303,11510,1939,11510,1795,0,144
1790812,35,4,1978,12,female,183,682,76,5880,1375,5880,1340,0,35
1329599,36,16,1977,9,male,315,710,205,3741,1885,3741,1528,0,357
1486156,15,3,1998,3,male,502,724,608,0,0,0,0,0,0
1873698,17,27,1996,11,male,1129,748,541,0,6,0,4,0,2
1604338,16,29,1997,5,male,459,823,734,0,4,0,3,0,1
1408658,16,26,1997,10,male,610,739,575,0,3,0,2,0,1
1429291,17,16,1996,6,female,527,744,160,0,6,0,4,0,2
1273256,19,5,1994,11,male,499,792,349,0,4,0,3,0,1
2056109,18,13,1995,3,male,401,747,618,0,0,0,0,0,0
1215456,18,31,1995,3,female,326,733,33,0,0,0,0,0,0
1917872,18,19,1995,5,male,676,827,664,0,2,0,2,0,0
1767525,18,22,1995,5,male,451,729,681,0,2,0,0,0,2
1640804,18,4,1995,6,female,293,781,60,0,4,0,3,0,1
2094514,18,21,1995,8,male,809,759,515,0,45,0,28,0,17
2026527,18,16,1995,9,male,534,807,653,0,0,0,0,0,0
2075606,18,6,1995,9,male,393,775,736,0,10,0,7,0,3
1500651,19,30,1994,1,male,774,739,544,0,3,0,3,0,0
1680185,19,5,1994,4,female,521,765,483,0,342,0,297,0,45
1037789,19,22,1994,6,male,1358,768,526,0,2,0,2,0,0
1899111,19,3,1994,6,male,413,722,672,0,49,0,0,0,49
1523746,19,21,1994,7,female,389,796,560,0,11,0,8,0,3
1325233,19,18,1994,9,female,199,829,14,0,4,0,4,0,0
1725714,19,23,1994,10,female,642,818,276,0,0,0,0,0,0
1153342,20,8,1993,1,male,1012,826,456,0,4,0,3,0,1
1722952,20,15,1993,2,male,851,769,730,0,0,0,0,0,0
1820245,20,3,1993,3,male,335,743,662,0,0,0,0,0,0
1481108,20,27,1993,8,male,458,819,665,0,8,0,7,0,1
1638671,21,19,1992,2,male,670,764,609,0,131,0,119,0,12
1392137,22,11,1991,1,male,653,833,686,0,47,0,43,0,4
1273032,24,9,1989,11,female,41,810,56,0,11,0,10,0,1
1953719,23,30,1990,10,male,1053,763,123,0,1,0,0,0,1
1164090,26,14,1987,12,male,1701,728,227,0,1,0,0,0,1
1752007,25,5,1988,7,male,513,781,531,0,2,0,2,0,0
1144955,25,17,1988,7,female,329,727,154,0,0,0,0,0,0
1752035,28,10,1985,10,male,1225,815,741,0,0,0,0,0,0
1015346,30,20,1983,12,male,923,791,723,0,2,0,1,0,1
2085954,31,1,1982,12,female,371,799,155,0,3,0,3,0,0
1578215,30,10,1983,10,male,718,736,621,0,10,0,9,0,1
1089135,56,9,1957,9,male,568,821,214,0,2,0,2,0,0
1154415,88,28,1925,8,female,1736,824,129,0,2,0,2,0,0
1532248,93,9,1920,12,male,1134,804,735,0,5,0,5,0,0
1560799,99,21,1914,1,male,455,738,535,0,1,0,1,0,0
1591048,100,24,1913,1,male,962,750,122,0,0,0,0,0,0
1067114,102,13,1911,10,female,1283,776,284,0,1,0,0,0,1
1566798,103,28,1910,3,male,1295,753,573,0,1,0,0,0,1
1814728,103,1,1910,7,male,597,801,625,0,0,0,0,0,0
1468521,108,13,1905,5,female,1247,730,177,0,1,0,0,0,1
1152662,113,14,1900,11,female,1643,745,280,0,11,0,4,0,7
1037493,26,18,1987,12,male,1878,803,320,1,0,0,0,1,0
1471753,63,1,1950,1,male,798,760,265,1,0,0,0,1,0
1583499,108,5,1905,11,male,936,772,521,1,0,0,0,1,0
1067682,14,4,1999,10,female,152,755,263,1,4,0,4,1,0
1535193,15,5,1998,3,male,799,792,238,1,2,0,0,1,2
1668233,22,19,1991,9,male,1072,792,575,1,2,0,1,1,1
1384013,22,21,1991,10,male,1209,834,588,1,3,0,0,1,3
1444693,25,26,1988,6,female,427,737,675,1,4,0,4,1,0
1911761,113,8,1900,10,female,1131,803,236,1,58,0,17,1,41
1170683,25,21,1988,11,male,1213,756,575,1,0,1,0,0,0
1935358,36,7,1977,7,male,554,743,654,1,0,1,0,0,0
1364988,94,11,1919,9,male,2033,801,167,1,0,1,0,0,0
1214188,108,21,1905,10,male,1361,824,413,1,1,1,1,0,0
1319224,17,13,1996,12,female,904,795,322,1,10,1,9,0,1
1402608,16,27,1997,7,female,275,795,60,1,6,1,6,0,0
1286805,19,31,1994,12,female,604,784,437,1,189,1,155,0,34
1316487,18,23,1995,3,female,295,765,497,1,102,1,99,0,3
1513803,20,26,1993,1,male,888,757,513,1,10,1,4,0,6
1166073,21,8,1992,6,male,341,799,744,1,4,1,1,0,3
1853266,22,11,1991,5,male,574,727,538,1,4,1,4,0,0
1624602,26,15,1987,7,male,1401,781,385,1,5,1,2,0,3
2144808,53,14,1960,8,male,729,812,251,1,10,1,7,0,3
1878617,103,5,1910,11,male,1030,799,491,1,8,1,8,0,0
1476553,108,26,1905,7,male,1239,742,460,1,2,1,2,0,0
1939105,19,29,1994,10,male,387,759,677,2,0,0,0,2,0
1017813,103,9,1910,2,male,1564,730,377,2,0,2,0,0,0
1734434,27,7,1986,9,male,2089,769,406,2,1,2,1,0,0
1087919,19,20,1994,11,female,372,830,411,2,7,2,6,0,1
1869619,18,3,1995,5,female,257,817,433,2,95,2,67,0,28
2147427,21,24,1992,5,male,549,770,315,2,43,2,38,0,5
2169610,21,23,1992,7,male,1159,808,329,2,8,2,5,0,3
1195569,29,10,1984,5,male,892,779,686,2,8,2,8,0,0
1316102,34,13,1979,7,male,75,724,706,2,223,2,157,0,66
2160369,82,6,1931,7,male,1538,777,532,2,8,2,8,0,0
1830300,97,18,1916,4,female,1169,723,374,2,23,2,12,0,11
1431572,29,1,1984,12,male,635,821,162,3,68,0,40,3,28
1295785,17,6,1996,8,male,829,744,211,3,22,2,19,1,3
1580482,20,13,1993,11,female,658,805,123,3,61,1,49,2,12
1932015,18,5,1995,8,male,520,731,673,3,0,3,0,0,0
2140407,50,22,1963,2,male,997,728,481,3,0,3,0,0,0
1827269,80,14,1933,3,female,630,745,152,3,1,3,0,0,1
1236346,15,1,1998,5,male,249,789,685,3,5,3,5,0,0
1262342,18,11,1995,12,male,521,805,440,3,56,3,44,0,12
1478171,17,28,1996,4,female,462,722,187,3,16,3,12,0,4
1057005,18,24,1995,8,female,551,788,346,3,5,3,4,0,1
2166405,20,10,1993,12,male,736,817,701,3,7,3,6,0,1
1462124,24,24,1989,7,male,1151,725,535,3,64,3,55,0,9
2121637,29,29,1984,5,male,415,822,730,3,6,3,5,0,1
1357448,83,16,1930,10,male,966,731,598,3,23,3,23,0,0
1090368,19,13,1994,12,male,587,765,455,4,18,0,9,4,9
2163391,17,29,1996,2,female,574,731,391,4,1,2,1,2,0
1881828,27,30,1986,11,female,581,728,247,4,12,1,4,3,8
2124274,18,8,1995,12,male,602,726,655,4,46,3,23,1,23
1968576,25,2,1988,1,male,1538,775,17,4,7,3,5,1,2
1870760,15,14,1998,5,female,457,731,427,4,0,4,0,0,0
1899147,108,15,1905,8,male,423,762,717,4,0,4,0,0,0
1431354,19,5,1994,8,male,305,792,458,4,1,4,1,0,0
1573022,21,9,1992,10,male,726,738,672,4,1,4,1,0,0
1923413,68,14,1945,1,male,981,809,593,4,1,4,1,0,0
1333077,18,3,1995,11,male,454,832,633,4,4,4,4,0,0
1361224,18,29,1995,12,male,351,746,663,4,8,4,8,0,0
1743537,17,17,1996,6,female,358,784,663,4,32,4,30,0,2
1282859,17,10,1996,7,male,616,748,528,4,11,4,7,0,4
2185599,18,7,1995,2,male,186,792,576,4,45,4,37,0,8
1178929,19,30,1994,10,male,545,734,580,4,15,4,12,0,3
1877182,108,31,1905,12,male,1317,792,450,4,29,4,16,0,13
1016673,112,20,1901,12,male,1230,802,139,4,6,4,5,0,1
1310334,20,30,1993,6,male,560,770,689,5,2,0,2,5,0
2192904,23,1,1990,10,male,253,830,404,5,39,0,14,5,25
1436595,15,4,1998,9,female,490,746,521,5,21,3,13,2,8
1507443,24,1,1989,12,male,303,790,756,5,23,3,14,2,9
1785074,19,13,1994,5,female,342,831,356,5,0,5,0,0,0
1620206,25,24,1988,12,male,927,760,542,5,3,5,2,0,1
1147255,108,4,1905,4,male,1055,768,693,5,3,5,3,0,0
1574593,16,15,1997,7,male,552,781,671,5,7,5,7,0,0
2001170,21,3,1992,3,male,1350,761,365,5,5,5,4,0,1
1423391,19,1,1994,12,male,378,805,649,5,10,5,8,0,2
1615686,18,27,1995,7,female,374,780,368,5,38,5,23,0,15
1400681,19,3,1994,3,male,567,800,727,5,19,5,17,0,2
1622463,19,8,1994,10,female,922,802,360,5,42,5,21,0,21
1509290,53,8,1960,12,female,955,755,538,5,13,5,12,0,1
2000608,103,23,1910,9,female,1029,729,356,5,18,5,15,0,3
1500653,113,13,1900,4,male,1731,789,396,6,0,0,0,6,0
1263917,19,9,1994,9,male,486,815,600,6,3,2,2,4,1
1449046,84,5,1929,9,male,1460,768,319,6,14,2,8,4,6
2124151,17,17,1996,4,male,220,746,483,6,40,5,36,1,4
1220038,33,11,1980,12,male,645,785,687,6,9,5,9,1,0
1751301,68,17,1945,5,female,1490,780,428,6,3,6,2,0,1
1710645,15,21,1998,6,female,690,736,543,6,20,6,20,0,0
1775608,20,6,1993,9,male,573,736,394,6,34,6,22,0,12
1256403,21,18,1992,9,male,482,751,643,6,140,6,115,0,25
1256667,29,18,1984,8,female,457,772,209,6,101,6,97,0,4
1859821,16,8,1997,8,male,515,745,663,7,5,1,1,6,4
1856584,64,11,1949,3,male,1331,737,352,7,12,0,5,7,7
1530401,15,18,1998,11,female,280,756,555,7,20,6,10,1,10
2161769,103,25,1910,6,male,459,806,765,7,5,7,5,0,0
1046613,15,23,1998,3,male,742,760,617,7,63,7,60,0,3
1587600,23,18,1990,2,male,461,825,746,7,82,7,56,0,26
1789989,21,5,1992,11,male,426,803,730,8,4,0,3,8,1
1238850,107,28,1906,3,male,2311,797,275,8,4,0,2,8,2
1778235,51,7,1962,2,male,620,757,402,8,114,0,30,8,84
1220628,63,15,1950,1,female,901,800,74,8,13,0,1,8,12
2138093,97,18,1916,12,female,784,820,504,8,0,8,0,0,0
1211256,108,29,1905,1,male,1507,725,491,8,0,8,0,0,0
1238780,18,4,1995,5,female,655,731,273,8,10,8,9,0,1
1865829,24,17,1989,11,male,1550,804,293,8,5,8,5,0,0
2024391,19,9,1994,12,male,363,759,705,8,44,8,29,0,15
1684304,18,10,1995,5,female,629,728,306,8,41,8,34,0,7
1261393,24,12,1989,10,female,377,812,205,8,65,8,51,0,14
1941306,101,27,1912,11,female,1947,782,120,8,17,8,15,0,2
1441988,108,21,1905,11,male,1371,731,514,9,33,0,28,9,5
1728869,17,18,1996,12,female,556,791,404,9,34,5,9,4,25
2127615,23,18,1990,1,male,835,828,455,9,51,3,17,6,34
1020320,14,7,1999,7,male,156,753,682,9,3,9,3,0,0
1383143,15,2,1998,8,female,388,821,157,9,20,9,15,0,5
1793102,16,16,1997,8,male,558,817,750,9,51,9,32,0,19
1660403,16,15,1997,8,male,95,731,133,9,71,9,64,0,7
1864783,20,19,1993,6,male,514,736,658,9,92,9,74,0,18
1727745,21,12,1992,1,male,466,757,499,9,17,9,7,0,10
1577760,21,7,1992,10,male,1374,765,501,9,64,9,62,0,2
1157787,14,17,1999,8,female,410,824,224,10,12,0,12,10,0
1069463,44,20,1969,6,male,441,829,506,10,51,0,21,10,30
1637015,18,4,1995,3,male,566,825,665,10,2,10,2,0,0
1009961,28,21,1985,6,male,565,799,739,10,6,10,2,0,4
2165709,99,8,1914,7,male,503,770,545,10,5,10,5,0,0
1480700,104,18,1909,1,female,1222,737,400,10,33,10,25,0,8
1097460,18,14,1995,2,male,1122,816,691,11,9,7,4,4,5
1271784,18,4,1995,3,female,575,791,341,11,480,5,379,6,101
1810595,108,22,1905,4,male,1704,786,152,11,8,9,2,2,6
2162244,19,29,1994,6,female,609,745,530,11,1,11,1,0,0
1752133,24,24,1989,3,male,455,738,713,11,1,11,1,0,0
1335574,20,16,1993,9,female,660,739,353,11,57,11,27,0,30
1508085,23,4,1990,5,female,1052,758,186,11,104,11,84,0,20
1753924,36,4,1977,4,male,539,758,543,11,19,11,16,0,3
2126366,68,17,1945,8,female,145,731,688,11,28,11,28,0,0
1905437,113,14,1900,5,male,1130,728,480,12,13,0,2,12,11
2106964,15,3,1998,4,male,289,776,356,12,54,4,25,8,29
1470089,25,12,1988,11,male,1211,803,495,12,13,10,7,2,6
2037822,17,3,1996,2,male,1258,742,362,12,0,12,0,0,0
2003237,17,4,1996,7,female,225,769,408,12,85,12,75,0,10
1901301,19,22,1994,3,male,537,733,621,12,36,12,29,0,7
1895471,46,4,1967,6,female,165,830,503,12,46,12,34,0,12
1309732,24,7,1989,11,male,696,755,672,13,134,10,110,3,24
1311602,20,2,1993,9,male,684,806,643,13,0,13,0,0,0
1852333,18,19,1995,9,male,194,821,695,13,23,13,19,0,4
1766834,23,1,1990,7,female,545,730,408,13,58,13,49,0,9
1060403,25,1,1988,12,male,1457,738,289,13,102,13,50,0,52
1877350,20,10,1993,5,male,646,794,506,14,7,9,1,5,6
1593718,23,22,1990,12,male,361,770,722,14,41,5,23,9,18
2138809,86,18,1927,11,female,1226,744,457,14,7,14,4,0,3
1458902,18,11,1995,10,male,106,734,133,14,53,14,51,0,2
1502996,19,20,1994,4,male,497,757,506,15,187,0,133,15,54
1844812,29,14,1984,2,male,331,738,550,15,9,8,7,7,2
1240423,45,24,1968,10,male,1394,820,579,15,75,4,6,11,69
1405734,22,17,1991,3,male,1170,759,372,15,6,12,1,3,5
1636562,26,10,1987,5,male,952,736,576,15,5,15,5,0,0
2133923,26,22,1987,2,male,577,774,656,15,17,15,16,0,1
1917953,20,23,1993,1,male,669,784,705,16,0,0,0,16,0
1989177,18,11,1995,10,male,655,745,399,16,17,4,5,12,12
2113603,22,24,1991,8,male,582,787,714,16,1,16,1,0,0
1809571,91,13,1922,9,male,498,758,268,16,4,16,2,0,2
1703870,16,30,1997,7,male,860,726,414,16,28,16,21,0,7
1851444,16,16,1997,10,female,283,756,228,16,24,16,15,0,9
1049316,20,28,1993,5,male,1410,732,443,16,125,16,83,0,42
2191854,98,5,1915,3,male,660,753,479,16,55,16,44,0,11
2052410,26,11,1987,4,male,563,775,528,17,14,17,13,0,1
1755715,103,13,1910,12,male,748,795,442,18,20,0,9,18,11
1964856,15,6,1998,8,female,289,743,90,18,118,17,70,1,48
1691879,105,5,1908,7,male,1715,767,552,18,61,18,58,0,3
1525644,15,8,1998,6,male,521,742,603,19,6,1,4,18,2
1837693,23,21,1990,3,female,580,746,529,19,19,19,14,0,5
1016939,28,17,1985,11,male,587,815,725,19,35,19,31,0,4
1538593,95,11,1918,11,male,1335,791,344,20,61,3,29,17,32
2018317,108,29,1905,6,male,1899,745,486,20,141,0,21,20,120
2108489,20,14,1993,12,male,1106,783,714,20,46,6,28,14,18
1508895,108,12,1905,7,male,361,792,723,20,83,18,68,2,15
1265147,19,6,1994,11,male,597,746,385,20,0,20,0,0,0
1166271,16,12,1997,2,female,153,828,683,20,56,20,33,0,23
1039752,17,8,1996,2,female,265,750,193,20,167,20,32,0,135
1291953,19,7,1994,6,female,686,771,608,20,56,20,49,0,7
1937850,102,4,1911,11,male,1852,758,279,21,138,0,56,21,82
1315166,17,27,1996,3,female,455,768,342,21,2,21,1,0,1
2144181,22,12,1991,10,female,673,775,465,21,242,21,192,0,50
1598805,105,30,1908,10,male,1980,739,223,22,22,1,12,21,10
1937575,30,15,1983,7,male,657,739,465,22,30,7,20,15,10
2099649,24,17,1989,1,male,1269,747,403,22,5,21,0,1,5
1768513,19,17,1994,7,female,529,765,272,22,11,22,5,0,6
1549533,23,1,1990,1,female,617,809,630,22,156,22,133,0,23
2059300,18,17,1995,10,male,512,802,465,23,39,0,20,23,19
1682255,23,5,1990,5,male,693,785,133,23,1,18,1,5,0
1312770,93,4,1920,6,male,1254,789,190,23,1,23,1,0,0
2187468,18,18,1995,8,male,561,748,578,23,80,23,65,0,15
1746493,15,27,1998,7,male,809,774,375,24,194,22,78,2,116
1695317,54,1,1959,8,female,277,773,511,24,88,21,50,3,38
1366621,17,11,1996,6,male,211,751,657,24,75,24,46,0,29
2064657,108,15,1905,11,male,924,740,474,25,1,0,1,25,0
1630995,108,1,1905,2,male,1021,759,420,25,21,8,4,17,17
1200126,108,11,1905,4,female,1756,804,451,25,71,12,27,13,44
1023711,20,29,1993,4,male,1647,755,269,25,2,25,2,0,0
1793216,103,15,1910,10,female,384,774,578,25,30,25,25,0,5
1180772,19,23,1994,4,female,637,741,322,25,62,25,46,0,16
2069826,108,19,1905,7,female,1647,827,413,26,135,24,37,2,98
2136351,15,12,1998,10,female,418,803,498,26,686,26,484,0,202
1853986,18,5,1995,3,female,382,759,229,27,11,0,6,27,5
2131204,103,5,1910,1,NA,2363,749,564,27,144,0,85,27,59
1540083,20,12,1993,12,male,1041,763,451,27,40,18,25,9,15
1708666,26,8,1987,8,male,374,746,590,27,48,27,30,0,18
1973764,93,11,1920,3,male,1385,813,617,28,12,2,2,26,10
1389177,102,17,1911,7,male,1218,819,585,28,103,28,99,0,4
1172680,17,11,1996,6,male,1390,811,158,29,149,12,73,17,76
1709102,18,24,1995,9,female,278,742,423,29,79,29,72,0,7
1289817,85,15,1928,8,male,7,814,662,30,8,0,8,30,0
1012841,59,19,1954,5,female,2353,752,426,30,483,1,1,29,482
1313772,17,4,1996,6,female,351,758,563,31,14,27,11,4,3
1412570,21,10,1992,1,male,867,743,316,31,40,30,21,1,19
1326567,17,17,1996,7,male,313,814,661,30,1,30,1,0,0
1099508,18,5,1995,7,male,635,746,605,30,6,30,4,0,2
2164843,32,7,1981,3,male,809,817,705,31,10,31,10,0,0
1234550,18,26,1995,4,male,397,722,634,31,23,31,17,0,6
1030205,18,8,1995,5,male,493,765,472,30,83,30,49,0,34
1500522,105,2,1908,3,female,1408,794,223,32,20,22,14,10,6
1527728,24,5,1989,11,male,1650,781,541,32,117,23,51,9,66
1912536,17,2,1996,11,female,355,773,641,32,25,32,18,0,7
1899222,16,25,1997,8,female,389,759,411,32,80,32,15,0,65
1293072,95,26,1918,12,female,1926,829,260,33,45,0,19,33,26
1811188,68,3,1945,2,male,1009,728,462,33,28,33,22,0,6
1073090,104,3,1909,8,male,1235,797,376,34,45,33,36,1,9
1618656,51,3,1962,11,male,353,783,619,35,1,0,0,35,1
1013909,110,20,1903,5,male,1964,778,327,36,15,0,3,36,12
1860238,16,14,1997,1,female,1144,737,447,36,175,5,128,31,47
1243757,19,27,1994,5,female,316,807,291,36,54,0,9,36,45
1496419,17,22,1996,8,female,605,733,499,36,50,22,31,14,19
1174605,14,30,1999,4,female,443,825,635,35,17,32,12,3,5
1316172,20,11,1993,4,male,299,744,525,36,11,28,10,8,1
2166577,103,9,1910,9,male,2716,794,524,36,239,29,189,7,50
1768918,23,6,1990,3,male,583,790,745,35,34,35,31,0,3
1082268,19,18,1994,12,female,718,800,552,35,85,35,60,0,25
1447565,108,30,1905,7,female,1022,818,264,38,40,7,11,31,29
2029001,108,20,1905,10,male,2101,763,318,39,35,0,24,39,11
1319715,15,9,1998,2,male,218,740,73,39,106,0,37,39,69
1926989,22,31,1991,8,female,185,734,457,38,18,38,12,0,6
1506778,23,5,1990,5,male,66,800,221,38,40,38,35,0,5
1850663,31,27,1982,5,male,663,783,693,39,90,39,78,0,12
1605706,31,23,1982,5,female,1149,815,517,40,54,18,48,22,6
1002559,15,16,1998,1,male,494,764,459,40,148,34,123,6,25
1250937,15,13,1998,4,male,328,784,322,40,59,40,49,0,10
1616780,14,13,1999,10,female,253,789,398,41,6,0,0,41,6
1468194,50,18,1963,10,female,325,750,318,41,18,4,9,37,9
1967911,103,3,1910,2,male,1895,768,433,42,222,2,92,40,130
2178013,22,29,1991,4,male,1027,743,624,42,22,11,16,31,6
1206695,29,28,1984,10,female,1344,764,188,42,91,24,50,18,41
2014511,61,23,1952,3,female,657,797,229,42,91,42,70,0,21
1525833,68,11,1945,3,male,822,725,397,41,125,41,109,0,16
1763722,17,26,1996,9,female,397,783,545,44,26,8,11,36,15
1892361,18,18,1995,3,male,228,742,640,44,84,1,35,43,49
1317475,20,21,1993,9,male,1076,759,559,44,7,11,3,33,4
1060864,77,7,1936,3,female,43,744,359,44,8,10,6,34,2
1035845,103,5,1910,4,female,981,829,288,43,20,43,12,0,8
2033746,102,4,1911,6,female,1582,730,394,44,42,44,37,0,5
2014348,18,4,1995,12,male,345,820,728,43,2173,43,1325,0,848
2136759,17,29,1996,8,female,276,822,140,43,67,43,47,0,20
2041372,29,13,1984,8,male,892,733,542,43,73,43,41,0,32
1327975,31,13,1982,4,female,532,782,433,44,418,44,328,0,90
1007777,24,3,1989,8,male,1748,754,399,45,163,25,115,20,48
1503275,68,8,1945,7,male,1000,788,554,47,1,47,1,0,0
1978768,24,8,1989,10,female,858,828,226,47,151,47,146,0,5
1470401,25,1,1988,1,male,299,727,431,46,142,46,128,0,14
1482812,64,27,1949,11,male,1125,821,430,47,295,47,160,0,135
2022740,23,8,1990,2,male,645,722,471,48,2,5,0,43,2
2122898,100,22,1913,9,male,1707,733,434,49,103,23,50,26,53
1746613,113,21,1900,1,female,1676,728,450,49,9,45,4,4,5
1735459,23,6,1990,10,male,1308,769,492,48,69,37,58,11,11
1530331,18,12,1995,10,female,339,732,472,48,33,48,24,0,9
1873407,68,19,1945,12,male,1653,780,487,48,118,48,111,0,7
1527442,21,11,1992,8,female,480,736,378,51,37,11,22,40,15
1035900,15,7,1998,1,female,642,816,371,51,130,23,70,28,60
1489647,21,10,1992,8,female,603,817,617,50,194,10,152,40,42
1125472,19,12,1994,5,male,1023,754,191,50,42,46,28,4,14
1299436,107,28,1906,11,male,1709,732,554,51,196,41,61,10,135
1556794,22,28,1991,8,female,850,807,187,51,102,51,89,0,13
1596645,26,25,1987,6,female,320,809,459,50,337,50,293,0,44
1034654,28,30,1985,4,female,1232,788,267,51,80,51,79,0,1
1758799,18,6,1995,1,male,672,787,165,52,162,29,97,23,65
1142061,18,1,1995,3,female,598,808,385,52,88,33,59,19,29
1390157,28,21,1985,2,female,812,737,535,52,411,50,308,2,103
1579122,83,2,1930,8,male,1022,785,476,53,84,51,48,2,36
1942423,68,7,1945,6,male,1477,787,398,52,6,52,1,0,5
1701156,17,26,1996,5,male,318,722,652,52,166,52,129,0,37
1142501,86,6,1927,8,male,1093,733,485,54,112,3,43,51,69
2101635,26,12,1987,9,male,592,816,742,55,10,50,9,5,1
1329973,24,20,1989,2,male,332,766,656,54,237,54,161,0,76
1237848,93,29,1920,6,male,789,766,304,54,87,54,55,0,32
2029571,16,3,1997,4,female,707,795,332,56,76,24,35,32,41
2058751,44,26,1969,3,male,625,723,176,58,370,25,131,33,239
1708820,14,28,1999,11,female,322,824,531,57,345,56,223,1,122
1512304,101,14,1912,5,male,284,832,754,58,519,53,397,5,122
1680063,103,8,1910,9,female,964,737,200,57,200,56,186,1,14
1767161,16,16,1997,12,male,466,722,373,57,122,57,78,0,44
2140188,19,25,1994,4,female,200,825,637,58,125,58,109,0,16
1124158,20,19,1993,5,male,704,741,464,56,771,56,668,0,103
1232981,32,28,1981,4,female,581,731,491,56,102,56,93,0,9
1606768,108,31,1905,3,male,1031,727,473,57,118,57,97,0,21
1262483,38,12,1975,11,male,706,780,617,60,18,0,7,60,11
1632176,15,10,1998,10,female,549,724,469,59,99,31,69,28,30
1066614,19,5,1994,2,female,610,807,510,60,318,41,223,19,95
1772214,23,25,1990,8,male,880,828,689,59,130,39,108,20,22
1278643,18,10,1995,9,male,297,722,478,59,336,58,195,1,141
1882649,108,6,1905,5,male,858,729,626,60,18,60,16,0,2
2040256,18,30,1995,4,female,149,768,123,59,94,59,88,0,6
1174314,28,26,1985,10,male,335,768,586,59,285,59,162,0,123
1510133,16,24,1997,10,female,410,767,356,62,38,12,13,50,25
1796360,71,15,1942,7,male,1597,776,687,61,4,31,2,30,2
1259052,19,17,1994,2,male,337,804,540,61,496,59,240,2,256
1606390,18,31,1995,8,male,541,785,696,61,13,61,9,0,4
2017714,17,22,1996,5,female,326,758,526,61,122,61,23,0,99
1439149,19,31,1994,12,male,557,793,607,63,112,63,104,0,8
1348570,21,27,1992,1,male,621,724,483,65,54,3,45,62,9
1825052,43,12,1970,6,male,1528,794,641,65,1241,3,1160,62,81
1121825,19,22,1994,6,male,686,799,485,65,4,64,2,1,2
1676821,23,6,1990,4,female,718,728,337,66,212,65,154,1,58
1665991,15,6,1998,3,male,206,723,580,66,48,66,42,0,6
1931811,18,6,1995,10,female,129,823,33,68,995,68,644,0,351
1674017,18,10,1995,7,male,870,741,592,69,11,37,8,32,3
1266188,17,12,1996,8,male,270,742,347,69,55,23,26,46,29
1326190,105,14,1908,1,male,1564,728,403,70,395,32,217,38,178
2079485,16,26,1997,1,female,412,823,602,71,72,68,44,3,28
1760737,58,5,1955,6,female,620,791,668,71,191,65,127,6,64
1688410,21,26,1992,6,male,291,777,684,74,15,0,4,74,11
1280593,16,5,1997,6,female,678,787,191,72,0,42,0,30,0
2147429,108,2,1905,4,female,1431,748,311,72,43,19,25,53,18
1369209,16,24,1997,3,male,632,739,439,74,204,20,65,54,139
1045154,21,13,1992,2,female,1345,810,181,72,189,65,165,7,24
1142272,24,6,1989,12,female,312,772,270,73,148,71,130,2,18
1887426,27,25,1986,5,female,709,821,592,73,153,66,128,7,25
1662236,20,23,1993,7,male,706,814,694,74,33,74,26,0,7
1525649,17,11,1996,10,male,470,784,664,72,51,72,50,0,1
1498959,16,13,1997,8,female,569,756,271,74,406,74,321,0,85
1427872,18,1,1995,1,female,383,739,390,72,178,72,86,0,92
1195738,20,11,1993,5,male,616,765,523,74,178,74,118,0,60
1905790,19,23,1994,11,female,619,779,518,76,460,14,325,62,135
1827647,24,23,1989,10,male,1440,830,591,75,640,45,239,30,401
1938084,27,17,1986,3,female,1105,814,375,76,710,35,666,41,44
1586191,53,27,1960,4,male,1009,793,419,76,14,74,13,2,1
1831697,21,25,1992,8,male,566,766,646,78,6,0,0,78,6
1090451,44,11,1969,1,male,231,795,682,80,16,23,4,57,12
2043603,69,9,1944,12,female,760,769,525,78,56,31,31,47,25
2069110,18,1,1995,3,female,623,831,409,80,142,17,73,63,69
1828292,21,31,1992,8,male,773,740,612,80,116,80,94,0,22
1306223,43,24,1970,4,female,1205,784,83,80,728,80,583,0,145
1036010,16,2,1997,7,male,601,796,452,83,128,45,24,38,104
2077287,19,14,1994,1,male,596,799,469,84,95,63,23,21,72
1283387,108,28,1905,5,male,973,729,391,81,96,81,77,0,19
1044069,18,6,1995,10,male,163,787,740,83,143,83,98,0,45
1671528,23,8,1990,8,male,417,796,580,85,36,9,14,76,22
1419335,103,22,1910,1,male,828,830,343,87,201,52,127,35,74
1261984,18,28,1995,10,male,270,794,683,86,42,86,26,0,16
1824964,18,21,1995,11,female,423,757,617,87,78,87,64,0,14
1246481,14,13,1999,5,female,137,771,681,85,198,85,129,0,69
1737417,13,30,2000,5,female,724,755,477,89,65,0,2,89,63
2075609,20,13,1993,6,female,255,811,318,88,163,1,115,87,48
1138899,18,2,1995,7,female,1529,742,202,90,166,24,94,66,72
1534393,22,7,1991,9,female,684,758,430,90,407,63,99,27,308
1945814,103,27,1910,3,female,460,768,311,89,22,81,14,8,8
1304238,68,1,1945,6,male,1313,793,617,89,63,86,40,3,23
1817078,18,16,1995,11,female,64,745,42,88,151,86,51,2,100
1445005,14,26,1999,11,female,255,779,336,94,61,9,36,85,25
2088952,21,3,1992,10,male,462,775,544,95,246,4,113,91,133
1285815,22,5,1991,5,male,408,774,85,95,151,19,44,76,107
1910683,77,18,1936,6,male,1303,732,607,94,181,56,87,38,94
1943728,29,1,1984,2,male,686,803,332,94,14,78,6,16,8
1248258,18,12,1995,7,male,435,756,627,93,93,81,47,12,46
1571196,16,6,1997,3,female,345,804,402,93,60,93,45,0,15
1857363,63,21,1950,11,female,752,762,461,92,116,92,44,0,72
1172114,64,17,1949,12,male,1447,808,334,94,176,94,136,0,40
2040372,103,12,1910,3,male,852,825,529,93,144,93,117,0,27
1793288,16,28,1997,10,female,594,746,497,96,60,7,18,89,42
1265652,23,27,1990,11,female,660,795,615,97,194,18,62,79,132
1110309,108,12,1905,2,male,871,769,468,98,202,1,69,97,133
1520384,107,9,1906,10,male,1477,775,144,98,17,65,14,33,3
1698426,20,30,1993,10,female,562,815,504,96,303,51,180,45,123
1995445,24,9,1989,8,male,821,741,543,96,35,74,13,22,22
1903146,21,18,1992,2,male,492,765,663,96,34,96,23,0,11
1021509,18,21,1995,6,female,254,754,79,98,282,98,150,0,132
1204550,68,10,1945,12,male,1113,781,463,102,46,47,25,55,21
1470629,25,8,1988,8,male,856,728,607,104,128,58,56,46,72
1445019,103,4,1910,4,male,1598,780,396,104,289,23,163,81,126
1565258,108,29,1905,10,female,1621,744,424,104,87,101,82,3,5
1115039,17,28,1996,6,female,279,783,285,102,235,86,96,16,139
1729186,24,7,1989,9,female,1532,726,244,104,507,76,410,28,97
1306228,21,23,1992,11,male,675,722,541,101,117,101,102,0,15
1098179,19,20,1994,7,female,547,737,238,101,177,101,89,0,88
1440251,23,16,1990,5,female,607,764,429,104,236,104,210,0,26
1315409,20,29,1993,10,female,500,743,498,108,51,7,15,101,36
1320366,16,17,1997,6,female,580,725,623,106,106,20,73,86,33
2060838,94,25,1919,9,male,967,763,293,105,204,0,93,105,111
1407918,17,2,1996,5,female,560,802,499,105,149,40,50,65,99
1615692,108,11,1905,7,female,960,771,594,107,19,98,16,9,3
1098254,108,8,1905,12,male,1259,794,400,106,81,99,68,7,13
1715021,18,12,1995,3,male,644,770,674,106,388,103,139,3,249
1247565,108,30,1905,1,male,1771,759,131,105,191,92,147,13,44
1284145,18,23,1995,7,male,513,825,254,108,37,108,23,0,14
1029497,20,20,1993,2,female,306,729,370,109,849,109,705,0,144
2122973,108,29,1905,1,male,1013,782,634,112,14,1,13,111,1
1665797,85,21,1928,5,female,1678,774,336,112,59,6,17,106,42
1693513,63,17,1950,7,female,1522,813,567,111,160,15,72,96,88
1634770,43,22,1970,1,male,1241,728,480,110,625,29,482,81,143
2104354,19,26,1994,6,male,624,823,643,113,122,105,104,8,18
1461217,31,8,1982,6,male,497,732,657,117,17,0,13,117,4
2074170,93,23,1920,10,male,1653,779,384,115,164,0,55,115,109
1463614,25,28,1988,4,male,654,736,229,118,302,19,152,99,150
1312504,25,10,1988,9,male,1005,781,458,117,377,41,176,76,201
1979221,21,20,1992,2,female,381,743,636,118,60,111,32,7,28
1063832,15,5,1998,12,female,424,734,376,115,151,84,125,31,26
1367571,16,11,1997,9,female,437,746,409,119,65,119,38,0,27
1168471,19,9,1994,5,male,533,790,395,114,105,114,55,0,50
1169210,103,10,1910,10,male,753,781,667,124,75,25,32,99,43
1094293,19,1,1994,11,male,303,734,509,124,192,65,151,59,41
1345631,21,9,1992,9,male,729,756,214,121,453,79,303,42,150
1446003,24,20,1989,12,male,396,759,737,121,6,119,5,2,1
1728040,103,14,1910,7,male,2264,736,356,124,34,122,26,2,8
1867294,68,17,1945,8,male,1554,761,378,123,114,95,46,28,68
1324144,18,18,1995,7,female,690,803,351,123,218,119,107,4,111
1421198,21,9,1992,6,female,1667,772,454,120,308,119,220,1,88
1984455,75,26,1938,5,male,2188,791,587,122,80,122,51,0,29
1369947,18,19,1995,2,female,327,807,631,120,541,120,526,0,15
1194397,100,13,1913,4,male,1752,731,513,123,191,123,131,0,60
1838405,15,3,1998,4,male,699,725,612,130,133,16,64,114,69
1808179,15,16,1998,1,female,783,813,293,129,565,92,398,37,167
2045173,27,21,1986,4,female,1046,773,491,125,311,64,113,61,198
2183101,29,29,1984,3,female,722,743,473,129,505,46,434,83,71
2155468,21,24,1992,4,male,583,798,506,129,47,129,23,0,24
1633380,22,28,1991,10,female,833,745,480,125,29,125,15,0,14
1045786,26,14,1987,9,male,412,742,522,130,80,130,57,0,23
2143451,85,1,1928,9,female,259,757,671,125,117,125,106,0,11
1189380,20,1,1993,11,male,1343,729,460,131,68,23,26,108,42
1704979,16,17,1997,12,male,439,829,419,136,443,36,300,100,143
1237861,20,25,1993,6,male,505,752,602,132,256,84,166,48,90
1207820,16,18,1997,5,female,242,817,635,136,74,136,62,0,12
2115278,18,4,1995,4,female,761,733,310,136,45,136,37,0,8
1577101,20,17,1993,7,male,869,799,521,131,83,131,75,0,8
1739446,21,23,1992,9,female,192,826,393,133,227,133,180,0,47
1840914,22,2,1991,4,male,502,760,670,141,68,0,31,141,37
1018771,25,17,1988,6,female,773,731,566,141,581,15,516,126,65
1635300,23,27,1990,3,female,467,756,462,139,162,39,98,100,64
1543501,29,19,1984,9,female,1229,729,421,140,100,33,35,107,65
1093968,17,20,1996,10,male,709,751,563,139,285,68,135,71,150
1466515,24,6,1989,8,female,1198,783,518,142,280,141,139,1,141
1752253,18,26,1995,7,female,265,788,459,143,54,143,43,0,11
1087643,18,23,1995,9,female,41,759,80,137,976,137,815,0,161
1524918,20,29,1993,5,female,637,757,271,147,205,61,131,86,74
2053589,18,25,1995,4,male,646,834,585,146,40,131,28,15,12
1925321,18,24,1995,7,male,199,785,691,144,22,144,17,0,5
1739337,80,19,1933,12,male,347,731,268,146,169,146,149,0,20
2106002,16,5,1997,1,female,612,727,379,148,753,148,662,0,91
1486889,19,11,1994,11,female,477,730,457,145,306,145,192,0,114
1381859,16,25,1997,12,female,688,817,568,151,202,73,136,78,66
1618551,100,31,1913,8,female,1810,781,120,151,119,87,68,64,51
2123118,19,5,1994,1,female,519,722,376,151,509,64,210,87,299
2129422,104,4,1909,2,male,1970,834,496,152,633,88,340,64,293
1208384,19,13,1994,6,female,526,738,597,152,8,152,8,0,0
1287926,74,2,1939,7,male,1536,740,350,156,44,156,37,0,7
1904914,14,11,1999,1,male,391,766,703,162,17,10,9,152,8
1319971,19,22,1994,12,male,744,789,576,164,241,2,127,162,114
1337372,34,25,1979,12,female,799,813,392,164,110,0,36,164,74
1273787,55,18,1958,10,male,575,768,661,159,61,34,42,125,19
1380956,35,6,1978,9,female,938,722,434,158,279,81,206,77,73
1682454,32,16,1981,5,female,409,805,485,161,309,145,119,16,190
1750627,67,10,1946,3,male,1337,794,88,158,22,158,8,0,14
2088479,103,18,1910,11,female,621,821,310,162,641,162,582,0,59
1135020,67,9,1946,12,female,1539,742,394,172,90,0,37,172,53
1957657,13,13,2000,3,male,288,732,636,169,94,75,54,94,40
1395028,18,25,1995,11,male,310,734,650,169,243,82,123,87,120
1022961,83,1,1930,12,male,1206,819,158,165,180,116,101,49,79
1307837,105,1,1908,3,female,1686,775,334,171,144,88,38,83,106
1997728,20,13,1993,4,male,777,782,378,172,392,90,177,82,215
2156431,18,18,1995,11,female,314,727,136,169,16,156,10,13,6
2119405,19,5,1994,12,male,294,832,566,168,349,165,244,3,105
1934866,21,18,1992,11,male,512,778,644,168,97,168,79,0,18
1192319,19,29,1994,3,male,464,816,453,177,163,7,62,170,101
1140388,19,2,1994,5,male,559,739,449,178,163,53,99,125,64
1318181,19,22,1994,5,female,849,748,505,178,456,41,355,137,101
1098324,16,18,1997,11,female,342,791,140,173,225,171,173,2,52
2182517,18,16,1995,12,female,827,802,564,173,2113,161,1187,12,926
1143789,19,25,1994,6,male,470,789,352,175,404,131,126,44,278
2159962,19,23,1994,8,female,857,809,305,178,431,129,264,49,167
2082037,15,24,1998,2,female,535,834,393,177,107,177,89,0,18
1022436,21,18,1992,11,female,371,776,486,176,94,176,83,0,11
2049146,21,25,1992,3,female,338,801,381,181,88,181,74,0,14
2060213,15,5,1998,1,female,317,778,429,178,641,178,549,0,92
1917762,18,6,1995,1,female,522,785,299,173,427,173,407,0,20
2069810,27,16,1986,1,male,365,788,467,182,554,35,165,147,389
1855594,19,5,1994,8,male,556,748,560,190,37,186,24,4,13
1506505,36,5,1977,5,male,87,819,797,186,263,172,244,14,19
1443936,21,17,1992,8,male,1494,811,301,190,324,170,271,20,53
1248119,19,3,1994,4,male,412,814,697,187,54,187,26,0,28
1470180,17,14,1996,2,male,82,789,769,184,132,184,112,0,20
1751793,19,8,1994,8,male,557,819,626,188,121,188,99,0,22
1220727,98,15,1915,8,female,282,767,190,182,130,182,108,0,22
1467983,19,8,1994,11,female,130,800,175,189,332,189,307,0,25
1716501,33,26,1980,4,female,318,763,408,185,282,185,260,0,22
1827501,13,18,2000,2,female,734,801,466,194,159,31,109,163,50
1984009,18,22,1995,7,female,528,725,328,192,221,12,102,180,119
2033477,93,1,1920,2,female,640,788,295,198,214,10,61,188,153
1178280,16,21,1997,3,female,178,756,89,191,451,36,336,155,115
1782734,14,28,1999,2,female,504,767,328,193,65,167,40,26,25
1534925,24,24,1989,6,male,698,737,196,199,111,189,54,10,57
2078722,32,12,1981,10,male,1688,774,241,199,104,165,78,34,26
1559059,15,23,1998,3,female,570,744,309,199,194,191,139,8,55
1625061,103,12,1910,3,male,1018,761,570,191,206,139,116,52,90
1020248,18,4,1995,3,female,1575,732,450,195,746,176,372,19,374
1568586,46,9,1967,7,female,1169,812,318,191,428,181,201,10,227
1895147,15,2,1998,5,male,395,798,700,197,68,197,58,0,10
2123400,21,30,1992,11,male,316,725,639,199,87,199,84,0,3
1346221,25,4,1988,3,male,628,759,452,196,74,196,70,0,4
1297711,27,1,1986,9,female,887,823,377,194,791,194,632,0,159
1143073,20,16,1993,12,female,952,766,276,209,1162,3,555,206,607
1038967,21,13,1992,5,female,1674,776,411,202,452,55,198,147,254
1835792,23,20,1990,1,female,681,810,227,209,525,85,184,124,341
1231732,15,25,1998,7,female,354,750,244,211,214,157,156,54,58
1612289,18,4,1995,4,female,778,793,581,204,315,196,217,8,98
1396599,21,23,1992,9,male,1047,823,667,201,43,200,30,1,13
1805592,88,26,1925,8,male,1611,828,524,206,262,205,187,1,75
1724877,15,29,1998,8,male,344,771,391,208,31,208,22,0,9
1732985,94,7,1919,3,male,559,766,366,211,238,211,179,0,59
1702597,19,12,1994,6,female,527,743,378,217,255,134,98,83,157
1551042,108,14,1905,8,male,1481,781,434,212,153,133,47,79,106
1851837,18,11,1995,9,female,718,748,323,218,613,151,220,67,393
1582284,100,5,1913,11,female,2227,747,397,217,416,106,141,111,275
1792898,23,7,1990,1,female,1517,759,310,216,103,197,66,19,37
1733315,100,1,1913,1,male,2257,802,325,217,434,163,269,54,165
1623661,113,29,1900,9,male,1424,781,691,215,9,215,9,0,0
1619133,16,2,1997,8,male,589,817,536,214,103,214,74,0,29
1519428,19,4,1994,4,male,408,751,621,220,129,220,93,0,36
1104250,20,17,1993,10,male,463,725,377,219,208,219,135,0,73
1023861,59,25,1954,2,male,1297,794,637,230,19,0,0,230,19
1030673,17,18,1996,2,male,805,804,575,231,249,160,140,71,109
2043703,18,27,1995,6,female,908,763,480,231,165,159,106,72,59
1347742,15,11,1998,2,male,168,822,429,223,360,48,201,175,159
2154376,18,7,1995,7,male,725,801,473,230,575,73,259,157,316
1823458,19,3,1994,10,female,512,786,237,232,595,61,308,171,287
1057340,22,28,1991,4,male,692,780,192,229,892,130,650,99,242
1116636,14,1,1999,1,male,150,832,651,230,29,200,23,30,6
1162698,19,16,1994,4,female,792,785,303,233,76,169,47,64,29
1113815,19,23,1994,1,male,493,811,708,229,215,217,180,12,35
1212231,94,17,1919,8,male,137,778,726,224,160,224,136,0,24
1407124,105,15,1908,2,female,1083,829,617,230,318,230,237,0,81
1231398,108,25,1905,2,male,1415,737,391,240,470,18,328,222,142
2125472,42,4,1971,10,female,103,762,646,243,201,95,82,148,119
1582686,21,28,1992,3,female,394,804,231,234,568,54,268,180,300
1924042,21,19,1992,1,female,1376,740,466,236,92,206,57,30,35
1207172,21,8,1992,8,male,637,725,581,243,326,214,247,29,79
1856272,19,6,1994,1,female,528,728,440,237,442,189,300,48,142
1291586,106,22,1907,2,male,258,724,531,239,100,239,78,0,22
1651473,33,5,1980,12,male,718,733,540,239,353,239,294,0,59
2100928,39,25,1974,7,female,560,775,159,256,213,45,125,211,88
1510830,52,24,1961,7,female,171,763,639,252,295,20,156,232,139
1731671,34,11,1979,6,female,633,742,557,247,137,176,34,71,103
1167405,20,3,1993,6,female,723,801,331,260,435,64,66,196,369
1857803,21,4,1992,1,male,421,797,711,247,181,238,139,9,42
1925115,23,14,1990,8,female,658,829,681,260,256,255,195,5,61
1198991,21,14,1992,2,male,1715,811,491,247,485,193,279,54,206
1063830,26,17,1987,10,female,1110,766,498,255,808,195,439,60,369
1921792,97,30,1916,9,male,1028,725,290,257,279,257,175,0,104
2092130,64,31,1949,1,male,1758,816,86,272,200,20,134,252,66
1686002,97,27,1916,8,male,1612,770,403,272,288,75,112,197,176
1671301,18,30,1995,1,female,633,724,522,261,437,173,134,88,303
1094786,100,5,1913,6,male,655,768,276,262,390,219,179,43,211
1221604,18,1,1995,9,female,230,729,142,267,410,238,251,29,159
2102625,18,19,1995,10,female,1280,725,167,266,1136,244,321,22,815
1125250,36,1,1977,1,male,448,797,260,274,19,274,12,0,7
1371716,18,18,1995,6,male,365,807,613,271,138,271,72,0,66
1687260,23,5,1990,7,female,179,738,499,273,75,273,60,0,15
1030114,22,21,1991,7,female,1588,777,461,277,339,167,259,110,80
1685286,39,7,1974,9,female,1754,826,264,292,1818,181,856,111,962
1521848,26,2,1987,10,female,1521,749,410,285,281,247,187,38,94
1846018,25,1,1988,1,male,193,748,474,287,221,287,170,0,51
1707331,16,10,1997,5,female,271,723,164,278,562,278,483,0,79
2143949,20,13,1993,12,female,560,750,328,280,496,280,408,0,88
2080858,19,13,1994,9,female,351,780,139,290,1058,290,856,0,202
1594960,53,16,1960,12,male,915,775,542,289,945,289,610,0,335
1378473,15,16,1998,10,male,247,722,599,308,374,44,233,264,141
1382275,20,6,1993,8,female,179,761,39,299,217,9,143,290,74
1428084,19,17,1994,4,male,1203,819,309,293,275,162,116,131,159
1914937,18,28,1995,10,male,467,803,648,301,312,268,191,33,121
2092549,113,29,1900,10,male,1902,794,161,297,264,245,145,52,119
1311783,49,17,1964,12,male,808,733,208,295,450,250,168,45,282
1900481,16,30,1997,3,female,222,812,164,303,1321,302,836,1,485
1046659,51,10,1962,7,female,778,741,452,298,1252,295,820,3,432
1543924,14,9,1999,6,female,251,831,617,300,138,300,108,0,30
1867530,18,12,1995,12,female,728,750,404,303,267,303,236,0,31
1122721,16,10,1997,4,male,673,796,581,296,496,296,287,0,209
1965568,20,7,1993,12,female,484,741,353,314,37,1,6,313,31
1290824,19,6,1994,10,male,894,800,255,313,184,0,36,313,148
2176611,51,10,1962,2,female,1732,833,433,315,154,39,97,276,57
2002307,108,4,1905,6,male,883,750,316,317,138,9,59,308,79
1948481,17,6,1996,9,male,424,755,461,316,246,35,149,281,97
1251873,19,11,1994,9,female,216,768,525,310,462,46,263,264,199
1690621,29,7,1984,3,female,842,753,333,315,1062,42,448,273,614
1257648,16,15,1997,12,female,1007,817,447,318,510,109,194,209,316
1164855,20,28,1993,7,female,690,806,499,309,390,279,167,30,223
1776290,19,14,1994,9,female,640,764,398,318,585,261,299,57,286
1649663,66,28,1947,6,male,427,741,555,312,562,270,386,42,176
1517799,19,21,1994,4,female,382,722,327,323,176,323,146,0,30
1663115,25,13,1988,7,female,535,742,242,318,214,318,197,0,17
1298319,105,5,1908,8,male,1181,783,585,315,209,315,75,0,134
1461721,19,3,1994,12,female,279,783,581,317,620,317,488,0,132
1955403,18,21,1995,8,male,1253,776,569,340,672,28,251,312,421
1365559,22,4,1991,8,male,623,772,471,345,195,88,93,257,102
1982488,20,5,1993,11,female,1576,772,518,336,400,74,129,262,271
2131144,19,6,1994,3,male,510,817,653,341,313,172,55,169,258
1702766,23,21,1990,3,male,529,827,669,331,845,105,276,226,569
1459252,35,3,1978,4,male,1394,790,673,330,405,283,309,47,96
1435345,103,20,1910,3,male,1173,726,241,339,468,309,169,30,299
1020389,24,7,1989,4,female,626,771,456,332,1082,327,714,5,368
1803394,33,1,1980,2,male,547,803,626,344,193,344,131,0,62
1292941,48,18,1965,8,female,212,755,650,344,66,344,62,0,4
1920256,17,1,1996,1,male,134,740,627,330,314,330,296,0,18
1516920,26,14,1987,1,female,533,734,525,343,997,343,878,0,119
1311748,103,23,1910,7,female,936,764,333,340,590,340,372,0,218
1823587,15,12,1998,8,female,577,830,560,351,193,0,71,351,122
1637901,108,31,1905,10,male,1022,783,389,347,152,65,86,282,66
1946973,83,30,1930,4,female,1559,746,210,361,450,0,155,361,295
1347844,21,5,1992,1,female,68,807,430,365,2153,46,1014,319,1139
1939477,103,31,1910,12,male,841,808,258,365,379,124,238,241,141
1657048,18,7,1995,4,female,299,766,269,355,478,287,239,68,239
2097990,15,21,1998,8,male,512,833,667,364,79,362,58,2,21
1167209,16,1,1997,1,male,260,798,720,357,190,357,132,0,58
1773766,19,3,1994,8,male,317,789,653,352,143,352,104,0,39
1104037,21,9,1992,7,male,472,739,367,360,115,360,99,0,16
1951131,37,20,1976,12,female,637,796,551,368,97,368,63,0,34
1681055,101,1,1912,1,male,1829,771,440,370,409,44,181,326,228
1231910,18,24,1995,9,female,396,833,671,382,89,244,71,138,18
1485883,20,28,1993,3,male,364,783,599,380,417,227,292,153,125
1965989,20,9,1993,4,female,570,783,337,392,597,264,308,128,289
1194657,21,26,1992,3,male,462,771,429,383,747,192,553,191,194
1347288,38,13,1975,1,female,1102,739,415,379,780,222,445,157,335
1778055,69,12,1944,11,female,1831,723,282,375,1096,256,510,119,586
1974946,18,25,1995,12,female,414,725,589,375,418,318,263,57,155
2055156,22,28,1991,12,female,1056,754,298,384,485,342,292,42,193
1128832,17,10,1996,8,female,186,752,533,375,372,375,229,0,143
1739227,23,1,1990,1,male,472,739,628,383,444,383,438,0,6
1113043,68,17,1945,8,male,979,830,363,371,334,371,300,0,34
1511411,89,31,1924,1,male,1353,732,285,390,730,390,233,0,497
1476069,14,29,1999,6,female,369,753,563,414,122,33,18,381,104
1012669,95,29,1918,12,NA,2228,830,383,413,506,0,243,413,263
1417982,18,4,1995,10,female,495,814,665,412,192,147,84,265,108
2000477,39,27,1974,2,female,816,722,346,395,274,170,110,225,164
1945867,76,19,1937,3,male,949,742,275,420,387,263,153,157,234
1322004,22,31,1991,3,female,1113,810,530,416,212,411,193,5,19
1375262,80,6,1933,9,male,1372,762,438,421,223,374,182,47,41
1047028,22,3,1991,5,female,253,809,281,405,376,302,223,103,153
1736988,103,11,1910,11,female,1175,834,399,416,540,392,263,24,277
1621774,22,4,1991,1,male,896,816,699,407,333,407,281,0,52
1185734,23,21,1990,7,female,599,831,486,413,441,413,202,0,239
1176927,43,19,1970,8,female,1735,823,542,411,491,411,263,0,228
1322783,16,13,1997,5,female,103,801,415,409,1737,409,1334,0,403
1138544,103,28,1910,1,female,307,826,464,409,1033,409,930,0,103
1587953,14,18,1999,4,female,280,831,215,430,228,22,133,408,95
1321567,15,8,1998,11,female,511,782,469,429,368,267,191,162,177
2161632,15,21,1998,2,female,824,795,324,441,537,239,325,202,212
1343749,18,6,1995,9,female,357,825,655,442,610,267,419,175,191
1915661,23,30,1990,5,female,991,754,435,435,487,283,124,152,363
1273436,19,11,1994,3,male,538,736,425,442,688,302,383,140,305
2042075,20,12,1993,6,female,719,753,559,447,431,332,248,115,183
1754865,20,19,1993,9,female,1723,755,344,426,477,393,302,33,175
1736166,28,24,1985,5,female,775,823,494,446,556,406,303,40,253
1748557,68,27,1945,4,NA,1862,790,435,422,425,410,318,12,107
2170423,19,11,1994,8,female,306,723,364,428,642,409,350,19,292
1894728,33,1,1980,1,male,807,802,565,440,698,333,391,107,307
1231366,19,5,1994,1,male,634,765,497,424,290,424,240,0,50
2182507,38,17,1975,8,female,329,768,250,444,414,444,370,0,44
1828552,106,7,1907,7,male,209,780,667,450,317,450,202,0,115
1480383,16,28,1997,10,female,497,805,611,481,217,87,127,394,90
1224015,23,23,1990,6,male,306,738,585,475,770,80,252,395,518
1281598,20,7,1993,4,male,597,812,661,458,223,213,127,245,96
1371282,98,20,1915,1,male,2167,772,670,480,129,429,91,51,38
1215945,15,2,1998,2,male,900,723,440,469,595,379,318,90,277
1789691,16,29,1997,9,female,446,822,380,480,343,373,101,107,242
1558835,17,5,1996,8,female,408,809,609,459,635,337,320,122,315
1755870,18,14,1995,7,female,622,768,153,476,509,443,350,33,159
1493623,23,30,1990,6,female,453,735,423,461,1237,427,498,34,739
1973803,18,19,1995,10,female,332,787,436,454,333,454,294,0,39
1533740,26,14,1987,4,female,345,778,593,470,452,470,250,0,202
1506737,94,12,1919,7,male,1177,759,651,455,374,455,194,0,180
1277749,23,31,1990,10,male,631,797,711,471,1569,471,977,0,592
2106450,30,1,1983,1,male,227,755,123,464,1021,464,900,0,121
1598201,35,2,1978,11,female,133,804,443,477,901,477,489,0,412
1007724,93,9,1920,12,female,1248,737,400,488,179,36,47,452,132
1417671,103,14,1910,4,male,1115,813,225,497,322,0,110,497,212
1327205,19,28,1994,12,female,172,746,649,501,856,380,285,121,571
1827518,19,4,1994,5,female,617,735,359,514,1409,482,869,32,540
1966588,29,18,1984,9,female,708,814,77,498,1101,414,341,84,760
1570677,46,9,1967,7,female,1286,774,572,491,1611,377,1152,114,459
2026409,16,10,1997,9,male,639,798,612,496,241,494,170,2,71
1178430,18,22,1995,8,female,423,759,213,512,773,509,449,3,324
1947852,23,9,1990,9,male,505,817,770,501,89,501,78,0,11
2186904,27,9,1986,8,male,961,738,456,486,122,486,109,0,13
2058817,31,14,1982,7,female,1550,828,161,488,253,488,166,0,87
1990323,108,5,1905,3,male,1655,731,228,492,230,492,200,0,30
1048824,18,11,1995,3,male,963,729,419,485,328,485,309,0,19
1655995,94,4,1919,1,male,463,748,466,507,397,507,339,0,58
1364155,25,1,1988,1,female,130,744,55,497,1698,497,1348,0,350
2015281,14,1,1999,11,female,670,825,516,528,669,372,425,156,244
1794260,17,27,1996,8,female,623,760,402,535,491,159,328,376,163
1880980,19,27,1994,7,male,393,741,554,520,371,187,314,333,57
1440166,22,30,1991,4,female,653,825,206,549,686,171,462,378,224
1882269,16,16,1997,10,female,637,833,450,549,1387,170,577,379,810
2071231,17,27,1996,4,female,39,725,483,525,1638,113,840,412,798
2174191,20,2,1993,11,female,384,730,550,520,50,470,38,50,12
1907884,18,11,1995,4,male,1219,735,258,560,775,553,720,7,55
1495098,18,28,1995,6,male,190,802,576,552,445,515,318,37,127
1404332,19,16,1994,6,female,1394,804,172,528,348,391,195,137,153
1513666,94,23,1919,5,female,484,833,509,534,353,420,122,114,231
1886864,18,11,1995,6,male,114,754,511,529,935,487,837,42,98
2027667,18,21,1995,7,male,465,792,689,558,1228,494,952,64,276
1871081,26,17,1987,9,male,424,794,602,554,1055,523,893,31,162
1071412,103,10,1910,10,male,1323,750,489,607,15,0,3,607,12
1408644,19,20,1994,2,female,588,770,518,579,701,163,333,416,368
1395478,18,20,1995,9,female,258,737,132,576,1362,382,990,194,372
1941278,61,2,1952,8,female,662,834,451,586,1219,224,620,362,599
2150556,17,4,1996,4,female,651,809,615,582,263,481,224,101,39
2039547,18,18,1995,1,female,316,737,541,590,484,590,437,0,47
2152114,19,7,1994,1,female,660,818,443,571,486,571,370,0,116
2168089,22,20,1991,4,female,551,774,262,637,753,94,294,543,459
1999764,57,31,1956,7,female,1309,790,126,622,195,150,146,472,49
1999752,24,25,1989,4,male,636,751,617,619,458,306,284,313,174
1875344,93,1,1920,9,female,2087,816,331,649,441,448,229,201,212
1706044,21,23,1992,11,female,589,821,319,643,1585,200,674,443,911
1981134,22,7,1991,9,male,548,774,291,662,1225,319,468,343,757
2190599,20,14,1993,7,female,1124,724,354,660,852,540,726,120,126
1685623,21,2,1992,4,male,196,774,546,610,550,595,343,15,207
1765643,23,9,1990,5,female,100,779,664,658,549,639,280,19,269
1969298,37,21,1976,5,female,654,739,147,646,1705,500,597,146,1108
1453471,29,24,1984,6,female,693,729,152,619,822,619,627,0,195
1083984,19,27,1994,4,female,571,759,582,696,287,66,110,630,177
1025793,108,29,1905,12,female,1506,824,392,709,424,40,140,669,284
1007756,19,10,1994,9,female,452,733,222,711,562,442,301,269,261
1869752,16,12,1997,2,female,183,808,255,694,744,677,623,17,121
1007390,48,23,1965,5,female,1560,749,124,685,689,685,603,0,86
1774248,108,18,1905,10,female,1089,834,300,684,789,684,420,0,369
1167374,18,16,1995,8,male,426,831,587,698,1908,698,1499,0,409
1568788,17,19,1996,8,male,172,793,768,748,601,59,318,689,283
2154246,15,25,1998,1,female,839,821,470,762,155,428,56,334,99
2157042,20,5,1993,5,female,423,746,530,752,1087,321,547,431,540
1745327,23,21,1990,10,female,501,812,309,768,528,373,332,395,196
1390792,24,20,1989,8,male,161,824,632,727,722,390,438,337,284
2129676,42,3,1971,2,female,1439,769,386,732,791,431,125,301,666
1945430,14,6,1999,10,female,377,785,626,752,671,656,314,96,357
1350848,24,12,1989,6,female,1330,724,256,740,594,695,378,45,216
2158739,23,19,1990,2,male,485,825,744,794,75,794,62,0,13
1444628,16,25,1997,8,male,309,780,673,795,189,795,178,0,11
1285965,17,16,1996,4,female,362,817,499,783,425,783,258,0,167
1930667,23,16,1990,9,male,270,773,655,770,259,770,222,0,37
2090680,18,10,1995,10,male,310,802,361,746,2618,746,2241,0,377
2101049,30,26,1983,9,female,659,779,408,801,1467,98,539,703,928
1074199,51,27,1962,10,female,1599,727,399,870,500,209,128,661,372
1425271,96,28,1917,1,female,1838,820,397,843,1005,245,322,598,683
1935080,82,2,1931,11,female,1879,733,522,820,1559,414,1109,406,450
1419518,20,10,1993,1,female,200,747,388,818,264,644,98,174,166
1401022,23,9,1990,12,male,226,745,251,853,1156,792,508,61,648
1721232,100,23,1913,10,female,1561,764,467,872,820,863,391,9,429
1199457,22,15,1991,9,female,459,817,127,857,1432,829,857,28,575
2109781,32,30,1981,9,female,504,732,527,803,3328,611,1698,192,1630
2112202,24,4,1989,2,female,233,747,419,869,961,868,484,1,477
1531056,23,21,1990,11,female,1223,808,405,847,1317,844,584,3,733
1419220,28,14,1985,11,male,371,801,670,871,222,871,200,0,22
2020722,103,21,1910,8,male,733,732,300,874,750,874,616,0,134
1780565,19,10,1994,5,female,442,793,280,904,969,147,700,757,269
1377726,20,7,1993,1,female,1084,743,367,889,1823,172,646,717,1177
1642058,18,24,1995,2,female,1462,807,540,901,271,319,177,582,94
1212433,25,15,1988,4,female,553,765,525,905,404,398,133,507,271
1911539,15,17,1998,5,female,895,739,313,923,912,459,425,464,487
2147294,24,20,1989,4,female,639,745,170,930,845,591,294,339,551
1244961,26,19,1987,12,male,451,768,533,913,304,864,208,49,96
2050088,26,8,1987,10,female,629,817,475,911,293,897,265,14,28
1202263,15,18,1998,2,female,265,798,164,938,1061,767,555,171,506
1897401,19,19,1994,11,female,381,832,621,957,1258,836,756,121,502
1252927,32,3,1981,5,female,1261,824,335,937,607,911,258,26,349
2000040,17,1,1996,11,female,58,744,653,883,2034,794,1520,89,514
2141816,103,30,1910,6,male,1049,739,458,898,383,894,353,4,30
1913222,22,9,1991,4,female,614,749,444,969,750,967,505,2,245
2042631,17,26,1996,1,male,530,791,568,926,203,926,194,0,9
1155418,17,20,1996,1,female,402,776,127,901,441,901,376,0,65
1282967,20,25,1993,8,female,415,831,459,897,316,897,269,0,47
1945168,22,12,1991,6,male,416,757,722,905,524,905,263,0,261
1993481,36,16,1977,8,male,448,824,691,945,496,945,233,0,263
1157580,100,9,1913,2,male,1059,778,547,986,355,986,341,0,14
1260277,18,19,1995,9,female,623,761,513,899,558,899,462,0,96
1441616,27,2,1986,4,male,126,724,698,905,973,905,882,0,91
2018914,13,2,2000,2,female,332,826,495,1024,683,125,145,899,538
1220184,20,1,1993,7,male,893,748,471,1069,1454,2,655,1067,799
1513654,15,23,1998,12,female,317,735,265,1063,611,359,192,704,419
1143777,19,19,1994,3,female,592,749,309,987,1080,278,594,709,486
1222625,16,19,1997,10,female,1042,756,439,1078,1709,748,1012,330,697
1674584,17,14,1996,8,female,401,818,395,1016,261197,659,131244,357,129953
1866690,18,7,1995,1,female,208,766,340,1057,1925,459,580,598,1345
1762527,19,9,1994,2,female,250,735,329,1005,1056,878,781,127,275
1156238,23,8,1990,8,male,695,820,486,1078,92,1078,92,0,0
1739926,68,2,1945,4,male,681,773,469,1129,172,1129,156,0,16
1432172,26,2,1987,3,female,322,723,62,1058,2872,1058,1728,0,1144
1019649,59,23,1954,6,female,1112,830,638,1267,86,0,27,1267,59
1834220,19,11,1994,11,female,462,808,445,1210,697,35,271,1175,426
1884243,45,22,1968,6,female,622,727,516,1144,1083,20,449,1124,634
1134298,52,3,1961,9,male,581,781,368,1204,1416,143,241,1061,1175
1014219,21,28,1992,11,female,374,820,720,1288,686,678,523,610,163
1023232,17,15,1996,1,male,788,772,466,1194,943,594,397,600,546
2010401,20,10,1993,3,female,1278,829,544,1214,1839,484,1155,730,684
1737239,18,27,1995,3,female,1117,797,211,1246,278,1224,175,22,103
1322722,55,30,1958,7,female,1674,822,405,1193,464,1132,248,61,216
1694978,108,16,1905,2,female,285,817,495,1265,989,1163,643,102,346
1777964,21,1,1992,7,female,634,787,329,1169,1777,944,1499,225,278
1620096,34,8,1979,8,female,340,725,519,1240,1927,1005,1438,235,489
1456056,19,6,1994,9,female,873,808,510,1160,179,1153,110,7,69
1255844,19,1,1994,6,female,1069,750,140,1260,1271,1249,1055,11,216
1325379,23,8,1990,4,male,449,793,439,1210,188,1210,72,0,116
1031900,108,9,1905,4,male,1316,806,560,1138,163,1138,141,0,22
1042126,14,3,1999,4,male,256,821,469,1185,573,1185,505,0,68
1371935,68,5,1945,4,male,858,767,554,1202,249,1202,182,0,67
1924320,97,6,1916,6,male,1213,819,527,1206,696,1206,647,0,49
1641844,20,7,1993,5,female,380,796,333,1222,1311,1222,1128,0,183
2154974,17,12,1996,2,male,356,763,607,1387,562,0,231,1387,331
2165066,34,23,1979,7,female,969,728,527,1402,289,56,102,1346,187
1181061,14,28,1999,9,male,159,829,715,1335,1060,164,206,1171,854
1933472,18,5,1995,11,male,1161,815,584,1340,1031,180,372,1160,659
1422125,27,3,1986,5,female,1097,771,447,1396,1174,220,735,1176,439
1975088,80,13,1933,4,female,1104,758,387,1338,879,261,458,1077,421
2159008,44,27,1969,8,female,454,826,434,1511,2634,134,122,1377,2512
2041163,14,28,1999,3,female,211,786,244,1441,650,970,445,471,205
1227971,14,9,1999,1,female,977,772,188,1414,1047,544,821,870,226
2155419,21,2,1992,8,female,216,806,374,1380,1679,276,1118,1104,561
1739457,45,23,1968,8,female,1832,741,299,1310,1782,906,299,404,1483
1639723,50,4,1963,11,male,1056,741,486,1434,1566,373,926,1061,640
1175119,108,24,1905,11,female,749,722,298,1400,2387,410,603,990,1784
2026244,15,3,1998,8,female,1168,734,464,1293,1260,968,800,325,460
1164305,16,7,1997,9,female,238,760,188,1404,1194,1237,637,167,557
2097682,17,16,1996,6,female,1151,767,386,1315,1182,1198,994,117,188
1444436,18,18,1995,3,female,303,751,473,1471,1184,1394,802,77,382
2053483,21,23,1992,12,male,219,834,680,1347,3020,1161,1850,186,1170
1722871,63,16,1950,4,male,727,799,544,1420,86,1419,79,1,7
1970642,15,19,1998,11,male,689,730,270,1388,519,1382,205,6,314
2009928,108,10,1905,9,female,1118,831,359,1351,517,1348,231,3,286
1868367,56,28,1957,3,female,1562,743,309,1319,1363,1319,714,0,649
2074097,15,1,1998,3,female,111,818,274,1570,2333,143,445,1427,1888
1616828,58,28,1955,8,female,1689,819,565,1669,228,1011,125,658,103
1368621,28,27,1985,5,female,513,787,446,1635,760,437,295,1198,465
1007094,35,6,1978,6,female,489,740,495,1713,809,1233,618,480,191
2157418,21,28,1992,12,male,920,795,373,1626,1744,965,399,661,1345
1007387,21,8,1992,10,female,842,752,421,1679,1252,898,492,781,760
1850997,34,13,1979,1,female,1025,770,377,1675,1586,630,460,1045,1126
1469257,61,12,1952,7,male,657,732,601,1684,3010,737,1430,947,1580
1192287,17,29,1996,10,male,476,834,670,1643,112,1593,95,50,17
2117480,17,6,1996,6,male,396,807,597,1838,736,1819,578,19,158
1835116,19,8,1994,8,male,406,744,471,1628,353,1417,285,211,68
1997959,23,13,1990,2,female,489,740,57,1551,548,1350,525,201,23
1453561,27,7,1986,8,male,527,804,719,1685,544,1456,427,229,117
1102930,17,5,1996,11,female,239,743,131,1694,1434,1502,930,192,504
2138601,16,9,1997,3,female,174,733,140,1583,1076,1196,464,387,612
1905121,18,15,1995,3,male,348,735,530,1752,1273,1637,566,115,707
1220547,20,30,1993,11,female,626,812,364,1711,1251,1677,657,34,594
1302407,58,6,1955,8,female,1167,778,567,1677,1297,1328,529,349,768
1576560,59,24,1954,12,female,2348,772,296,1822,556,1819,325,3,231
1586826,16,22,1997,9,female,200,737,507,1628,436,1628,294,0,142
1327814,17,28,1996,8,male,493,780,618,1586,642,1586,431,0,211
1559207,20,29,1993,1,male,357,774,474,1830,680,1830,355,0,325
1288815,52,24,1961,4,female,884,802,556,1637,834,1637,462,0,372
1129963,27,5,1986,5,male,108,783,641,1869,1788,1869,1708,0,80
1541248,68,17,1945,8,male,472,754,401,1634,1371,1634,1069,0,302
1649398,72,2,1941,11,female,1300,827,299,1530,1305,1530,995,0,310
1571469,18,11,1995,6,female,287,763,389,1936,2643,261,981,1675,1662
2002335,71,5,1942,3,male,750,722,574,2227,1594,0,250,2227,1344
2026591,13,4,2000,3,female,130,817,290,2037,2484,1064,1890,973,594
1851094,14,24,1999,6,female,414,774,397,1952,1076,1541,444,411,632
1255913,15,2,1998,1,male,237,767,597,1919,595,1686,479,233,116
1498975,15,17,1998,5,female,296,756,353,1944,702,1424,377,520,325
2094366,17,24,1996,9,male,325,831,584,2100,723,1954,576,146,147
1859564,20,29,1993,11,female,378,722,454,2227,899,2169,628,58,271
1705214,22,16,1991,8,female,531,796,631,2270,1083,1832,832,438,251
1980431,18,26,1995,6,female,717,809,354,2015,1459,1851,446,164,1013
1959033,44,8,1969,6,female,28,752,653,2156,3157,1583,1471,573,1686
1123706,18,12,1995,3,female,558,767,360,1994,3495,1623,2485,371,1010
1284102,26,26,1987,4,female,322,739,557,1979,781,1979,555,0,226
1124035,17,15,1996,2,female,173,792,391,1976,1768,1976,1574,0,194
1769001,27,17,1986,6,female,62,830,714,2211,1527,2211,1150,0,377
1413186,91,10,1922,7,male,462,759,521,2032,1355,2032,1306,0,49
1149300,24,7,1989,3,female,2,834,104,2169,5404,2169,1520,0,3884
2011687,16,20,1997,1,female,478,778,270,2504,514,111,297,2393,217
1506794,18,16,1995,9,female,788,744,459,2576,947,66,212,2510,735
1561685,21,13,1992,9,female,390,824,537,3556,2116,479,1009,3077,1107
1004475,22,4,1991,2,male,474,729,569,2747,643,141,505,2606,138
1210008,49,21,1964,9,female,719,795,573,2586,2497,215,1138,2371,1359
1652451,19,7,1994,10,female,321,773,617,3114,439,1004,284,2110,155
1718830,28,21,1985,12,female,847,753,464,2612,1272,908,476,1704,796
1804650,13,17,2000,9,female,40,826,442,2507,1873,1179,1183,1328,690
1452932,17,22,1996,3,female,1312,729,341,2669,2998,1915,1420,754,1578
1262968,19,21,1994,2,male,497,812,624,2581,2674,1142,1026,1439,1648
1780277,25,10,1988,2,female,809,764,312,3326,4551,2045,2558,1281,1993
1953841,24,18,1989,4,male,404,820,696,2731,305,2659,266,72,39
1790181,16,2,1997,11,female,464,754,362,2944,1289,2904,1010,40,279
1477333,18,16,1995,12,female,769,759,357,2418,678,2386,595,32,83
2172403,20,23,1993,9,female,703,751,516,3345,2029,2744,624,601,1405
1254469,39,28,1974,7,female,321,767,365,3191,1250,3134,652,57,598
1762512,88,3,1925,9,male,1832,824,535,2694,1396,2589,1210,105,186
1488669,15,25,1998,11,female,648,808,465,3504,3023,3246,1822,258,1201
1639000,14,2,1999,4,female,273,833,425,2613,2112,2321,1543,292,569
1148615,18,26,1995,11,male,331,818,436,2383,1894,2353,1349,30,545
1723806,20,26,1993,11,male,871,755,373,2826,2478,2430,1675,396,803
1926242,22,6,1991,2,female,25,750,401,2997,1874,2868,1251,129,623
1718591,21,4,1992,3,male,170,743,560,2453,881,2453,795,0,86
1655486,23,10,1990,10,male,361,727,533,2960,756,2960,604,0,152
1142566,19,8,1994,1,male,286,739,480,3257,3037,3257,1809,0,1228
1445913,28,6,1985,6,female,51,773,170,3542,2366,3542,1959,0,407
2107795,65,12,1948,8,female,395,793,466,2436,4192,2436,3766,0,426
2163713,17,5,1996,10,female,73,775,403,6976,2736,0,683,6976,2053
2104503,67,31,1946,1,female,1143,751,347,13622,2299,2545,1875,11077,424
1513900,17,17,1996,9,male,242,813,504,9965,8042,534,3133,9431,4909
1930221,18,27,1995,1,female,182,730,499,5652,3486,1088,3241,4564,245
1002588,17,11,1996,10,female,346,777,434,14050,8212,3423,5041,10627,3171
1475433,18,6,1995,12,female,159,784,571,5001,7467,2952,4911,2049,2556
1715584,27,23,1986,10,female,2047,830,546,4599,4033,3153,1095,1446,2938
1369400,15,2,1998,10,female,780,725,317,4596,1310,3650,766,946,544
1984566,18,22,1995,4,female,1288,808,353,4179,2318,3704,1184,475,1134
1193132,71,3,1942,11,female,307,722,508,5669,1730,4857,535,812,1195
1664534,17,4,1996,10,female,164,734,46,6403,6146,6212,5174,191,972
1087348,19,5,1994,2,female,189,746,525,3887,2069,3858,1764,29,305
1889021,20,10,1993,10,male,330,801,485,4270,2195,4249,1717,21,478
1668072,25,1,1988,7,male,542,798,436,10773,2204,10748,2108,25,96
1076331,15,30,1998,12,female,420,811,453,3943,4443,3937,2250,6,2193
1092280,21,2,1992,2,female,390,726,380,5326,900,5326,747,0,153
1234286,23,7,1990,11,male,372,741,517,5438,1438,5438,1183,0,255
1393420,23,25,1990,10,male,430,742,587,3955,1726,3955,1361,0,365
1274062,24,1,1989,1,male,336,747,594,4402,1484,4402,830,0,654
1707261,24,27,1989,7,male,359,729,610,3809,698,3809,651,0,47
1457525,25,10,1988,10,male,130,810,490,4847,1816,4847,1699,0,117
1595110,19,29,1994,11,female,686,733,302,4219,4532,4219,4166,0,366
1614581,33,25,1980,11,female,275,732,35,6724,4264,6724,3442,0,822
1210836,14,14,1999,5,female,240,864,531,0,0,0,0,0,0
1205269,14,1,1999,8,female,325,950,71,0,46,0,35,0,11
1673194,16,5,1997,11,female,368,840,578,0,28,0,25,0,3
1435329,15,13,1998,4,female,299,894,225,0,0,0,0,0,0
1346751,16,29,1997,1,male,548,876,554,0,2,0,1,0,1
1204600,16,29,1997,4,female,368,914,127,0,2,0,2,0,0
1186964,16,3,1997,9,female,739,900,603,0,5,0,3,0,2
1871973,16,30,1997,10,male,390,964,821,0,15,0,11,0,4
2069833,17,20,1996,3,male,276,993,10,0,30,0,24,0,6
2169356,19,24,1994,12,male,554,927,832,0,37,0,15,0,22
1889401,18,25,1995,5,male,407,979,671,0,0,0,0,0,0
1025225,18,6,1995,5,female,362,877,316,0,0,0,0,0,0
1857073,18,9,1995,9,male,138,859,837,0,1,0,1,0,0
2094097,20,30,1993,11,male,299,899,668,0,40,0,38,0,2
1048995,19,22,1994,2,male,1086,988,904,0,0,0,0,0,0
1269513,19,3,1994,7,male,602,957,870,0,2,0,2,0,0
1201429,19,16,1994,7,male,516,936,847,0,1,0,1,0,0
1736821,21,18,1992,12,male,425,919,847,0,0,0,0,0,0
1732229,20,3,1993,4,male,558,904,831,0,0,0,0,0,0
1143814,20,7,1993,9,male,1061,905,543,0,1,0,0,0,1
2186544,21,27,1992,7,male,661,888,784,0,0,0,0,0,0
1393974,23,3,1990,11,male,617,995,892,0,0,0,0,0,0
1123911,22,7,1991,1,male,576,974,886,0,19,0,15,0,4
1454100,22,19,1991,3,male,517,958,919,0,50,0,29,0,21
1634658,23,14,1990,2,male,661,845,495,0,0,0,0,0,0
1193906,23,26,1990,9,male,1759,864,443,0,3,0,3,0,0
1802416,25,7,1988,5,male,511,873,752,0,0,0,0,0,0
1608581,28,17,1985,9,male,512,895,768,0,1,0,1,0,0
1666051,77,13,1936,10,female,1323,947,550,0,14,0,7,0,7
1796921,83,30,1930,8,male,1661,981,230,0,0,0,0,0,0
2107617,93,16,1920,11,female,563,941,303,0,8,0,2,0,6
2119666,24,13,1989,9,male,547,994,780,1,0,0,0,1,0
1988838,88,12,1925,12,male,1184,970,431,1,1,0,1,1,0
1780173,25,8,1988,4,male,1654,911,684,1,3,0,2,1,1
2000575,47,10,1966,10,male,507,876,745,1,2,0,1,1,1
1070766,55,10,1958,8,male,1585,976,25,1,4,0,3,1,1
1048596,18,21,1995,6,male,1210,894,206,1,0,1,0,0,0
2117599,19,16,1994,2,male,290,981,163,1,0,1,0,0,0
2065235,23,19,1990,7,male,1395,983,854,1,0,1,0,0,0
2123951,26,10,1987,5,male,421,899,871,1,0,1,0,0,0
1460161,18,4,1995,3,male,657,893,727,1,1,1,0,0,1
2128543,15,10,1998,12,female,570,965,412,1,4,1,3,0,1
1424557,14,18,1999,1,female,244,968,645,1,8,1,5,0,3
1501445,14,13,1999,4,female,287,895,768,1,3,1,3,0,0
1445714,17,30,1996,11,male,849,919,577,1,7,1,6,0,1
1763391,17,10,1996,3,female,617,928,277,1,165,1,144,0,21
1367969,19,13,1994,9,male,348,984,924,1,6,1,5,0,1
1846954,20,11,1993,5,female,273,867,186,1,16,1,12,0,4
2193273,28,13,1985,3,male,599,892,836,1,22,1,18,0,4
1102975,68,16,1945,1,male,1448,884,613,1,27,1,13,0,14
2084540,87,1,1926,6,female,728,951,620,1,9,1,3,0,6
2076495,93,20,1920,7,female,693,854,634,1,15,1,13,0,2
1587679,17,10,1996,1,male,815,862,572,2,19,0,7,2,12
1218883,102,18,1911,1,female,1069,952,800,2,0,1,0,1,0
2187808,25,10,1988,6,female,697,840,358,2,21,1,11,1,10
1363754,32,3,1981,2,male,1059,958,752,2,9,1,9,1,0
1188738,108,6,1905,10,male,1293,871,750,2,167,1,142,1,25
1409027,30,6,1983,2,male,489,873,779,2,1,2,1,0,0
1360805,68,25,1945,2,male,1159,840,805,2,1,2,0,0,1
1007307,100,21,1913,1,female,1568,913,427,2,1,2,1,0,0
2041916,18,19,1995,5,male,931,841,654,2,2,2,2,0,0
1848208,26,6,1987,11,male,327,855,678,2,2,2,1,0,1
1373164,15,22,1998,11,female,576,990,84,2,5,2,5,0,0
1766274,14,6,1999,2,male,388,875,720,2,38,2,30,0,8
1787740,18,10,1995,3,male,623,911,703,2,8,2,6,0,2
1139125,20,13,1993,8,male,645,849,751,2,103,2,90,0,13
2018887,22,1,1991,1,male,703,906,750,2,14,2,7,0,7
1447495,22,12,1991,5,male,630,836,655,2,83,2,53,0,30
1005881,23,2,1990,5,male,697,886,625,2,35,2,31,0,4
2148349,28,22,1985,12,male,696,991,639,2,25,2,18,0,7
1734593,94,2,1919,6,male,1259,897,214,2,7,2,5,0,2
1416902,103,2,1910,8,female,804,915,319,2,10,2,5,0,5
1091246,108,28,1905,12,male,1641,911,553,2,9,2,6,0,3
1813420,108,29,1905,6,female,1193,880,292,2,68,2,46,0,22
1328270,14,21,1999,1,female,345,855,299,3,18,0,10,3,8
1816664,55,9,1958,4,male,222,955,12,3,20,0,5,3,15
1071469,26,16,1987,1,female,470,857,771,3,5,1,5,2,0
1792838,57,12,1956,9,male,1571,862,230,3,0,3,0,0,0
1105789,15,25,1998,1,female,197,934,780,3,2,3,2,0,0
1291394,18,13,1995,5,female,1023,840,68,3,2,3,1,0,1
2025999,15,24,1998,8,male,65,928,910,3,40,3,34,0,6
1409260,19,27,1994,2,male,1065,955,734,3,7,3,6,0,1
1139487,23,21,1990,1,male,581,919,763,3,44,3,44,0,0
1110183,26,20,1987,9,male,1616,962,386,3,30,3,30,0,0
1847808,103,2,1910,1,female,1012,978,239,3,14,3,8,0,6
1180343,108,1,1905,3,female,1324,979,328,3,12,3,10,0,2
1871729,15,31,1998,8,male,619,865,744,4,20,1,19,3,1
1501162,107,1,1906,3,male,1100,844,536,4,2,3,2,1,0
1141480,24,10,1989,1,male,665,874,754,4,35,3,24,1,11
1475507,101,26,1912,5,male,925,907,578,4,5,4,5,0,0
1887264,20,15,1993,8,male,548,861,771,4,6,4,3,0,3
1878703,31,7,1982,12,female,1323,870,372,4,55,4,26,0,29
1896201,103,21,1910,6,male,1382,928,361,4,16,4,8,0,8
1730637,17,18,1996,1,male,221,926,889,5,0,0,0,5,0
1678912,69,11,1944,6,male,1597,839,465,5,14,0,3,5,11
1412639,14,17,1999,2,male,700,964,381,5,3,5,1,0,2
1494417,18,7,1995,7,male,1073,905,813,5,16,5,12,0,4
1396358,23,14,1990,6,female,264,873,155,5,37,5,29,0,8
1924454,24,16,1989,1,female,1365,943,132,5,118,5,78,0,40
1321766,105,19,1908,8,female,1072,950,294,6,17,0,10,6,7
1860063,19,6,1994,9,male,1446,882,706,6,8,6,7,0,1
1848281,23,20,1990,5,male,560,845,767,6,76,6,42,0,34
1801751,32,9,1981,1,male,351,835,679,6,35,6,24,0,11
1693446,22,10,1991,7,male,666,861,637,7,45,0,24,7,21
1032775,20,6,1993,6,male,451,858,799,7,2,5,1,2,1
1346335,19,24,1994,6,female,817,860,332,7,287,2,190,5,97
1836115,22,17,1991,4,male,383,985,916,7,19,2,6,5,13
1110877,17,25,1996,8,male,345,959,781,7,0,7,0,0,0
1367816,27,9,1986,7,male,779,899,807,7,0,7,0,0,0
1093608,103,29,1910,4,male,1393,846,536,7,7,7,6,0,1
1656083,21,28,1992,12,male,671,903,658,7,12,7,10,0,2
1326009,103,12,1910,12,male,1111,860,631,7,28,7,15,0,13
1711339,103,21,1910,5,male,697,890,591,7,19,7,19,0,0
1068497,23,6,1990,5,male,740,921,844,8,9,4,6,4,3
1940772,108,24,1905,8,male,1446,847,398,8,2,6,2,2,0
1578359,21,11,1992,7,female,567,852,457,8,11,8,5,0,6
1172261,14,5,1999,12,female,276,964,127,8,32,8,23,0,9
1409814,68,20,1945,11,female,767,985,286,8,27,8,20,0,7
1103525,103,10,1910,10,male,389,983,738,9,84,0,70,9,14
1096080,108,9,1905,7,male,1009,987,573,9,51,0,4,9,47
1752477,101,9,1912,5,male,1435,880,503,9,2,5,2,4,0
1213526,20,18,1993,4,female,802,924,741,9,12,2,4,7,8
1728248,108,10,1905,5,female,538,990,127,9,20,4,13,5,7
1468506,17,15,1996,2,female,522,883,17,9,7,8,1,1,6
1693930,14,8,1999,5,female,405,886,578,9,0,9,0,0,0
1367628,108,5,1905,1,male,890,903,587,9,0,9,0,0,0
2132506,18,15,1995,5,male,218,869,595,9,4,9,4,0,0
1389879,16,30,1997,9,female,491,977,695,9,7,9,4,0,3
1644878,15,24,1998,2,female,38,993,49,9,101,9,70,0,31
1834745,19,24,1994,12,female,426,953,788,9,31,9,19,0,12
2126710,19,22,1994,5,female,403,855,238,9,54,9,40,0,14
1428338,19,9,1994,6,male,452,873,569,9,311,9,170,0,141
1901364,24,12,1989,12,male,564,852,770,9,84,9,83,0,1
1294102,107,25,1906,6,female,1462,849,110,10,57,3,47,7,10
2173744,20,13,1993,11,male,855,934,845,10,28,8,26,2,2
1532261,24,2,1989,9,female,570,917,369,10,113,8,101,2,12
1066864,19,30,1994,4,female,412,936,730,10,10,10,9,0,1
1914232,103,29,1910,4,male,976,929,647,10,28,10,24,0,4
1976516,108,24,1905,2,female,1305,947,398,10,16,10,14,0,2
1109449,57,21,1956,9,male,580,921,674,11,40,2,11,9,29
1795512,110,24,1903,1,male,2420,885,428,11,10,5,7,6,3
1965293,68,5,1945,5,male,886,976,871,11,1,11,1,0,0
1576888,18,19,1995,12,male,603,865,152,11,42,11,35,0,7
1875464,17,4,1996,9,female,511,858,463,11,32,11,17,0,15
1254959,14,23,1999,11,male,213,854,522,12,268,1,139,11,129
1507207,15,15,1998,3,female,264,904,648,12,82,1,22,11,60
1906006,108,2,1905,4,female,1014,990,244,12,14,12,14,0,0
1989864,18,4,1995,12,female,448,872,175,12,30,12,25,0,5
1777560,20,28,1993,11,female,993,897,797,12,187,12,160,0,27
2173017,100,2,1913,3,male,1357,957,357,12,843,12,321,0,522
1222069,18,30,1995,12,male,578,990,867,13,13,1,7,12,6
1884906,19,21,1994,3,female,550,933,576,13,34,2,4,11,30
1131229,16,14,1997,4,female,598,987,633,13,82,13,68,0,14
1223549,22,12,1991,5,male,622,966,815,13,274,13,267,0,7
1352649,108,16,1905,11,male,525,846,706,13,27,13,26,0,1
1317564,15,16,1998,10,male,333,894,825,14,3,2,1,12,2
1520770,108,9,1905,2,male,1408,995,540,14,7,0,7,14,0
1034404,16,25,1997,5,male,789,900,684,14,54,13,48,1,6
1440517,15,26,1998,9,female,261,897,580,14,32,14,32,0,0
1795247,19,7,1994,3,male,664,937,681,14,30,14,29,0,1
1908610,53,12,1960,8,female,722,870,222,14,70,14,54,0,16
2009333,15,6,1998,3,male,769,978,623,15,0,0,0,15,0
1591278,68,17,1945,8,male,504,898,807,15,1,15,0,0,1
1061646,35,2,1978,2,male,694,987,905,15,20,15,17,0,3
1767419,19,17,1994,4,female,333,994,422,15,68,15,63,0,5
1251344,20,23,1993,2,female,771,898,160,15,515,15,319,0,196
1773495,22,29,1991,1,female,1547,892,191,15,218,15,115,0,103
1256012,35,5,1978,9,female,598,935,453,15,972,15,835,0,137
1434697,56,25,1957,7,male,915,954,537,16,4,4,1,12,3
1144970,96,2,1917,2,male,1680,914,445,16,12,15,8,1,4
1630718,91,22,1922,2,male,2205,932,319,16,44,12,35,4,9
1848318,16,13,1997,11,female,391,868,464,16,1,16,1,0,0
1838452,16,21,1997,3,female,231,848,621,16,0,16,0,0,0
1551138,19,29,1994,11,female,513,882,759,16,36,16,22,0,14
1193647,24,1,1989,6,male,1172,991,342,17,63,10,44,7,19
1066579,96,30,1917,11,male,822,840,492,17,4,17,4,0,0
1195583,22,1,1991,8,male,553,945,749,18,9,16,6,2,3
1543929,23,15,1990,5,male,641,838,707,18,6,18,6,0,0
1178141,17,16,1996,6,female,480,953,739,18,201,18,164,0,37
1123499,108,5,1905,2,male,864,966,522,19,20,19,18,0,2
1937176,19,4,1994,12,female,381,989,388,19,97,19,60,0,37
1729861,18,25,1995,9,female,528,842,580,19,44,19,43,0,1
1131537,21,12,1992,5,female,738,846,400,19,349,19,319,0,30
1331640,20,20,1993,8,female,416,888,286,20,21,0,10,20,11
1258572,71,11,1942,2,female,1364,903,25,20,2,16,1,4,1
1003518,103,6,1910,4,male,1266,903,728,20,22,17,16,3,6
1357339,103,1,1910,7,male,359,972,815,20,64,16,55,4,9
1286814,63,18,1950,7,male,1275,964,846,20,4,20,4,0,0
1338295,108,5,1905,9,female,2155,985,269,20,155,20,87,0,68
1355150,98,5,1915,4,female,1853,987,353,21,3,0,1,21,2
2028350,14,8,1999,5,female,291,925,819,21,11,8,6,13,5
1276503,106,20,1907,8,male,991,929,336,21,3,21,3,0,0
1287781,18,10,1995,1,female,232,970,681,21,48,21,18,0,30
1364804,25,31,1988,12,male,706,892,819,23,0,4,0,19,0
1657301,15,25,1998,11,female,576,910,319,23,183,9,55,14,128
1995366,98,30,1915,11,female,1989,878,166,23,2,18,1,5,1
1537060,19,9,1994,1,male,676,993,624,23,10,23,4,0,6
1506763,22,24,1991,11,male,453,872,795,23,17,23,9,0,8
2133830,74,25,1939,11,male,1485,881,538,24,8,0,6,24,2
1419990,18,14,1995,8,female,822,956,230,24,50,24,33,0,17
1666960,22,10,1991,5,male,394,844,704,24,220,24,204,0,16
1032955,22,10,1991,6,male,1422,846,434,24,40,24,34,0,6
2022661,23,1,1990,2,male,421,884,668,24,54,24,39,0,15
1363258,20,7,1993,1,male,1030,860,483,25,5,3,3,22,2
2048046,68,20,1945,4,male,1005,980,642,25,68,25,49,0,19
1348065,19,18,1994,11,male,456,883,682,26,74,17,52,9,22
1658634,108,5,1905,3,male,1315,917,411,26,11,25,5,1,6
1245479,18,4,1995,3,male,389,855,763,26,0,26,0,0,0
1862800,25,21,1988,2,male,1127,837,462,26,29,26,26,0,3
1536238,31,1,1982,11,male,1446,880,324,26,97,26,85,0,12
1764271,100,13,1913,10,male,1460,965,565,26,140,26,110,0,30
1233839,18,14,1995,8,male,290,862,677,27,4,27,2,0,2
1524141,103,15,1910,12,female,820,992,277,27,14,27,9,0,5
1270282,68,8,1945,5,female,1089,930,428,27,34,27,30,0,4
1684585,17,20,1996,12,female,438,928,810,27,265,27,166,0,99
1285537,22,22,1991,6,male,1438,899,752,28,26,14,15,14,11
1162702,15,14,1998,2,female,453,961,787,28,75,14,48,14,27
1824287,18,19,1995,5,male,552,920,818,28,80,28,80,0,0
1050035,108,8,1905,3,male,1586,951,193,29,3,6,3,23,0
1970816,68,4,1945,10,male,1720,975,710,29,55,29,44,0,11
2101598,19,14,1994,3,male,413,888,226,30,172,2,60,28,112
1688844,14,31,1999,10,female,293,860,698,30,52,29,17,1,35
1134354,18,13,1995,5,female,548,867,532,32,4,0,0,32,4
1411916,15,16,1998,5,male,861,969,784,32,31,2,12,30,19
1150097,20,26,1993,2,male,840,870,626,32,6,26,4,6,2
1174549,108,31,1905,1,male,831,882,541,34,23,5,20,29,3
1377062,19,1,1994,2,male,410,981,741,34,169,4,136,30,33
2121569,68,5,1945,1,male,751,855,757,34,1,34,0,0,1
2154738,19,4,1994,6,female,484,859,515,34,399,34,300,0,99
1978493,103,4,1910,9,male,1701,876,407,36,90,14,53,22,37
1972097,107,22,1906,7,male,1523,852,668,36,56,19,55,17,1
1532585,32,2,1981,3,male,501,971,60,36,70,33,62,3,8
1278377,103,4,1910,11,male,1265,853,659,35,73,30,42,5,31
2002902,23,6,1990,12,male,744,928,641,35,0,35,0,0,0
1135142,25,22,1988,6,male,665,987,705,36,1,36,1,0,0
1678191,103,15,1910,7,male,1011,877,673,35,5,35,3,0,2
2003934,19,24,1994,4,male,464,857,751,37,8,0,3,37,5
2062775,29,19,1984,2,male,371,862,789,37,4,37,1,0,3
2192259,22,22,1991,6,male,586,882,648,37,11,37,11,0,0
1258444,49,1,1964,9,male,1156,868,623,37,7,37,5,0,2
1061368,68,28,1945,5,female,430,923,321,37,45,37,39,0,6
1207439,103,5,1910,10,female,1601,986,124,37,43,37,43,0,0
1810768,14,19,1999,1,female,528,866,391,39,409,3,205,36,204
1588058,24,23,1989,7,male,815,856,306,38,71,13,60,25,11
1212850,28,1,1985,1,male,680,880,802,38,88,25,35,13,53
1608739,18,22,1995,2,male,576,916,701,38,14,38,9,0,5
1409311,18,6,1995,1,male,775,849,599,38,166,38,134,0,32
2070328,20,19,1993,3,male,589,993,886,38,218,38,198,0,20
1347785,14,8,1999,4,male,366,952,665,42,62,30,39,12,23
2088381,17,15,1996,11,male,563,973,820,41,61,11,15,30,46
1800375,20,26,1993,8,male,832,861,671,42,177,36,145,6,32
1550910,30,28,1983,7,female,739,890,530,41,84,38,31,3,53
1164116,19,2,1994,4,male,542,898,747,42,8,42,8,0,0
1916919,108,30,1905,6,female,1083,901,609,41,41,41,29,0,12
1562478,18,21,1995,7,male,214,897,625,41,113,41,94,0,19
1724567,17,17,1996,9,female,697,945,575,43,44,23,25,20,19
1174206,15,14,1998,6,male,459,896,647,43,63,38,10,5,53
1909370,17,18,1996,4,male,801,982,726,43,30,42,20,1,10
1678196,24,9,1989,3,female,484,851,611,44,63,44,45,0,18
1935708,21,30,1992,7,female,403,861,587,43,114,43,79,0,35
2011685,82,31,1931,5,male,1164,924,534,45,64,33,18,12,46
1700721,15,19,1998,4,female,628,981,131,46,44,0,25,46,19
1797123,19,13,1994,8,female,510,955,284,47,53,30,31,17,22
1665839,34,23,1979,11,female,734,879,513,47,48,32,25,15,23
1942957,17,22,1996,2,female,706,909,171,46,55,36,36,10,19
1450632,16,26,1997,4,female,582,962,600,47,230,45,139,2,91
1299300,108,22,1905,2,female,1073,912,51,46,59,46,47,0,12
1207733,17,15,1996,11,female,738,881,536,47,103,47,89,0,14
1370888,79,6,1934,3,female,1450,954,59,47,168,47,136,0,32
1276570,18,12,1995,7,male,853,837,259,49,57,4,11,45,46
2173780,50,11,1963,9,NA,2129,863,389,49,781,24,327,25,454
1924598,19,8,1994,4,male,235,874,708,48,3,48,3,0,0
1640702,27,17,1986,3,male,1096,846,654,49,144,49,136,0,8
1046334,100,25,1913,5,female,1479,879,173,49,221,49,194,0,27
1226910,24,18,1989,12,male,293,844,198,51,2,51,0,0,2
1542425,16,13,1997,10,female,700,853,533,51,163,51,96,0,67
1906766,22,21,1991,8,male,571,905,149,51,268,51,233,0,35
1048752,18,1,1995,3,male,446,986,378,53,160,53,132,0,28
1235996,20,22,1993,7,female,368,987,476,52,298,52,201,0,97
1009909,15,2,1998,4,female,574,845,255,55,190,2,108,53,82
1612877,97,22,1916,12,female,1684,882,365,55,17,41,13,14,4
1811600,68,6,1945,11,male,1015,933,797,55,5,55,3,0,2
2048271,18,26,1995,5,female,253,891,247,54,13,54,11,0,2
1252684,15,6,1998,3,female,74,838,445,54,109,54,86,0,23
1926430,23,27,1990,10,male,1406,988,532,55,423,55,340,0,83
1135173,108,30,1905,1,male,1074,914,814,56,68,0,51,56,17
1346099,17,14,1996,2,female,446,914,557,56,85,7,30,49,55
1785588,93,16,1920,1,female,1972,913,63,57,64,50,55,7,9
1180027,103,21,1910,11,male,664,989,936,57,103,57,99,0,4
1752840,108,6,1905,10,male,1656,930,578,59,51,2,21,57,30
1305302,16,13,1997,7,male,440,846,690,60,37,42,23,18,14
1183964,20,20,1993,9,male,918,889,776,59,50,34,34,25,16
1330013,102,6,1911,6,female,1228,910,619,60,1,52,0,8,1
1297598,25,22,1988,4,male,1340,840,123,60,36,57,26,3,10
2086265,21,2,1992,12,female,551,918,458,60,110,53,54,7,56
1666204,68,20,1945,4,male,1507,862,180,60,99,59,43,1,56
1713136,106,9,1907,6,female,822,838,284,59,60,59,45,0,15
1497395,21,3,1992,12,male,281,976,880,59,376,59,301,0,75
1129202,23,6,1990,6,male,437,908,681,60,270,60,242,0,28
2051271,68,29,1945,11,female,422,892,602,60,138,60,133,0,5
1459536,50,22,1963,7,male,1581,906,403,63,8,0,6,63,2
1628858,19,20,1994,2,male,373,920,868,63,23,0,14,63,9
2067343,108,22,1905,10,male,753,931,643,62,46,0,12,62,34
1540617,15,21,1998,9,female,426,977,642,61,4,28,2,33,2
1035351,67,1,1946,2,male,401,905,834,62,7,28,5,34,2
1389736,103,14,1910,7,male,1169,850,480,62,7,21,7,41,0
1691870,91,17,1922,9,male,2197,937,497,62,12,32,4,30,8
1543251,16,19,1997,10,male,797,946,749,61,251,59,168,2,83
1811052,28,5,1985,1,male,591,891,771,63,123,52,83,11,40
1444391,24,7,1989,4,male,777,918,726,63,18,63,18,0,0
1890736,19,11,1994,9,male,312,837,787,63,87,63,78,0,9
1336621,68,22,1945,7,male,584,838,285,62,71,62,54,0,17
1778597,19,26,1994,7,female,1056,851,724,61,231,61,207,0,24
1678161,24,25,1989,12,female,758,951,204,65,318,16,210,49,108
1293093,29,10,1984,11,male,1147,986,716,65,61,65,51,0,10
1982311,21,6,1992,10,male,1326,877,618,66,147,6,90,60,57
1654051,19,7,1994,10,female,402,870,731,67,113,50,84,17,29
1100249,103,7,1910,4,female,1443,931,159,68,181,56,124,12,57
1662503,103,20,1910,10,male,1423,914,735,68,34,68,33,0,1
1619065,108,10,1905,12,female,498,934,359,67,26,67,25,0,1
1467083,18,1,1995,9,female,225,907,418,66,203,66,187,0,16
1221826,20,3,1993,2,male,412,913,701,66,1971,66,1676,0,295
1499956,21,1,1992,1,female,1159,995,209,66,153,66,116,0,37
1656971,24,15,1989,2,male,601,893,660,67,155,67,134,0,21
2076189,25,28,1988,2,female,434,892,690,67,242,67,192,0,50
2156105,100,18,1913,1,female,1064,874,623,68,113,68,82,0,31
1210711,21,12,1992,4,male,669,915,820,69,14,0,4,69,10
1206010,18,23,1995,10,female,168,921,662,69,154,4,92,65,62
1758555,15,21,1998,6,female,350,875,449,69,204,39,50,30,154
1417024,103,8,1910,9,female,1862,879,431,70,134,14,40,56,94
1298024,18,11,1995,6,male,182,993,671,70,378,61,291,9,87
2162406,98,16,1915,11,male,1116,936,448,69,44,69,38,0,6
1958098,18,5,1995,1,male,312,850,73,73,13,0,5,73,8
1985857,16,23,1997,5,male,580,895,541,74,77,22,38,52,39
1785310,17,9,1996,5,female,205,957,226,73,66,72,37,1,29
2122912,21,12,1992,10,male,762,955,785,74,67,74,53,0,14
1435765,22,20,1991,7,male,969,836,596,76,7,0,2,76,5
1475321,18,27,1995,3,male,329,853,736,76,80,6,48,70,32
1984059,19,17,1994,3,male,645,909,780,77,87,77,79,0,8
1423433,68,17,1945,8,male,561,841,555,75,50,75,34,0,16
1386791,20,9,1993,8,female,117,880,847,75,144,75,118,0,26
1362781,25,9,1988,9,male,831,933,853,80,194,52,141,28,53
1554863,18,11,1995,6,male,652,870,563,78,17,78,10,0,7
1111584,18,27,1995,3,male,286,847,735,78,409,78,255,0,154
1575726,23,17,1990,8,male,434,908,508,84,889,15,435,69,454
1302609,16,21,1997,10,male,484,855,693,81,40,25,27,56,13
1810017,19,2,1994,2,male,476,852,794,81,5,81,4,0,1
1368487,15,3,1998,5,female,345,892,620,87,370,48,273,39,97
1433137,19,17,1994,2,male,406,994,730,86,129,51,90,35,39
1851362,16,14,1997,6,female,934,858,142,87,195,70,175,17,20
1073279,103,16,1910,1,male,476,892,630,86,26,86,25,0,1
1684754,19,9,1994,11,male,598,873,688,86,55,86,49,0,6
1443297,18,23,1995,4,female,334,858,331,85,109,85,76,0,33
1485915,20,2,1993,9,female,336,920,276,91,122,64,57,27,65
1563714,20,31,1993,8,female,339,843,372,89,684,82,238,7,446
2153967,15,6,1998,12,male,342,978,806,89,35,89,13,0,22
1491207,108,2,1905,8,female,2654,949,355,93,30,84,27,9,3
1741103,108,22,1905,3,male,1442,880,448,95,74,78,47,17,27
1158103,18,7,1995,8,female,544,855,467,93,194,83,113,10,81
1147582,104,29,1909,10,female,1326,842,18,92,192,78,102,14,90
2116067,73,2,1940,3,male,1196,917,748,93,121,93,101,0,20
1410162,16,11,1997,8,female,270,936,292,94,567,94,548,0,19
1678062,18,23,1995,3,male,385,850,426,99,305,66,262,33,43
1369928,17,9,1996,8,female,394,885,540,99,130,77,76,22,54
1186987,23,20,1990,2,female,272,964,99,97,73,87,46,10,27
2149255,18,7,1995,6,male,476,877,793,99,5,99,4,0,1
1735709,101,12,1912,12,female,1439,937,703,97,50,97,37,0,13
1394473,23,7,1990,8,male,529,892,744,97,68,97,63,0,5
1797412,103,10,1910,12,female,207,841,149,98,259,98,172,0,87
1086831,108,14,1905,4,female,1563,891,266,104,210,39,137,65,73
1061101,28,28,1985,9,female,329,915,805,103,61,101,37,2,24
1819129,14,29,1999,3,female,647,894,654,100,61,96,43,4,18
1216466,14,16,1999,7,male,318,950,783,104,202,83,160,21,42
1943829,18,26,1995,7,male,786,978,387,101,136,101,92,0,44
1796297,39,15,1974,11,male,1462,956,579,106,41,0,18,106,23
1564041,18,17,1995,4,male,539,994,222,107,45,35,26,72,19
1865678,21,28,1992,6,female,658,838,344,105,75,40,47,65,28
1419553,105,9,1908,7,male,1319,899,221,105,148,28,66,77,82
1232748,26,18,1987,9,female,1545,898,252,107,269,71,137,36,132
1143020,21,14,1992,10,male,362,962,772,105,116,103,103,2,13
1163324,21,8,1992,7,female,134,961,455,106,701,88,556,18,145
1933431,15,22,1998,7,female,356,959,584,109,41,109,17,0,24
1869862,20,8,1993,3,male,359,902,668,105,57,105,51,0,6
1055099,18,7,1995,9,female,110,917,720,109,223,109,156,0,67
1257627,92,6,1921,10,male,455,969,745,110,67,10,23,100,44
1197382,102,1,1911,9,male,1978,841,442,113,116,0,17,113,99
2072942,20,4,1993,10,female,297,877,242,110,768,1,482,109,286
1927632,22,2,1991,8,female,1074,900,479,111,182,67,72,44,110
1562497,108,26,1905,3,male,801,838,668,112,48,112,46,0,2
2018681,17,7,1996,11,female,448,950,377,112,103,112,86,0,17
1366972,17,9,1996,10,male,599,936,798,112,69,112,60,0,9
1663333,16,10,1997,12,female,535,987,358,114,130,7,32,107,98
1482989,17,4,1996,9,male,1407,946,165,119,361,2,100,117,261
1234798,18,1,1995,4,female,159,909,373,117,206,82,178,35,28
2166804,19,1,1994,5,male,574,890,733,119,762,44,355,75,407
1545903,16,11,1997,8,male,406,909,634,117,169,95,90,22,79
1808498,103,28,1910,6,male,1426,861,333,117,137,115,123,2,14
1404097,102,26,1911,3,male,985,914,572,118,244,91,49,27,195
1462427,32,16,1981,10,male,284,908,602,119,39,119,30,0,9
2157205,18,17,1995,1,female,473,932,475,116,87,116,68,0,19
1561560,24,13,1989,12,male,1875,950,703,119,247,119,169,0,78
2156188,19,10,1994,12,female,805,971,184,122,221,78,210,44,11
1972221,40,19,1973,1,male,503,915,608,121,415,44,262,77,153
2071627,18,18,1995,3,male,397,891,785,123,47,123,23,0,24
1122158,15,21,1998,10,female,327,956,581,124,256,124,142,0,114
1864924,19,5,1994,1,male,829,880,730,129,169,13,45,116,124
2084975,15,10,1998,6,female,273,901,279,130,339,47,201,83,138
1825611,20,10,1993,9,female,930,854,270,130,372,103,277,27,95
1883062,21,18,1992,8,male,604,916,423,130,24,130,23,0,1
1220138,24,17,1989,7,male,1360,956,711,127,29,127,25,0,4
1699018,19,26,1994,6,male,527,920,504,128,100,128,65,0,35
1463533,24,25,1989,2,male,340,890,338,126,266,126,126,0,140
1688807,14,7,1999,12,female,296,945,306,132,110,64,35,68,75
1876896,15,19,1998,11,female,392,965,180,135,493,56,225,79,268
1516320,18,24,1995,10,male,1441,876,366,132,322,66,173,66,149
1602681,25,7,1988,12,male,695,927,576,132,0,132,0,0,0
1684354,27,6,1986,7,female,1675,920,117,134,71,134,60,0,11
1571968,20,3,1993,3,female,483,950,169,133,306,133,196,0,110
1396929,68,2,1945,12,male,508,961,855,132,1485,132,1172,0,313
1204454,100,15,1913,4,female,2308,899,407,137,191,51,87,86,104
1346524,18,11,1995,1,male,179,899,194,138,508,67,257,71,251
2180356,20,11,1993,9,female,349,957,113,143,1245,79,243,64,1002
1881220,21,8,1992,3,male,734,991,499,138,676,61,540,77,136
1675019,38,28,1975,2,female,1327,898,522,143,98,126,53,17,45
1690487,17,3,1996,3,male,565,928,650,137,515,101,462,36,53
1503512,19,1,1994,9,male,122,938,167,143,1196,123,457,20,739
2181149,28,11,1985,11,female,1349,874,553,137,324,130,172,7,152
1909262,21,18,1992,1,female,368,902,153,138,221,138,157,0,64
2008976,103,29,1910,5,male,1316,889,438,138,226,138,183,0,43
1918947,20,14,1993,2,female,940,908,434,146,79,71,50,75,29
2052585,106,8,1907,4,female,2282,986,422,146,103,91,97,55,6
1875765,25,6,1988,2,male,284,986,234,144,281,53,204,91,77
1442490,108,1,1905,7,NA,1332,967,537,150,1311,76,671,74,640
2188598,68,14,1945,3,female,1546,843,483,150,126,117,57,33,69
1104584,23,29,1990,9,male,426,848,723,148,382,148,284,0,98
1220674,100,20,1913,3,male,1433,955,576,146,838,146,590,0,248
1989048,19,8,1994,11,male,181,937,389,155,57,2,8,153,49
1877524,64,3,1949,4,female,551,892,578,153,26,0,2,153,24
2090270,108,25,1905,7,female,1269,873,291,156,34,139,16,17,18
2012562,16,10,1997,8,female,355,969,770,153,201,113,115,40,86
1170160,93,9,1920,1,male,2362,923,256,151,152,146,124,5,28
1179776,21,27,1992,5,male,1117,968,555,151,414,146,310,5,104
1260699,95,30,1918,1,female,2019,881,482,151,479,110,303,41,176
1962760,102,9,1911,8,female,1641,961,397,157,613,147,442,10,171
2142499,19,17,1994,10,male,188,913,773,155,77,155,53,0,24
1170109,23,14,1990,2,male,485,873,791,154,58,154,55,0,3
1328786,55,2,1958,8,female,361,930,694,156,1057,156,955,0,102
1929099,103,28,1910,8,male,1540,847,506,156,400,156,240,0,160
1866594,20,27,1993,9,male,371,867,793,163,160,63,66,100,94
1139579,103,24,1910,11,male,1487,893,487,164,218,48,91,116,127
1926744,22,2,1991,4,female,438,894,531,160,50,160,36,0,14
1976706,14,24,1999,10,female,241,846,54,162,239,162,209,0,30
1376567,16,18,1997,8,female,373,930,817,162,297,162,150,0,147
1864238,22,29,1991,9,male,809,975,736,164,276,164,245,0,31
1952598,23,6,1990,5,male,650,941,594,160,1041,160,677,0,364
1827559,20,6,1993,7,female,682,956,635,172,122,123,73,49,49
1729275,19,27,1994,10,female,985,843,520,169,417,98,125,71,292
1502580,14,11,1999,12,female,83,961,158,167,1246,139,595,28,651
1433333,18,29,1995,8,female,429,868,417,169,487,151,435,18,52
1545166,23,14,1990,1,male,263,909,244,170,638,168,450,2,188
1120951,19,10,1994,9,male,598,927,797,175,26,12,15,163,11
1312518,18,21,1995,1,female,561,883,303,177,252,120,97,57,155
1702102,18,8,1995,8,female,643,970,682,179,422,109,255,70,167
1900471,18,4,1995,10,male,530,991,330,181,685,80,358,101,327
1704087,20,15,1993,12,male,345,850,757,174,291,125,183,49,108
1252092,24,15,1989,12,female,1543,906,157,179,351,125,112,54,239
1439131,100,16,1913,10,male,1495,872,528,181,500,77,229,104,271
2134091,20,1,1993,10,female,383,958,444,180,70,157,53,23,17
1454214,15,19,1998,11,male,477,893,837,180,201,149,121,31,80
1674131,17,18,1996,7,female,858,835,386,178,124,159,74,19,50
1801035,58,30,1955,5,female,1786,990,565,176,150,171,77,5,73
1022541,106,21,1907,9,male,1721,922,522,174,124,140,109,34,15
1009870,107,5,1906,1,female,637,953,794,176,180,158,38,18,142
1673985,20,16,1993,1,male,674,892,734,175,561,128,333,47,228
1285873,23,18,1990,9,male,777,869,776,175,100,175,87,0,13
1464830,31,15,1982,6,female,668,905,748,179,840,179,633,0,207
2116635,16,5,1997,7,female,671,890,281,186,199,24,53,162,146
1693988,25,1,1988,5,male,558,979,704,185,82,115,63,70,19
1033677,108,20,1905,7,male,912,930,581,189,120,98,53,91,67
1733983,17,20,1996,4,female,460,866,574,183,422,100,274,83,148
1588587,21,21,1992,11,male,218,919,260,184,387,112,172,72,215
1861466,15,17,1998,6,female,268,913,408,186,657,163,519,23,138
1039318,22,28,1991,5,female,477,930,703,187,322,166,130,21,192
1043240,15,15,1998,7,male,688,887,736,186,27,186,25,0,2
1119923,68,26,1945,3,female,352,846,483,183,74,183,65,0,9
1276215,94,18,1919,6,male,1279,928,830,185,99,185,71,0,28
1728595,24,10,1989,10,female,1595,899,352,190,221,190,175,0,46
1068965,108,20,1905,9,male,1573,840,360,187,231,187,221,0,10
1650468,17,22,1996,5,male,671,839,565,193,223,190,76,3,147
1117841,16,2,1997,3,female,525,854,426,192,339,154,188,38,151
1329043,100,5,1913,9,female,1559,969,423,196,361,187,337,9,24
1154245,26,9,1987,9,female,684,867,756,200,252,199,189,1,63
1193653,16,1,1997,5,male,567,993,765,192,146,192,84,0,62
1438274,18,24,1995,11,male,489,845,600,193,414,193,322,0,92
1772718,86,11,1927,7,male,1952,888,673,202,61,6,22,196,39
1588493,103,2,1910,1,male,796,923,528,208,149,110,53,98,96
1464504,108,21,1905,5,male,1940,886,209,204,128,135,114,69,14
1070774,17,1,1996,8,female,293,881,574,204,394,97,243,107,151
2062485,94,28,1919,11,male,2058,922,625,210,97,157,77,53,20
1882253,14,10,1999,4,female,349,866,669,202,827,202,530,0,297
1502339,17,8,1996,10,male,153,861,716,204,1058,204,984,0,74
1906911,20,1,1993,8,female,363,993,453,203,636,203,610,0,26
1776428,20,25,1993,1,female,677,988,565,213,327,0,154,213,173
2095297,103,5,1910,10,male,858,868,633,221,477,31,158,190,319
1303577,17,16,1996,9,male,526,989,658,218,66,166,41,52,25
1279777,16,5,1997,3,female,578,963,287,216,80,216,68,0,12
1579502,25,4,1988,4,male,378,975,759,213,79,213,73,0,6
1636509,19,19,1994,4,male,709,972,795,213,166,213,145,0,21
1395639,56,11,1957,9,female,1189,985,404,220,367,220,266,0,101
1511187,17,11,1996,4,male,392,840,762,233,52,22,27,211,25
1734595,58,8,1955,9,female,923,943,90,226,1516,1,903,225,613
2092258,113,20,1900,6,male,2131,971,518,227,353,30,121,197,232
1900754,18,14,1995,9,male,654,974,640,233,87,59,63,174,24
1660436,61,19,1952,9,female,481,866,394,223,639,66,221,157,418
1036376,95,14,1918,5,female,2630,909,535,227,157,201,126,26,31
2074452,33,9,1980,2,female,1410,865,215,224,270,224,183,0,87
1670686,94,17,1919,10,male,2544,867,403,227,190,227,133,0,57
1128394,23,27,1990,4,female,236,894,111,223,655,223,545,0,110
1858229,17,20,1996,5,male,429,887,571,238,10,68,4,170,6
2104751,21,13,1992,6,female,1473,982,253,244,92,148,41,96,51
1385601,21,30,1992,3,male,1534,865,608,245,183,100,126,145,57
1922831,15,15,1998,7,female,737,866,517,236,362,122,139,114,223
1692455,19,16,1994,11,male,442,925,825,237,375,137,93,100,282
2005340,18,17,1995,9,female,684,852,619,242,853,53,548,189,305
2140418,17,25,1996,10,female,555,907,345,244,104,179,46,65,58
1803519,16,14,1997,12,female,1336,984,392,239,364,173,294,66,70
1236290,68,29,1945,9,female,1360,978,670,245,202,244,148,1,54
1523121,16,18,1997,4,female,257,898,467,240,347,240,289,0,58
1356350,19,7,1994,11,female,247,904,704,237,516,237,390,0,126
1596476,16,25,1997,1,male,909,935,646,254,392,29,183,225,209
1655692,20,18,1993,10,male,423,972,863,257,137,115,52,142,85
1268436,15,5,1998,5,female,343,840,421,255,176,77,54,178,122
1726050,15,10,1998,7,female,454,888,575,258,271,158,40,100,231
1894921,23,29,1990,3,female,1641,853,283,260,167,119,19,141,148
1797419,83,15,1930,9,female,832,918,574,248,172,146,55,102,117
2111399,108,22,1905,2,female,980,936,274,249,238,166,173,83,65
2055620,14,21,1999,6,female,601,893,478,252,605,65,268,187,337
1309217,21,5,1992,8,male,693,885,406,249,408,170,209,79,199
1941191,38,25,1975,9,male,2027,993,587,256,240,191,142,65,98
2105799,100,31,1913,12,male,1299,965,608,257,229,252,167,5,62
2170012,23,11,1990,7,male,672,960,729,258,43,258,28,0,15
1442915,108,5,1905,2,male,1455,875,365,249,138,249,106,0,32
1265714,108,2,1905,11,female,1203,991,156,250,439,250,324,0,115
1044682,68,10,1945,5,male,1161,921,342,263,536,10,178,253,358
1990585,105,11,1908,8,female,1361,857,148,270,670,0,123,270,547
2090717,17,5,1996,6,male,1082,848,682,276,202,107,89,169,113
1991738,94,5,1919,11,female,1129,968,100,272,203,105,136,167,67
1728350,103,2,1910,1,male,910,882,530,269,411,185,124,84,287
1213712,18,26,1995,4,female,898,853,422,261,228,189,142,72,86
1669396,56,9,1957,5,female,1698,861,556,263,810,259,483,4,327
2108097,19,11,1994,4,female,588,870,547,270,91,270,70,0,21
1441976,30,3,1983,12,female,243,845,172,264,294,264,254,0,40
1085907,19,27,1994,7,female,504,952,284,263,750,263,679,0,71
1714511,19,20,1994,9,male,421,843,763,262,864,262,709,0,155
1325458,16,26,1997,9,male,535,910,312,290,623,25,171,265,452
2042512,68,28,1945,3,male,732,873,289,278,470,2,194,276,276
1268684,18,19,1995,5,male,503,841,338,284,239,183,143,101,96
1182093,22,30,1991,7,male,128,918,818,290,1197,134,871,156,326
1723684,29,6,1984,8,female,849,977,678,280,512,57,137,223,375
1509269,18,22,1995,8,male,891,895,299,278,93,275,62,3,31
1631822,16,18,1997,2,female,287,975,467,286,460,278,291,8,169
1879133,17,30,1996,9,male,406,898,716,285,117,285,29,0,88
1829650,100,25,1913,9,male,706,928,317,281,100,281,64,0,36
2122738,103,1,1910,10,male,963,869,729,290,81,290,69,0,12
1358236,19,11,1994,8,female,524,895,681,277,479,277,331,0,148
1307929,19,27,1994,10,male,945,886,383,287,434,287,324,0,110
1870815,108,16,1905,12,female,1538,876,514,279,467,279,256,0,211
2006369,21,13,1992,3,male,590,986,566,302,100,7,29,295,71
1757852,18,2,1995,8,male,281,973,461,295,157,177,105,118,52
2168964,18,11,1995,1,male,1022,980,601,296,461,203,156,93,305
1331204,15,17,1998,1,male,545,952,902,305,140,285,109,20,31
1497078,19,17,1994,10,female,1174,931,463,303,360,279,306,24,54
2105913,24,28,1989,3,female,2410,845,466,304,253,288,233,16,20
1729855,17,5,1996,9,male,589,925,762,308,472,225,338,83,134
1833030,18,9,1995,9,male,1671,931,148,298,524,225,398,73,126
1492710,17,12,1996,6,male,673,836,561,306,106,306,58,0,48
1080540,19,1,1994,3,male,566,933,714,295,83,295,34,0,49
1482048,61,29,1952,3,female,448,913,798,305,93,305,54,0,39
1773597,19,7,1994,6,female,372,864,155,293,248,293,211,0,37
1694341,19,23,1994,8,male,554,841,613,308,362,308,166,0,196
1341966,23,23,1990,10,male,408,878,570,299,192,299,187,0,5
1759415,26,28,1987,10,male,160,903,823,302,287,302,286,0,1
1389722,18,30,1995,7,female,121,853,590,298,1635,298,1124,0,511
1710601,20,11,1993,8,female,570,923,293,293,476,293,431,0,45
1948852,23,25,1990,11,female,413,921,232,294,575,294,536,0,39
1846158,47,26,1966,6,female,1293,969,691,316,129,5,36,311,93
1177968,111,28,1902,11,female,1294,914,630,326,96,0,14,326,82
1129251,19,7,1994,10,female,454,894,550,317,606,13,250,304,356
1461049,24,5,1989,9,female,442,909,520,327,214,91,52,236,162
1945703,18,2,1995,4,female,618,881,577,314,777,65,202,249,575
1372655,23,11,1990,10,male,692,979,684,321,378,250,212,71,166
2096854,26,23,1987,3,female,1490,992,366,309,872,291,524,18,348
1265798,103,13,1910,8,male,488,881,552,318,36,318,23,0,13
2040778,94,12,1919,10,male,1317,871,436,315,96,315,77,0,19
1151810,19,3,1994,8,female,841,879,576,324,200,324,129,0,71
1435344,31,23,1982,3,female,1229,979,707,321,214,321,186,0,28
1531763,23,26,1990,10,female,379,895,103,319,947,319,773,0,174
2163146,37,10,1976,4,female,237,851,488,337,921,53,321,284,600
1245028,26,20,1987,5,male,453,895,850,329,66,221,58,108,8
1107589,17,21,1996,2,female,668,880,511,343,249,178,112,165,137
1150444,21,8,1992,3,female,534,981,551,340,302,238,154,102,148
1732645,104,22,1909,12,female,1471,943,605,344,540,334,304,10,236
2158581,22,14,1991,5,male,566,854,760,333,178,333,168,0,10
1675123,52,4,1961,5,female,887,990,832,331,78,331,41,0,37
1008673,14,11,1999,12,female,216,993,294,368,307,147,82,221,225
1179211,27,10,1986,10,male,636,903,623,366,405,103,233,263,172
1883514,103,21,1910,8,male,133,944,216,355,448,131,225,224,223
1942019,20,18,1993,7,female,609,839,537,359,1077,142,632,217,445
1830555,51,25,1962,8,female,1744,920,422,357,668,172,234,185,434
2123961,22,26,1991,9,female,613,911,718,347,491,268,283,79,208
1544153,44,5,1969,8,female,1465,951,594,357,457,312,50,45,407
1565062,102,10,1911,4,male,602,985,736,367,935,354,635,13,300
1230864,21,18,1992,1,female,638,994,536,351,56,351,38,0,18
1742855,18,19,1995,12,male,359,848,752,349,205,349,181,0,24
1276500,35,23,1978,10,male,670,971,837,354,214,354,127,0,87
1751445,27,7,1986,5,female,484,927,669,365,528,365,484,0,44
1407083,18,9,1995,6,female,1722,990,555,385,347,63,154,322,193
1224745,42,22,1971,5,female,379,865,500,389,426,99,110,290,316
1170846,45,11,1968,1,female,1644,836,615,386,682,238,295,148,387
1950258,17,24,1996,4,female,606,909,358,393,1030,302,633,91,397
1085224,58,29,1955,1,male,1712,846,344,384,813,334,492,50,321
1164571,16,20,1997,10,male,566,942,324,370,221,370,152,0,69
1520019,18,8,1995,3,male,982,909,671,375,183,375,119,0,64
1144646,16,6,1997,2,male,486,946,512,372,472,372,411,0,61
1097370,54,4,1959,3,female,1448,915,660,391,901,391,795,0,106
1367006,101,6,1912,12,female,1145,929,538,386,807,386,473,0,334
1229156,17,1,1996,6,female,699,870,747,400,363,28,274,372,89
1271178,18,4,1995,3,female,1538,872,408,395,738,117,271,278,467
2079691,19,27,1994,10,female,828,931,397,416,937,281,439,135,498
1045080,63,2,1950,8,female,1076,914,567,397,607,85,218,312,389
1842852,15,11,1998,5,female,588,894,404,396,162,389,39,7,123
1475109,17,17,1996,12,female,634,980,757,412,240,299,107,113,133
1649066,16,11,1997,8,male,264,873,496,404,90,315,73,89,17
1343588,17,25,1996,7,female,368,970,552,397,587,292,137,105,450
1482349,18,13,1995,3,female,915,994,528,419,597,362,313,57,284
1840565,21,5,1992,11,female,629,870,567,404,475,357,319,47,156
1732043,50,12,1963,12,female,821,880,332,419,548,350,274,69,274
1312891,19,11,1994,11,female,464,841,545,415,861,378,652,37,209
2160507,23,5,1990,5,female,623,990,649,403,1516,363,612,40,904
1766963,102,11,1911,6,female,1508,908,360,410,742,309,464,101,278
2103109,28,1,1985,1,male,481,994,797,414,187,414,155,0,32
1607008,51,25,1962,3,male,1079,897,633,423,160,118,34,305,126
1818284,23,15,1990,12,female,560,970,478,445,980,237,611,208,369
1063782,16,5,1997,8,female,684,850,466,445,406,366,116,79,290
1624213,19,5,1994,9,female,653,850,566,444,474,420,420,24,54
1894144,18,30,1995,10,male,489,903,450,427,658,399,296,28,362
1680399,24,3,1989,7,male,365,917,851,422,224,422,213,0,11
2035747,100,31,1913,8,female,293,952,824,429,461,429,361,0,100
1213604,17,11,1996,4,female,411,991,396,444,717,444,460,0,257
1632857,19,7,1994,6,female,342,911,721,473,167,23,83,450,84
1278207,16,25,1997,6,female,560,868,368,478,411,0,296,478,115
1965927,18,6,1995,8,female,324,868,489,466,545,51,153,415,392
1742015,36,3,1977,5,female,604,894,620,473,355,4,135,469,220
1018796,108,14,1905,2,female,1826,898,620,479,306,4,173,475,133
1922050,16,4,1997,6,female,692,885,607,457,731,247,515,210,216
1955571,16,1,1997,8,female,290,855,490,452,542,396,403,56,139
1211705,18,25,1995,10,male,816,966,808,473,369,428,195,45,174
1447403,108,22,1905,11,male,1034,900,361,468,261,467,226,1,35
1951460,18,6,1995,2,female,247,858,55,454,1154,452,1081,2,73
1688300,43,29,1970,7,male,492,859,743,483,191,483,185,0,6
1852034,68,19,1945,1,male,715,844,391,483,90,483,69,0,21
1867810,54,3,1959,6,male,1655,890,651,454,547,454,239,0,308
1088981,16,22,1997,1,female,683,992,473,470,761,470,516,0,245
2163048,17,9,1996,6,male,479,907,685,514,180,142,130,372,50
1343370,18,25,1995,7,female,161,966,253,505,555,166,371,339,184
1213086,19,1,1994,8,female,915,972,224,493,394,287,117,206,277
1158541,23,21,1990,9,female,465,858,648,500,658,104,329,396,329
1370493,18,19,1995,4,female,552,918,178,500,175,397,98,103,77
1052421,16,31,1997,10,female,986,864,739,514,419,410,122,104,297
1157162,18,13,1995,11,female,696,971,418,508,495,368,271,140,224
1915431,29,11,1984,12,female,703,975,491,518,413,474,265,44,148
1592352,17,13,1996,3,female,368,947,688,506,3982,487,3710,19,272
1941901,19,4,1994,6,female,1092,915,526,513,2922,454,1901,59,1021
1557125,42,20,1971,2,male,1545,929,225,485,768,389,675,96,93
1947595,16,3,1997,12,female,571,840,455,495,787,494,572,1,215
1666482,17,4,1996,10,female,472,844,538,496,297,496,265,0,32
1728468,19,28,1994,8,male,557,986,545,494,821,494,748,0,73
1726072,14,6,1999,8,female,840,970,574,524,41,2,8,522,33
1190474,19,7,1994,1,male,564,994,729,560,1914,109,782,451,1132
1565765,65,2,1948,4,female,2376,945,289,533,1392,33,687,500,705
1171687,87,26,1926,6,male,1468,846,312,523,274,255,111,268,163
1835831,18,24,1995,3,female,613,918,356,555,659,160,225,395,434
1638580,25,26,1988,12,male,1549,941,360,533,431,393,195,140,236
1019712,20,20,1993,1,female,678,862,508,542,1376,533,548,9,828
1720052,20,7,1993,9,female,427,849,621,552,186,547,126,5,60
1059873,19,5,1994,5,male,664,977,879,529,53,529,43,0,10
1113495,17,27,1996,12,male,512,899,771,531,192,531,166,0,26
1547621,18,25,1995,12,male,533,966,851,523,232,523,188,0,44
1664001,24,8,1989,8,male,382,879,811,532,190,532,129,0,61
1010688,17,19,1996,11,female,693,943,248,539,659,539,543,0,116
2025624,18,10,1995,8,female,350,835,562,522,431,522,361,0,70
1561608,24,3,1989,9,male,1514,957,147,538,372,538,285,0,87
1475227,15,19,1998,5,female,469,886,125,537,1020,537,591,0,429
1212608,16,26,1997,4,female,465,970,750,528,1119,528,391,0,728
1085637,61,28,1952,8,female,904,883,574,581,285,22,54,559,231
1761658,28,23,1985,5,male,645,958,630,568,423,74,405,494,18
1056758,19,3,1994,6,female,138,844,371,605,312,397,196,208,116
1429186,14,1,1999,1,female,1281,987,604,606,419,141,143,465,276
1359850,15,18,1998,7,male,281,974,768,563,579,397,226,166,353
1659509,18,2,1995,8,female,724,893,449,586,833,153,248,433,585
1331557,23,27,1990,5,female,1961,874,358,580,1406,415,792,165,614
1970597,19,27,1994,9,female,340,884,505,595,727,531,302,64,425
1958197,113,7,1900,6,male,1473,947,442,571,478,561,368,10,110
2034163,19,7,1994,3,male,620,983,827,576,102,576,101,0,1
1187285,68,27,1945,5,male,732,889,519,567,345,567,335,0,10
1636974,18,20,1995,11,female,87,855,643,576,1620,576,1119,0,501
1038115,20,1,1993,8,male,474,921,857,644,75,4,59,640,16
1355934,107,11,1906,4,female,1956,846,284,644,342,0,141,644,201
1165674,16,18,1997,10,female,156,931,251,621,813,123,156,498,657
2099071,50,8,1963,1,female,1953,933,737,657,943,19,365,638,578
2018619,13,12,2000,1,female,449,930,524,634,802,402,273,232,529
1010317,15,11,1998,1,female,550,918,519,659,899,396,560,263,339
1280932,19,26,1994,8,female,1050,944,357,637,488,160,168,477,320
2065642,34,23,1979,11,female,567,969,598,648,595,345,276,303,319
2125725,16,6,1997,9,female,1267,935,550,620,1153,207,592,413,561
1800515,108,14,1905,11,male,1580,941,399,641,88,492,16,149,72
2180502,108,22,1905,7,female,1336,921,327,610,53,539,35,71,18
1406292,15,14,1998,3,female,291,904,446,618,828,589,706,29,122
1260308,22,24,1991,2,female,1841,993,375,635,865,593,399,42,466
2045879,15,14,1998,7,female,225,875,428,639,341,637,232,2,109
1850986,20,10,1993,8,male,349,917,709,620,191,618,140,2,51
1722281,103,1,1910,1,male,1191,897,539,640,371,639,273,1,98
1888742,17,1,1996,2,female,375,894,665,638,221,638,204,0,17
1615894,19,28,1994,9,male,381,982,900,649,341,649,205,0,136
1569589,21,2,1992,7,female,817,971,278,641,674,641,628,0,46
1799995,96,8,1917,10,male,1994,905,246,648,3423,648,2104,0,1319
2074221,18,11,1995,11,female,579,887,594,715,580,75,215,640,365
1083779,21,26,1992,8,male,415,858,554,673,1742,44,1124,629,618
1415431,17,19,1996,3,female,651,933,462,685,560,316,294,369,266
1818067,18,31,1995,1,female,1418,952,393,680,500,198,232,482,268
1721211,18,14,1995,6,female,460,845,584,704,486,282,280,422,206
1082171,21,9,1992,12,male,1525,942,362,698,1037,174,635,524,402
1211942,22,3,1991,4,female,164,921,773,705,1067,198,488,507,579
1803152,41,17,1972,10,female,521,929,126,723,2378,340,880,383,1498
1840928,19,15,1994,5,female,1273,899,313,670,553,669,370,1,183
1672140,15,26,1998,1,female,357,931,266,667,412,667,261,0,151
2085123,20,22,1993,1,female,412,946,660,708,558,708,429,0,129
2136698,23,19,1990,5,male,341,959,437,681,676,681,283,0,393
1551688,59,19,1954,6,male,684,954,629,671,499,671,297,0,202
1736644,108,7,1905,5,male,514,916,756,769,321,4,88,765,233
1527302,17,6,1996,4,female,868,884,417,753,755,139,313,614,442
1242084,18,15,1995,8,female,820,856,501,749,671,35,416,714,255
1555372,55,7,1958,4,male,798,843,728,786,251,513,133,273,118
1599384,14,5,1999,11,female,350,852,556,755,799,181,400,574,399
2156131,16,23,1997,8,female,515,967,255,762,599,222,411,540,188
1557179,17,8,1996,5,male,554,884,472,727,759,267,397,460,362
1682244,14,29,1999,12,female,16,847,558,737,1197,386,298,351,899
2097969,22,25,1991,9,female,367,977,692,754,5332,241,4356,513,976
1447423,25,5,1988,10,female,1771,966,527,781,1278,196,829,585,449
1389970,26,1,1987,2,female,549,966,127,781,1299,196,462,585,837
2135542,15,6,1998,8,female,400,942,519,763,397,667,165,96,232
2071084,16,22,1997,3,female,1420,930,466,753,708,681,452,72,256
1350465,18,17,1995,4,female,1153,936,351,739,533,675,512,64,21
2038354,19,4,1994,4,female,456,876,345,769,362,769,324,0,38
1891840,18,17,1995,2,male,590,966,686,816,1163,151,727,665,436
2075104,48,11,1965,5,female,472,911,663,823,590,73,338,750,252
2008961,13,9,2000,2,female,15,869,569,825,3228,119,1638,706,1590
1832921,26,3,1987,1,male,365,875,646,866,266,188,156,678,110
1140194,101,18,1912,1,male,1353,880,522,825,187,578,128,247,59
1201823,15,13,1998,3,male,363,918,809,878,546,296,342,582,204
1638747,18,29,1995,11,male,606,866,573,843,926,584,797,259,129
1204594,21,13,1992,6,female,846,883,297,835,1563,248,639,587,924
1513531,22,14,1991,4,male,201,884,538,799,2637,470,1702,329,935
1403408,22,4,1991,8,male,339,993,592,815,1362,330,522,485,840
1478071,18,6,1995,11,female,375,896,699,812,492,729,243,83,249
1378663,18,6,1995,5,male,1418,884,319,861,1036,697,484,164,552
2190378,19,2,1994,8,male,316,927,769,827,638,808,441,19,197
1020542,21,19,1992,11,female,942,863,589,813,1152,630,826,183,326
1664451,21,28,1992,5,male,751,983,659,845,969,647,829,198,140
1983879,19,11,1994,9,female,250,940,360,802,1359,759,946,43,413
1415388,20,7,1993,1,female,386,918,456,865,2072,856,1602,9,470
1418291,27,11,1986,3,female,1990,901,250,851,2310,666,1336,185,974
1812862,15,6,1998,1,female,601,938,394,827,1225,824,1042,3,183
1282390,47,25,1966,9,female,1502,954,353,825,1227,825,733,0,494
2143210,19,20,1994,8,female,170,922,721,975,1247,182,572,793,675
1601194,19,18,1994,10,female,492,887,581,969,449,591,249,378,200
1912842,14,17,1999,3,male,545,852,596,952,646,267,236,685,410
1959227,16,6,1997,7,female,654,915,367,888,749,423,605,465,144
1537568,18,21,1995,11,female,1002,866,352,931,1257,394,546,537,711
1310491,22,18,1991,1,female,712,897,545,922,1133,479,801,443,332
1242708,15,12,1998,10,female,543,959,676,942,1976,422,1223,520,753
1208816,19,29,1994,8,male,193,992,893,920,2395,366,514,554,1881
2137710,15,6,1998,3,female,390,862,298,889,807,726,784,163,23
1976629,18,5,1995,5,female,254,938,473,968,849,895,503,73,346
1745681,19,8,1994,5,male,458,948,780,925,676,789,536,136,140
2029860,20,2,1993,1,female,521,970,319,930,620,891,443,39,177
1815458,20,15,1993,3,female,601,874,112,947,917,889,374,58,543
1248988,24,10,1989,8,female,1120,851,460,908,1059,887,483,21,576
1952077,19,14,1994,9,male,319,908,485,965,2507,954,2072,11,435
2016439,16,16,1997,9,female,312,929,377,955,830,953,651,2,179
1763046,18,13,1995,10,male,414,979,575,961,969,955,619,6,350
1298011,20,26,1993,5,female,1650,885,462,908,637,904,368,4,269
1143407,61,13,1952,10,female,2329,843,213,949,640,943,425,6,215
1874930,15,22,1998,3,female,353,953,767,891,540,891,446,0,94
1961616,19,24,1994,10,male,398,884,836,880,456,880,302,0,154
2006370,108,11,1905,8,male,1624,949,487,924,709,924,525,0,184
1377138,24,22,1989,8,female,361,851,459,946,1966,946,1889,0,77
1467852,16,7,1997,8,female,664,987,736,1024,754,147,214,877,540
1578658,27,16,1986,5,female,176,877,598,1090,1573,197,728,893,845
1348644,39,7,1974,8,female,682,876,581,1009,1309,3,555,1006,754
1687994,19,21,1994,3,male,622,870,242,1039,2014,151,918,888,1096
1239286,20,25,1993,10,male,292,920,579,1088,1891,2,442,1086,1449
1130346,20,14,1993,7,female,788,838,462,1021,501,675,440,346,61
1072154,33,10,1980,9,female,2160,837,540,1005,337,670,236,335,101
1375876,20,29,1993,1,female,1096,886,510,1055,903,417,497,638,406
1754243,17,5,1996,7,female,323,853,435,1064,3148,287,959,777,2189
1154488,55,13,1958,1,female,1776,938,519,990,1967,686,930,304,1037
1759577,21,27,1992,5,female,1457,836,367,1050,486,845,305,205,181
1312095,15,22,1998,4,male,321,897,660,1075,967,1003,708,72,259
1505979,19,21,1994,1,female,398,934,460,1023,1240,806,655,217,585
1595387,19,30,1994,9,female,432,930,543,1083,1331,976,824,107,507
1648783,21,4,1992,12,female,698,995,540,1016,1021,753,504,263,517
1473690,16,6,1997,5,female,370,989,234,1037,1993,1024,1241,13,752
2167081,14,6,1999,9,female,420,883,631,1052,298,1046,170,6,128
1119495,19,30,1994,5,female,483,890,88,1031,1546,1029,523,2,1023
1085775,20,2,1993,2,female,596,888,508,1066,2021,1058,913,8,1108
1254117,68,24,1945,3,male,1099,924,634,1061,594,1061,480,0,114
1934710,97,31,1916,8,male,1640,936,551,1009,299,1009,253,0,46
1986553,22,23,1991,11,female,321,890,642,1081,1001,1081,965,0,36
1670156,43,1,1970,9,female,1197,892,614,1138,1650,11,813,1127,837
1401313,106,23,1907,9,female,1495,850,428,1266,1063,12,157,1254,906
1482065,15,24,1998,12,female,96,930,230,1148,2062,54,1575,1094,487
1311679,108,29,1905,1,male,1080,985,637,1203,187,380,123,823,64
1765555,20,16,1993,12,male,745,973,554,1254,742,460,171,794,571
1062366,19,28,1994,9,female,480,854,761,1247,268,700,133,547,135
1902872,15,25,1998,8,female,434,903,623,1229,1018,687,567,542,451
1509949,21,18,1992,5,female,766,953,221,1173,1106,433,244,740,862
1791543,18,14,1995,5,female,1063,870,375,1257,2380,562,1522,695,858
1389225,44,3,1969,8,female,162,944,814,1260,423,935,322,325,101
1600184,108,13,1905,5,male,1468,903,307,1241,485,1216,437,25,48
1681425,16,28,1997,10,female,695,940,461,1274,1107,1123,972,151,135
1800873,18,11,1995,3,male,445,896,745,1146,1029,860,544,286,485
2099561,21,1,1992,10,male,529,849,645,1189,835,867,653,322,182
1226039,24,19,1989,6,female,1360,854,417,1271,1520,1038,1004,233,516
1153196,19,8,1994,2,female,274,840,589,1229,3941,1226,2773,3,1168
1296487,68,22,1945,5,male,1022,912,796,1177,85,1177,71,0,14
1173534,14,13,1999,9,male,214,926,695,1155,544,1155,471,0,73
1899722,19,22,1994,2,male,516,888,633,1281,343,1281,281,0,62
1361701,108,18,1905,7,male,176,925,907,1158,538,1158,267,0,271
1065456,14,27,1999,2,female,420,850,413,1201,944,1201,796,0,148
2031675,26,3,1987,3,female,330,971,536,1137,1599,1137,998,0,601
1206311,18,2,1995,4,female,626,877,644,1382,695,130,363,1252,332
2188601,16,20,1997,7,female,423,928,631,1342,1261,157,376,1185,885
1119474,16,2,1997,9,female,307,851,639,1504,1183,8,84,1496,1099
1836352,19,18,1994,10,female,1032,932,492,1346,1849,171,572,1175,1277
1735886,19,21,1994,11,female,574,921,611,1487,2699,274,1520,1213,1179
1966720,58,4,1955,5,female,1861,957,543,1309,530,922,245,387,285
1721326,17,24,1996,1,female,482,915,586,1322,830,479,121,843,709
2026351,31,7,1982,6,female,1197,930,307,1452,996,564,785,888,211
1427355,47,24,1966,10,female,1759,920,311,1443,1372,632,1116,811,256
1828611,15,18,1998,11,female,237,914,510,1438,2274,891,1445,547,829
1683023,25,14,1988,10,female,1269,918,354,1384,6696,663,4105,721,2591
1504638,26,17,1987,9,female,1076,921,322,1289,2019,847,1824,442,195
1984739,17,8,1996,8,female,635,914,653,1295,606,1035,420,260,186
2011647,25,5,1988,8,female,1909,904,376,1511,900,1450,719,61,181
1585346,13,28,2000,1,female,169,861,498,1377,1852,1361,1693,16,159
1278395,15,24,1998,11,female,67,894,622,1421,1622,1344,1014,77,608
1274204,14,5,1999,1,female,81,883,389,1372,1490,1167,941,205,549
1605457,15,28,1998,9,female,887,985,610,1459,2178,1159,1062,300,1116
2125272,56,14,1957,3,female,1775,976,444,1437,1958,1392,774,45,1184
1407294,17,13,1996,1,female,32,952,289,1340,5018,1186,3929,154,1089
1142302,30,21,1983,11,male,403,874,691,1482,115,1482,98,0,17
2148905,24,16,1989,5,female,491,892,189,1472,479,1472,301,0,178
2006001,19,10,1994,11,male,380,955,822,1329,1459,1329,1380,0,79
1750066,23,1,1990,1,female,599,935,292,1389,860,1389,644,0,216
1387585,19,12,1994,1,female,424,925,767,1844,242,159,136,1685,106
1656687,23,2,1990,3,male,623,990,573,1606,908,204,429,1402,479
1492677,54,19,1959,6,female,1218,986,303,1595,1644,23,214,1572,1430
1716617,14,16,1999,2,male,261,872,710,1718,3870,84,2278,1634,1592
1769021,16,13,1997,12,male,380,902,814,1574,674,841,447,733,227
2152035,19,6,1994,6,female,151,855,669,1529,680,1054,595,475,85
1151745,18,18,1995,10,female,457,878,435,1856,1157,1313,508,543,649
1975459,17,4,1996,4,female,331,964,625,1596,2534,642,1440,954,1094
1710374,16,3,1997,12,female,396,951,674,1767,1069,1736,886,31,183
1850771,18,10,1995,4,male,205,871,541,1605,422,1312,271,293,151
1712217,23,9,1990,9,male,464,838,570,1554,730,1528,638,26,92
1508730,63,22,1950,5,female,362,869,409,1601,837,1520,625,81,212
1606214,17,29,1996,2,male,1141,869,639,1660,1425,1498,894,162,531
1910640,23,14,1990,11,female,593,977,758,1597,3363,1393,2713,204,650
2082228,23,22,1990,4,female,295,857,431,1562,1033,1559,427,3,606
1028269,15,9,1998,4,male,274,985,801,1823,640,1823,623,0,17
1892420,19,29,1994,5,female,512,994,488,1858,337,1858,258,0,79
1487522,103,14,1910,2,male,779,900,579,1637,506,1637,253,0,253
1441764,16,20,1997,2,female,511,852,562,1584,1922,1584,1637,0,285
2140404,103,2,1910,5,female,1266,986,499,1532,1157,1532,908,0,249
1148676,26,30,1987,5,female,295,905,404,1624,3174,1624,2630,0,544
1499506,28,30,1985,7,female,379,891,454,1899,321,246,172,1653,149
1622918,66,7,1947,4,female,1565,919,204,1958,991,0,124,1958,867
1232604,31,9,1982,10,female,1884,994,542,2120,2373,391,1825,1729,548
1377295,13,2,2000,5,female,494,994,734,2237,5055,68,2400,2169,2655
1194245,15,28,1998,2,female,610,846,361,1957,856,1140,545,817,311
1787854,15,13,1998,8,female,379,938,205,1979,1175,919,559,1060,616
1172761,14,22,1999,11,female,585,846,629,2041,2208,1337,1570,704,638
1026737,14,10,1999,12,female,279,955,371,1931,1255,813,541,1118,714
1930086,14,16,1999,1,female,281,955,396,2065,2493,541,699,1524,1794
1259677,16,19,1997,10,male,207,945,619,2195,2249,1143,1003,1052,1246
1743034,17,22,1996,4,male,89,949,609,1942,1727,1034,1335,908,392
1221584,18,22,1995,3,female,433,922,533,2035,2950,1467,1705,568,1245
1182199,19,11,1994,3,male,109,938,778,2094,2379,1156,1179,938,1200
1335059,19,11,1994,10,female,78,843,164,1920,2329,938,1852,982,477
1231302,23,7,1990,10,female,927,889,437,2009,1839,1409,1433,600,406
1592556,24,16,1989,10,female,375,923,516,1903,2053,1290,876,613,1177
1491057,19,24,1994,8,female,380,845,473,1892,4056,1285,1535,607,2521
1753675,16,29,1997,11,male,555,983,340,1965,782,1900,643,65,139
1336780,20,1,1993,1,male,271,984,822,2186,1196,2028,1094,158,102
1033792,21,10,1992,3,female,599,900,549,1907,951,1707,547,200,404
1077098,26,16,1987,5,male,348,890,784,2331,1072,2274,645,57,427
2048718,20,21,1993,10,female,205,965,221,2158,1793,2011,1371,147,422
1006319,46,21,1967,1,female,81,859,793,2094,2602,2059,2208,35,394
1310366,16,22,1997,9,female,43,850,479,2215,7040,1961,4295,254,2745
1862774,20,1,1993,8,female,150,955,130,1979,3498,1874,1913,105,1585
1880512,22,29,1991,1,female,944,954,441,2028,2823,2008,2133,20,690
1620277,15,8,1998,5,male,263,840,690,1972,320,1972,145,0,175
1704800,17,5,1996,7,female,415,923,102,2138,312,2138,243,0,69
1333148,17,14,1996,2,male,473,888,783,1921,346,1921,261,0,85
1786999,20,12,1993,9,male,405,982,713,2124,1506,2124,905,0,601
1464410,24,1,1989,12,female,472,842,158,2156,1941,2156,1602,0,339
2190564,59,4,1954,9,female,1524,949,321,2041,1247,2041,1161,0,86
1392388,20,23,1993,9,female,322,896,672,1979,5573,1979,5369,0,204
1268781,17,16,1996,3,female,796,936,293,2887,937,29,254,2858,683
1760642,18,11,1995,6,female,32,890,557,3051,1714,250,802,2801,912
1793807,22,12,1991,6,female,378,954,314,2527,1949,123,1042,2404,907
1531922,18,6,1995,3,female,219,867,530,2578,1415,1467,911,1111,504
1207948,20,3,1993,3,female,319,868,619,2961,598,2129,333,832,265
1488469,42,20,1971,11,female,641,967,383,2644,928,1076,337,1568,591
1500253,46,5,1967,1,female,1744,927,573,2962,616,1352,259,1610,357
2024446,84,22,1929,11,female,598,908,623,3529,1539,2447,1221,1082,318
1793964,14,18,1999,5,female,815,958,327,3168,4146,2024,3678,1144,468
1567231,19,26,1994,7,female,363,877,444,3198,1962,1927,918,1271,1044
2066050,26,2,1987,4,male,640,888,577,2402,1472,699,497,1703,975
1302319,28,15,1985,11,female,942,850,323,2745,1870,1452,526,1293,1344
1655748,41,12,1972,11,female,1610,930,471,2796,2069,1854,1106,942,963
1433932,21,30,1992,10,female,711,913,118,2962,4623,1366,2459,1596,2164
1723827,18,15,1995,5,male,1246,866,647,2855,668,2640,459,215,209
1858404,18,20,1995,9,male,242,842,594,2954,1383,2304,512,650,871
1549890,21,5,1992,5,female,190,975,141,3357,3744,2503,2485,854,1259
1061641,40,21,1973,1,female,715,909,386,2382,3203,1949,1529,433,1674
1328744,16,14,1997,3,female,255,888,424,2522,4308,2108,2489,414,1819
1343471,18,4,1995,9,female,260,922,548,2932,5300,2504,4182,428,1118
1453972,25,8,1988,12,female,1544,886,495,3387,5380,3051,3544,336,1836
1178301,16,27,1997,5,male,441,962,854,2408,395,2408,300,0,95
1405193,27,17,1986,8,male,735,872,779,3044,117,3044,108,0,9
1605384,18,29,1995,8,female,319,839,245,2504,1352,2504,1169,0,183
1121810,21,25,1992,5,female,289,961,657,2898,1136,2898,1056,0,80
1174089,28,28,1985,6,female,421,980,411,3204,914,3204,645,0,269
1948313,94,19,1919,9,male,263,860,748,3078,4159,3078,3200,0,959
2153948,30,28,1983,2,female,436,878,372,2468,4084,2468,3458,0,626
1045753,17,26,1996,6,male,297,984,655,6033,749,0,43,6033,706
1769162,59,29,1954,6,female,517,948,838,3833,533,205,296,3628,237
1122131,14,10,1999,4,male,337,978,263,3839,4583,420,1790,3419,2793
1492196,18,2,1995,10,female,494,934,361,4757,5310,596,1468,4161,3842
1801148,20,21,1993,5,female,761,909,110,6170,5862,1007,4783,5163,1079
2000518,26,16,1987,11,female,747,854,386,9013,7927,1728,4254,7285,3673
2190003,57,20,1956,7,female,722,903,259,9931,12489,1090,7305,8841,5184
1178137,18,24,1995,1,female,441,968,590,4521,3011,1100,947,3421,2064
2060817,18,9,1995,6,female,698,846,473,7382,4897,2998,3666,4384,1231
1237688,20,16,1993,12,female,337,853,353,4372,2868,1901,1849,2471,1019
2083921,23,1,1990,9,male,736,867,684,7151,5574,2452,1058,4699,4516
1359467,19,11,1994,6,female,173,869,385,3888,9403,1682,4597,2206,4806
1587929,15,14,1998,8,male,344,977,731,3651,2053,3510,1936,141,117
1710783,20,2,1993,11,male,1389,936,578,3718,957,2729,684,989,273
1140783,23,19,1990,9,female,112,840,769,4105,1741,3259,912,846,829
1535233,25,31,1988,10,male,407,929,739,4654,1862,3887,1381,767,481
1486893,31,2,1982,4,male,361,887,713,6895,4189,6575,2353,320,1836
1123124,17,17,1996,11,male,553,970,620,9116,11226,8546,8274,570,2952
2064896,16,7,1997,9,female,95,856,612,12848,9615,11921,7798,927,1817
1545563,17,4,1996,9,male,44,921,664,4415,2953,4303,2305,112,648
1178386,19,20,1994,8,female,359,941,434,4840,3301,4056,2019,784,1282
1086468,22,4,1991,8,male,458,880,314,10850,9087,10454,4399,396,4688
1730595,23,26,1990,8,female,80,914,607,4068,2834,3788,2294,280,540
1326675,16,29,1997,11,male,623,871,578,5490,2468,5487,1853,3,615
2157909,18,4,1995,8,male,448,900,868,3991,1307,3990,753,1,554
1751505,20,31,1993,3,male,501,983,640,6112,1616,6112,1308,0,308
1397067,26,5,1987,9,male,427,942,586,5443,1100,5443,1008,0,92
2155467,28,10,1985,10,female,248,836,411,5445,1910,5445,1335,0,575
1218924,34,4,1979,5,female,349,911,38,3722,1091,3722,947,0,144
1629444,68,4,1945,2,female,466,900,441,3953,1431,3953,1352,0,79
1494855,22,9,1991,7,female,420,934,827,6977,7296,6977,4806,0,2490
1035448,30,15,1983,6,female,275,908,242,4480,6363,4480,5727,0,636
1197369,84,30,1929,12,female,295,888,255,4597,3040,4597,2536,0,504
1952962,19,3,1994,9,female,453,1252,420,8,20,8,18,0,2
1537834,55,31,1958,12,male,1976,1238,531,8,29,8,26,0,3
1269788,18,15,1995,4,male,408,1098,844,9,607,6,377,3,230
1923460,15,11,1998,9,female,382,1217,596,9,127,8,48,1,79
1150783,16,10,1997,11,male,351,1048,627,9,53,9,40,0,13
1247603,17,19,1996,8,female,720,1053,267,9,153,9,123,0,30
1724238,22,9,1991,10,female,603,1056,140,9,272,9,180,0,92
1465182,30,1,1983,2,female,588,1138,540,9,102,9,92,0,10
1345525,73,29,1940,12,male,1485,1099,842,10,3,0,1,10,2
1816409,101,11,1912,6,male,1276,1129,98,10,33,0,20,10,13
2187568,15,9,1998,6,male,1152,1057,882,10,66,3,41,7,25
1987223,17,20,1996,7,male,223,1098,1024,10,65,4,55,6,10
1092567,21,26,1992,11,male,363,1046,937,10,221,5,188,5,33
1065366,14,22,1999,10,female,191,1012,142,10,33,8,23,2,10
1042778,34,27,1979,4,male,538,1093,900,10,8,10,8,0,0
1691106,19,1,1994,7,male,358,1256,1010,10,58,10,20,0,38
1001629,106,16,1907,8,male,844,1248,906,11,29,0,11,11,18
1452644,18,29,1995,7,female,432,1085,382,11,0,9,0,2,0
1478190,19,4,1994,3,male,610,1192,911,11,37,9,27,2,10
1111780,103,9,1910,7,male,1288,1216,966,11,20,11,17,0,3
1050765,17,15,1996,10,male,478,1128,819,12,6,6,5,6,1
1934588,22,25,1991,9,female,1126,1135,120,12,353,6,235,6,118
1497960,23,30,1990,6,male,356,1241,1065,12,11,11,11,1,0
1238375,48,23,1965,4,male,1303,1014,616,12,11,12,10,0,1
2151294,19,17,1994,1,female,369,1143,239,12,31,12,22,0,9
2103526,21,28,1992,7,female,828,1213,999,12,136,12,114,0,22
1384554,23,1,1990,8,male,538,1016,873,13,14,13,13,0,1
1489721,14,17,1999,6,male,488,1029,850,13,61,13,27,0,34
2005136,18,24,1995,10,female,104,1075,287,13,221,13,171,0,50
1664732,22,1,1991,4,male,430,1267,1149,13,28,13,25,0,3
1696285,24,2,1989,9,male,1164,1089,659,13,29,13,13,0,16
1134615,50,18,1963,4,female,558,1166,805,14,28,0,12,14,16
1970603,100,31,1913,12,female,1670,1044,258,14,13,3,5,11,8
1479893,24,24,1989,2,male,756,996,812,14,38,5,19,9,19
1584578,19,12,1994,4,male,601,1017,805,14,6,14,6,0,0
1981848,20,28,1993,8,male,1129,1176,176,14,8,14,4,0,4
1787190,18,8,1995,2,female,291,1221,721,14,175,14,150,0,25
1407156,21,1,1992,1,male,538,1097,951,14,41,14,36,0,5
1547940,23,14,1990,6,male,887,1139,890,14,247,14,219,0,28
1212317,63,24,1950,10,male,1546,1116,717,14,66,14,43,0,23
1428667,21,31,1992,7,female,270,1186,176,15,81,4,58,11,23
1790390,108,25,1905,9,male,1573,1102,373,15,14,15,3,0,11
2000695,16,30,1997,11,female,410,1004,804,15,27,15,22,0,5
2054692,24,24,1989,3,male,1427,1210,604,15,293,15,138,0,155
1525909,103,5,1910,6,male,481,1218,667,16,8,16,8,0,0
1043233,19,13,1994,7,male,456,1128,911,16,12,16,12,0,0
1103509,68,20,1945,6,male,675,1128,949,16,46,16,43,0,3
1427300,64,21,1949,5,male,218,1147,242,17,39,0,14,17,25
1637140,19,2,1994,11,male,680,1003,224,17,17,10,6,7,11
1705857,20,26,1993,2,male,616,1084,891,17,25,17,23,0,2
1429673,103,30,1910,12,male,1066,1145,953,17,14,17,12,0,2
1861353,20,3,1993,3,male,539,1019,814,18,1106,18,887,0,219
1311415,16,16,1997,4,male,426,1016,945,19,9,0,4,19,5
1826007,18,1,1995,1,male,841,1134,712,19,157,13,83,6,74
1249132,103,26,1910,6,male,486,1199,1071,19,23,17,19,2,4
1347642,19,5,1994,5,male,758,1041,981,19,27,19,26,0,1
1571510,21,25,1992,5,male,543,1017,791,19,76,19,58,0,18
1030231,31,14,1982,3,female,1469,1206,614,19,290,19,214,0,76
1197506,32,3,1981,4,female,1087,1200,744,19,33,19,29,0,4
1386593,18,15,1995,10,male,554,1006,900,20,42,3,29,17,13
1365159,22,4,1991,4,male,480,1097,109,20,35,0,6,20,29
1691903,108,11,1905,7,male,1501,1039,525,20,257,2,53,18,204
2052550,21,5,1992,5,female,495,1048,613,20,359,9,178,11,181
2174388,17,30,1996,8,male,895,1050,695,20,37,15,14,5,23
1594489,17,21,1996,5,male,409,1249,1111,20,69,20,42,0,27
1224198,15,19,1998,5,male,109,998,911,21,11,0,3,21,8
1982245,19,9,1994,8,male,719,1145,811,21,11,6,3,15,8
1035172,18,30,1995,11,male,241,1071,245,21,67,21,18,0,49
1578888,35,5,1978,12,male,1493,1029,580,21,86,21,44,0,42
1164616,97,3,1916,4,female,2226,1204,306,22,5,0,1,22,4
1411601,99,2,1914,2,male,221,1085,658,22,5,4,2,18,3
1131393,17,16,1996,2,male,1553,1167,425,22,15,1,9,21,6
1385209,18,16,1995,2,male,508,1188,1057,22,18,22,12,0,6
1429366,18,24,1995,6,male,747,1169,853,22,14,22,14,0,0
1208113,74,17,1939,3,female,1646,1007,441,22,29,22,24,0,5
1702870,68,24,1945,1,male,608,1248,973,22,126,22,71,0,55
1002894,16,4,1997,12,male,423,1200,283,23,114,17,92,6,22
1533909,17,17,1996,7,male,476,1189,1005,23,30,23,27,0,3
1969585,68,21,1945,8,female,1268,1110,396,23,36,23,36,0,0
1508454,19,4,1994,8,male,537,1113,1005,24,44,1,41,23,3
1516471,16,20,1997,12,female,343,1225,106,24,21,19,14,5,7
1978631,22,9,1991,7,male,1137,1120,792,24,72,19,38,5,34
1908675,19,24,1994,8,female,298,1071,637,24,102,24,97,0,5
2092776,21,21,1992,11,male,1278,1179,661,24,162,24,138,0,24
1132569,17,23,1996,1,male,390,1192,985,25,6,4,5,21,1
1709970,62,3,1951,9,female,592,1252,246,25,191,25,98,0,93
1836980,21,26,1992,2,male,1033,1224,895,26,0,0,0,26,0
2163071,108,1,1905,1,male,1308,1223,233,27,42,0,23,27,19
1241255,18,21,1995,1,male,456,1058,893,27,13,27,4,0,9
2087814,18,11,1995,1,female,666,1070,261,27,29,27,27,0,2
2015185,20,28,1993,7,male,923,1008,562,27,192,27,147,0,45
2067965,16,27,1997,3,male,464,1130,629,28,39,5,20,23,19
2089923,48,29,1965,5,male,2178,1263,618,28,242,3,117,25,125
1781971,19,12,1994,4,male,303,1073,993,28,157,28,127,0,30
1130376,60,7,1953,7,male,1433,1259,647,28,1121,28,481,0,640
1757408,23,14,1990,12,male,503,1261,885,29,265,29,231,0,34
1665770,16,21,1997,12,male,288,1002,733,31,17,1,9,30,8
1932172,23,19,1990,1,female,400,1130,304,30,407,14,354,16,53
2109834,108,13,1905,8,male,530,1105,924,31,13,28,10,3,3
1973545,103,17,1910,6,male,646,1178,680,30,1673,27,1202,3,471
1474299,103,15,1910,12,female,1628,1075,553,31,0,31,0,0,0
1278179,20,11,1993,11,male,412,1059,653,30,10,30,10,0,0
1275436,20,2,1993,6,male,438,1127,789,31,13,31,12,0,1
1504926,16,14,1997,2,male,276,1107,364,30,62,30,35,0,27
1022331,25,1,1988,2,male,684,1104,903,31,297,31,270,0,27
1385915,38,20,1975,1,female,607,1028,308,30,98,30,31,0,67
1195097,66,22,1947,12,male,1630,1177,203,31,178,31,116,0,62
1369726,20,25,1993,12,male,1597,1044,524,32,291,26,248,6,43
1615345,26,17,1987,8,female,499,1092,396,33,139,15,25,18,114
1314959,16,10,1997,10,female,629,1083,306,33,647,33,562,0,85
1302926,22,25,1991,4,male,575,1054,999,33,104,33,83,0,21
1748811,16,19,1997,4,female,772,1015,462,36,46,13,16,23,30
1900900,18,24,1995,1,female,494,1021,891,35,32,9,14,26,18
1751160,68,15,1945,1,male,1546,1140,602,36,42,25,32,11,10
1328984,19,17,1994,7,male,796,1007,637,36,79,10,62,26,17
1809061,18,24,1995,6,male,196,1060,991,35,25,30,17,5,8
1673670,18,19,1995,1,female,288,1072,136,35,47,35,39,0,8
1925200,103,1,1910,1,male,1221,1129,656,35,27,35,25,0,2
1363150,27,24,1986,7,female,925,1146,905,36,364,36,236,0,128
1511809,91,1,1922,1,female,380,1189,117,36,620,36,565,0,55
2048522,94,18,1919,9,female,726,1246,285,37,28,20,17,17,11
1786149,68,1,1945,1,female,674,1241,710,38,109,3,95,35,14
1714877,20,24,1993,6,female,686,1000,535,38,110,37,101,1,9
2145246,68,17,1945,8,female,400,1033,317,38,341,38,301,0,40
1798962,21,20,1992,3,male,240,1099,1024,40,2,25,2,15,0
1441344,21,18,1992,3,female,440,1244,421,40,736,24,97,16,639
1580710,103,13,1910,4,male,1081,1054,378,40,29,40,26,0,3
1294877,23,7,1990,10,female,656,1264,560,41,443,19,280,22,163
1007757,16,18,1997,3,male,278,1178,1079,41,16,32,11,9,5
1212210,108,20,1905,1,male,1977,1071,516,41,7,31,2,10,5
1720347,19,31,1994,5,male,545,1197,1037,41,59,37,43,4,16
1731906,37,28,1976,12,male,1413,1057,798,42,17,42,13,0,4
1124768,19,30,1994,8,female,372,1169,497,42,27,42,27,0,0
1167591,19,24,1994,10,male,354,1120,932,41,34,41,26,0,8
2127383,17,1,1996,10,female,499,1074,640,43,146,1,36,42,110
2009743,18,19,1995,4,female,877,1023,356,44,87,15,29,29,58
2165716,22,29,1991,6,female,432,1086,598,44,212,26,107,18,105
2112731,28,26,1985,12,female,667,1142,260,44,68,29,40,15,28
1782977,100,27,1913,1,female,1469,1256,696,43,0,43,0,0,0
1318944,18,25,1995,6,female,651,1215,870,43,181,43,147,0,34
1469089,19,26,1994,8,female,540,1145,820,44,87,44,65,0,22
1700703,19,9,1994,1,male,841,1071,837,47,25,1,9,46,16
2116429,102,24,1911,6,male,2330,1062,605,47,63,26,43,21,20
1769750,22,10,1991,7,male,851,1030,813,46,40,46,39,0,1
2158420,18,29,1995,9,male,406,1035,860,48,11,22,11,26,0
1121248,18,23,1995,11,male,539,1200,854,49,60,25,43,24,17
1102583,27,11,1986,1,male,1340,1013,770,48,191,13,137,35,54
2165836,40,1,1973,1,male,971,1070,882,49,30,49,29,0,1
2064789,34,21,1979,9,male,1059,1103,981,49,92,49,70,0,22
1357943,15,5,1998,6,male,270,1079,847,50,109,19,69,31,40
1184578,59,11,1954,7,male,1672,1039,825,50,128,25,51,25,77
1871921,17,2,1996,2,male,762,1180,969,50,114,50,101,0,13
1823694,19,21,1994,10,male,742,1217,647,50,465,50,350,0,115
2011972,22,29,1991,9,female,701,999,702,51,167,51,101,0,66
1327076,19,8,1994,5,female,490,1124,851,53,36,5,26,48,10
1009416,23,29,1990,4,male,517,1245,1069,55,34,55,32,0,2
1891914,42,21,1971,12,male,507,1107,1010,55,39,55,23,0,16
1929479,21,15,1992,7,female,450,1082,424,54,298,54,159,0,139
1519183,17,16,1996,11,male,688,1012,722,57,72,6,36,51,36
1076263,91,29,1922,12,male,2205,1144,823,58,51,6,36,52,15
1238325,103,14,1910,5,male,1400,1202,943,58,49,52,38,6,11
2078056,108,29,1905,1,female,1234,1261,544,57,24,57,18,0,6
1460414,15,11,1998,12,male,308,1049,525,57,107,57,85,0,22
2172458,15,16,1998,4,female,371,1229,1048,57,1386,57,1073,0,313
1559415,26,3,1987,11,female,1540,1031,527,59,54,5,27,54,27
1894446,20,1,1993,1,female,88,1165,5,59,207,0,71,59,136
2039379,21,4,1992,8,female,1456,1246,149,59,587,0,396,59,191
1647944,31,15,1982,1,male,1704,1222,507,60,28,60,26,0,2
2146293,83,14,1930,11,female,1470,1007,487,63,90,1,38,62,52
2042057,103,31,1910,1,male,769,1174,890,61,29,61,19,0,10
2142320,103,17,1910,9,male,1012,1028,744,61,46,61,35,0,11
1256172,16,10,1997,8,female,617,1094,262,61,111,61,24,0,87
2172260,15,19,1998,12,female,442,1130,553,64,0,0,0,64,0
2016465,14,27,1999,10,female,364,1194,716,65,146,42,99,23,47
2131990,33,12,1980,11,male,880,1120,678,65,69,62,35,3,34
1113331,21,18,1992,6,male,1296,1064,796,64,38,64,32,0,6
1094575,25,8,1988,8,male,572,1238,993,65,1688,65,1488,0,200
1799894,108,10,1905,6,male,1209,1055,558,67,85,13,75,54,10
1869427,18,30,1995,7,male,544,1045,835,66,51,55,14,11,37
1583739,23,19,1990,10,female,667,1191,881,69,48,8,13,61,35
2144947,18,24,1995,10,female,651,1158,520,71,16,71,10,0,6
1757225,103,4,1910,4,male,403,1148,977,70,66,70,60,0,6
1143853,18,20,1995,4,male,397,1106,979,71,293,71,274,0,19
1198973,19,7,1994,11,male,893,1200,894,73,29,0,10,73,19
1802348,18,6,1995,1,female,249,1243,228,72,88,9,27,63,61
1693755,21,9,1992,8,male,869,1038,877,74,49,50,47,24,2
1582182,18,21,1995,1,female,384,1247,704,74,725,50,600,24,125
1559229,17,9,1996,9,male,456,1124,1015,77,186,0,164,77,22
1256090,19,18,1994,6,female,690,1155,403,76,660,51,158,25,502
1502596,22,17,1991,6,male,1559,1055,696,77,26,77,23,0,3
1663531,21,25,1992,10,male,776,1086,545,75,1002,75,636,0,366
1893301,23,7,1990,7,female,853,1141,131,75,363,75,333,0,30
1765225,17,18,1996,9,female,568,1037,270,80,74,80,54,0,20
1681044,105,1,1908,1,male,1345,1119,840,84,91,28,42,56,49
1715661,15,10,1998,4,female,459,999,693,81,374,41,242,40,132
1667355,18,10,1995,10,female,916,1029,153,84,617,84,411,0,206
1683695,19,21,1994,3,female,314,1021,618,83,187,83,154,0,33
1118183,16,18,1997,11,male,794,1239,893,88,305,17,255,71,50
1429922,16,1,1997,12,male,331,1218,1018,90,3,29,3,61,0
1721519,21,15,1992,7,male,548,1131,1061,89,50,34,42,55,8
1977384,34,1,1979,9,male,325,1155,1023,88,39,38,20,50,19
1949868,23,9,1990,8,male,464,1059,851,90,184,44,164,46,20
1320936,68,4,1945,7,female,1570,1225,446,88,367,73,132,15,235
2172451,19,25,1994,5,male,580,1058,926,88,34,88,33,0,1
1175270,15,23,1998,12,female,582,1215,425,89,74,89,32,0,42
2192753,104,30,1909,4,female,1494,1102,507,94,37,54,15,40,22
1599530,19,9,1994,10,male,546,1144,712,95,59,51,33,44,26
1799416,85,22,1928,12,female,2469,1002,538,95,97,42,40,53,57
2183681,18,3,1995,4,male,1608,1095,416,94,327,36,198,58,129
1054434,101,1,1912,4,male,1590,1199,750,92,160,70,95,22,65
1559176,19,10,1994,2,male,612,1169,981,93,176,93,136,0,40
2146682,21,6,1992,5,female,764,1258,574,95,717,95,539,0,178
1560045,21,18,1992,7,female,203,1060,118,95,197,95,147,0,50
1322782,61,31,1952,10,male,376,1188,313,99,181,0,75,99,106
2066568,52,1,1961,1,male,438,1058,517,96,161,76,111,20,50
1787062,26,8,1987,7,female,820,1038,579,97,128,97,95,0,33
2025751,20,27,1993,10,male,685,1164,782,96,315,96,290,0,25
1206596,93,2,1920,7,female,2266,1064,445,104,12,24,9,80,3
1116097,22,13,1991,5,male,455,1041,624,104,73,59,34,45,39
1759993,25,12,1988,1,male,427,1135,1072,101,224,101,170,0,54
1590277,100,2,1913,7,female,1687,997,354,104,163,104,78,0,85
1968209,15,1,1998,11,male,643,1034,874,106,75,2,7,104,68
1132626,19,23,1994,11,male,1360,1158,1036,108,67,33,7,75,60
1062326,90,9,1923,10,male,1744,1027,591,107,13,85,7,22,6
1802541,100,7,1913,6,female,2145,1016,984,108,31,100,18,8,13
1463917,15,23,1998,3,female,361,1114,151,107,80,100,24,7,56
1060052,106,21,1907,2,male,1676,1139,688,106,76,99,60,7,16
1796778,20,16,1993,7,female,1319,1118,485,107,256,88,194,19,62
2190678,24,12,1989,3,female,281,1062,277,108,120,108,113,0,7
1704701,18,30,1995,1,male,642,1126,444,113,143,0,33,113,110
1511479,103,23,1910,5,male,1771,1049,504,111,84,14,24,97,60
1574683,103,11,1910,9,male,1862,1045,765,112,172,55,28,57,144
1744210,41,29,1972,8,male,509,1083,934,113,62,112,51,1,11
1456425,27,6,1986,6,male,399,1101,881,112,84,112,59,0,25
1680478,17,19,1996,7,male,274,1037,898,112,200,112,120,0,80
1321359,25,4,1988,7,male,1337,1122,620,112,309,112,276,0,33
1306832,108,6,1905,10,male,501,1221,816,111,294,111,282,0,12
1764531,68,3,1945,2,male,1622,1124,717,118,122,77,73,41,49
1355404,18,31,1995,7,male,1022,1001,863,117,289,112,194,5,95
1570360,108,1,1905,1,female,1059,1205,494,119,73,119,67,0,6
1872024,19,1,1994,6,female,516,1018,491,122,279,0,154,122,125
1361995,14,13,1999,5,female,273,1070,86,120,159,83,105,37,54
1302746,15,10,1998,1,male,970,1216,797,124,610,74,268,50,342
1604787,26,13,1987,4,female,472,1157,535,124,47,124,40,0,7
1243677,16,19,1997,4,male,1221,1207,758,123,129,123,63,0,66
1966844,15,2,1998,8,female,503,1110,658,123,563,123,428,0,135
1806670,17,4,1996,4,female,597,1264,241,121,319,121,243,0,76
1179096,94,3,1919,2,male,750,1222,846,122,217,122,157,0,60
1860560,16,20,1997,3,female,583,1021,683,127,109,2,10,125,99
1017110,17,29,1996,10,male,397,1100,935,128,118,5,51,123,67
1649191,83,21,1930,1,male,294,1059,940,127,302,0,136,127,166
1700672,108,9,1905,2,male,1019,1242,652,129,78,34,30,95,48
1129287,14,22,1999,2,female,522,1035,668,130,177,73,98,57,79
1278156,16,6,1997,9,female,610,1056,663,129,518,86,189,43,329
2061318,19,16,1994,10,female,535,1197,734,127,346,87,223,40,123
1018557,20,21,1993,7,female,1308,1055,163,130,833,60,312,70,521
1528731,103,10,1910,10,female,1144,1086,475,130,178,96,154,34,24
1540624,20,13,1993,10,male,826,1119,825,128,237,127,155,1,82
1256890,18,8,1995,2,male,347,1048,909,129,133,129,93,0,40
1387354,65,21,1948,12,male,1393,1134,817,134,77,12,13,122,64
2170832,17,6,1996,11,female,721,1136,430,135,110,45,49,90,61
1942278,16,17,1997,12,female,171,1048,440,134,100,102,39,32,61
1915031,66,24,1947,11,female,1821,1079,449,135,144,120,76,15,68
1076734,103,12,1910,12,female,1196,1129,717,135,101,125,92,10,9
1251412,103,3,1910,3,male,1488,999,802,136,121,134,92,2,29
1021423,18,15,1995,5,male,506,1003,655,134,195,134,131,0,64
1147187,18,28,1995,12,female,693,1067,596,132,340,132,272,0,68
1391818,16,7,1997,8,female,335,1021,589,140,503,2,383,138,120
1601778,100,16,1913,1,male,3139,1069,373,137,63,45,35,92,28
1316151,99,22,1914,11,female,1133,1139,190,142,141,45,104,97,37
1405092,102,1,1911,1,male,1755,1029,811,138,100,31,69,107,31
1398084,19,12,1994,5,female,618,1009,325,143,347,91,137,52,210
2155100,22,24,1991,11,female,1601,1126,331,143,281,117,126,26,155
1787186,14,10,1999,5,female,321,1019,811,148,156,24,54,124,102
1234116,108,30,1905,12,male,1124,1199,806,144,214,49,71,95,143
2036528,19,7,1994,1,female,766,1094,535,145,757,145,533,0,224
2077840,16,13,1997,11,female,279,1057,832,151,108,11,64,140,44
1907053,19,8,1994,2,female,1412,997,68,155,188,104,104,51,84
1984645,18,22,1995,12,female,54,1127,122,151,405,62,193,89,212
1766676,18,15,1995,4,male,403,1038,586,152,439,72,109,80,330
2167809,18,21,1995,7,male,1033,1038,716,152,851,101,629,51,222
1960221,15,13,1998,1,female,668,1211,648,155,44,155,39,0,5
1140131,94,6,1919,7,female,999,1187,150,153,86,153,70,0,16
2140270,18,21,1995,1,female,531,1075,506,156,289,156,259,0,30
1257650,18,26,1995,9,female,1323,1178,524,161,182,72,137,89,45
1203660,17,7,1996,10,female,609,1208,466,162,347,69,200,93,147
1167507,57,9,1956,11,male,1167,1126,948,163,11,151,6,12,5
2155614,15,14,1998,2,male,179,1197,1116,158,137,148,125,10,12
1929096,21,13,1992,11,female,325,1198,789,159,211,123,57,36,154
1956844,108,8,1905,3,female,1326,1233,506,163,180,143,111,20,69
1597113,17,20,1996,8,female,664,1025,494,161,1046,132,467,29,579
1806913,19,12,1994,10,male,526,1089,677,161,333,150,140,11,193
1601812,63,6,1950,8,female,2159,1194,724,158,1919,156,1086,2,833
1419865,47,22,1966,6,female,211,1171,324,160,312,159,151,1,161
1311048,61,19,1952,6,female,545,1108,34,162,1531,161,1003,1,528
1187470,103,16,1910,9,male,647,1131,612,159,163,159,109,0,54
1626132,20,27,1993,12,male,534,1089,936,164,304,164,228,0,76
1396502,18,12,1995,5,male,797,1081,715,167,71,0,30,167,41
2123486,108,8,1905,12,male,1548,1237,584,167,393,28,251,139,142
1042427,103,14,1910,5,male,986,1191,760,172,62,172,56,0,6
1853518,15,10,1998,1,female,708,1040,528,167,195,167,123,0,72
2138977,19,5,1994,8,male,197,1010,683,168,1377,168,810,0,567
2057628,100,7,1913,8,female,1059,1014,374,180,56,117,17,63,39
1665955,15,8,1998,10,female,89,996,385,181,984,93,425,88,559
1281414,15,29,1998,3,female,563,1150,556,173,154,166,64,7,90
1918731,16,5,1997,9,female,630,1243,644,179,483,161,440,18,43
1235096,19,5,1994,5,male,453,1173,746,176,118,176,88,0,30
1917133,91,4,1922,7,male,505,1156,920,176,251,176,231,0,20
1893801,18,2,1995,8,male,389,1092,868,181,461,181,366,0,95
1124679,28,8,1985,10,male,728,1150,919,177,277,177,182,0,95
1405319,85,17,1928,12,female,957,1114,486,188,87,0,5,188,82
1355843,83,4,1930,2,female,1785,1144,437,190,293,1,87,189,206
2143921,68,6,1945,6,male,1389,1141,513,186,24,116,18,70,6
1990099,19,24,1994,6,female,813,1181,815,185,486,98,230,87,256
1871287,21,21,1992,8,female,743,1041,346,186,1224,99,588,87,636
1785185,24,5,1989,4,male,664,1059,920,189,12,138,11,51,1
2126797,18,9,1995,5,female,463,1093,303,186,229,186,108,0,121
1264796,20,1,1993,12,male,268,1155,392,183,247,183,190,0,57
1809022,41,31,1972,12,male,439,1137,897,187,202,187,182,0,20
1205947,19,23,1994,12,female,524,1044,189,183,458,183,349,0,109
1175438,21,9,1992,6,female,559,1100,588,182,314,182,251,0,63
1604790,23,29,1990,11,female,674,1251,449,187,877,187,636,0,241
1876164,19,11,1994,3,female,303,1073,481,198,460,115,307,83,153
1923389,18,25,1995,6,female,467,1184,750,200,356,176,145,24,211
1102886,22,9,1991,4,female,1253,1191,435,200,413,193,287,7,126
1215639,22,26,1991,10,female,479,1095,78,200,92,200,75,0,17
2131613,15,28,1998,12,female,506,1054,778,193,286,193,227,0,59
1492015,16,9,1997,10,male,620,1037,449,193,208,193,182,0,26
1730988,23,9,1990,9,male,762,1070,503,196,271,196,249,0,22
1233153,20,19,1993,3,female,284,1264,485,191,1554,191,1258,0,296
2017453,103,1,1910,4,female,1407,997,629,208,130,9,9,199,121
2172609,23,10,1990,5,male,672,1263,1132,210,100,50,71,160,29
1282048,14,17,1999,5,female,171,1020,330,208,703,143,467,65,236
1922302,22,19,1991,11,female,1458,1120,515,208,1093,127,656,81,437
1407380,96,22,1917,2,male,1311,1226,659,204,344,89,193,115,151
1507196,63,2,1950,1,male,1099,1113,411,204,37,166,14,38,23
1887449,18,17,1995,10,male,1556,1052,555,206,142,189,123,17,19
1987197,108,12,1905,10,male,1178,1000,765,201,179,159,127,42,52
1244088,14,21,1999,8,female,461,1018,172,207,597,207,332,0,265
1239294,17,10,1996,5,female,665,1184,809,207,796,207,679,0,117
1511229,92,12,1921,2,female,1523,1163,1083,213,928,9,26,204,902
1048671,16,16,1997,4,male,648,1173,823,220,153,52,99,168,54
1915141,108,6,1905,7,female,911,1071,648,219,299,124,124,95,175
1642117,16,20,1997,6,female,528,1137,609,214,640,120,430,94,210
1155441,16,24,1997,7,female,482,1055,580,217,521,132,234,85,287
1857783,43,26,1970,11,male,657,1072,680,220,139,215,129,5,10
1436722,108,20,1905,8,male,1139,1233,762,214,141,191,93,23,48
2068888,15,16,1998,11,female,678,1024,611,217,461,197,262,20,199
1679536,16,13,1997,11,male,676,1038,783,217,570,169,358,48,212
2149786,19,1,1994,4,female,601,1156,209,213,1388,200,884,13,504
2118930,22,10,1991,1,male,281,1069,997,217,46,217,38,0,8
1172881,15,23,1998,10,female,314,1016,98,217,512,217,372,0,140
1578318,15,16,1998,10,female,613,1118,308,228,349,51,164,177,185
1231360,17,28,1996,5,female,540,1132,708,231,414,139,303,92,111
1064683,20,20,1993,12,female,814,1191,807,231,358,49,88,182,270
1383825,20,27,1993,10,male,480,1105,929,230,127,184,91,46,36
1360458,21,17,1992,8,male,571,1010,719,222,250,195,141,27,109
1385913,23,25,1990,9,female,808,1020,667,226,543,203,388,23,155
1774557,18,23,1995,4,male,1166,1198,829,229,58,229,47,0,11
2115375,13,7,2000,3,female,65,1045,244,224,201,224,140,0,61
1660637,100,1,1913,1,male,1154,1012,662,231,207,231,178,0,29
1632192,108,5,1905,2,male,406,1066,778,224,575,224,439,0,136
1759451,18,23,1995,3,female,287,1190,155,243,204,4,158,239,46
2124448,14,25,1999,1,female,793,1224,409,235,380,28,179,207,201
2056111,21,5,1992,3,female,1860,1000,484,242,458,43,242,199,216
1482584,16,20,1997,11,female,521,1162,629,241,86,103,45,138,41
2001146,68,17,1945,8,male,1086,1188,111,244,123,149,54,95,69
2078060,16,29,1997,9,female,1017,1107,347,243,596,83,177,160,419
1403547,100,25,1913,11,female,972,1104,576,245,219,241,149,4,70
1989519,15,18,1998,10,female,313,1110,390,243,1338,237,1225,6,113
2030219,26,6,1987,2,female,1201,1071,547,246,141,246,69,0,72
1387317,25,8,1988,7,female,36,1239,37,243,815,243,716,0,99
1069024,19,5,1994,10,female,545,1236,508,256,478,22,302,234,176
1996158,27,2,1986,2,male,429,1229,946,254,572,0,104,254,468
1934957,108,16,1905,10,female,3101,1164,497,248,281,121,156,127,125
1428950,27,14,1986,12,male,573,1043,470,260,699,131,239,129,460
1570957,101,7,1912,11,male,1753,1021,480,259,157,250,124,9,33
1246197,17,27,1996,8,female,538,1139,880,254,179,245,169,9,10
2008828,19,4,1994,1,female,841,1250,418,249,3866,186,2970,63,896
1972884,20,29,1993,10,female,56,1041,26,259,1163,236,616,23,547
1114933,20,29,1993,12,female,676,1224,703,258,137,256,108,2,29
1111598,18,1,1995,1,male,557,1237,1105,255,140,255,133,0,7
1860536,85,30,1928,11,male,695,1240,938,256,94,256,48,0,46
1093263,24,25,1989,7,female,602,998,574,276,200,0,115,276,85
1201715,108,6,1905,11,male,1611,1230,718,276,301,12,83,264,218
1073783,18,11,1995,8,female,555,1079,459,276,166,199,58,77,108
1507387,20,24,1993,11,male,830,1209,988,263,297,74,220,189,77
1453456,19,26,1994,4,female,424,1112,776,269,442,109,188,160,254
1684133,50,30,1963,11,female,1869,1019,591,273,242,260,143,13,99
1962958,23,23,1990,8,male,1382,1231,1005,276,4,276,3,0,1
1975547,103,30,1910,9,male,1314,1223,892,271,183,271,166,0,17
1554697,16,3,1997,8,male,535,1265,383,269,411,269,268,0,143
2151461,19,11,1994,8,male,520,1219,926,271,768,271,598,0,170
1023169,108,25,1905,1,male,623,1017,865,278,96,34,6,244,90
1201801,108,29,1905,3,male,1539,1095,768,279,93,42,37,237,56
2023304,17,2,1996,3,female,539,1234,158,287,199,22,60,265,139
1047021,16,12,1997,5,female,302,1033,436,281,430,29,158,252,272
1597386,18,22,1995,8,female,624,1095,556,283,333,157,227,126,106
1728728,108,14,1905,8,female,1171,1153,284,289,269,207,95,82,174
1407257,22,20,1991,12,female,950,1030,343,280,232,220,151,60,81
1973483,17,28,1996,9,female,324,1182,509,287,714,284,230,3,484
1400352,24,13,1989,8,female,1604,1063,413,277,416,243,376,34,40
1788746,22,15,1991,1,male,443,1142,1056,278,64,278,63,0,1
2138345,15,12,1998,11,male,511,1036,901,289,406,289,335,0,71
1039591,16,18,1997,3,female,396,1165,903,282,224,282,174,0,50
1960766,24,2,1989,3,female,402,1184,721,289,369,289,256,0,113
1333713,17,5,1996,8,female,360,1220,207,290,1709,290,874,0,835
1419732,19,28,1994,2,female,521,1195,664,281,475,281,305,0,170
1815748,103,27,1910,1,female,1420,1005,477,296,324,13,194,283,130
1161048,19,14,1994,12,female,80,1102,483,305,1005,298,505,7,500
1317069,18,25,1995,10,female,85,1023,272,295,127,293,55,2,72
1191604,16,5,1997,5,male,375,1076,913,325,11,0,8,325,3
1639821,19,5,1994,12,female,576,1073,465,309,432,41,230,268,202
1908055,50,21,1963,4,female,1372,1258,564,326,566,15,245,311,321
2125022,19,29,1994,7,male,772,1080,710,310,77,222,57,88,20
1150106,19,19,1994,8,female,840,1086,657,313,394,82,290,231,104
1369346,19,8,1994,10,female,1530,1097,401,312,742,130,272,182,470
1590129,16,18,1997,2,female,484,1234,781,312,452,297,379,15,73
1705561,62,19,1951,8,male,1045,1222,734,316,238,269,140,47,98
1408155,21,15,1992,5,female,635,1174,462,323,1165,318,476,5,689
1608799,21,13,1992,6,female,796,1081,715,323,497,314,342,9,155
2181637,42,10,1971,6,female,1746,1144,535,312,1424,270,1103,42,321
1051638,15,11,1998,11,male,409,1231,980,318,3265,318,2567,0,698
1879520,26,6,1987,5,female,1637,1150,454,313,679,313,519,0,160
1462430,40,9,1973,10,female,717,1034,85,310,1111,310,605,0,506
1230661,18,10,1995,9,female,565,1042,466,337,129,12,63,325,66
1087201,18,14,1995,9,female,361,1060,550,339,883,11,385,328,498
1057889,14,10,1999,1,male,326,1255,1127,335,103,212,66,123,37
1161957,24,17,1989,4,male,448,1063,930,338,409,195,375,143,34
1755231,24,11,1989,10,female,432,1042,447,339,214,242,125,97,89
2082520,19,7,1994,3,female,1496,1023,643,340,626,100,466,240,160
1361416,19,28,1994,8,male,1376,1148,606,340,1236,279,958,61,278
2002472,103,21,1910,8,male,735,1104,650,346,592,339,368,7,224
1765801,29,1,1984,1,male,717,1186,1054,338,47,338,38,0,9
1646271,20,19,1993,10,male,638,1116,554,343,208,343,194,0,14
1871492,94,26,1919,8,male,434,1224,1069,339,153,339,127,0,26
1976709,19,6,1994,3,female,744,1197,371,333,440,333,279,0,161
1039573,36,11,1977,12,female,1732,1054,433,363,191,130,111,233,80
1956776,21,5,1992,1,female,1570,1149,503,364,487,156,384,208,103
1077097,26,30,1987,8,male,1112,1080,726,357,372,73,212,284,160
1711714,13,1,2000,1,female,390,1067,171,359,211,278,148,81,63
1071393,17,4,1996,5,female,894,1204,672,353,197,295,173,58,24
1594163,17,29,1996,4,female,715,1252,807,356,286,276,93,80,193
1351079,17,6,1996,7,female,1371,1202,250,359,1742,359,1143,0,599
1009411,76,1,1937,7,male,1928,1115,540,382,739,25,324,357,415
1179391,13,4,2000,6,female,820,1047,624,382,246,105,108,277,138
1036606,102,1,1911,5,female,1932,1012,500,394,269,110,128,284,141
2054826,19,9,1994,9,male,1169,1019,492,385,599,218,302,167,297
2122058,93,19,1920,2,male,868,1122,266,372,570,134,377,238,193
1063351,20,10,1993,11,female,1734,1074,413,377,408,282,196,95,212
1644369,14,10,1999,6,female,118,1036,483,392,1166,376,939,16,227
1675207,19,17,1994,5,male,587,1058,563,377,581,364,500,13,81
1146847,19,16,1994,8,female,15,1038,264,380,671,366,481,14,190
1764984,25,21,1988,2,female,441,1002,830,379,241,376,214,3,27
2117458,33,14,1980,10,male,1758,1054,703,381,231,381,160,0,71
1939102,20,30,1993,10,female,606,1016,463,385,312,385,298,0,14
1757753,21,4,1992,4,male,529,1135,837,375,362,375,251,0,111
1941412,17,16,1996,9,female,1255,1253,299,407,863,27,668,380,195
1053638,32,4,1981,4,female,1571,1100,223,406,1073,59,523,347,550
1842536,17,27,1996,3,male,849,1139,636,401,381,266,280,135,101
2142682,18,29,1995,5,male,1378,1253,449,400,419,107,320,293,99
1268085,23,16,1990,1,male,1790,1172,530,410,488,84,272,326,216
1194656,19,4,1994,8,female,869,1132,486,409,1719,289,1215,120,504
1707025,21,25,1992,8,female,684,1018,252,400,949,189,164,211,785
1313101,23,24,1990,12,female,266,1256,495,402,1083,192,407,210,676
1636116,48,19,1965,7,male,1482,1003,737,421,2629,256,1423,165,1206
1394065,52,17,1961,7,female,797,1259,469,407,361,372,294,35,67
1245707,23,28,1990,3,female,176,1078,36,396,1165,333,942,63,223
1928123,24,29,1989,9,female,1246,1009,547,409,1019,315,539,94,480
1976093,21,13,1992,12,male,227,1172,1023,415,320,415,304,0,16
1533161,23,24,1990,5,female,338,1124,363,399,360,399,318,0,42
1433922,99,14,1914,4,male,2043,1266,873,427,207,1,140,426,67
1668129,15,29,1998,4,male,212,1072,868,429,466,65,166,364,300
1914350,22,22,1991,7,female,444,1031,358,431,579,82,298,349,281
1909640,15,17,1998,3,female,201,1011,320,435,2630,22,1186,413,1444
1020006,16,20,1997,11,female,545,998,234,445,612,194,390,251,222
1590203,15,8,1998,5,male,476,1232,735,436,1815,178,1064,258,751
1840900,19,20,1994,7,female,551,1138,179,443,1019,193,252,250,767
1000008,14,9,1999,9,female,343,1156,233,431,198,400,167,31,31
2144861,15,18,1998,2,male,902,1143,803,446,122,365,112,81,10
2006363,19,14,1994,8,male,202,999,905,430,236,351,130,79,106
1710476,18,8,1995,5,female,417,1205,859,434,284,336,227,98,57
1309483,20,3,1993,3,female,544,1233,246,445,601,352,303,93,298
2182886,28,15,1985,4,male,958,1168,935,441,414,434,341,7,73
2053206,17,7,1996,11,female,538,1011,683,442,1554,416,927,26,627
1761653,16,4,1997,8,female,1261,1167,250,440,840,387,340,53,500
1320716,20,1,1993,3,female,838,1007,550,448,675,440,580,8,95
1836399,15,23,1998,6,female,480,1059,682,437,618,435,442,2,176
1059722,24,5,1989,7,female,729,1139,762,440,265,440,230,0,35
2064745,16,1,1997,1,female,732,1119,518,448,317,448,272,0,45
1562152,27,7,1986,8,male,597,1111,562,439,472,439,291,0,181
2056765,108,17,1905,10,female,577,1165,198,443,337,443,236,0,101
1794399,17,2,1996,12,male,744,1163,500,437,1314,437,726,0,588
1353693,44,9,1969,9,female,310,1039,789,452,116,46,63,406,53
1958114,103,31,1910,12,male,1978,1134,623,452,261,16,75,436,186
1282747,15,26,1998,8,male,588,1012,521,471,609,82,406,389,203
1443970,20,9,1993,3,male,700,1018,502,462,295,44,81,418,214
1442607,14,5,1999,2,female,796,1177,156,480,968,53,779,427,189
1659642,17,24,1996,7,male,552,1029,832,462,573,236,361,226,212
1655155,21,30,1992,3,female,842,1212,538,470,690,246,434,224,256
1611090,25,2,1988,4,female,381,1021,467,471,507,181,299,290,208
1737000,38,23,1975,12,male,910,1189,492,462,1383,240,403,222,980
1732806,108,1,1905,7,male,1417,1252,784,467,95,434,30,33,65
2084013,36,18,1977,12,male,1409,1037,243,475,346,376,153,99,193
2007607,17,31,1996,8,female,643,1120,444,470,1030,358,808,112,222
1899032,18,24,1995,2,male,233,1030,715,458,1914,424,1185,34,729
1103068,18,30,1995,8,female,1937,1199,300,454,1386,431,725,23,661
2061805,20,6,1993,9,male,403,1012,813,466,89,466,81,0,8
1836427,22,16,1991,12,female,524,1056,317,466,462,466,420,0,42
1344060,15,29,1998,4,female,490,1162,910,459,1088,459,1068,0,20
1365005,18,5,1995,10,male,625,1155,942,499,394,353,251,146,143
2032933,102,11,1911,11,female,3019,1041,678,518,725,307,609,211,116
2169926,22,6,1991,12,male,728,1088,507,490,847,116,375,374,472
1730384,21,22,1992,4,male,664,1238,990,495,1466,105,485,390,981
1644026,31,10,1982,8,female,775,1177,1009,507,634,498,557,9,77
1603035,13,11,2000,8,female,101,1008,676,498,1936,391,1188,107,748
1996132,16,13,1997,6,female,621,1001,644,485,872,380,438,105,434
2081278,18,31,1995,8,female,796,1201,184,511,1694,502,1583,9,111
1542300,94,27,1919,5,male,393,1048,758,500,837,448,405,52,432
1834109,21,4,1992,3,male,764,1022,755,503,248,503,174,0,74
1419184,18,1,1995,1,female,82,1034,255,493,2545,493,2004,0,541
1291773,107,25,1906,10,female,1166,1128,781,494,860,494,835,0,25
1944420,62,16,1951,5,female,1711,1012,475,525,79,0,17,525,62
2148397,68,28,1945,2,male,1399,1252,1005,557,39,0,29,557,10
2134846,23,22,1990,12,male,937,1209,1053,540,605,37,552,503,53
1368542,16,14,1997,5,male,801,1045,350,556,3078,27,1237,529,1841
2058423,16,21,1997,4,female,569,1049,483,561,446,184,309,377,137
1378130,20,29,1993,12,female,694,1018,571,531,539,371,313,160,226
1040445,19,5,1994,12,female,661,1134,295,547,2792,204,1581,343,1211
2137131,46,20,1967,10,female,1647,1083,423,544,1219,372,695,172,524
1330543,18,5,1995,3,female,819,1124,506,526,178,471,94,55,84
1176194,19,24,1994,8,female,1561,1204,672,533,313,459,168,74,145
1919783,41,29,1972,12,male,1043,1098,747,525,767,410,550,115,217
1356377,20,1,1993,10,male,363,1206,579,567,899,48,381,519,518
2165821,62,23,1951,6,female,1734,1015,243,573,9799,8,1941,565,7858
2017854,14,11,1999,5,female,590,1120,757,600,485,318,284,282,201
1819679,19,15,1994,2,male,578,1159,630,600,667,133,210,467,457
1135116,20,29,1993,6,female,855,1080,716,567,636,186,307,381,329
1002613,25,30,1988,11,female,782,1130,588,598,663,428,182,170,481
1110352,42,1,1971,12,female,1725,1243,1025,586,884,177,695,409,189
1756058,31,13,1982,9,female,398,1113,926,599,681,571,444,28,237
2043317,17,17,1996,7,female,383,1128,750,582,1562,575,1276,7,286
1309167,42,8,1971,6,female,218,1106,514,606,1329,514,597,92,732
1922408,18,18,1995,8,female,262,1220,721,608,1163,602,895,6,268
1077030,25,1,1988,1,male,242,1022,61,563,1245,560,685,3,560
1324664,95,8,1918,6,female,898,1175,475,582,229,582,227,0,2
1935293,103,21,1910,9,male,539,1080,890,609,174,609,157,0,17
1544982,21,6,1992,9,male,493,1038,709,578,721,578,612,0,109
1404625,16,19,1997,1,male,575,1092,927,618,446,94,241,524,205
1429613,16,1,1997,6,female,247,1211,972,622,404,18,246,604,158
2180253,21,13,1992,9,male,575,1067,747,637,800,44,240,593,560
2122319,22,17,1991,1,female,219,1030,840,617,1136,1,232,616,904
1929052,66,24,1947,2,female,1670,1129,784,638,1385,75,526,563,859
1723795,17,5,1996,12,female,402,1010,139,630,155,429,93,201,62
1512953,53,24,1960,9,male,1360,1169,783,631,1516,319,746,312,770
1663163,15,7,1998,10,female,468,1041,452,620,1114,521,480,99,634
1649485,24,10,1989,4,female,899,1210,534,613,942,559,368,54,574
1676355,64,3,1949,4,female,1850,1106,173,661,3031,644,2110,17,921
1690988,15,13,1998,8,male,351,1037,903,616,281,616,249,0,32
2184200,18,26,1995,2,female,242,1191,825,612,281,612,264,0,17
1143715,103,16,1910,6,male,649,1060,901,618,197,618,178,0,19
1871838,19,29,1994,12,male,868,1266,1039,613,450,613,372,0,78
2109254,16,17,1997,7,female,585,1075,661,620,935,620,662,0,273
2143647,20,4,1993,8,male,256,1084,503,635,1967,635,1202,0,765
1578402,16,17,1997,9,male,390,1099,701,719,1943,70,654,649,1289
2163569,21,12,1992,7,female,1433,1007,699,691,395,174,183,517,212
1659814,51,24,1962,3,male,618,1007,665,695,380,373,275,322,105
2130851,26,7,1987,10,female,1213,1012,674,698,586,201,163,497,423
1459269,18,28,1995,5,female,727,1132,310,668,1380,433,352,235,1028
1271934,20,27,1993,10,female,523,1076,138,675,3267,245,1267,430,2000
1301079,38,30,1975,4,female,755,996,677,717,1238,256,433,461,805
1884941,32,3,1981,6,male,13,1039,902,708,400,618,396,90,4
1032493,14,18,1999,8,male,443,1111,554,698,906,656,366,42,540
1338312,16,1,1997,6,female,463,1060,598,693,921,673,674,20,247
2109384,18,29,1995,7,female,240,1269,616,712,3072,526,2733,186,339
1801601,18,18,1995,12,female,810,1062,655,678,110,678,86,0,24
1487435,19,9,1994,6,male,571,1162,857,691,110,691,88,0,22
1100095,20,23,1993,3,male,645,1134,909,722,62,722,56,0,6
1022695,20,12,1993,12,male,576,1103,905,709,419,709,337,0,82
1300713,32,17,1981,9,male,510,1064,885,689,168,689,158,0,10
1650020,17,2,1996,5,female,510,1251,545,715,981,715,889,0,92
1187719,18,28,1995,3,male,413,1020,783,708,1181,708,983,0,198
1831973,16,11,1997,5,female,1012,1065,255,785,1124,152,342,633,782
2048246,19,10,1994,8,female,763,1115,419,763,1029,119,548,644,481
1482861,108,1,1905,9,female,831,1168,531,742,1518,106,771,636,747
1587947,17,11,1996,1,female,589,1265,369,734,580,194,298,540,282
2083022,18,22,1995,3,female,459,1265,767,791,4359,270,2826,521,1533
1242403,19,9,1994,7,female,1545,1186,316,775,1530,396,445,379,1085
1759519,19,10,1994,9,female,461,1209,795,750,1730,486,850,264,880
1775592,23,20,1990,12,male,391,1005,792,780,331,660,250,120,81
1620309,15,6,1998,6,female,401,1096,570,759,485,660,374,99,111
2060763,17,25,1996,11,female,625,1081,307,791,1185,699,599,92,586
1543460,16,19,1997,2,female,562,1207,665,791,695,589,661,202,34
1500748,23,19,1990,9,male,848,1100,381,735,807,711,229,24,578
1121041,83,23,1930,3,female,1096,1208,316,750,806,569,476,181,330
1507296,85,14,1928,7,female,586,1011,615,730,667,602,287,128,380
2193090,100,23,1913,8,female,1689,1222,175,788,1062,782,681,6,381
1488236,20,4,1993,5,male,623,1078,854,740,133,740,115,0,18
1911729,40,30,1973,10,female,714,1104,437,794,1168,794,1023,0,145
1953187,20,15,1993,12,female,176,1144,202,785,1312,785,651,0,661
1770547,29,12,1984,11,male,386,1027,848,768,1537,768,1475,0,62
2186392,18,14,1995,4,female,346,1043,549,856,1000,127,595,729,405
1119231,20,17,1993,10,female,255,1187,785,816,974,97,488,719,486
1831369,26,26,1987,6,female,369,1029,712,808,2253,9,840,799,1413
1122422,31,24,1982,7,female,880,1210,264,807,1724,63,622,744,1102
1459750,18,12,1995,1,female,382,1108,102,849,460,561,274,288,186
1634388,18,17,1995,3,female,1476,1222,398,830,454,567,274,263,180
2018875,21,26,1992,12,female,549,1098,368,856,173,499,43,357,130
2104953,26,9,1987,9,female,250,1137,686,862,390,347,312,515,78
1753908,16,9,1997,8,female,497,1087,850,872,564,372,343,500,221
1404779,18,26,1995,1,male,822,1024,843,828,1231,454,746,374,485
1150974,18,28,1995,1,male,437,1206,1067,857,960,232,585,625,375
1118346,20,4,1993,1,male,975,1034,585,845,559,425,250,420,309
1109971,18,1,1995,6,female,205,1229,26,877,1760,184,1123,693,637
1189135,17,12,1996,4,female,1351,1221,550,867,479,732,253,135,226
1618776,17,21,1996,11,female,1659,1115,195,826,1093,674,817,152,276
1145504,18,20,1995,6,female,1394,1121,437,801,963,644,417,157,546
2135555,38,17,1975,2,male,514,1026,190,822,3476,768,1003,54,2473
1156932,44,13,1969,6,female,1654,1112,456,839,2044,815,1374,24,670
1001096,14,14,1999,2,female,360,1196,832,851,499,851,432,0,67
1516706,17,18,1996,5,male,660,1119,844,822,456,822,410,0,46
2092683,25,22,1988,12,male,529,1001,444,862,166,862,139,0,27
1148440,18,1,1995,3,female,212,1114,469,835,2654,835,1763,0,891
1202860,16,22,1997,8,male,443,1053,985,955,582,22,347,933,235
1417515,21,4,1992,3,male,501,1192,601,974,1869,114,932,860,937
1041953,19,12,1994,5,female,865,1159,600,881,1282,526,565,355,717
1620338,20,12,1993,2,female,246,1015,710,908,1075,573,577,335,498
1029054,54,21,1959,3,male,567,1103,798,890,805,368,489,522,316
1078188,61,7,1952,8,female,1488,1193,971,976,394,733,220,243,174
1284790,17,26,1996,3,male,615,1201,939,982,664,885,377,97,287
1439106,16,10,1997,11,female,587,1170,766,926,2328,866,1374,60,954
1827101,20,17,1993,12,male,790,1129,616,903,374,903,344,0,30
1219119,26,17,1987,8,male,395,1153,758,890,348,890,317,0,31
1603097,97,3,1916,4,male,1476,1061,763,886,358,886,312,0,46
2099131,27,14,1986,2,male,446,1150,860,914,832,914,827,0,5
2037218,103,19,1910,10,female,827,1260,711,888,949,888,770,0,179
1878083,15,19,1998,8,male,312,1117,841,1039,439,117,168,922,271
1663926,15,16,1998,9,female,801,1232,658,1010,2331,52,1233,958,1098
1293077,20,3,1993,7,female,1457,1250,400,1061,1958,158,722,903,1236
1910511,18,30,1995,10,female,228,1135,497,1074,480,668,293,406,187
1678114,16,16,1997,1,male,465,999,658,1102,1087,699,471,403,616
1272055,17,29,1996,10,male,145,1185,1032,993,706,215,117,778,589
1273093,20,11,1993,5,female,466,1072,603,1049,706,277,189,772,517
2008986,33,1,1980,6,male,415,1053,573,1066,1542,285,317,781,1225
1140724,47,28,1966,1,male,1831,1012,635,1064,1483,735,459,329,1024
1423535,103,29,1910,12,male,1725,1175,581,1037,1538,306,342,731,1196
2041477,16,24,1997,8,female,334,1177,783,1094,3888,520,1370,574,2518
1365651,17,11,1996,5,female,133,1254,932,1053,2248,605,772,448,1476
2185372,18,7,1995,8,male,110,1256,702,1005,2092,556,1139,449,953
1703069,19,29,1994,10,female,148,1116,672,1054,4509,213,1363,841,3146
1814645,43,15,1970,11,female,2276,1238,717,1097,2825,236,543,861,2282
2011346,20,28,1993,12,male,734,1037,292,1120,640,856,389,264,251
1486021,20,11,1993,6,female,786,1009,647,1031,305,764,169,267,136
1502651,18,16,1995,10,female,585,1077,343,989,668,953,473,36,195
1814778,23,30,1990,7,male,491,1241,681,1104,2437,892,1504,212,933
1780363,16,1,1997,8,female,541,1048,661,1105,742,1103,300,2,442
2062271,108,27,1905,5,male,1263,1261,1112,990,73,990,69,0,4
1145091,15,12,1998,12,male,544,1101,774,1098,294,1098,245,0,49
1620453,15,1,1998,12,female,559,1226,860,1049,623,1049,557,0,66
1615922,26,16,1987,3,female,240,1038,777,988,507,988,239,0,268
1362862,18,25,1995,9,female,174,1051,629,1108,699,1108,620,0,79
1280589,19,23,1994,7,male,407,1047,583,992,1248,992,1070,0,178
1918429,20,3,1993,3,female,732,1204,802,1192,773,26,369,1166,404
1165205,96,25,1917,12,male,1365,1210,347,1176,1102,0,51,1176,1051
1451179,15,25,1998,10,female,383,1025,429,1153,1780,128,803,1025,977
1077741,16,7,1997,8,female,872,1054,656,1150,589,237,357,913,232
1005458,14,18,1999,3,female,478,1025,532,1165,793,403,313,762,480
1940928,16,18,1997,9,female,1006,1123,300,1213,1599,760,924,453,675
1201943,18,13,1995,11,female,169,998,657,1258,1274,737,868,521,406
1544554,20,25,1993,7,female,1518,1022,422,1140,895,375,343,765,552
1113782,23,1,1990,1,female,1618,1052,578,1141,869,314,502,827,367
1639620,25,11,1988,9,female,187,1065,978,1218,1296,686,634,532,662
1577533,53,7,1960,6,female,1556,1046,570,1155,1655,307,324,848,1331
1549109,26,28,1987,3,male,299,1113,375,1197,2024,635,1023,562,1001
1423936,38,5,1975,1,female,1747,1144,596,1132,2540,755,1080,377,1460
1922305,64,13,1949,6,female,1320,1078,646,1138,2251,359,698,779,1553
1107983,20,4,1993,12,female,210,1161,892,1211,301,1147,218,64,83
1719307,19,21,1994,9,female,277,1085,951,1268,672,1232,303,36,369
1279127,37,7,1976,3,female,479,1091,947,1156,443,953,344,203,99
2191024,14,1,1999,6,male,169,1231,1101,1138,1331,996,1142,142,189
1680597,15,17,1998,9,female,449,1233,683,1275,1226,1230,1036,45,190
2011940,18,7,1995,7,male,653,1218,649,1257,1436,1031,836,226,600
1114082,21,16,1992,6,male,1436,1040,631,1250,928,1230,701,20,227
1143036,49,19,1964,4,female,1894,1076,750,1224,1334,1033,570,191,764
2177118,17,8,1996,6,female,281,1224,183,1279,2432,1035,926,244,1506
1333320,19,12,1994,10,female,1134,1129,473,1233,2160,1015,1259,218,901
1975125,29,28,1984,8,female,769,1036,648,1176,1945,994,1302,182,643
1866281,33,9,1980,5,female,905,1027,375,1231,2490,1202,1361,29,1129
1799374,53,9,1960,12,female,1689,1168,1014,1261,2890,1208,2015,53,875
1039734,108,13,1905,4,male,1460,1264,1114,1218,482,1214,390,4,92
1908714,108,3,1905,7,female,630,1191,377,1136,318,1135,267,1,51
1991613,18,15,1995,12,female,361,1092,304,1208,1459,1204,715,4,744
1055112,21,26,1992,12,female,716,1268,562,1252,784,1249,545,3,239
1218066,14,27,1999,4,male,356,1047,917,1271,3154,1267,2743,4,411
1995267,16,6,1997,12,male,558,1094,839,1138,263,1138,225,0,38
1064392,80,3,1933,3,male,1132,1168,995,1134,203,1134,184,0,19
1193585,103,18,1910,4,male,1116,1261,924,1233,573,1233,444,0,129
1704599,17,11,1996,11,female,542,1257,870,1211,1355,1211,1207,0,148
1887870,16,25,1997,2,female,551,1023,669,1225,1297,1225,1106,0,191
1117388,26,1,1987,1,female,304,1072,605,1179,5879,1179,5092,0,787
1885427,28,6,1985,6,female,372,1050,169,1161,2134,1161,1967,0,167
1206939,18,28,1995,1,female,337,1065,699,1402,459,25,74,1377,385
1538209,15,7,1998,5,female,555,1010,400,1429,901,12,369,1417,532
1905569,16,2,1997,5,female,601,1238,463,1300,1809,24,736,1276,1073
1906546,21,21,1992,9,female,741,1049,568,1493,1190,27,710,1466,480
1759140,21,30,1992,12,female,315,1121,900,1499,273,739,161,760,112
1855916,26,27,1987,12,male,669,1054,931,1335,676,625,493,710,183
1535763,56,10,1957,9,female,253,1057,581,1289,525,748,381,541,144
1428159,17,26,1996,4,male,716,1219,643,1368,1042,985,720,383,322
1398833,17,24,1996,6,female,508,1053,587,1484,1338,845,865,639,473
1743569,17,30,1996,8,male,778,1081,827,1350,1956,291,1326,1059,630
1294823,18,15,1995,1,female,1470,1058,383,1399,1519,539,1212,860,307
1431705,44,28,1969,6,female,664,1232,440,1320,1518,882,1266,438,252
1471163,19,3,1994,6,female,690,1199,226,1413,3505,577,1396,836,2109
1670596,21,28,1992,9,female,438,1098,322,1367,5383,642,2792,725,2591
1287842,17,18,1996,4,female,916,1094,604,1358,967,1023,362,335,605
1349858,20,15,1993,9,female,440,1132,853,1319,1794,955,1062,364,732
2101538,23,20,1990,5,female,158,1074,561,1347,840,1194,491,153,349
1598252,29,11,1984,1,female,2112,1226,530,1431,969,1392,320,39,649
2157773,19,2,1994,2,female,423,1115,467,1434,4191,1404,2715,30,1476
1552177,19,15,1994,6,male,174,1013,380,1310,7657,1286,5006,24,2651
1911928,15,12,1998,7,female,415,1095,629,1508,255,1503,164,5,91
2112148,38,4,1975,5,female,489,1158,334,1389,1431,1383,1203,6,228
2187936,21,15,1992,10,female,408,1160,781,1407,3029,1400,1939,7,1090
1647513,36,28,1977,6,male,563,1144,422,1322,359,1322,344,0,15
1677620,84,29,1929,4,female,93,1025,253,1326,1060,1326,995,0,65
1508348,17,8,1996,5,female,875,1267,343,1488,3975,1488,3049,0,926
1751676,16,3,1997,9,female,443,1225,778,1804,2083,33,528,1771,1555
1952407,17,27,1996,2,female,1000,1085,655,1600,1937,31,886,1569,1051
1206543,23,25,1990,4,female,73,1193,877,1660,1679,201,207,1459,1472
1632517,68,25,1945,12,male,350,1090,591,1580,1553,122,816,1458,737
1211415,21,20,1992,11,male,258,1240,892,1659,650,381,394,1278,256
1329711,15,2,1998,6,female,556,1179,1001,1760,1215,962,429,798,786
1239931,15,4,1998,9,female,1151,1080,406,1775,1659,931,657,844,1002
1771542,16,24,1997,6,female,252,1006,487,1549,1097,1030,835,519,262
1694445,17,3,1996,7,female,563,1031,873,1721,1070,766,442,955,628
1705411,18,5,1995,5,female,267,1010,184,1622,1049,1078,367,544,682
1071480,25,16,1988,5,male,876,1003,445,1562,1784,566,402,996,1382
2014609,18,2,1995,5,female,767,1059,229,1754,4434,678,1294,1076,3140
1013194,19,4,1994,5,male,212,998,610,1651,4491,451,2018,1200,2473
1646470,19,10,1994,10,male,84,1123,443,1854,3320,1243,1982,611,1338
1940138,23,30,1990,11,female,656,1078,694,1826,3665,928,2016,898,1649
1371426,103,24,1910,7,male,1369,1246,430,1644,2908,948,921,696,1987
1993569,15,24,1998,7,female,418,1144,723,1780,547,1750,402,30,145
1297646,19,14,1994,4,male,433,1020,889,1549,667,1292,312,257,355
2041104,16,29,1997,11,female,665,1179,793,1727,1841,1407,1319,320,522
2145460,16,26,1997,5,male,1054,1258,573,1644,2242,1528,938,116,1304
1553906,18,21,1995,5,male,460,1077,570,1784,1814,1651,1308,133,506
1508767,17,20,1996,5,female,563,1193,292,1842,2873,1777,2284,65,589
1979737,19,26,1994,6,female,488,1105,758,1625,613,1622,362,3,251
1265372,21,20,1992,7,female,971,1208,546,1677,963,1677,864,0,99
1308028,29,1,1984,1,male,364,1158,1074,1747,467,1747,396,0,71
2122233,32,29,1981,12,male,497,1108,895,1554,450,1554,398,0,52
2164803,14,29,1999,4,female,441,1186,628,1717,2136,1717,1758,0,378
2039405,16,14,1997,8,female,257,1227,850,1800,1223,1800,1100,0,123
2064694,68,21,1945,3,female,639,1228,231,1861,1760,1861,1589,0,171
2006910,100,27,1913,10,female,1227,1077,347,1550,1098,1550,887,0,211
1592354,20,10,1993,11,male,651,1070,676,2138,519,278,227,1860,292
1565262,15,16,1998,4,female,613,1010,500,2070,2471,200,965,1870,1506
2015096,18,2,1995,7,female,182,1014,516,2219,1429,374,265,1845,1164
2061751,21,30,1992,9,male,222,1119,554,1893,3170,285,1153,1608,2017
1333149,18,2,1995,3,female,375,1124,336,1898,426,1089,307,809,119
1011509,23,20,1990,1,female,1046,1062,555,1949,727,608,199,1341,528
1704576,19,7,1994,11,female,732,1141,519,2002,1502,980,334,1022,1168
1814310,19,24,1994,8,male,227,1079,874,2225,2517,588,1215,1637,1302
1174974,16,1,1997,4,female,227,1090,887,2285,1007,2202,915,83,92
1834488,16,27,1997,5,female,612,1199,727,2261,1145,1767,667,494,478
1568282,19,4,1994,3,male,97,1036,919,2290,1348,1869,1211,421,137
1041478,50,4,1963,6,female,1330,1185,873,1959,545,1657,165,302,380
1622889,15,20,1998,5,female,1096,1185,335,2004,2436,1830,1842,174,594
1698567,19,17,1994,2,female,600,1028,754,1916,1292,1672,722,244,569
2163614,25,9,1988,9,female,516,1037,442,1911,2002,1775,1271,136,731
1367055,18,11,1995,5,female,442,1203,593,1893,4212,1836,3457,57,755
1298429,20,9,1993,7,female,206,1170,799,2240,754,2239,430,1,324
1609305,29,4,1984,9,male,449,1057,883,1944,218,1944,195,0,23
1145882,90,23,1923,12,male,611,1242,927,1999,257,1999,234,0,23
2036993,19,22,1994,1,female,286,1037,658,2106,1431,2106,1204,0,227
1950623,19,22,1994,2,female,520,1006,478,2339,2199,2339,1703,0,496
1452297,25,8,1988,5,male,1234,1162,958,2327,1440,2327,471,0,969
1607466,57,30,1956,11,female,1726,1208,797,2103,1319,2103,921,0,398
1982672,27,26,1986,12,female,711,1208,363,1944,3130,1944,2870,0,260
1209271,19,19,1994,11,female,353,1197,574,2401,1355,96,750,2305,605
1240248,13,14,2000,7,female,970,1183,491,3414,3428,109,1360,3305,2068
1363660,17,19,1996,4,female,473,1084,569,3074,4553,252,3515,2822,1038
2040443,26,1,1987,1,female,35,1054,708,2430,2626,136,360,2294,2266
1231564,93,30,1920,9,male,858,1243,880,3536,359,1575,94,1961,265
1950511,16,2,1997,3,male,336,1113,858,3416,800,1441,519,1975,281
2065720,15,1,1998,2,male,205,1102,705,3514,2344,1127,1183,2387,1161
1338347,15,25,1998,3,female,177,1147,862,3314,3183,1031,1366,2283,1817
1737656,18,28,1995,9,female,667,1228,970,3370,2807,2038,2033,1332,774
1295808,58,24,1955,9,female,1246,1083,392,3098,3864,827,1439,2271,2425
1395813,13,27,2000,6,female,676,1239,500,3368,9919,1710,2993,1658,6926
1020353,15,20,1998,11,female,819,1041,675,2522,1012,2207,699,315,313
1472001,18,6,1995,12,male,747,1261,918,2648,1294,2178,899,470,395
1002882,23,13,1990,3,male,262,1049,874,3532,868,3144,625,388,243
2047332,16,27,1997,11,male,377,1002,590,2856,2012,2692,1767,164,245
1903238,15,11,1998,4,female,276,1122,324,2927,1966,2786,1491,141,475
1615033,18,3,1995,12,female,1007,1143,648,2895,1791,2430,1154,465,637
1335890,22,9,1991,5,female,538,1079,657,3137,2281,2730,1467,407,814
1045917,23,22,1990,4,male,529,1132,664,2752,2388,2116,1468,636,920
1979634,46,6,1967,12,female,1968,1174,962,2404,2003,2315,1331,89,672
1089286,18,20,1995,6,female,654,1033,162,2599,4055,2524,2072,75,1983
1730451,19,7,1994,1,male,311,1062,779,2775,2483,2767,1479,8,1004
1265320,23,10,1990,6,male,483,1041,828,3097,444,3097,374,0,70
1746170,17,31,1996,7,male,675,1225,862,2589,1339,2589,1281,0,58
2072545,17,22,1996,10,female,266,1076,463,2434,933,2434,834,0,99
2156811,19,23,1994,11,male,825,1020,906,2623,1095,2623,758,0,337
1960475,31,31,1982,3,female,467,1037,107,2883,572,2883,514,0,58
1784101,94,31,1919,12,male,632,1055,709,3223,1812,3223,1537,0,275
1302090,102,15,1911,6,male,774,1196,995,2411,823,2411,766,0,57
1007185,103,21,1910,7,female,814,1057,468,3474,1151,3474,1034,0,117
1484526,24,19,1989,8,female,959,1072,765,2525,1952,2525,1750,0,202
1559095,23,1,1990,10,female,388,1140,639,6940,3123,65,986,6875,2137
1570692,14,30,1999,10,female,816,1174,749,8326,5792,1561,3778,6765,2014
1353893,19,1,1994,11,male,305,1092,238,10803,7748,901,3919,9902,3829
1748468,20,22,1993,8,female,1486,1182,553,7156,5026,1403,3481,5753,1545
1298937,19,7,1994,5,female,568,1095,494,6980,10690,1298,5713,5682,4977
1800195,18,16,1995,12,female,1003,1108,492,6280,3100,3026,1598,3254,1502
1812645,17,13,1996,6,male,651,1222,591,4059,1487,1404,572,2655,915
1530437,18,5,1995,8,female,1100,1134,616,4583,2737,2626,1550,1957,1187
1154586,63,5,1950,5,male,1371,1137,434,8301,3991,4639,2380,3662,1611
2103193,15,3,1998,5,male,1042,1266,905,5022,6168,3053,3000,1969,3168
1826481,19,1,1994,12,female,303,1230,387,5490,3879,1960,2380,3530,1499
1005210,18,15,1995,9,female,667,1162,329,10762,11783,6669,6630,4093,5153
1130367,19,18,1994,10,male,517,1000,853,5367,3338,2780,2530,2587,808
2121773,25,20,1988,12,female,162,1020,589,3896,3392,959,1585,2937,1807
1097319,103,29,1910,3,male,549,1192,642,8963,1276,8747,1020,216,256
2108285,15,11,1998,11,female,499,1222,943,4212,2444,4005,1954,207,490
1953792,18,3,1995,5,female,238,1120,655,5191,2738,4875,1098,316,1640
1794309,18,17,1995,6,female,613,1211,718,3842,1150,3777,763,65,387
1723999,22,5,1991,12,female,529,1014,380,4900,2280,4849,1657,51,623
2001093,16,17,1997,11,female,784,1091,606,8627,5884,6966,4748,1661,1136
1241897,17,31,1996,7,female,352,1047,411,10489,8515,10316,7343,173,1172
1128774,18,16,1995,6,female,1154,1150,513,5726,4183,5484,2333,242,1850
1959140,18,12,1995,8,female,942,1263,702,3793,4487,3730,4245,63,242
1460116,20,18,1993,12,female,543,1084,847,5954,4536,4355,2336,1599,2200
2131320,19,20,1994,1,female,1023,1181,636,5887,3954,4800,1924,1087,2030
1646437,33,23,1980,5,male,1473,1100,742,8749,8059,7086,4784,1663,3275
1267229,24,14,1989,9,female,484,1171,695,14799,22513,12934,17955,1865,4558
1680228,19,13,1994,6,male,612,1026,804,5318,2000,5269,1757,49,243
1732225,25,2,1988,6,female,63,1073,806,3629,2131,3617,1724,12,407
2007018,47,9,1966,4,female,608,1124,950,4452,1399,4439,943,13,456
1992740,15,15,1998,5,female,562,1027,817,7616,6771,7578,4390,38,2381
1158610,18,16,1995,2,female,166,1034,683,4843,4485,4808,2111,35,2374
1245068,22,5,1991,12,female,317,1003,760,3832,3196,3812,2730,20,466
1268927,17,7,1996,8,male,619,1099,898,4731,351,4731,294,0,57
1684195,23,14,1990,3,male,529,1056,665,25111,3447,25111,3111,0,336
1220557,35,12,1978,6,male,232,1128,600,7819,1134,7819,1001,0,133
1100061,27,4,1986,2,female,405,1247,853,4523,2423,4523,1948,0,475
1633537,18,14,1995,4,female,318,1014,496,4044,5513,4044,4754,0,759
1720248,18,12,1995,6,female,378,1155,205,3786,3045,3786,2646,0,399
2037447,20,23,1993,5,female,360,1160,668,7447,5547,7447,3756,0,1791
1539043,21,22,1992,4,female,231,1253,835,4110,4714,4110,4258,0,456
2076321,31,2,1982,2,female,223,1019,406,6071,4064,6071,3330,0,734
1919841,45,27,1968,1,female,1419,1230,491,11615,11929,11615,10758,0,1171
1348426,61,7,1952,3,male,721,1279,821,0,83,0,73,0,10
1854397,103,27,1910,12,male,856,1302,1065,0,13,0,8,0,5
1839690,103,13,1910,12,female,703,1338,541,0,0,0,0,0,0
2098825,108,27,1905,11,male,1179,1778,764,0,0,0,0,0,0
1095611,108,16,1905,8,male,853,1334,742,0,9,0,8,0,1
1303970,108,1,1905,11,female,1138,1727,581,0,26,0,20,0,6
2095658,15,1,1998,1,male,760,1809,1114,1,0,0,0,1,0
2058565,22,21,1991,5,male,1499,1644,628,1,1,0,0,1,1
1709906,24,19,1989,3,male,828,1549,1443,1,1,0,0,1,1
2134988,17,16,1996,10,male,1227,1284,689,1,9,0,4,1,5
1244598,18,4,1995,9,male,686,1830,716,1,22,0,3,1,19
1546544,48,6,1965,7,male,447,1569,221,1,5,0,3,1,2
1530366,102,2,1911,1,male,839,1634,53,1,41,0,18,1,23
2100327,19,11,1994,11,male,622,1562,1009,1,0,1,0,0,0
1817708,21,1,1992,12,female,1541,1497,852,1,1,1,0,0,1
1976011,31,10,1982,4,male,922,1605,295,1,1,1,1,0,0
1910026,13,29,2000,3,female,183,1281,33,1,56,1,51,0,5
1861181,19,6,1994,12,female,640,1601,335,1,2,1,0,0,2
2124076,20,13,1993,12,male,688,1617,1509,1,8,1,5,0,3
1846661,23,14,1990,8,female,503,1802,1668,1,36,1,15,0,21
1178583,56,12,1957,3,female,1320,1714,604,1,30,1,24,0,6
1936241,56,8,1957,4,male,570,1600,1562,1,151,1,87,0,64
1396981,17,2,1996,11,male,639,1793,919,2,106,0,26,2,80
2021145,81,1,1932,1,male,1574,1572,357,2,3,0,0,2,3
1944820,103,3,1910,5,male,1671,1356,143,2,47,0,36,2,11
1112722,15,17,1998,2,female,443,1279,784,2,2,1,1,1,1
1959425,23,10,1990,2,male,573,1665,1486,2,249,1,168,1,81
1172894,18,1,1995,5,male,567,1725,706,2,0,2,0,0,0
1984081,20,16,1993,1,male,766,1822,1594,2,0,2,0,0,0
1699649,18,4,1995,9,female,561,1445,438,2,55,2,47,0,8
1032717,20,10,1993,3,male,720,1546,905,2,19,2,17,0,2
1501692,21,2,1992,8,male,424,1570,1021,2,29,2,16,0,13
2106122,25,2,1988,8,male,670,1290,1105,2,16,2,12,0,4
1379199,103,22,1910,1,male,646,1508,685,2,48,2,24,0,24
1129308,108,23,1905,10,male,1466,1612,1429,3,21,0,20,3,1
1705454,17,1,1996,8,male,1207,1717,1290,3,158,1,118,2,40
1477387,96,24,1917,8,female,1069,1404,1005,3,0,3,0,0,0
1665963,14,8,1999,1,female,513,1384,830,3,51,3,34,0,17
1335928,18,28,1995,4,female,620,1486,391,3,27,3,20,0,7
1617113,18,31,1995,8,female,816,1534,601,3,187,3,157,0,30
1534657,24,12,1989,5,male,582,1366,1284,3,5,3,3,0,2
1905084,43,17,1970,12,male,301,1891,61,3,35,3,16,0,19
1182730,68,29,1945,8,female,1268,1320,537,3,8,3,7,0,1
1071552,96,13,1917,5,female,202,1455,452,4,695,0,95,4,600
1400829,35,6,1978,8,male,464,1490,1459,4,0,2,0,2,0
1723198,17,25,1996,10,female,646,1271,539,4,32,1,25,3,7
2177989,14,17,1999,8,female,311,1452,665,4,33,3,10,1,23
1214450,18,21,1995,7,male,518,1584,1103,4,13,4,11,0,2
1907976,19,18,1994,8,female,494,1845,310,4,444,4,298,0,146
1491290,21,2,1992,9,female,707,1644,750,4,20,4,19,0,1
2124187,25,15,1988,9,female,702,1323,120,4,659,4,534,0,125
1170126,104,1,1909,7,male,1858,1361,648,4,32,4,28,0,4
2094705,103,2,1910,7,male,1488,1908,600,5,9,0,6,5,3
1861402,31,23,1982,5,female,1354,1576,325,5,1313,1,837,4,476
2139247,26,16,1987,12,male,709,1334,1229,5,217,4,191,1,26
1168231,22,23,1991,5,female,268,1732,332,5,22,5,22,0,0
1849701,95,8,1918,9,female,1002,1412,805,5,129,5,95,0,34
1687615,103,13,1910,1,female,721,1504,176,5,13,5,11,0,2
1037626,103,14,1910,10,male,1357,1585,836,5,14,5,13,0,1
1053352,16,28,1997,8,male,466,1496,1238,6,0,0,0,6,0
1831689,18,1,1995,2,male,561,1323,738,6,2,0,1,6,1
1794093,15,24,1998,9,female,419,1584,1368,6,9,1,8,5,1
1222124,16,12,1997,2,male,629,1463,664,6,19,1,10,5,9
1253065,20,12,1993,12,male,991,1722,905,6,11,0,8,6,3
1201356,72,21,1941,4,male,426,1312,1118,6,3,5,1,1,2
1457724,15,17,1998,3,female,486,1584,1093,6,3,6,3,0,0
2032039,103,11,1910,3,female,1226,1490,267,6,7,6,6,0,1
1270792,30,12,1983,10,male,655,1749,1210,6,13,6,11,0,2
1150110,45,28,1968,7,male,456,1568,1297,6,18,6,17,0,1
1258839,69,16,1944,10,male,1109,1521,1235,6,74,6,56,0,18
1337547,23,30,1990,8,male,640,1273,990,7,0,0,0,7,0
2004258,18,12,1995,12,male,721,1905,1810,7,2,0,1,7,1
1424262,18,10,1995,6,female,1529,1559,278,7,2,7,2,0,0
1423091,18,5,1995,12,male,638,1308,1064,7,6,7,5,0,1
1809656,20,29,1993,8,male,554,1568,1381,7,68,7,56,0,12
1004025,24,7,1989,5,male,958,1277,1159,7,23,7,14,0,9
1119920,37,2,1976,3,male,1521,1531,367,7,28,7,25,0,3
1302005,108,12,1905,9,male,857,1288,816,7,63,7,49,0,14
2115152,15,4,1998,7,female,293,1275,108,8,9,1,7,7,2
2174107,15,13,1998,11,female,664,1624,84,8,83,0,36,8,47
1630729,17,17,1996,12,male,928,1385,193,8,22,0,21,8,1
1152457,103,14,1910,9,male,1283,1800,319,8,128,0,51,8,77
2187633,17,12,1996,9,female,574,1539,306,8,18,4,15,4,3
1785494,103,9,1910,3,male,1004,1326,822,8,4,7,3,1,1
2037679,16,13,1997,3,male,590,1309,316,8,75,8,35,0,40
2073716,17,3,1996,3,female,478,1821,428,8,983,8,795,0,188
1577424,86,18,1927,6,male,1489,1330,747,8,192,8,182,0,10
1119928,90,8,1923,3,female,727,1524,651,8,20,8,13,0,7
1200174,104,29,1909,4,male,943,1537,1281,8,41,8,25,0,16
1456953,15,21,1998,4,male,608,1349,965,9,9,2,1,7,8
1559868,103,4,1910,11,female,1293,1603,561,9,18,6,17,3,1
1842054,108,18,1905,7,male,746,1340,1168,9,4,9,4,0,0
2160301,103,25,1910,5,male,780,1662,1137,9,11,9,8,0,3
1835879,19,14,1994,1,male,561,1478,853,9,14,9,14,0,0
1928393,91,12,1922,6,male,1225,1570,1201,9,38,9,29,0,9
1610167,24,4,1989,8,male,498,1684,1464,10,27,2,23,8,4
1320139,113,25,1900,6,male,1740,1709,1381,10,95,6,51,4,44
1727011,15,21,1998,12,female,348,1461,194,10,64,10,59,0,5
1422667,23,27,1990,12,male,713,1367,1210,10,257,10,207,0,50
1794452,95,22,1918,8,female,1299,1539,285,10,53,10,40,0,13
1677189,56,20,1957,1,male,1130,1465,997,11,14,0,6,11,8
1252889,20,28,1993,4,male,1300,1570,928,11,30,5,19,6,11
1584528,68,10,1945,6,male,1573,1329,539,11,16,11,8,0,8
1433733,21,29,1992,5,male,998,1494,669,11,19,11,19,0,0
2135378,16,28,1997,9,female,695,1535,916,12,36,2,32,10,4
1505720,19,17,1994,9,female,333,1537,614,12,355,4,298,8,57
1598809,68,13,1945,2,male,1539,1407,970,12,50,12,30,0,20
1471036,77,23,1936,1,male,2171,1408,249,12,28,12,24,0,4
1835827,15,19,1998,8,male,721,1753,1250,13,0,0,0,13,0
1987236,19,12,1994,10,female,280,1524,985,13,132,3,82,10,50
1576625,19,14,1994,2,male,920,1316,1004,13,19,13,17,0,2
1289727,16,3,1997,5,male,637,1339,910,13,25,13,18,0,7
1739866,16,4,1997,8,female,353,1630,922,13,75,13,45,0,30
1309103,21,8,1992,6,female,390,1355,444,13,142,13,129,0,13
1868478,68,11,1945,2,male,834,1362,492,13,32,13,28,0,4
1100917,19,10,1994,9,male,334,1711,67,14,0,0,0,14,0
2135549,21,5,1992,7,male,949,1772,983,14,29,0,9,14,20
1546098,18,28,1995,7,male,1403,1779,1117,14,79,14,62,0,17
1459402,20,18,1993,12,female,723,1389,434,14,22,14,19,0,3
1435216,21,7,1992,9,female,986,1576,250,14,537,14,397,0,140
1264457,23,15,1990,4,male,285,1556,255,14,80,14,55,0,25
1820153,18,29,1995,8,female,350,1567,40,15,6,15,4,0,2
1914747,18,12,1995,7,male,991,1435,246,16,35,11,19,5,16
1290433,104,30,1909,12,male,1474,1576,904,16,94,10,86,6,8
1884563,19,3,1994,3,female,722,1787,519,16,92,14,78,2,14
2134628,19,3,1994,8,male,781,1271,1066,16,16,16,15,0,1
1489044,22,25,1991,9,male,942,1406,1061,16,44,16,40,0,4
1850650,18,28,1995,11,female,607,1897,979,17,3,17,2,0,1
1022314,14,7,1999,8,female,203,1530,595,17,570,17,472,0,98
1806671,19,4,1994,11,female,567,1350,569,17,178,17,148,0,30
2135122,108,17,1905,6,male,3139,1343,167,18,14,0,12,18,2
1884269,18,23,1995,5,male,825,1460,1109,18,11,10,3,8,8
1096832,15,25,1998,2,female,726,1660,300,18,13,18,10,0,3
1008808,26,4,1987,8,male,1125,1342,1123,18,12,18,9,0,3
1681314,18,10,1995,9,male,194,1345,1163,18,59,18,35,0,24
2015159,17,3,1996,9,female,1304,1275,1004,19,119,18,85,1,34
2131206,98,20,1915,10,female,917,1322,539,19,43,15,20,4,23
1905098,22,12,1991,9,male,924,1617,1346,19,10,19,6,0,4
2165824,108,30,1905,12,male,1161,1316,1075,19,10,19,10,0,0
1138075,20,19,1993,1,male,476,1495,857,19,55,19,48,0,7
1103188,15,26,1998,3,female,117,1459,48,20,102,6,62,14,40
1063605,16,28,1997,6,male,383,1661,903,20,136,12,128,8,8
1061301,18,28,1995,5,female,172,1681,334,20,833,16,627,4,206
1349884,19,28,1994,7,female,672,1890,685,20,11,20,9,0,2
1881300,17,26,1996,10,female,628,1724,370,21,229,13,172,8,57
2176083,16,10,1997,6,female,687,1402,660,21,39,19,31,2,8
1536205,14,12,1999,1,male,461,1749,1667,21,13,21,9,0,4
1759788,95,18,1918,1,female,1524,1389,997,21,290,21,220,0,70
1682287,16,28,1997,3,female,641,1576,247,22,78,5,66,17,12
1750170,19,22,1994,6,male,1342,1451,1160,22,79,6,22,16,57
1392905,16,2,1997,7,female,553,1635,660,22,92,22,74,0,18
1942303,18,16,1995,10,male,892,1874,1501,22,191,22,177,0,14
1327688,68,14,1945,12,female,945,1531,526,22,34,22,25,0,9
1258311,22,12,1991,4,male,965,1420,1096,23,10,23,9,0,1
1737307,24,17,1989,1,female,484,1641,886,23,285,23,247,0,38
2159482,68,6,1945,2,female,1554,1822,618,23,57,23,38,0,19
1387095,108,20,1905,2,female,2119,1627,682,23,106,23,99,0,7
1111566,20,9,1993,12,male,470,1534,1288,24,28,0,19,24,9
1964324,17,24,1996,5,male,634,1465,1338,24,35,24,30,0,5
1261270,16,20,1997,2,female,500,1277,905,24,129,24,117,0,12
1156523,17,9,1996,1,female,597,1883,278,24,171,24,151,0,20
2089195,98,12,1915,7,female,20,1343,167,24,41,24,33,0,8
1630972,103,2,1910,7,male,1685,1289,474,24,57,24,41,0,16
1131895,105,11,1908,8,female,1545,1421,226,25,39,9,19,16,20
2132667,27,24,1986,3,female,1744,1382,612,25,108,19,70,6,38
1677916,21,17,1992,12,male,594,1861,1472,26,270,22,200,4,70
1715384,15,28,1998,8,female,655,1680,263,26,112,26,66,0,46
2104450,94,19,1919,3,female,559,1747,969,26,109,26,97,0,12
1004515,19,14,1994,9,male,1014,1375,1032,27,10,1,6,26,4
1281105,108,30,1905,12,male,652,1728,1574,27,17,0,5,27,12
1357822,26,1,1987,1,male,534,1354,1256,27,9,27,9,0,0
1854882,19,23,1994,5,male,391,1429,1164,27,95,27,78,0,17
1929749,68,4,1945,5,male,1060,1404,650,27,100,27,72,0,28
2049364,101,23,1912,5,female,1694,1496,682,28,52,15,15,13,37
1477965,16,6,1997,5,male,532,1307,1216,28,55,26,41,2,14
1623538,18,15,1995,7,female,772,1388,935,28,247,28,150,0,97
1369459,15,1,1998,3,female,614,1309,316,29,114,9,54,20,60
1584472,108,28,1905,8,male,969,1344,1052,29,71,27,54,2,17
2044201,78,29,1935,7,female,1023,1770,1166,29,17,29,15,0,2
1482747,19,8,1994,8,female,670,1436,656,29,120,29,107,0,13
1025598,22,2,1991,4,male,1303,1305,1111,29,207,29,175,0,32
1132823,94,25,1919,8,female,2283,1825,333,31,6,2,3,29,3
2094049,23,20,1990,11,female,1467,1338,322,31,72,4,40,27,32
2146632,18,5,1995,6,male,451,1652,1253,30,11,19,4,11,7
1747526,101,14,1912,4,female,363,1750,618,31,23,31,20,0,3
1940887,19,30,1994,11,female,347,1333,132,31,397,31,313,0,84
1622833,21,3,1992,9,male,844,1693,777,31,102,31,81,0,21
2003376,15,19,1998,11,male,678,1910,1357,32,105,18,56,14,49
1289090,33,15,1980,8,male,348,1577,82,32,59,25,14,7,45
1011361,18,10,1995,8,female,621,1504,913,34,977,34,830,0,147
1335525,103,1,1910,1,female,968,1824,621,36,11,11,10,25,1
1417757,103,31,1910,8,female,505,1643,609,35,402,25,87,10,315
2053925,101,1,1912,4,male,1865,1836,1379,37,16,0,10,37,6
1973340,20,15,1993,12,female,1636,1297,611,38,124,20,96,18,28
1242251,19,30,1994,5,female,900,1404,690,39,72,12,31,27,41
1357973,20,6,1993,8,male,1118,1799,1171,38,58,31,51,7,7
1215376,20,18,1993,10,male,700,1352,1025,38,198,31,116,7,82
1467258,63,18,1950,6,male,1183,1632,907,40,48,29,27,11,21
1368360,103,30,1910,12,male,772,1337,706,41,129,40,129,1,0
1160229,28,31,1985,5,female,362,1510,1321,41,112,41,94,0,18
1567587,18,22,1995,11,female,607,1487,1139,43,193,13,89,30,104
1437658,24,25,1989,11,female,372,1774,176,44,407,16,332,28,75
1769910,25,8,1988,8,male,474,1349,1014,44,13,42,9,2,4
2122676,101,20,1912,11,female,1586,1401,396,43,3,43,3,0,0
1679726,103,5,1910,1,male,1099,1733,1286,44,18,44,17,0,1
2106062,17,1,1996,9,female,577,1837,251,43,62,43,53,0,9
1822930,106,7,1907,10,female,404,1313,185,44,34,44,26,0,8
2049037,15,19,1998,10,male,637,1422,1007,43,269,43,255,0,14
1604986,18,13,1995,4,female,518,1819,1264,43,148,43,131,0,17
1816768,43,10,1970,10,male,173,1414,886,45,123,1,61,44,62
1856637,26,14,1987,9,female,1751,1280,753,45,144,37,88,8,56
1556788,23,16,1990,4,male,743,1614,1121,46,115,30,89,16,26
2127629,16,29,1997,6,male,758,1443,734,47,9,47,7,0,2
1377338,18,27,1995,8,female,817,1309,764,46,8,46,7,0,1
1948593,23,7,1990,9,male,537,1270,1118,47,11,47,10,0,1
1274777,19,13,1994,10,male,437,1452,1066,46,61,46,28,0,33
1852811,18,26,1995,5,female,576,1449,934,46,134,46,95,0,39
1443366,20,21,1993,8,male,645,1519,1129,46,69,46,54,0,15
1439205,21,23,1992,9,male,527,1726,1381,47,157,47,146,0,11
1407496,74,18,1939,10,female,451,1411,841,49,153,1,27,48,126
2030154,16,28,1997,7,female,900,1507,240,48,34,26,18,22,16
1575950,19,19,1994,10,female,709,1414,1054,48,57,13,44,35,13
1759747,103,15,1910,1,male,939,1405,944,49,3,47,2,2,1
1780611,16,17,1997,9,female,614,1383,246,49,404,49,260,0,144
2002583,18,24,1995,12,female,306,1453,227,48,197,48,149,0,48
1183808,15,20,1998,7,male,819,1658,760,50,89,3,60,47,29
1112605,14,13,1999,7,female,419,1290,796,50,66,50,47,0,19
1229862,15,24,1998,5,female,198,1361,1252,51,33,51,20,0,13
1443672,17,2,1996,6,female,621,1363,732,51,80,51,41,0,39
1567479,29,4,1984,12,male,1290,1519,256,52,69,9,32,43,37
1346037,19,20,1994,8,female,173,1454,59,53,815,23,349,30,466
1673266,108,30,1905,12,male,1510,1288,139,54,18,6,9,48,9
1437662,19,3,1994,8,female,628,1481,458,55,13,55,11,0,2
1301457,101,12,1912,4,male,1067,1801,1324,55,64,55,47,0,17
2063854,22,8,1991,7,female,544,1761,1227,55,1009,55,835,0,174
1173641,68,25,1945,6,female,1005,1830,912,55,991,55,394,0,597
1915096,26,18,1987,12,male,742,1773,1152,58,208,3,101,55,107
1846182,15,8,1998,3,male,495,1448,1120,56,53,17,20,39,33
1561795,20,25,1993,3,male,663,1325,743,56,2,56,1,0,1
1303330,103,21,1910,10,male,1477,1711,411,56,51,56,28,0,23
1052712,16,16,1997,12,male,685,1553,627,58,249,58,186,0,63
2188047,19,26,1994,12,female,236,1293,138,58,654,58,468,0,186
1061706,23,26,1990,9,female,185,1427,467,56,234,56,124,0,110
1384831,21,19,1992,5,female,731,1315,689,59,220,36,170,23,50
1236128,30,29,1983,4,male,673,1463,847,60,241,18,104,42,137
1389347,17,31,1996,5,male,469,1505,1009,60,68,58,48,2,20
1230845,23,9,1990,9,male,651,1459,619,59,27,59,27,0,0
1068131,16,8,1997,12,female,367,1297,579,59,145,59,141,0,4
1737792,21,23,1992,1,male,1242,1516,1230,61,264,55,189,6,75
1976777,22,8,1991,9,female,938,1518,987,62,48,62,45,0,3
1563684,73,11,1940,10,female,1664,1888,293,63,65,63,40,0,25
2177448,18,1,1995,1,female,498,1670,537,62,129,62,85,0,44
1884729,18,14,1995,3,female,280,1416,30,62,114,62,104,0,10
1364707,22,30,1991,1,female,504,1822,134,62,427,62,290,0,137
1998708,18,11,1995,1,male,817,1520,764,64,2,63,0,1,2
1171468,37,22,1976,4,female,163,1586,1227,64,2376,54,2070,10,306
2145185,63,5,1950,5,female,1537,1634,89,65,70,65,55,0,15
1843796,24,10,1989,7,male,1411,1632,1012,65,131,65,99,0,32
2039932,91,17,1922,8,male,949,1661,900,68,23,13,21,55,2
1210908,108,16,1905,11,female,711,1450,366,67,20,0,16,67,4
1899966,14,10,1999,6,female,545,1767,1069,68,89,4,68,64,21
1410753,17,21,1996,1,female,380,1321,562,67,322,3,200,64,122
1131431,22,23,1991,5,female,364,1741,1333,67,227,31,56,36,171
1912510,23,7,1990,7,male,654,1629,1433,68,46,68,33,0,13
2069984,108,21,1905,2,female,1494,1525,712,71,24,0,6,71,18
2060339,28,9,1985,4,male,1418,1437,1055,69,112,4,33,65,79
1669062,32,23,1981,8,female,428,1421,23,69,376,12,223,57,153
1267401,18,10,1995,9,male,590,1609,1445,71,53,71,43,0,10
1815874,19,11,1994,5,male,989,1647,1315,71,66,71,54,0,12
1152506,16,19,1997,1,female,697,1676,374,69,129,69,115,0,14
1348679,22,23,1991,10,female,1439,1335,334,72,440,71,313,1,127
1912560,23,6,1990,6,male,539,1311,1051,74,69,74,61,0,8
2137368,102,6,1911,7,female,2136,1550,205,73,126,73,97,0,29
1847421,63,8,1950,8,male,1212,1287,519,76,53,28,20,48,33
1270267,15,25,1998,9,female,433,1525,625,76,39,73,34,3,5
1723691,16,21,1997,5,male,642,1668,1428,77,62,77,57,0,5
1446905,102,1,1911,1,female,2244,1345,483,80,959,0,431,80,528
2099729,101,9,1912,10,male,818,1656,1318,79,46,21,30,58,16
1744881,16,10,1997,2,male,643,1442,479,80,1049,49,637,31,412
1503823,35,17,1978,8,female,749,1898,305,80,229,52,170,28,59
1235940,16,27,1997,5,female,492,1736,975,80,36,67,13,13,23
1443489,18,31,1995,5,female,358,1865,1359,78,485,78,338,0,147
1037745,22,10,1991,3,male,590,1539,1307,84,273,4,157,80,116
1089042,20,31,1993,5,female,1015,1655,339,82,228,34,177,48,51
1141190,20,17,1993,8,male,363,1672,1446,84,354,50,123,34,231
1626192,18,24,1995,1,female,313,1823,819,81,386,79,215,2,171
1476355,20,13,1993,7,female,495,1372,942,83,757,81,675,2,82
1427083,99,13,1914,7,male,953,1567,733,83,99,83,87,0,12
1531653,98,30,1915,5,male,1533,1518,652,86,42,0,21,86,21
1889804,18,27,1995,4,female,630,1490,904,87,303,65,201,22,102
1404521,17,1,1996,1,male,688,1404,1093,87,7,87,4,0,3
1537253,23,31,1990,3,male,880,1366,949,85,18,85,18,0,0
1311328,103,17,1910,6,male,814,1605,1048,87,47,87,39,0,8
1855559,18,5,1995,7,male,583,1271,580,87,603,87,430,0,173
2153140,18,10,1995,7,female,95,1388,359,85,473,85,281,0,192
1624921,18,1,1995,1,male,398,1556,1181,88,616,8,512,80,104
1560856,108,7,1905,2,female,1131,1772,72,88,472,88,379,0,93
1847849,19,25,1994,10,female,837,1702,922,92,274,13,109,79,165
1420655,17,15,1996,4,female,1378,1907,351,93,212,24,103,69,109
1254325,84,2,1929,8,female,1340,1351,797,95,234,79,217,16,17
1508591,24,5,1989,5,male,521,1360,1291,93,46,93,46,0,0
1012833,19,28,1994,8,female,665,1330,802,95,363,95,190,0,173
1995353,21,14,1992,3,male,655,1610,1258,99,94,48,64,51,30
1566502,20,8,1993,8,male,1021,1862,1562,97,211,48,83,49,128
2163830,19,5,1994,4,female,361,1280,474,99,467,83,381,16,86
1013720,18,4,1995,6,male,480,1392,954,96,86,96,72,0,14
1934932,24,5,1989,3,female,662,1774,364,96,134,96,126,0,8
1044710,16,26,1997,11,female,988,1355,442,98,258,98,179,0,79
1604624,70,1,1943,1,female,1977,1320,711,97,315,97,193,0,122
1960129,14,1,1999,5,male,537,1610,781,102,110,87,55,15,55
1657321,14,4,1999,8,female,408,1438,690,100,119,100,81,0,38
1664145,16,10,1997,1,female,296,1366,682,100,832,100,627,0,205
1388337,17,19,1996,5,female,358,1310,137,104,407,104,321,0,86
1474910,67,16,1946,4,male,123,1351,133,108,719,0,175,108,544
1419745,26,8,1987,10,female,947,1296,191,105,35,28,9,77,26
2104825,20,26,1993,5,female,1621,1560,234,108,224,34,131,74,93
1678779,103,8,1910,2,female,1039,1715,916,105,188,80,74,25,114
2045305,28,16,1985,3,female,538,1702,994,109,533,108,429,1,104
1827648,21,8,1992,12,female,1019,1566,1319,105,261,105,206,0,55
1790382,18,16,1995,7,female,743,1503,1261,112,482,20,396,92,86
1661790,17,28,1996,2,female,937,1691,477,111,447,72,379,39,68
1430129,18,1,1995,9,female,1136,1357,967,111,399,52,335,59,64
1089611,19,9,1994,10,female,1090,1881,1526,111,823,42,478,69,345
1327533,20,13,1993,9,female,645,1743,437,111,436,50,177,61,259
1438852,63,30,1950,10,male,1397,1833,1620,113,832,23,662,90,170
1919393,43,31,1970,1,male,511,1899,755,111,11902,86,8724,25,3178
1576469,17,15,1996,5,female,372,1549,1078,112,736,111,473,1,263
2059838,54,25,1959,7,male,675,1356,1103,110,5,110,5,0,0
1605280,19,26,1994,4,male,960,1482,1375,116,152,24,120,92,32
2031070,18,7,1995,5,female,241,1497,809,117,280,63,108,54,172
1059447,19,10,1994,7,female,721,1751,1180,115,206,72,160,43,46
1342135,24,17,1989,5,male,688,1529,1360,118,252,48,105,70,147
1671192,108,13,1905,9,male,1568,1481,1012,114,101,109,64,5,37
2131898,68,6,1945,9,male,1124,1382,1155,117,326,117,258,0,68
1446143,17,5,1996,7,female,1028,1761,331,123,416,7,344,116,72
1122358,18,9,1995,2,male,1169,1356,680,123,149,30,121,93,28
1569228,18,30,1995,12,female,311,1287,731,124,81,114,76,10,5
2128469,18,15,1995,8,female,731,1367,847,120,232,103,140,17,92
1543545,16,22,1997,3,female,565,1831,266,124,163,124,95,0,68
1275981,19,12,1994,10,male,754,1357,624,126,362,81,280,45,82
1855501,17,22,1996,3,female,404,1453,1300,130,203,126,171,4,32
1732016,58,7,1955,4,male,1420,1619,882,129,404,121,210,8,194
1286319,100,5,1913,10,male,1694,1562,1079,127,413,122,360,5,53
1796903,18,1,1995,1,male,586,1354,1017,126,140,125,131,1,9
1151997,26,17,1987,4,male,394,1576,1017,127,480,127,356,0,124
1305202,16,3,1997,2,male,788,1898,379,133,1256,28,524,105,732
1096151,32,25,1981,10,female,713,1375,652,131,156,129,149,2,7
1852764,60,1,1953,6,female,630,1549,151,134,638,131,328,3,310
1641404,17,13,1996,6,female,610,1705,1179,132,214,131,91,1,123
1924596,15,6,1998,7,female,234,1640,155,134,204,134,187,0,17
2036104,18,7,1995,10,male,653,1515,838,133,338,133,323,0,15
1061621,21,1,1992,1,female,655,1279,805,136,470,136,429,0,41
1911219,15,31,1998,1,female,458,1493,568,139,193,2,123,137,70
1904893,68,15,1945,3,male,283,1827,1133,143,774,3,411,140,363
1066162,52,17,1961,3,male,875,1332,1011,141,207,107,95,34,112
2078617,15,20,1998,12,female,491,1323,949,140,767,118,482,22,285
1575119,85,23,1928,5,male,1295,1505,812,138,220,118,90,20,130
1268543,21,31,1992,12,male,795,1449,1039,138,50,138,46,0,4
1301981,18,10,1995,4,female,233,1579,324,137,1468,137,1070,0,398
1007037,21,29,1992,2,male,1302,1399,1140,146,70,5,22,141,48
1604269,63,26,1950,1,male,615,1388,656,145,259,0,31,145,228
1704226,21,6,1992,11,male,705,1659,1360,147,519,67,300,80,219
1818468,19,28,1994,5,male,1037,1836,1030,147,125,137,101,10,24
1289059,21,8,1992,10,male,817,1451,1195,144,93,127,73,17,20
1422009,21,6,1992,2,female,334,1332,608,147,810,130,205,17,605
2147402,102,1,1911,7,female,1310,1701,938,149,225,148,172,1,53
1681394,23,16,1990,8,male,545,1435,1285,146,74,146,65,0,9
1804204,18,5,1995,5,female,208,1823,931,147,1352,147,844,0,508
1528119,21,22,1992,2,female,569,1757,1422,149,558,149,465,0,93
1866649,103,2,1910,9,male,1553,1369,641,154,158,0,50,154,108
1833313,87,8,1926,1,male,610,1277,924,156,292,0,113,156,179
1765443,18,12,1995,5,male,916,1395,881,155,203,69,128,86,75
1715506,19,4,1994,6,female,951,1375,943,155,449,98,247,57,202
1989445,22,18,1991,7,female,1506,1295,434,152,261,139,156,13,105
1554160,31,21,1982,10,male,1107,1464,1034,155,746,134,577,21,169
1468087,25,17,1988,10,female,340,1281,1204,154,429,153,296,1,133
1448411,16,8,1997,5,male,231,1533,430,153,1001,153,758,0,243
1207752,16,23,1997,1,female,365,1750,793,164,496,77,321,87,175
1853813,17,12,1996,9,female,670,1484,1163,158,264,111,234,47,30
1295056,21,10,1992,12,male,1601,1806,892,161,314,42,207,119,107
2049698,106,10,1907,6,female,1912,1486,501,159,249,144,130,15,119
1683757,19,13,1994,11,male,490,1302,1033,162,220,162,152,0,68
1139892,27,4,1986,1,female,72,1413,458,163,215,163,166,0,49
1697569,15,11,1998,8,female,374,1339,340,161,521,161,253,0,268
1683823,19,20,1994,7,female,258,1417,130,169,0,0,0,169,0
1066708,62,14,1951,2,female,2207,1528,864,169,96,5,38,164,58
1120665,17,18,1996,3,female,825,1484,694,172,303,106,256,66,47
1286228,112,27,1901,11,male,1372,1621,1017,166,131,148,97,18,34
1720881,17,18,1996,7,female,324,1625,545,172,456,147,417,25,39
1508276,23,26,1990,10,male,908,1844,929,165,305,164,262,1,43
1343610,68,6,1945,6,female,1039,1649,107,173,151,173,131,0,20
1316163,17,3,1996,6,female,460,1655,487,175,1154,175,1067,0,87
1235209,18,29,1995,10,female,378,1692,751,173,1553,173,1428,0,125
1887124,24,12,1989,11,female,214,1812,508,176,302,176,260,0,42
1540907,23,2,1990,1,female,769,1683,624,177,358,177,316,0,42
1289905,94,22,1919,4,male,1015,1411,461,183,36,15,10,168,26
1117657,19,15,1994,2,female,293,1559,46,183,214,11,171,172,43
1946320,21,14,1992,1,female,1519,1731,305,187,562,28,403,159,159
1588980,19,29,1994,8,male,1350,1332,741,185,200,141,171,44,29
2141513,68,20,1945,5,female,894,1472,186,187,954,183,625,4,329
1419975,18,3,1995,1,female,271,1456,341,190,903,189,591,1,312
1721114,108,29,1905,1,male,1222,1508,1008,183,34,183,30,0,4
2000703,19,23,1994,2,female,1348,1661,538,182,604,182,543,0,61
2161292,113,11,1900,4,female,1509,1307,274,190,603,190,440,0,163
1212688,19,3,1994,5,female,399,1353,962,199,781,4,485,195,296
1227961,21,1,1992,5,male,480,1584,1409,194,541,14,337,180,204
1262399,22,1,1991,10,male,682,1291,917,192,436,82,237,110,199
1164147,35,22,1978,7,male,1174,1627,702,194,1105,110,545,84,560
1721465,104,26,1909,11,female,1211,1311,291,195,156,182,143,13,13
1045983,18,1,1995,9,female,644,1779,607,197,226,197,189,0,37
1951180,19,1,1994,3,female,735,1311,829,193,127,193,112,0,15
1560355,18,31,1995,7,female,552,1536,1138,195,640,195,583,0,57
2096729,18,10,1995,3,female,821,1831,480,203,98,8,33,195,65
1456216,94,19,1919,3,male,1184,1464,443,201,654,7,215,194,439
2006079,100,12,1913,10,male,1728,1776,540,201,111,96,47,105,64
1646755,23,2,1990,4,female,1755,1574,956,208,490,83,268,125,222
1195891,30,25,1983,11,male,542,1270,306,203,185,195,89,8,96
1845215,108,16,1905,6,male,1711,1393,1052,201,165,201,108,0,57
1999122,108,2,1905,9,male,199,1526,1419,211,161,211,113,0,48
1812585,18,26,1995,3,female,188,1512,177,203,412,203,350,0,62
1508286,20,3,1993,11,male,472,1901,1491,208,447,208,338,0,109
1309365,17,14,1996,9,male,479,1385,1260,215,106,3,81,212,25
1058405,58,16,1955,12,male,710,1689,269,221,1074,3,317,218,757
1296968,19,7,1994,2,female,418,1872,831,218,815,99,538,119,277
1131896,21,7,1992,11,male,727,1443,359,221,488,54,225,167,263
1919058,20,30,1993,5,male,533,1423,1198,212,1555,66,185,146,1370
2049001,19,1,1994,10,female,666,1430,859,220,146,192,123,28,23
1916981,16,7,1997,1,male,509,1465,1093,215,841,158,355,57,486
1684649,19,19,1994,6,female,1689,1304,174,212,731,171,514,41,217
1680217,15,16,1998,7,female,291,1668,183,219,193,219,70,0,123
1685252,19,12,1994,7,female,1122,1579,1088,224,558,35,247,189,311
1886369,16,13,1997,5,female,911,1442,907,225,513,98,213,127,300
1061868,17,8,1996,2,female,450,1611,953,229,1012,174,835,55,177
1298192,99,25,1914,3,male,571,1273,937,222,87,222,66,0,21
1672883,56,16,1957,2,female,504,1410,71,227,329,227,212,0,117
1596965,14,10,1999,5,female,568,1554,703,246,198,1,103,245,95
2038115,108,13,1905,9,female,2042,1706,645,234,107,57,81,177,26
1494138,16,20,1997,6,female,780,1503,916,238,583,59,500,179,83
1112302,24,4,1989,10,female,793,1405,787,243,421,116,294,127,127
1193989,106,26,1907,2,female,712,1442,363,235,241,197,174,38,67
1381097,18,7,1995,4,female,464,1298,907,236,948,212,518,24,430
1564821,16,19,1997,3,female,482,1818,289,241,402,240,267,1,135
1185214,18,31,1995,8,female,388,1761,513,234,243,234,230,0,13
1353951,24,9,1989,9,female,268,1563,882,237,477,237,270,0,207
1904378,103,11,1910,1,female,1027,1532,218,240,10658,240,9142,0,1516
1940186,17,15,1996,9,female,718,1544,1001,257,227,44,60,213,167
1227479,18,26,1995,6,female,50,1702,339,256,507,83,340,173,167
1184725,20,29,1993,1,male,784,1573,741,257,683,174,320,83,363
1270684,108,8,1905,4,female,926,1736,568,253,49,243,45,10,4
1979082,102,29,1911,9,male,1476,1687,570,255,421,253,301,2,120
1972012,17,16,1996,11,female,453,1536,653,248,4,248,3,0,1
1561246,17,27,1996,12,female,287,1356,789,261,211,85,105,176,106
1617497,19,11,1994,9,male,671,1770,1443,272,680,134,478,138,202
2105257,19,23,1994,10,male,361,1394,1242,276,226,260,185,16,41
1128441,108,21,1905,3,female,1056,1560,399,274,174,202,107,72,67
1874524,19,18,1994,8,male,399,1321,1106,268,38,268,30,0,8
2064185,16,25,1997,12,male,823,1523,1250,278,64,0,39,278,25
1978315,19,3,1994,1,female,1176,1696,1024,284,387,56,198,228,189
1942327,53,21,1960,5,female,1816,1837,1041,282,195,0,41,282,154
1439823,18,3,1995,1,female,588,1800,833,282,1264,18,725,264,539
1181414,21,14,1992,9,male,408,1610,1234,281,731,199,564,82,167
1481513,23,3,1990,9,female,334,1464,590,290,422,220,83,70,339
2161641,16,30,1997,1,male,800,1367,1045,292,2898,243,2228,49,670
1959157,18,9,1995,3,female,317,1412,539,287,1005,273,424,14,581
1299945,18,25,1995,5,female,244,1432,382,286,854,281,578,5,276
2059645,18,11,1995,7,female,410,1367,86,284,536,210,349,74,187
1581805,18,25,1995,5,male,872,1529,771,291,217,291,171,0,46
1027808,19,24,1994,5,female,540,1591,290,291,507,291,371,0,136
1175643,18,7,1995,3,female,1550,1676,767,297,407,184,311,113,96
2105196,14,17,1999,1,female,656,1513,871,308,1570,178,787,130,783
1432225,15,7,1998,6,female,292,1431,1072,302,751,147,406,155,345
2068015,15,13,1998,7,female,803,1728,869,307,1314,70,670,237,644
2096458,19,7,1994,2,female,588,1862,605,298,1283,214,817,84,466
2043368,16,14,1997,11,male,632,1536,1004,304,877,262,793,42,84
2169140,20,22,1993,8,male,651,1633,667,293,465,277,239,16,226
1105579,15,16,1998,6,female,423,1665,603,298,95,298,68,0,27
1108814,17,4,1996,5,male,566,1907,1263,308,68,308,61,0,7
1172137,21,29,1992,2,female,562,1353,979,308,550,308,333,0,217
1632859,108,16,1905,7,female,1024,1515,412,315,382,14,92,301,290
1047626,17,1,1996,1,female,637,1589,601,312,208,111,105,201,103
1053602,17,1,1996,1,female,605,1684,463,326,276,156,116,170,160
1447755,113,29,1900,3,male,2323,1311,639,322,449,89,126,233,323
1608257,18,11,1995,1,male,427,1761,1375,312,658,220,307,92,351
2119521,74,26,1939,9,NA,1998,1609,348,313,834,179,696,134,138
1136026,19,17,1994,8,female,973,1773,700,325,1514,291,751,34,763
1569446,27,1,1986,1,female,1540,1770,888,318,834,274,597,44,237
1119326,21,23,1992,2,male,506,1367,1198,314,124,314,115,0,9
1234707,16,20,1997,2,female,363,1470,1197,310,384,310,338,0,46
1636518,19,3,1994,4,male,569,1811,1511,319,214,319,192,0,22
2108941,74,19,1939,9,female,26,1775,155,310,209,310,204,0,5
1018319,18,6,1995,6,female,563,1492,972,312,606,312,540,0,66
1203202,68,20,1945,6,male,634,1367,1088,323,1175,323,690,0,485
2016903,63,11,1950,1,female,1887,1297,701,343,447,3,51,340,396
1839174,77,12,1936,1,male,1183,1403,710,344,1425,53,726,291,699
1361765,14,9,1999,2,female,465,1582,1055,337,1544,98,872,239,672
1044746,19,3,1994,8,female,497,1817,1287,339,723,229,376,110,347
1731447,47,24,1966,2,female,468,1414,205,332,617,148,136,184,481
1484839,20,6,1993,11,female,1434,1273,456,331,126,301,81,30,45
1675771,19,21,1994,8,female,587,1305,918,337,529,316,387,21,142
2064303,18,7,1995,4,male,192,1351,1316,336,117,334,76,2,41
1415381,18,7,1995,3,female,277,1886,700,346,861,344,695,2,166
1204897,14,18,1999,1,male,431,1279,826,341,253,341,234,0,19
1421515,18,27,1995,1,female,702,1591,1027,345,223,345,216,0,7
1351959,16,10,1997,11,female,481,1769,947,359,1628,57,738,302,890
1167861,17,4,1996,10,female,974,1824,203,360,570,52,183,308,387
1729347,33,30,1980,7,female,835,1375,1025,349,816,10,511,339,305
1847200,108,13,1905,3,male,1262,1601,1247,349,90,125,54,224,36
1919795,14,19,1999,4,female,585,1446,490,369,738,229,297,140,441
1968021,17,12,1996,9,female,1572,1640,678,361,576,134,241,227,335
1317942,24,19,1989,12,male,793,1587,1197,347,953,196,481,151,472
1218900,17,10,1996,9,male,742,1280,1057,347,341,331,260,16,81
1317941,18,20,1995,4,female,448,1324,860,360,306,328,187,32,119
2093618,20,2,1993,11,female,186,1873,1250,359,263,338,233,21,30
2081030,22,10,1991,8,male,385,1349,803,353,504,333,222,20,282
1786647,17,24,1996,8,male,591,1578,932,349,1083,312,405,37,678
1908406,21,30,1992,6,female,571,1317,425,365,817,269,742,96,75
1673387,17,16,1996,8,female,547,1659,216,349,760,346,338,3,422
1826225,102,10,1911,8,female,2293,1314,607,355,729,354,347,1,382
1621274,19,1,1994,1,male,887,1315,1037,357,607,357,447,0,160
2043422,102,2,1911,4,female,833,1765,506,356,2065,356,1387,0,678
1413349,63,29,1950,3,female,1645,1385,762,388,189,16,84,372,105
1007246,23,2,1990,5,male,590,1283,1044,377,478,40,252,337,226
2128844,30,7,1983,7,female,387,1464,468,372,604,17,105,355,499
1854944,108,9,1905,8,male,1463,1692,431,392,192,187,107,205,85
1910740,16,3,1997,2,female,860,1312,437,388,461,262,257,126,204
1197028,22,6,1991,9,male,620,1529,683,370,413,93,135,277,278
2181868,24,19,1989,5,female,1448,1444,859,373,354,247,194,126,160
1022065,19,16,1994,8,male,1527,1597,1001,393,1236,132,603,261,633
1306117,16,27,1997,7,female,1011,1600,604,379,795,294,620,85,175
2130684,17,3,1996,6,male,1397,1386,847,380,168,379,114,1,54
1359129,15,12,1998,1,female,272,1491,327,376,358,376,308,0,50
1104006,16,9,1997,6,female,217,1681,105,387,1118,387,698,0,420
1734176,55,1,1958,6,male,774,1519,1164,414,33,75,13,339,20
2075064,19,23,1994,2,male,639,1535,1053,399,521,15,230,384,291
2105387,15,22,1998,1,female,500,1862,366,411,501,130,306,281,195
2026660,15,20,1998,6,female,409,1697,454,410,651,286,244,124,407
1213789,19,15,1994,9,female,1364,1551,639,417,677,166,380,251,297
2102356,19,16,1994,9,female,572,1381,752,395,698,105,293,290,405
2072625,17,17,1996,7,female,226,1483,1024,420,252,383,130,37,122
2012009,17,19,1996,8,female,865,1639,261,408,2660,316,1229,92,1431
2164283,20,20,1993,8,female,679,1780,806,395,1268,373,610,22,658
2126118,17,23,1996,11,female,654,1551,1132,412,101,412,67,0,34
1607163,21,19,1992,7,male,573,1570,1443,413,92,413,53,0,39
1823887,23,24,1990,11,male,617,1465,992,396,292,396,243,0,49
1876515,16,13,1997,5,male,341,1331,818,414,1079,414,682,0,397
1160263,23,4,1990,10,male,337,1572,943,399,1147,399,858,0,289
1742519,68,21,1945,8,male,1420,1702,266,451,182,56,133,395,49
1585676,18,6,1995,8,male,465,1310,1028,450,140,268,114,182,26
2180403,17,1,1996,4,male,1179,1865,1122,446,1879,212,994,234,885
2187953,18,8,1995,7,female,210,1719,945,450,2170,273,1200,177,970
1432792,19,18,1994,6,male,1297,1374,159,448,5104,231,3446,217,1658
1118410,20,25,1993,9,male,893,1626,522,439,749,200,276,239,473
1916721,22,8,1991,11,female,585,1871,285,428,1416,262,954,166,462
2017668,25,8,1988,10,male,1186,1482,940,445,1303,127,412,318,891
1911986,30,9,1983,12,male,547,1351,671,427,1504,204,551,223,953
1587481,87,4,1926,7,male,1621,1759,1153,437,198,317,170,120,28
1029182,18,18,1995,10,female,613,1501,608,436,446,413,302,23,144
2181440,18,2,1995,4,female,633,1391,718,442,814,416,592,26,222
1948887,19,12,1994,3,male,898,1460,919,423,320,419,305,4,15
1757579,19,30,1994,9,female,509,1383,956,446,665,446,514,0,151
1995794,15,11,1998,8,female,247,1733,29,427,660,427,603,0,57
1674828,23,3,1990,3,female,676,1645,324,433,772,433,699,0,73
1880508,46,25,1967,2,male,148,1762,1593,471,139,46,43,425,96
1403584,15,10,1998,9,female,436,1331,683,471,674,52,433,419,241
1799207,19,2,1994,5,male,428,1444,959,478,472,50,217,428,255
1308982,18,18,1995,1,male,364,1761,868,481,811,53,422,428,389
2060125,20,19,1993,9,female,949,1872,565,466,1072,66,897,400,175
1943845,19,20,1994,1,male,251,1852,1405,464,1603,301,1002,163,601
1527212,28,15,1985,1,male,1376,1481,512,453,1310,204,1051,249,259
1611296,16,30,1997,5,male,520,1596,1052,483,333,411,243,72,90
1987701,15,17,1998,5,female,459,1480,404,478,3191,373,2194,105,997
1316212,34,18,1979,7,female,1353,1552,225,478,819,463,522,15,297
1391505,20,13,1993,3,male,357,1419,1140,471,285,471,259,0,26
1649732,16,21,1997,8,female,209,1339,669,461,1219,461,1118,0,101
1444475,19,17,1994,8,male,1107,1764,1460,466,786,466,630,0,156
1674096,24,22,1989,5,male,488,1368,1232,462,2511,462,2189,0,322
1619733,74,23,1939,9,female,342,1526,1051,472,2262,472,1167,0,1095
1589128,108,18,1905,10,male,1578,1403,921,486,276,50,79,436,197
1858882,21,24,1992,5,female,682,1742,747,513,1805,38,608,475,1197
2153185,41,10,1972,10,female,1474,1351,764,518,204,170,114,348,90
1520366,19,8,1994,1,female,571,1357,425,508,740,178,246,330,494
1107094,17,24,1996,2,female,400,1424,508,498,1043,290,486,208,557
1591583,16,11,1997,1,male,728,1510,1224,502,501,494,393,8,108
1510375,18,17,1995,3,male,645,1777,1083,485,469,471,332,14,137
1026140,68,17,1945,12,male,1016,1727,1137,512,384,485,240,27,144
1862649,18,23,1995,8,female,1194,1302,387,507,1194,427,884,80,310
2082795,108,16,1905,8,male,384,1477,1273,486,1697,481,784,5,913
2181890,20,7,1993,7,male,988,1362,1098,507,159,504,124,3,35
2017494,24,23,1989,4,female,257,1293,1243,509,151,509,141,0,10
1222039,18,18,1995,3,male,368,1629,819,488,347,488,293,0,54
1890773,19,3,1994,5,male,66,1781,963,500,785,500,644,0,141
1664530,24,7,1989,4,female,526,1390,603,552,1242,1,661,551,581
1112502,60,21,1953,4,male,756,1578,1282,521,2672,83,1960,438,712
2111553,14,13,1999,1,female,271,1643,651,547,131,302,113,245,18
1509291,15,27,1998,6,male,214,1822,444,551,222,246,70,305,152
1204210,17,25,1996,10,male,1100,1651,1243,530,461,168,173,362,288
1696866,21,29,1992,4,male,674,1291,652,528,554,206,366,322,188
1082336,29,21,1984,11,female,616,1527,557,532,421,261,167,271,254
1336182,21,20,1992,3,male,1126,1649,1337,541,1057,371,676,170,381
1961998,22,28,1991,11,male,268,1750,1435,526,33,456,27,70,6
1908985,17,8,1996,11,female,1300,1347,302,542,125,487,71,55,54
1261459,108,16,1905,7,male,1470,1275,827,552,170,437,78,115,92
2047981,25,17,1988,12,male,589,1668,1215,557,728,434,493,123,235
1999826,16,8,1997,5,male,45,1850,123,561,3885,414,2325,147,1560
1815780,26,9,1987,5,male,1546,1525,1040,536,477,531,282,5,195
1306529,20,24,1993,10,female,492,1473,80,526,243,526,184,0,59
1531054,17,25,1996,11,male,475,1673,1458,554,376,554,267,0,109
1444360,14,10,1999,8,female,401,1354,632,570,128,55,63,515,65
1333505,17,22,1996,12,female,1546,1524,776,575,1046,125,443,450,603
1375189,23,26,1990,1,male,1045,1902,172,578,1028,390,626,188,402
1712392,15,13,1998,2,female,580,1542,1072,570,390,475,96,95,294
1419994,19,14,1994,6,female,589,1437,313,576,392,427,215,149,177
1953464,20,4,1993,5,female,1693,1775,570,579,659,530,310,49,349
1456627,16,24,1997,6,male,761,1374,960,581,1199,562,803,19,396
1253931,36,19,1977,11,male,1746,1759,1005,569,1045,536,816,33,229
1157762,18,6,1995,7,female,195,1446,1355,563,312,561,243,2,69
1202483,17,14,1996,12,female,77,1808,225,593,328,593,199,0,129
1890309,57,18,1956,9,male,288,1649,294,590,141,590,123,0,18
1601015,19,10,1994,4,male,347,1594,757,587,542,587,509,0,33
1889150,16,23,1997,6,male,509,1357,1168,652,94,8,13,644,81
1379191,29,26,1984,2,male,524,1819,1495,610,366,10,199,600,167
1996691,19,28,1994,9,female,502,1375,837,651,404,44,175,607,229
2054255,17,31,1996,5,male,194,1526,964,626,1229,6,984,620,245
1101956,18,14,1995,6,male,923,1910,494,615,5645,18,4269,597,1376
1720971,62,27,1951,5,male,292,1595,219,640,3224,0,1067,640,2157
1530580,39,5,1974,3,female,1472,1394,638,639,166,189,83,450,83
1500556,42,3,1971,6,female,1541,1374,792,624,245,438,154,186,91
1465198,19,3,1994,12,female,1590,1878,708,626,480,205,181,421,299
1184479,15,25,1998,1,female,569,1450,589,614,2925,364,1375,250,1550
1511094,15,11,1998,8,female,425,1658,380,648,2269,411,1537,237,732
1537736,19,10,1994,9,female,1308,1671,637,631,2912,253,1369,378,1543
1976866,27,4,1986,5,female,1082,1383,226,611,1316,405,404,206,912
1815761,19,20,1994,3,female,422,1856,1039,646,359,633,215,13,144
1164471,108,16,1905,10,male,793,1410,1048,616,359,600,245,16,114
1461991,18,24,1995,12,male,148,1282,1070,632,570,542,466,90,104
1323658,21,22,1992,3,female,1184,1427,718,615,566,539,235,76,331
1143206,22,20,1991,3,female,744,1411,795,647,910,574,491,73,419
1914375,100,13,1913,12,male,2321,1305,782,650,573,630,269,20,304
1985688,17,14,1996,5,female,929,1763,823,657,849,657,684,0,165
1707201,16,15,1997,3,female,214,1782,453,638,1109,638,824,0,285
1808733,18,29,1995,12,female,840,1600,1152,661,2686,661,2421,0,265
1282227,108,29,1905,5,male,1041,1736,947,616,1642,616,1364,0,278
2067103,14,20,1999,3,female,349,1436,853,682,636,74,334,608,302
1741297,108,4,1905,1,male,1030,1462,864,675,953,110,632,565,321
1281860,15,9,1998,7,female,617,1465,758,666,1784,64,347,602,1437
2156090,18,21,1995,2,male,433,1479,696,670,873,445,686,225,187
1891942,19,24,1994,5,male,935,1385,738,712,649,167,105,545,544
1314104,19,7,1994,4,female,1552,1401,319,714,28053,346,18648,368,9405
1590815,22,12,1991,3,female,429,1393,96,686,1964,434,782,252,1182
1619701,20,1,1993,4,female,592,1347,968,708,277,679,213,29,64
1015496,23,5,1990,3,male,822,1560,912,677,384,595,238,82,146
1767168,22,24,1991,7,male,265,1729,1348,684,548,530,366,154,182
1926359,22,6,1991,10,female,1259,1312,582,664,1295,531,584,133,711
2140008,17,13,1996,3,female,651,1273,515,668,257,668,219,0,38
1963452,93,14,1920,4,female,1608,1323,375,689,2568,689,1397,0,1171
1535995,15,21,1998,2,female,554,1455,880,759,281,76,103,683,178
1841154,26,22,1987,7,male,1188,1661,718,767,873,81,533,686,340
1500650,19,27,1994,12,male,435,1380,1120,775,213,250,189,525,24
1376169,18,5,1995,12,female,121,1712,1086,777,999,530,615,247,384
1687407,19,27,1994,5,female,605,1357,309,727,932,207,354,520,578
1030498,20,12,1993,8,female,757,1432,910,740,870,286,367,454,503
1313584,71,25,1942,7,female,2283,1533,813,754,785,219,421,535,364
1662762,17,5,1996,10,female,603,1407,566,736,2348,390,1685,346,663
1078644,18,4,1995,1,female,999,1880,597,737,2202,244,750,493,1452
1138442,18,3,1995,7,male,131,1422,695,746,3569,430,2051,316,1518
1268878,18,20,1995,10,female,424,1596,1264,735,1379,411,1169,324,210
1250623,16,24,1997,12,female,817,1353,399,727,2293,704,1514,23,779
1669677,22,29,1991,5,female,667,1842,619,730,1428,563,1081,167,347
1339487,18,16,1995,2,male,420,1557,1164,733,964,730,877,3,87
1596619,89,30,1924,8,female,1433,1524,271,780,856,774,518,6,338
2166102,23,11,1990,7,female,1137,1486,829,778,2203,772,1313,6,890
2100389,19,8,1994,9,male,527,1740,1493,779,385,779,313,0,72
1490362,15,18,1998,2,female,378,1333,939,787,806,787,692,0,114
1825204,24,31,1989,7,female,1618,1532,511,757,688,757,596,0,92
2148873,18,16,1995,6,female,297,1421,837,775,1518,775,1185,0,333
1919917,20,30,1993,10,female,494,1675,1167,858,265,52,226,806,39
1482449,15,11,1998,9,female,565,1641,658,867,1028,126,236,741,792
1542562,17,7,1996,7,female,609,1627,437,852,754,0,148,852,606
1102074,17,16,1996,11,male,399,1403,181,821,1399,115,467,706,932
1488206,19,17,1994,1,male,177,1290,1136,846,2789,119,929,727,1860
1922878,19,12,1994,6,male,224,1587,177,802,3164,0,470,802,2694
1767661,49,23,1964,11,female,1150,1761,844,858,2759,25,2172,833,587
1657732,18,29,1995,12,female,762,1516,583,831,524,403,147,428,377
1928067,19,4,1994,11,female,190,1747,131,851,1132,381,597,470,535
1074912,18,5,1995,3,female,564,1733,865,849,1170,239,681,610,489
1689015,19,29,1994,7,female,392,1525,971,835,1082,575,629,260,453
1494452,26,29,1987,7,female,1063,1656,536,848,4223,250,3209,598,1014
1589352,68,21,1945,4,female,610,1387,251,803,1353,316,948,487,405
2026420,16,3,1997,9,female,554,1614,972,877,468,759,293,118,175
1912654,22,20,1991,7,female,1718,1289,750,856,478,668,428,188,50
2021868,14,11,1999,2,female,416,1423,695,836,862,821,444,15,418
1301924,18,5,1995,2,female,611,1663,240,854,649,640,331,214,318
1850436,18,19,1995,7,female,440,1377,1075,857,999,650,686,207,313
1559451,103,19,1910,12,female,1452,1280,359,818,872,760,672,58,200
2044224,22,19,1991,12,male,671,1533,967,809,5895,683,2593,126,3302
1684493,22,2,1991,6,male,819,1503,636,842,1689,825,1094,17,595
1872125,16,29,1997,4,female,503,1519,411,869,3623,863,3090,6,533
1942818,18,16,1995,6,male,665,1771,1287,803,343,803,298,0,45
1520751,27,5,1986,4,male,1179,1900,1636,831,347,831,262,0,85
1956816,22,22,1991,8,male,583,1470,1030,851,531,851,501,0,30
2105121,15,6,1998,7,female,571,1741,691,862,5029,862,3719,0,1310
2137224,19,12,1994,10,female,370,1826,661,825,1536,825,1398,0,138
1667338,61,30,1952,11,female,1752,1396,283,903,318,4,60,899,258
1569650,19,21,1994,7,male,400,1724,1112,895,998,52,771,843,227
1127435,104,27,1909,6,female,1243,1572,546,892,1053,7,234,885,819
2055991,15,11,1998,11,female,466,1843,1133,974,1469,142,427,832,1042
1696338,16,19,1997,11,female,233,1324,726,938,2010,147,748,791,1262
1753554,15,1,1998,10,female,323,1314,977,887,982,276,314,611,668
1718708,16,16,1997,4,male,844,1593,1062,905,1338,188,822,717,516
1959613,16,16,1997,8,female,323,1476,997,964,654,224,205,740,449
1710550,19,22,1994,11,female,638,1277,633,935,1079,226,212,709,867
1169809,23,9,1990,6,male,253,1278,945,959,1033,632,524,327,509
1285683,20,7,1993,5,male,484,1393,754,982,3473,373,2152,609,1321
1866697,20,16,1993,9,male,713,1862,390,913,1960,342,977,571,983
1813217,30,10,1983,10,female,443,1731,1293,914,5102,216,2301,698,2801
2185997,19,10,1994,10,male,250,1418,1002,948,625,803,366,145,259
1480887,20,21,1993,10,male,493,1342,412,896,825,831,423,65,402
1187043,15,3,1998,6,female,149,1524,585,958,4387,932,2323,26,2064
1396641,22,16,1991,10,female,1043,1905,832,911,1191,911,900,0,291
1338461,18,16,1995,7,male,141,1676,1279,900,2775,900,2252,0,523
1087417,33,1,1980,1,female,606,1909,118,956,4027,956,3550,0,477
1839631,16,8,1997,5,female,885,1706,618,1125,983,25,386,1100,597
1990018,20,11,1993,11,male,872,1454,590,1061,870,181,630,880,240
1011849,54,8,1959,5,female,1813,1707,736,989,2069,102,661,887,1408
1044950,18,20,1995,6,female,1127,1869,296,1013,786,533,336,480,450
1762430,37,28,1976,4,female,1121,1282,1011,1007,845,461,246,546,599
2104562,45,22,1968,6,female,1838,1315,494,1005,1432,349,433,656,999
1800069,15,12,1998,3,female,1673,1871,835,1029,2375,491,1927,538,448
1602002,18,6,1995,6,female,522,1439,1092,1037,1996,358,1381,679,615
1844398,18,1,1995,11,male,344,1342,602,1060,3328,465,1953,595,1375
1163700,19,29,1994,1,female,458,1413,448,1117,2104,679,824,438,1280
1399231,20,12,1993,10,female,1619,1781,694,1047,7615,600,4545,447,3070
1149125,18,23,1995,12,male,1037,1373,709,1001,630,956,453,45,177
1809403,20,22,1993,8,female,945,1513,665,1064,1912,1053,1760,11,152
1377722,20,12,1993,9,female,262,1552,636,1032,1761,1022,1132,10,629
1837240,16,9,1997,9,female,368,1285,939,1097,401,1097,326,0,75
2137677,18,12,1995,4,female,209,1364,207,1086,241,1086,139,0,102
1624397,80,23,1933,3,male,1189,1700,1267,1123,499,1123,468,0,31
1902387,19,9,1994,8,male,489,1807,1373,1059,1388,1059,1310,0,78
1015187,68,1,1945,9,male,343,1422,1240,1081,770,1081,393,0,377
1217521,18,28,1995,4,female,681,1440,817,999,1714,999,1056,0,658
1017268,48,17,1965,7,female,789,1800,1125,1165,1430,4,248,1161,1182
1463457,15,1,1998,3,female,752,1604,1035,1190,2166,177,975,1013,1191
1364825,16,8,1997,5,male,473,1476,1321,1224,47,298,33,926,14
1719092,100,9,1913,11,female,2144,1690,1315,1225,555,578,329,647,226
1291714,16,18,1997,8,female,748,1288,601,1227,1214,768,660,459,554
1564990,19,10,1994,5,female,1325,1446,367,1249,1149,496,420,753,729
1990674,45,17,1968,11,female,1239,1834,350,1175,919,786,482,389,437
2126255,20,22,1993,9,female,1078,1795,1247,1210,3720,798,1731,412,1989
1859410,17,29,1996,12,male,129,1469,1430,1154,202,921,154,233,48
1349202,21,18,1992,3,female,605,1628,483,1163,942,907,699,256,243
2019088,108,4,1905,2,male,1377,1341,714,1194,1405,1177,1042,17,363
2131388,24,20,1989,8,female,430,1861,818,1268,201,1268,188,0,13
1283945,47,5,1966,11,male,681,1337,916,1250,397,1250,297,0,100
2138477,71,12,1942,2,male,340,1472,1163,1144,833,1144,716,0,117
1311351,22,7,1991,12,female,412,1326,651,1133,1968,1133,666,0,1302
1791664,108,31,1905,12,male,441,1416,1278,1506,730,58,375,1448,355
1566240,20,6,1993,4,female,318,1276,841,1483,1037,284,217,1199,820
1107316,23,16,1990,4,female,61,1481,1029,1319,859,202,352,1117,507
1464611,108,6,1905,8,male,1248,1325,930,1340,1092,92,433,1248,659
1702451,16,9,1997,1,female,431,1361,351,1472,552,657,243,815,309
1381225,18,27,1995,12,female,416,1596,1167,1514,710,399,472,1115,238
1581307,20,16,1993,9,male,2026,1863,1315,1290,548,787,200,503,348
1205714,23,3,1990,12,female,664,1831,840,1298,549,537,170,761,379
1245069,16,7,1997,11,male,336,1768,1132,1326,1394,835,875,491,519
1313112,15,22,1998,9,female,795,1586,705,1378,1743,529,1011,849,732
1521843,39,25,1974,4,male,766,1387,628,1332,1944,476,857,856,1087
1123663,103,25,1910,10,female,1470,1866,583,1369,1385,784,500,585,885
1446107,14,14,1999,2,male,555,1319,1083,1333,2260,780,833,553,1427
1325929,15,23,1998,4,female,834,1473,342,1414,2829,384,1289,1030,1540
1541513,16,5,1997,3,male,240,1430,1226,1333,614,1310,505,23,109
2036967,20,20,1993,9,female,1118,1450,710,1305,1939,1059,1376,246,563
1199611,21,9,1992,7,female,1218,1704,372,1316,1872,1301,1617,15,255
1449449,23,25,1990,1,male,1767,1715,791,1304,1251,1226,861,78,390
1419811,33,15,1980,11,female,529,1644,992,1396,1970,1255,1539,141,431
2095545,18,12,1995,6,male,870,1505,1267,1450,249,1450,239,0,10
1134094,108,17,1905,9,male,1258,1527,1144,1370,756,1370,577,0,179
1432222,25,5,1988,2,female,624,1626,441,1309,1130,1309,982,0,148
2176917,33,26,1980,10,female,825,1896,837,1369,2518,1369,2355,0,163
1581171,103,12,1910,12,female,764,1421,839,1817,930,2,178,1815,752
1796734,16,15,1997,7,female,219,1439,937,1747,1810,56,416,1691,1394
1501765,20,2,1993,10,male,223,1320,895,1648,1202,219,773,1429,429
1627957,21,9,1992,4,male,504,1747,511,1869,1271,244,780,1625,491
1218807,21,7,1992,4,male,858,1277,790,1750,3205,238,1237,1512,1968
1912174,14,25,1999,2,female,470,1658,431,1630,837,340,328,1290,509
1138775,16,19,1997,8,female,617,1406,782,1565,665,600,317,965,348
1488396,31,4,1982,3,male,591,1906,1023,1566,788,578,312,988,476
2143416,15,18,1998,11,female,663,1756,463,1752,1230,1083,624,669,606
1946197,15,25,1998,4,male,1079,1601,1286,1762,1229,404,762,1358,467
1968078,16,22,1997,2,female,859,1639,390,1828,2275,1086,1835,742,440
1647904,17,26,1996,6,male,1264,1846,1078,1637,1068,1082,613,555,455
2193190,19,29,1994,10,female,569,1681,557,1621,1457,672,668,949,789
2135050,26,22,1987,5,male,953,1449,689,1732,1887,662,1061,1070,826
1319501,18,12,1995,4,female,305,1580,668,1590,2710,377,638,1213,2072
1323979,23,30,1990,8,female,590,1697,656,1530,3780,420,1007,1110,2773
1782252,16,1,1997,9,female,284,1672,1230,1800,38,1400,29,400,9
2167585,18,22,1995,12,male,1003,1328,1022,1595,397,1489,351,106,46
1829367,55,30,1958,6,male,1603,1475,182,1592,685,1512,460,80,225
2010086,65,10,1948,11,male,765,1774,622,1682,953,1441,327,241,626
1606794,103,10,1910,2,female,1517,1516,948,1651,964,1633,795,18,169
1265766,18,5,1995,11,female,195,1456,686,1572,1516,1541,605,31,911
1485394,18,4,1995,5,male,347,1780,1344,1761,2225,1722,1953,39,272
1420221,19,18,1994,10,female,608,1441,604,1606,1104,1548,952,58,152
1112008,20,8,1993,8,female,1591,1855,744,1689,1416,1355,729,334,687
1672543,28,17,1985,9,female,2195,1386,449,1609,981,1494,542,115,439
1786722,13,25,2000,1,female,664,1832,705,1595,2458,1356,1824,239,634
1426705,20,8,1993,12,female,877,1562,175,1691,2934,1342,2155,349,779
1532366,19,16,1994,1,female,185,1516,415,1744,2908,1636,2589,108,319
1345802,20,5,1993,4,female,1532,1798,472,1562,3361,1143,1526,419,1835
1743401,24,2,1989,5,male,1465,1722,1229,1827,744,1825,599,2,145
1461440,16,13,1997,7,male,247,1565,955,1744,1664,1743,1278,1,386
1755401,18,26,1995,4,female,277,1801,739,1603,1824,1599,1357,4,467
1291098,16,8,1997,10,female,499,1860,181,1550,2537,1547,2391,3,146
1040715,19,9,1994,6,male,367,1675,1301,1799,296,1799,289,0,7
1066951,23,14,1990,11,male,389,1833,1342,1602,884,1602,805,0,79
2056071,68,13,1945,4,male,885,1588,880,1743,566,1743,527,0,39
1475750,17,15,1996,12,female,267,1280,215,1784,1423,1784,844,0,579
1562451,21,18,1992,10,female,387,1467,615,1771,1599,1771,1303,0,296
1971278,52,31,1961,8,female,321,1407,910,1837,1693,1837,1442,0,251
1702364,108,5,1905,5,female,1505,1592,564,1693,2482,1693,1925,0,557
2049031,94,11,1919,10,male,634,1437,1148,2098,137,255,83,1843,54
1162406,15,10,1998,5,male,210,1581,1271,2205,1700,230,623,1975,1077
1533828,21,13,1992,8,female,793,1753,1090,2314,1724,215,855,2099,869
1584885,59,2,1954,5,female,1849,1837,949,1947,2133,229,549,1718,1584
1633413,15,12,1998,9,female,1349,1556,624,2055,5115,321,3222,1734,1893
1114450,16,16,1997,1,male,775,1338,1147,2118,3215,407,1604,1711,1611
1860624,14,29,1999,7,female,819,1293,675,2202,915,1201,314,1001,601
1049398,16,15,1997,5,female,992,1517,542,2203,803,1580,483,623,320
2048904,18,7,1995,4,male,1328,1738,1181,2013,535,818,276,1195,259
1875575,16,27,1997,2,female,544,1378,535,2241,3211,581,1400,1660,1811
1625694,16,29,1997,5,female,546,1733,1055,2277,3119,973,1830,1304,1289
1973975,17,2,1996,3,male,1317,1347,780,2262,1964,1277,1143,985,821
1926124,19,18,1994,12,female,421,1674,356,1981,2515,460,864,1521,1651
1421010,19,19,1994,6,female,665,1893,1248,2112,1287,1499,782,613,505
1860809,19,26,1994,8,female,470,1676,656,2247,2506,711,1101,1536,1405
1493471,45,29,1968,5,male,1996,1323,743,1970,1524,738,438,1232,1086
1818772,18,26,1995,10,female,622,1522,888,2059,3779,876,1436,1183,2343
1287273,19,18,1994,3,male,569,1319,721,2323,5662,959,2292,1364,3370
1216467,19,24,1994,5,female,1091,1382,473,2169,4623,1277,1120,892,3503
1561449,21,27,1992,5,female,231,1682,470,2295,4190,904,1352,1391,2838
2100547,66,9,1947,1,female,1018,1410,771,2352,4931,1237,3083,1115,1848
1211213,34,2,1979,6,male,773,1541,1175,2177,1295,2002,1120,175,175
1244687,16,18,1997,2,female,207,1466,783,2319,1765,1824,986,495,779
1366254,16,14,1997,4,male,596,1347,814,2106,1457,1699,1024,407,433
1796866,16,28,1997,5,female,1135,1535,364,2203,3048,1901,2733,302,315
2047291,18,9,1995,5,female,778,1295,978,2354,3160,1989,2526,365,634
1295174,19,23,1994,2,female,680,1297,172,2083,3048,2049,2431,34,617
1708106,20,22,1993,2,female,991,1488,929,2287,2014,2215,1225,72,789
1605373,30,9,1983,12,female,950,1394,815,2081,1288,1532,963,549,325
1838332,17,10,1996,5,female,1038,1567,513,2042,3116,1593,1769,449,1347
1808104,22,8,1991,3,female,1069,1430,696,2133,17495,1883,8651,250,8844
2018305,20,31,1993,5,female,944,1514,662,2184,2482,2162,2125,22,357
1360176,68,22,1945,12,female,480,1342,977,2002,2702,2000,2043,2,659
2118698,17,4,1996,9,female,392,1447,741,1932,2920,1925,1637,7,1283
1309633,18,10,1995,10,female,282,1596,1104,2248,3961,2247,2150,1,1811
1354456,16,20,1997,7,male,460,1467,998,2241,302,2241,172,0,130
1717083,18,16,1995,2,male,274,1748,843,2122,337,2122,303,0,34
1943866,26,5,1987,3,female,589,1400,761,2132,350,2132,264,0,86
1057548,17,22,1996,11,female,1003,1686,432,2067,571,2067,428,0,143
1050029,17,8,1996,11,male,485,1343,1130,2239,805,2239,515,0,290
1814579,81,27,1932,10,female,1289,1786,1128,1938,680,1938,638,0,42
1494045,25,12,1988,8,male,904,1311,916,2264,2280,2264,2056,0,224
2129408,24,1,1989,9,female,499,1650,412,2230,8340,2230,7170,0,1170
1601323,18,1,1995,1,female,365,1500,1154,2432,3482,432,1011,2000,2471
1282426,23,10,1990,11,male,779,1575,909,2580,1944,276,1553,2304,391
1947458,63,27,1950,7,male,901,1713,1327,2652,1719,263,1124,2389,595
1644936,18,14,1995,5,female,236,1422,191,2890,5272,320,2043,2570,3229
1938843,19,12,1994,9,female,1586,1321,508,3569,7031,368,6229,3201,802
1957156,20,24,1993,9,female,572,1746,830,2985,5786,594,4843,2391,943
1384573,14,1,1999,6,female,431,1491,1069,3368,1996,1000,547,2368,1449
1109912,16,18,1997,2,female,1027,1625,987,3330,1509,1843,624,1487,885
1167635,19,21,1994,12,female,651,1338,611,3065,1585,1901,738,1164,847
1223972,23,10,1990,12,male,1435,1570,688,2682,1099,1259,715,1423,384
1810531,27,16,1986,6,female,918,1315,723,2641,956,991,595,1650,361
1288301,51,24,1962,10,female,1344,1466,1036,2863,1338,1894,522,969,816
2088893,15,23,1998,9,female,442,1859,1187,2906,2356,1170,1860,1736,496
1449153,17,2,1996,7,female,301,1656,331,2549,2188,1345,1416,1204,772
2165949,18,20,1995,6,female,1368,1807,856,2407,2911,1112,2088,1295,823
1798537,19,15,1994,5,female,1012,1591,1222,3285,2274,2016,1376,1269,898
1691605,19,4,1994,7,male,727,1623,1217,3301,4734,796,2917,2505,1817
1279706,36,24,1977,11,female,496,1270,542,2418,2487,860,667,1558,1820
1617206,15,10,1998,1,female,821,1586,1090,2671,16936,1461,8420,1210,8516
1053086,50,29,1963,4,male,1525,1528,786,3469,5263,1677,2045,1792,3218
1084319,18,31,1995,5,male,437,1588,1207,2711,1187,2123,1051,588,136
1392135,19,17,1994,6,female,609,1283,800,2720,1430,2472,1270,248,160
1113807,103,20,1910,2,male,1221,1463,740,2455,993,2353,831,102,162
1521275,15,24,1998,12,female,821,1296,441,2686,2698,2349,1421,337,1277
1572419,17,1,1996,1,male,552,1478,935,2749,2220,2610,2014,139,206
1597241,18,17,1995,3,female,324,1485,111,2771,1721,2329,985,442,736
1208672,16,9,1997,12,female,150,1724,172,2542,4763,1895,2657,647,2106
1344521,18,9,1995,2,female,437,1822,870,3181,5459,2413,3432,768,2027
1905014,18,10,1995,8,female,475,1706,665,2642,6140,2473,3363,169,2777
1173275,19,31,1994,3,female,242,1307,936,2799,5365,2518,4485,281,880
1425934,20,29,1993,8,male,393,1456,381,2551,3864,2219,1847,332,2017
1368458,14,21,1999,2,female,481,1352,462,3214,598,3212,484,2,114
1568305,28,14,1985,6,female,484,1539,954,2914,24229,2913,16072,1,8157
1489177,18,12,1995,5,female,253,1409,533,2779,1624,2779,1351,0,273
1202463,27,2,1986,11,male,1369,1341,957,2878,1738,2878,1616,0,122
1674338,26,3,1987,8,male,855,1824,1349,3101,590,3101,328,0,262
2001034,28,28,1985,3,male,536,1444,928,3132,1269,3132,969,0,300
1079321,18,1,1995,1,female,578,1288,434,2748,2882,2748,2422,0,460
1342941,25,13,1988,11,male,1054,1784,1160,2641,1909,2641,1759,0,150
2134916,74,13,1939,5,male,1028,1304,708,7074,975,3,548,7071,427
1806696,15,17,1998,2,female,448,1307,855,10803,5454,40,3907,10763,1547
1754892,24,7,1989,9,female,418,1379,719,4633,2592,455,1420,4178,1172
1739198,15,22,1998,12,female,563,1767,838,4185,5807,437,1971,3748,3836
1288654,18,11,1995,3,male,361,1750,603,6455,5105,359,1529,6096,3576
2063032,19,24,1994,5,female,448,1294,271,4267,2623,473,1912,3794,711
1820513,20,8,1993,7,female,1092,1282,936,11130,8704,591,4419,10539,4285
2090566,56,24,1957,8,female,1474,1401,777,5710,6290,128,3615,5582,2675
1729635,103,4,1910,1,male,1002,1766,497,4189,2625,493,928,3696,1697
1386285,18,15,1995,9,female,443,1567,663,5620,20704,220,9694,5400,11010
1034148,17,11,1996,8,female,499,1652,959,6267,3625,2795,2076,3472,1549
1665822,23,24,1990,2,female,508,1423,577,8205,4121,4550,2065,3655,2056
2109614,23,4,1990,2,female,473,1767,1446,3599,1827,2255,901,1344,926
1656079,66,16,1947,3,female,2012,1567,1237,12566,4846,3296,3024,9270,1822
1671707,74,13,1939,11,male,1662,1384,833,6086,1059,2274,650,3812,409
1125963,15,23,1998,12,female,1168,1854,833,4981,3050,2300,1286,2681,1764
1772336,17,20,1996,3,female,1270,1458,1039,5494,4388,1400,1974,4094,2414
2185689,18,18,1995,3,female,99,1607,621,5654,6072,3823,5016,1831,1056
2142811,20,15,1993,11,female,1537,1722,1017,4501,6016,2464,1999,2037,4017
2179210,20,11,1993,12,female,370,1837,740,6916,9643,2296,6543,4620,3100
2190354,22,12,1991,12,male,762,1280,515,4442,3338,2804,2438,1638,900
1731072,21,25,1992,10,female,1263,1602,1085,8721,12938,3023,5559,5698,7379
1636713,24,20,1989,9,female,569,1371,544,6593,5944,2189,3825,4404,2119
1950549,38,22,1975,6,female,2244,1291,250,4831,3610,3446,3019,1385,591
1003700,69,18,1944,4,female,1776,1330,947,4142,5084,1487,3361,2655,1723
1688481,83,25,1930,9,male,1158,1850,1018,4215,2690,1238,1317,2977,1373
1332241,15,22,1998,6,female,294,1789,606,4000,6212,2821,4392,1179,1820
1652225,18,17,1995,7,female,773,1274,364,3925,8398,865,4104,3060,4294
1801536,17,14,1996,10,female,270,1340,1021,4915,2496,3984,1076,931,1420
1956429,18,5,1995,5,male,541,1392,1231,4303,1704,3784,1547,519,157
2034020,18,10,1995,7,female,526,1533,422,7799,4520,7547,3534,252,986
1087168,18,12,1995,7,male,514,1557,1132,4750,2497,4504,1788,246,709
1187594,21,10,1992,11,female,1104,1388,774,4914,2192,4399,1985,515,207
1880144,23,16,1990,2,female,338,1289,897,4005,983,3946,698,59,285
1878566,29,22,1984,5,female,829,1570,1030,13692,3114,12639,2010,1053,1104
1618900,21,27,1992,4,male,267,1874,564,4080,5791,3148,3798,932,1993
2068345,22,18,1991,6,male,553,1365,793,5561,4742,5267,2195,294,2547
2033044,25,9,1988,6,female,329,1315,1003,11257,13397,8802,8506,2455,4891
2027384,101,20,1912,2,male,1505,1310,545,11696,17434,9915,16855,1781,579
1006009,108,31,1905,12,female,196,1709,97,5208,3307,4926,2484,282,823
1996736,18,7,1995,2,female,459,1643,570,4334,7737,3709,4781,625,2956
1554413,18,19,1995,3,female,1075,1848,850,12172,30222,10479,16944,1693,13278
2126022,39,29,1974,11,male,947,1729,589,10115,18110,9961,10735,154,7375
1999852,18,19,1995,10,female,655,1384,295,6334,1293,6294,758,40,535
1825900,32,3,1981,1,female,441,1804,366,6320,6808,6286,4659,34,2149
1115903,17,4,1996,4,male,301,1281,647,5831,3344,5831,2979,0,365
1543600,68,18,1945,9,female,661,1665,416,6871,2627,6871,2045,0,582
2052324,23,5,1990,12,male,427,1519,1339,3874,5216,3874,4329,0,887
1066764,23,7,1990,4,female,291,1728,660,3897,4233,3897,3899,0,334
1042399,28,29,1985,10,female,832,1314,482,5958,5595,5958,4978,0,617
1767540,29,25,1984,5,female,290,1761,72,6809,8757,6809,7905,0,852
2036431,63,22,1950,5,female,484,1489,702,5000,3298,5000,3009,0,289
1504676,98,18,1915,4,female,409,1656,84,4149,2577,4149,1929,0,648
1908082,103,31,1910,12,male,1300,1744,937,4307,2860,4307,1970,0,890
1113088,103,12,1910,4,female,560,1319,898,7674,10608,7674,9979,0,629
1299284,15,29,1998,3,female,437,3820,1834,0,778,0,123,0,655
1883270,18,14,1995,11,female,341,2050,467,0,0,0,0,0,0
2000570,19,14,1994,11,female,588,2166,767,0,21,0,17,0,4
1009782,18,5,1995,3,female,270,3160,1165,0,18,0,18,0,0
1170092,18,1,1995,5,male,258,1921,1684,0,2,0,1,0,1
1708655,18,8,1995,8,female,463,4380,426,0,138,0,103,0,35
1875104,18,25,1995,10,female,785,4210,156,0,39,0,32,0,7
1103619,20,30,1993,12,female,669,3056,2184,0,578,0,515,0,63
1828338,19,16,1994,5,female,881,2969,353,0,2,0,0,0,2
1123687,19,9,1994,8,female,537,2671,1636,0,222,0,156,0,66
2087068,20,1,1993,1,male,299,3151,401,0,62,0,54,0,8
1395122,20,5,1993,2,female,880,2334,470,0,13,0,11,0,2
1993020,21,8,1992,1,male,1262,1954,1050,0,0,0,0,0,0
1708796,21,5,1992,1,female,561,2247,1848,0,1,0,1,0,0
1743715,23,13,1990,2,male,558,2982,1464,0,39,0,25,0,14
1564560,23,21,1990,5,male,1200,2211,1804,0,1,0,0,0,1
1003994,24,26,1989,4,male,757,1915,331,0,153,0,118,0,35
1369321,35,29,1978,10,male,222,2060,164,0,10,0,9,0,1
1642762,37,14,1976,1,male,128,2379,379,0,174,0,121,0,53
1007637,40,21,1973,7,male,1278,2840,2213,0,6,0,5,0,1
1007051,52,20,1961,7,female,374,2191,1184,0,1,0,1,0,0
1248568,59,24,1954,7,male,115,2051,0,0,43,0,20,0,23
1660276,66,1,1947,7,male,716,4917,431,0,114,0,69,0,45
2174966,68,25,1945,10,male,386,2302,237,0,17,0,8,0,9
1648605,86,19,1927,12,female,1469,2665,387,0,146,0,31,0,115
1792910,86,6,1927,9,male,610,4759,994,0,8,0,7,0,1
1267270,98,29,1915,12,female,1293,3483,386,0,8,0,5,0,3
1978609,103,4,1910,3,female,636,2129,640,0,2,0,2,0,0
1130147,103,1,1910,4,male,1210,1965,856,0,4,0,2,0,2
1494340,103,22,1910,8,female,677,4075,611,0,7,0,5,0,2
1418432,100,1,1913,1,male,941,3865,413,1,7,0,7,1,0
1190211,103,23,1910,9,female,1026,2449,928,1,185,0,70,1,115
1617592,16,2,1997,7,female,781,3876,2012,1,76,1,39,0,37
2165615,18,26,1995,2,female,667,2200,1044,1,4,1,1,0,3
1317774,20,3,1993,10,female,700,3547,460,1,345,1,323,0,22
1635584,21,29,1992,9,male,471,2504,1987,1,7,1,5,0,2
1233776,22,23,1991,10,female,818,2274,482,1,64,1,59,0,5
2075087,29,27,1984,1,male,921,1940,863,1,24,1,19,0,5
1888602,68,12,1945,6,male,488,3206,2212,1,2,1,2,0,0
1767178,94,21,1919,5,male,1142,2517,1977,1,8,1,6,0,2
1750236,108,18,1905,2,male,1539,4632,931,1,428,1,325,0,103
1849808,108,10,1905,4,male,1525,4061,2147,1,17,1,13,0,4
1587911,108,7,1905,10,female,1105,4797,535,1,137,1,31,0,106
1876432,18,24,1995,4,female,434,4587,874,2,1,0,0,2,1
1475295,90,9,1923,2,male,1287,2474,336,2,12,0,2,2,10
1236937,108,24,1905,1,female,1064,2746,169,2,43,0,19,2,24
1098559,16,1,1997,2,female,592,4737,701,2,61,2,42,0,19
1275926,18,23,1995,5,female,571,2459,364,2,3,2,3,0,0
1696272,18,9,1995,9,female,484,2086,1391,2,25,2,18,0,7
1474688,20,18,1993,8,male,1340,2004,267,2,17,2,13,0,4
1247217,20,1,1993,9,male,527,2712,2289,2,317,2,218,0,99
1389037,22,8,1991,2,female,1713,2157,1065,2,19,2,16,0,3
1531202,23,17,1990,5,male,917,3328,2817,2,18,2,17,0,1
1341044,24,15,1989,6,female,1448,2436,650,2,16,2,15,0,1
1661090,68,7,1945,5,female,609,3478,252,2,31,2,17,0,14
1589512,103,9,1910,5,female,1248,2843,158,2,164,2,124,0,40
1335548,107,28,1906,11,male,1072,4284,792,2,9,2,7,0,2
1680023,17,13,1996,10,female,736,2415,1795,3,0,0,0,3,0
1228091,23,25,1990,12,male,798,4217,1952,3,35,0,21,3,14
2038559,84,4,1929,3,male,1200,4637,434,3,85,0,38,3,47
1432950,20,17,1993,5,female,1366,2801,510,3,346,3,294,0,52
1597178,20,29,1993,6,male,686,2404,1794,3,78,3,59,0,19
2171280,21,25,1992,7,female,629,3019,440,3,303,3,211,0,92
1719467,32,6,1981,4,male,1120,2694,1105,3,38,3,33,0,5
1089933,108,13,1905,6,male,1674,4770,2032,4,40,0,34,4,6
1475624,18,7,1995,7,female,357,2299,268,4,35,4,27,0,8
1311714,19,31,1994,1,male,503,2404,1993,4,515,4,450,0,65
1071306,19,13,1994,3,male,470,2468,947,4,45,4,44,0,1
1273463,24,18,1989,7,male,557,2129,1590,4,231,4,211,0,20
1468235,84,23,1929,6,female,1698,2650,408,4,23,4,20,0,3
1223717,108,12,1905,7,female,1055,2922,1366,4,107,4,69,0,38
2154556,100,19,1913,3,male,2473,4765,2668,5,1,0,1,5,0
1940972,38,8,1975,1,male,1077,3105,1325,5,14,1,10,4,4
1371277,96,12,1917,4,female,1446,2914,324,5,11,2,9,3,2
1111675,17,10,1996,7,female,1532,3461,718,5,141,4,81,1,60
1406197,102,25,1911,12,male,1085,2560,1525,5,2,5,2,0,0
1333011,19,16,1994,11,female,715,3153,1338,6,387,5,218,1,169
2022131,16,14,1997,8,male,743,2294,1157,6,0,6,0,0,0
1867596,41,14,1972,3,male,412,1936,1488,6,0,6,0,0,0
1631890,20,5,1993,3,male,1375,2016,1097,6,21,6,18,0,3
1480994,68,23,1945,1,male,811,4250,2293,6,113,6,107,0,6
1029773,103,5,1910,5,male,1498,4717,1219,6,249,6,181,0,68
1046097,103,9,1910,10,female,1790,2295,197,7,113,0,41,7,72
1386477,61,30,1952,3,male,1210,4844,561,7,247,5,96,2,151
1958800,16,7,1997,2,female,418,2970,415,7,39,6,30,1,9
1265455,15,11,1998,3,female,377,2748,369,7,3,7,1,0,2
1634378,15,17,1998,10,female,614,3126,158,7,333,7,293,0,40
1154962,19,23,1994,11,female,543,2684,174,7,328,7,290,0,38
1758362,18,6,1995,6,male,565,2917,2279,7,13,7,10,0,3
2087089,66,4,1947,2,female,1267,2147,362,8,866,0,541,8,325
1428547,22,1,1991,1,male,760,1932,1068,8,60,6,27,2,33
1264927,16,14,1997,3,female,335,1988,77,8,111,8,75,0,36
1154291,18,1,1995,8,female,666,4351,270,8,86,8,69,0,17
1335780,23,28,1990,2,female,357,1955,1068,8,287,8,103,0,184
1546436,48,18,1965,11,male,392,4272,26,8,561,8,421,0,140
2124873,100,2,1913,5,female,1495,2493,527,8,34,8,26,0,8
1595764,23,8,1990,11,male,173,4304,166,9,49,0,42,9,7
1019859,19,12,1994,11,male,571,2011,334,9,959,5,465,4,494
1863890,55,2,1958,7,male,847,3096,940,9,317,2,282,7,35
1962836,20,14,1993,11,male,620,2329,600,9,24,9,19,0,5
1910579,21,1,1992,10,male,668,2601,2074,9,55,9,40,0,15
1719628,63,8,1950,10,female,991,2921,908,9,26,9,21,0,5
2122302,62,25,1951,5,male,758,4066,214,10,90,0,40,10,50
1905980,20,28,1993,5,male,1327,2647,756,11,888,7,598,4,290
1650359,18,31,1995,12,female,562,2554,1429,11,123,11,83,0,40
1481975,20,3,1993,6,female,733,2029,885,11,38,11,28,0,10
1759734,103,11,1910,1,male,1879,2871,2229,11,124,11,93,0,31
2068981,20,3,1993,9,male,565,1927,1556,12,1,0,0,12,1
2015057,15,8,1998,1,male,370,1981,1752,12,13,0,4,12,9
1119263,86,14,1927,8,female,939,3387,662,12,1,8,1,4,0
1767134,15,28,1998,7,female,628,2940,723,12,978,4,383,8,595
1461051,25,29,1988,12,female,521,2628,517,12,1380,12,1059,0,321
1133967,64,1,1949,10,male,374,4524,100,13,208,13,174,0,34
1216554,17,1,1996,3,male,540,4135,2450,14,62,0,51,14,11
1509174,18,6,1995,2,male,178,2115,339,14,104,3,81,11,23
1992914,15,19,1998,2,female,588,1959,543,14,247,14,188,0,59
1640179,21,8,1992,7,female,1529,4589,1822,14,56,14,19,0,37
1432216,68,17,1945,8,female,869,4207,488,14,178,14,125,0,53
2009328,108,9,1905,9,female,1613,4138,1212,14,60,14,38,0,22
1147692,15,31,1998,10,female,552,4373,1289,15,159,15,125,0,34
1541316,19,24,1994,4,male,709,2180,1506,15,539,15,424,0,115
2002114,101,9,1912,4,female,818,3597,1109,16,365,0,75,16,290
2127347,16,4,1997,3,female,734,2066,1388,16,699,16,606,0,93
1751766,16,31,1997,5,female,649,4759,1750,16,158,16,70,0,88
1229350,17,12,1996,3,male,438,2193,1754,16,66,16,52,0,14
1235124,97,4,1916,6,male,1355,4112,2868,16,63,16,52,0,11
1272829,16,25,1997,1,female,530,2883,615,17,54,17,28,0,26
1624190,16,23,1997,5,female,569,3528,824,17,325,17,200,0,125
1383700,18,13,1995,8,female,540,3718,1407,17,66,17,59,0,7
1336228,68,2,1945,12,female,977,3025,945,17,186,17,138,0,48
1917113,103,6,1910,9,female,696,1938,358,17,147,17,111,0,36
1171968,20,23,1993,10,male,654,1926,379,18,24,0,10,18,14
1791282,24,10,1989,3,male,313,2190,1226,18,23,5,9,13,14
2037123,26,22,1987,11,male,264,2025,590,18,17,18,15,0,2
1693434,21,2,1992,2,female,399,4211,28,18,1027,18,724,0,303
1723548,20,2,1993,12,male,205,1950,98,19,52,19,46,0,6
1921091,99,8,1914,3,female,1421,4731,591,19,154,19,124,0,30
1726799,23,1,1990,12,female,674,4371,768,21,23,21,17,0,6
1397326,25,16,1988,4,male,404,3113,2080,21,24,21,21,0,3
1745831,18,12,1995,10,female,255,3318,545,21,183,21,149,0,34
2033393,57,6,1956,1,male,1426,2064,882,22,146,4,86,18,60
1115385,103,6,1910,1,female,1690,4449,194,22,322,0,269,22,53
1640206,105,6,1908,7,male,1376,4548,2043,22,62,0,2,22,60
1231484,15,17,1998,12,male,535,2077,1697,22,75,13,60,9,15
1213319,16,15,1997,4,female,669,4337,1422,22,179,22,93,0,86
1221158,77,28,1936,4,male,984,3279,1455,23,511,0,186,23,325
1095115,16,28,1997,2,female,626,2148,1574,23,217,17,155,6,62
2055363,18,17,1995,3,male,383,2382,2134,23,180,23,123,0,57
1083386,68,16,1945,4,female,1559,4499,582,23,51,23,38,0,13
1457494,113,31,1900,12,male,1284,4703,1851,24,17,1,1,23,16
1825800,17,1,1996,11,male,1221,3563,1023,25,113,5,33,20,80
1844401,103,15,1910,6,female,1403,2153,794,25,97,25,78,0,19
2000307,92,10,1921,9,female,704,3380,131,26,47,8,23,18,24
1670309,16,24,1997,11,female,1042,2293,1410,26,683,26,618,0,65
1149793,20,9,1993,2,male,534,3048,2248,26,120,26,71,0,49
2090699,103,1,1910,10,female,783,4923,96,26,80,26,71,0,9
1485353,108,10,1905,7,male,1102,2430,1754,26,58,26,50,0,8
1109689,108,29,1905,9,female,1122,2731,207,27,52,4,31,23,21
1210151,21,31,1992,8,female,1684,4080,278,27,446,17,260,10,186
1713723,17,27,1996,11,female,667,4277,1477,27,1447,27,1236,0,211
1301550,26,1,1987,7,female,515,3898,592,27,579,27,454,0,125
1921204,18,10,1995,2,female,491,4695,1388,28,151,28,121,0,30
1941125,41,22,1972,6,male,418,3835,18,28,111,28,48,0,63
1512331,80,14,1933,3,male,788,3331,1476,28,738,28,419,0,319
1357273,103,24,1910,4,female,899,4597,331,28,1223,28,645,0,578
1329365,19,4,1994,5,male,938,2941,1579,29,3916,27,2461,2,1455
1723648,83,1,1930,3,female,1781,2226,170,29,8,29,7,0,1
1366239,18,12,1995,8,female,574,3179,1382,29,68,29,56,0,12
1636420,19,28,1994,6,female,129,4181,27,31,673,26,583,5,90
1582859,15,29,1998,7,male,452,2241,1164,30,67,30,64,0,3
1673475,21,30,1992,4,female,463,3345,680,30,354,30,216,0,138
1716377,83,6,1930,7,male,2124,2191,894,30,75,30,68,0,7
2127905,95,1,1918,9,male,807,2337,334,32,599,0,164,32,435
1375615,15,24,1998,4,female,451,2406,791,32,271,23,214,9,57
1058648,103,19,1910,6,male,1421,2540,1405,32,1660,32,1328,0,332
1594534,22,7,1991,1,female,565,4622,1846,33,1849,33,1511,0,338
1930344,23,8,1990,4,female,767,2368,1148,34,275,6,203,28,72
1544577,15,21,1998,10,female,650,2640,912,36,210,28,133,8,77
1010176,101,18,1912,9,female,2061,4529,400,35,56,35,35,0,21
1686615,108,12,1905,12,female,1143,2219,901,35,85,35,75,0,10
1926655,19,1,1994,8,female,469,4863,241,37,166,36,117,1,49
1479326,68,17,1945,8,male,1555,2102,867,37,19,37,19,0,0
1715024,18,28,1995,2,female,395,4376,326,37,153,37,121,0,32
2031535,19,25,1994,4,female,1353,4598,2396,37,1486,37,1138,0,348
1564435,23,15,1990,7,female,1115,2901,1068,38,507,14,411,24,96
1755863,21,13,1992,8,female,1514,2190,734,38,275,38,218,0,57
1257757,18,22,1995,6,female,268,2569,2130,40,430,40,388,0,42
1892405,20,26,1993,11,female,901,4106,398,40,71,40,67,0,4
1863977,113,7,1900,10,female,1307,2033,369,41,20,0,8,41,12
1885919,71,25,1942,4,male,824,3090,567,42,184,0,36,42,148
2136337,103,12,1910,10,female,920,4119,36,41,505,0,247,41,258
1852402,15,2,1998,4,female,550,1968,813,42,118,42,96,0,22
1046916,22,12,1991,9,male,611,3627,62,41,2372,41,2005,0,367
1259648,103,1,1910,1,male,2287,4196,1734,43,1,4,1,39,0
1813646,19,3,1994,1,male,587,2274,2040,44,15,3,8,41,7
2094770,108,19,1905,10,male,1861,2234,680,44,166,2,45,42,121
2173258,102,5,1911,2,male,1569,3877,680,44,12,43,10,1,2
2038976,15,2,1998,12,female,601,2811,883,43,486,42,397,1,89
1473173,15,23,1998,8,female,622,1923,879,43,4,43,1,0,3
2060728,23,25,1990,1,female,1050,3504,1598,43,206,43,117,0,89
1963616,94,1,1919,1,male,1210,2352,1329,45,188,45,163,0,25
1279050,17,1,1996,10,female,315,2014,388,46,1000,8,647,38,353
2147027,16,16,1997,4,female,503,3630,161,46,380,46,340,0,40
1451542,18,1,1995,1,female,546,2062,789,48,237,9,156,39,81
2042959,17,5,1996,1,female,159,2003,173,49,946,34,863,15,83
1280840,19,11,1994,5,female,898,2832,1048,49,231,10,130,39,101
1006228,18,6,1995,2,female,1029,4589,1330,48,173,38,114,10,59
1372279,103,12,1910,10,female,574,4229,594,49,1196,36,1022,13,174
1930403,16,12,1997,2,female,444,4220,1361,49,619,49,483,0,136
1851736,20,8,1993,6,female,469,4185,580,48,109,48,95,0,14
1584342,21,12,1992,12,male,972,3234,2133,51,12,43,12,8,0
1177267,80,3,1933,3,male,214,2384,516,50,18,50,14,0,4
1966857,102,6,1911,12,NA,2389,2548,1130,50,29,50,22,0,7
1462904,16,30,1997,12,female,527,3163,1345,50,71,50,56,0,15
2093543,18,10,1995,3,female,449,1964,681,50,252,50,212,0,40
1763036,18,19,1995,4,male,806,2530,1777,53,1,32,1,21,0
1420712,24,15,1989,12,male,616,1977,1770,53,153,26,133,27,20
1515748,95,1,1918,11,female,1975,4354,748,53,135,19,74,34,61
1145616,15,7,1998,1,female,384,2263,438,52,601,52,476,0,125
1434033,17,6,1996,6,female,236,2719,115,52,269,52,187,0,82
2176872,18,8,1995,9,female,604,4655,1597,52,247,52,204,0,43
1080716,61,24,1952,9,male,1159,3056,1788,53,116,53,95,0,21
1709355,108,23,1905,6,male,1085,2060,1365,55,35,55,31,0,4
1226929,17,4,1996,7,female,81,2067,227,55,1741,55,1411,0,330
1472795,16,20,1997,6,female,553,2644,430,57,318,19,218,38,100
1636714,15,28,1998,8,female,887,2956,1248,56,275,50,190,6,85
1587019,20,3,1993,3,female,562,3729,1763,60,149,60,135,0,14
1995608,21,8,1992,4,male,996,2473,1999,60,3409,60,2738,0,671
2086393,23,19,1990,4,female,845,2674,494,59,196,59,150,0,46
1477118,82,9,1931,7,male,967,2825,257,60,119,60,100,0,19
1775690,19,28,1994,7,male,1475,2416,779,62,323,43,233,19,90
1961273,17,11,1996,4,female,629,2788,464,61,166,61,143,0,23
2123198,21,9,1992,11,female,1072,1975,385,65,212,6,101,59,111
2182336,18,19,1995,4,male,798,2156,392,64,132,64,99,0,33
2168340,68,7,1945,6,male,1052,3495,2004,64,306,64,284,0,22
1384750,23,27,1990,12,female,885,2521,900,67,312,12,120,55,192
2136143,23,6,1990,10,male,422,4047,1097,66,54,32,46,34,8
1237158,19,28,1994,12,male,481,2476,2103,66,2196,19,1685,47,511
1862123,24,27,1989,9,female,1477,4062,1056,66,315,34,256,32,59
2164373,19,18,1994,10,female,839,3721,1535,68,825,63,579,5,246
1898274,91,17,1922,11,female,1340,4560,1040,67,206,67,182,0,24
2015646,16,30,1997,1,female,720,2357,472,69,159,4,118,65,41
1312765,24,9,1989,9,male,1068,2143,1504,69,48,41,39,28,9
1212832,19,31,1994,7,female,1413,4482,305,71,1575,22,1169,49,406
1841790,18,9,1995,12,female,107,2614,75,70,907,70,789,0,118
2107126,20,28,1993,5,female,1345,2623,593,69,758,69,620,0,138
1860599,18,23,1995,2,female,357,2079,759,74,62,1,43,73,19
2031813,15,14,1998,7,female,564,4227,1739,73,118,19,9,54,109
1975886,28,2,1985,5,male,431,2354,1964,73,80,73,73,0,7
1131317,18,21,1995,4,female,289,1919,1163,73,163,73,150,0,13
2137946,64,19,1949,10,male,1762,2025,834,76,31,36,18,40,13
2115148,103,28,1910,11,female,1180,3191,246,75,300,45,158,30,142
1066459,23,14,1990,5,female,83,3423,168,77,5120,77,4049,0,1071
1078844,20,2,1993,6,male,1190,4638,1480,80,179,1,70,79,109
1522217,94,13,1919,5,male,1727,2200,1552,80,286,11,185,69,101
1500480,16,2,1997,1,female,665,4755,1326,79,652,25,323,54,329
1284415,98,2,1915,5,female,1337,4655,623,80,10,76,6,4,4
2187950,23,17,1990,8,male,422,2072,1919,78,841,78,815,0,26
2080126,108,13,1905,12,male,1468,1988,821,84,71,14,30,70,41
2090944,17,3,1996,7,female,827,2413,580,81,1693,2,1408,79,285
1666336,19,19,1994,7,female,562,2473,557,82,223,82,210,0,13
1618800,106,7,1907,8,male,1380,2160,806,87,7,4,1,83,6
1961641,14,27,1999,2,female,516,3966,2308,86,721,23,454,63,267
1033021,17,19,1996,3,female,797,3973,883,87,335,19,207,68,128
1171020,19,10,1994,5,female,677,4683,913,85,431,53,286,32,145
1801932,15,19,1998,1,female,625,2802,250,88,1633,12,1235,76,398
2096613,108,19,1905,1,female,1964,1991,535,90,255,87,218,3,37
1877745,16,17,1997,5,female,338,2673,706,89,290,89,220,0,70
1811927,80,20,1933,7,male,851,4548,1270,89,614,89,529,0,85
1313410,108,1,1905,3,female,887,3579,1076,90,284,90,244,0,40
1824490,15,30,1998,7,female,646,4526,402,94,7711,94,4682,0,3029
1261153,17,17,1996,12,female,341,2554,1346,92,2102,92,1661,0,441
1321996,18,17,1995,7,female,702,3103,1240,95,2649,95,1262,0,1387
1770870,58,7,1955,6,male,1602,3111,1707,96,530,48,397,48,133
2033824,18,26,1995,3,female,121,3704,133,98,932,96,843,2,89
1880489,99,13,1914,5,female,1238,3216,705,99,19,99,4,0,15
1508074,14,1,1999,1,male,169,3311,493,98,109,98,93,0,16
1768936,19,2,1994,11,female,486,3080,944,99,486,99,379,0,107
1594715,21,29,1992,10,female,426,2282,279,100,2128,12,1418,88,710
1360671,16,25,1997,7,female,804,1987,1113,101,660,31,478,70,182
1189003,19,1,1994,1,female,583,2661,708,103,294,56,253,47,41
2118433,16,2,1997,1,female,435,3600,114,100,206,95,157,5,49
1826988,103,8,1910,5,female,694,2042,422,104,981,81,709,23,272
1078313,17,26,1996,6,female,577,4584,2196,108,682,1,390,107,292
1338883,18,5,1995,11,female,139,3080,278,106,769,59,544,47,225
2180017,17,17,1996,2,female,658,3525,1896,105,3167,39,1772,66,1395
1719894,17,13,1996,6,female,1104,4662,1391,108,2477,74,1512,34,965
1053589,19,8,1994,6,female,454,1985,519,107,9,80,1,27,8
1400630,19,24,1994,6,female,506,2749,437,106,554,94,415,12,139
1897311,18,31,1995,12,female,138,3348,480,105,285,105,275,0,10
1122188,25,15,1988,3,female,403,2095,293,109,3148,109,2434,0,714
1736366,108,17,1905,10,female,423,2287,152,108,1530,108,1108,0,422
1285799,16,27,1997,3,male,554,2344,1404,112,134,5,98,107,36
1539861,16,11,1997,11,male,644,2669,2195,111,1515,16,978,95,537
1430882,16,9,1997,4,female,685,1966,390,110,13,110,13,0,0
1888428,94,7,1919,1,female,864,4359,835,110,211,110,180,0,31
1804255,18,17,1995,10,female,682,3989,260,119,596,119,460,0,136
1979055,22,20,1991,4,female,1036,2014,152,118,3129,118,2865,0,264
1734687,58,31,1955,10,male,1057,2786,2092,114,304,114,294,0,10
1175550,15,23,1998,2,female,632,4475,750,120,500,39,260,81,240
1604966,56,28,1957,10,male,1807,2092,712,120,431,94,149,26,282
2163894,17,5,1996,1,male,616,2410,1329,122,26,122,22,0,4
1286620,18,10,1995,9,female,481,2066,550,124,313,124,263,0,50
1839907,103,5,1910,5,female,1691,2067,475,122,327,122,276,0,51
1749626,108,10,1905,1,female,1291,3403,314,123,381,123,324,0,57
1292089,20,16,1993,6,female,1067,4607,1336,128,467,6,168,122,299
1291288,87,5,1926,11,male,1405,3850,551,125,626,8,490,117,136
2154380,19,14,1994,7,female,1409,3441,2075,128,389,38,196,90,193
1163502,36,27,1977,9,male,2258,2561,1711,127,1893,47,1442,80,451
2138779,16,4,1997,5,female,604,2883,325,126,86,100,51,26,35
1742536,14,24,1999,8,female,246,2424,1728,128,159,128,153,0,6
1943844,24,28,1989,12,female,525,2046,521,127,266,127,211,0,55
1224427,108,29,1905,6,male,874,2473,814,136,2,136,1,0,1
1934998,15,27,1998,4,female,701,2043,137,135,541,135,378,0,163
1902079,68,29,1945,10,female,1285,4358,1809,131,1024,131,543,0,481
1531854,108,7,1905,4,male,1952,3048,1233,132,852,132,805,0,47
1182720,19,17,1994,1,female,1101,4252,958,142,706,134,507,8,199
1383071,20,29,1993,6,male,549,2633,213,137,4959,101,2791,36,2168
1033100,17,27,1996,11,female,290,2283,420,141,1989,141,1285,0,704
2038656,17,28,1996,3,female,399,2495,765,143,3045,143,2445,0,600
1561009,18,11,1995,9,female,404,2973,979,137,240,137,220,0,20
1294472,61,28,1952,9,male,797,4478,321,144,6,0,5,144,1
1129143,52,19,1961,9,female,595,3945,1311,150,1025,55,637,95,388
1684159,17,22,1996,12,female,120,3504,782,147,373,144,307,3,66
1838288,20,14,1993,11,female,165,1964,99,146,1706,146,1547,0,159
1758272,22,16,1991,12,male,445,4037,1704,147,2997,147,2419,0,578
1295794,77,7,1936,12,male,899,2186,149,152,1243,0,400,152,843
1640650,18,29,1995,7,female,1581,1940,897,156,1151,52,89,104,1062
1127838,21,21,1992,10,female,881,4767,1240,151,599,108,251,43,348
2113188,89,25,1924,1,male,1494,4583,1788,157,112,144,33,13,79
1816311,108,2,1905,8,male,1001,1913,1336,157,139,117,99,40,40
1126316,23,3,1990,10,male,314,3637,281,154,1142,112,900,42,242
1949609,27,30,1986,4,female,1416,3561,1039,151,754,151,365,0,389
1730678,19,11,1994,9,male,1561,3131,970,163,1228,17,576,146,652
1371642,15,7,1998,9,female,555,1926,613,161,570,57,176,104,394
2110108,25,26,1988,2,male,665,2396,714,163,198,163,176,0,22
1148138,18,20,1995,10,female,362,1948,297,159,776,159,644,0,132
2131474,84,6,1929,1,female,405,4507,1172,162,1745,162,1459,0,286
1038541,17,8,1996,9,female,757,2600,1148,165,183,104,149,61,34
1415176,15,8,1998,12,female,593,3459,1068,166,836,56,533,110,303
1260745,19,19,1994,6,male,278,2931,725,165,470,48,267,117,203
2119798,21,4,1992,7,female,1380,3095,333,168,495,137,382,31,113
1824450,23,19,1990,10,male,272,4274,100,170,3488,169,2861,1,627
1403953,19,11,1994,11,male,519,3693,3415,170,20,170,19,0,1
1092658,17,13,1996,1,male,376,3513,359,172,208,172,193,0,15
1008202,55,14,1958,6,male,1700,2062,645,166,197,166,168,0,29
1224155,113,10,1900,10,male,1262,1950,1544,167,188,167,67,0,121
1617593,19,6,1994,4,female,404,3529,1919,166,491,166,356,0,135
1945705,17,1,1996,1,female,882,3357,978,177,314,119,211,58,103
1439214,33,27,1980,10,male,266,4792,42,177,1052,153,639,24,413
1824451,104,9,1909,8,female,538,2043,184,174,271,130,89,44,182
1401648,16,25,1997,12,female,135,2107,484,177,401,177,285,0,116
2025725,17,21,1996,3,female,702,4701,1130,184,4803,47,1561,137,3242
1501174,20,10,1993,10,male,914,2434,711,184,1022,86,878,98,144
1107829,18,20,1995,6,male,452,2587,1247,184,269,167,206,17,63
1616766,68,22,1945,10,male,1276,1992,1529,199,127,187,91,12,36
1063247,19,30,1994,12,female,826,2826,552,196,1280,146,387,50,893
2007684,18,12,1995,2,female,617,4384,669,196,328,196,293,0,35
1535976,102,1,1911,4,female,1624,2435,770,194,3364,194,2631,0,733
2058804,14,24,1999,2,female,404,2451,921,210,891,1,291,209,600
1166773,17,2,1996,11,male,1174,1974,1111,203,739,32,221,171,518
1137301,19,13,1994,3,female,1767,4302,754,203,1006,18,451,185,555
1769821,19,13,1994,2,female,608,4507,296,202,1185,144,702,58,483
1855389,17,10,1996,1,female,1206,3430,1039,205,1596,192,1055,13,541
1357077,21,26,1992,6,male,952,2766,1931,216,225,156,174,60,51
1718739,39,20,1974,9,male,616,2028,351,221,1087,143,357,78,730
1942093,19,5,1994,9,male,653,3623,856,215,6699,162,5111,53,1588
1166085,20,31,1993,8,female,463,4180,649,212,2001,160,982,52,1019
2040681,21,2,1992,3,female,1369,3716,596,221,1726,204,1177,17,549
1394092,103,7,1910,1,male,1526,2646,2093,216,527,216,460,0,67
1832848,23,4,1990,9,female,1627,3095,474,222,312,1,218,221,94
1112584,27,11,1986,11,male,1349,2936,2637,222,43,72,28,150,15
1398239,17,12,1996,7,female,545,2154,159,230,199,152,121,78,78
1349746,16,3,1997,9,male,197,4190,1170,230,1703,133,1339,97,364
2033463,18,24,1995,6,female,551,3014,1028,226,3037,182,1809,44,1228
1820520,18,1,1995,4,female,1263,1983,309,231,711,229,221,2,490
1255687,21,10,1992,10,male,408,1925,1410,224,99,224,57,0,42
1647174,113,25,1900,5,female,1503,2830,735,224,256,224,234,0,22
1119831,18,25,1995,9,female,570,3475,546,233,1576,233,1456,0,120
1306533,20,1,1993,11,female,680,3273,775,228,1226,228,1011,0,215
1517807,17,30,1996,7,female,394,2590,1240,245,486,1,152,244,334
1973701,17,5,1996,9,female,1436,3299,441,236,667,16,123,220,544
1738053,18,30,1995,11,female,353,2022,1144,241,131,147,50,94,81
1692860,21,20,1992,12,female,1165,3257,501,240,2277,144,1528,96,749
1324261,19,5,1994,5,female,1554,3874,1618,243,1046,190,457,53,589
1831130,16,2,1997,3,female,624,2218,500,241,114,241,99,0,15
1541529,17,20,1996,10,female,590,2053,836,244,685,244,479,0,206
1860748,108,27,1905,6,male,139,2343,42,253,353,0,216,253,137
1476864,16,15,1997,7,female,313,4578,399,253,6118,10,3526,243,2592
2041740,17,19,1996,1,female,556,2302,835,249,371,145,106,104,265
1641987,19,12,1994,4,male,1440,2564,1394,248,314,88,184,160,130
2031089,16,29,1997,5,male,615,2690,860,247,607,90,368,157,239
1208589,20,8,1993,12,male,640,2141,881,251,738,179,218,72,520
1733618,17,20,1996,11,female,540,1955,987,249,54,229,25,20,29
1468499,18,15,1995,6,male,728,2609,2085,251,283,248,246,3,37
2141603,20,11,1993,5,male,517,2983,2772,253,1763,245,1544,8,219
2018614,17,16,1996,12,female,516,4282,1192,251,1115,251,665,0,450
1005698,16,14,1997,1,male,212,3869,565,252,407,252,337,0,70
1803948,34,23,1979,8,female,392,2308,242,254,1071,254,915,0,156
1935447,68,21,1945,9,male,999,2447,432,260,414,260,387,0,27
1054433,23,9,1990,11,female,1018,1985,251,269,1608,48,1239,221,369
1292166,108,6,1905,6,female,1026,4227,335,269,855,31,588,238,267
1551501,100,18,1913,10,male,647,2645,2129,262,299,64,211,198,88
2058557,15,9,1998,1,female,657,3194,1017,268,767,89,452,179,315
1014347,18,5,1995,3,male,834,3121,1721,270,1958,63,739,207,1219
1426597,73,3,1940,3,female,649,4720,708,270,1625,76,406,194,1219
1595032,18,18,1995,3,female,1031,4085,1454,274,618,272,452,2,166
1149553,23,9,1990,12,male,710,2034,1151,268,143,268,135,0,8
1533729,19,3,1994,11,female,1387,2780,551,266,818,266,741,0,77
1916745,18,10,1995,8,female,322,2382,670,276,802,276,727,0,75
2127584,16,14,1997,9,female,744,2427,1436,282,3317,15,2111,267,1206
1446210,17,22,1996,2,female,309,4540,454,290,2047,4,1279,286,768
1535023,19,9,1994,9,male,222,3847,259,278,2145,2,1447,276,698
1411015,21,21,1992,9,male,366,2251,1993,279,375,84,174,195,201
1527265,96,7,1917,1,female,2341,2236,739,288,353,190,207,98,146
1736833,15,28,1998,4,female,613,4681,907,292,1388,69,866,223,522
1221402,19,29,1994,7,female,482,4043,2248,292,1489,74,276,218,1213
1218112,15,24,1998,7,female,215,2539,122,280,6004,255,2374,25,3630
1672753,18,2,1995,5,female,258,2017,470,279,1147,235,674,44,473
1045456,22,12,1991,5,female,1184,2223,1050,280,630,223,470,57,160
1982338,23,12,1990,12,male,826,2245,1299,285,149,285,139,0,10
2171422,16,5,1997,5,female,405,1911,566,283,2026,283,1830,0,196
1285576,21,14,1992,3,female,1054,2805,802,281,451,281,395,0,56
1000764,17,16,1996,11,female,547,2217,1638,300,172,18,81,282,91
1919096,19,12,1994,8,female,467,2640,792,302,245,9,142,293,103
1991549,94,1,1919,6,male,1351,2203,799,301,282,26,148,275,134
1779169,15,15,1998,3,female,403,2645,290,303,559,53,480,250,79
1060916,19,15,1994,6,female,568,1923,302,297,1775,173,1210,124,565
1550592,38,21,1975,7,male,827,2542,825,305,1314,198,963,107,351
1656844,88,22,1925,6,male,736,4558,854,296,4573,159,2874,137,1699
2119518,14,1,1999,5,female,225,2023,1460,296,3400,296,2162,0,1238
1799588,16,13,1997,11,female,660,4279,612,299,4278,299,3789,0,489
1422110,19,1,1994,11,female,402,4732,196,294,1893,294,1692,0,201
1667033,21,8,1992,7,male,1127,3450,2837,327,243,56,118,271,125
1508572,15,9,1998,7,female,464,2635,403,318,955,27,769,291,186
1529639,96,7,1917,10,female,604,4803,555,313,501,0,219,313,282
2158166,16,5,1997,3,female,1192,3817,1688,321,1428,161,939,160,489
1124345,108,15,1905,3,female,1614,3008,1191,319,742,205,493,114,249
1050760,17,17,1996,8,female,655,2722,1008,313,3144,245,2111,68,1033
1248415,103,23,1910,10,female,444,2952,115,320,775,320,418,0,357
1183492,108,23,1905,2,female,1463,3448,1308,330,581,16,354,314,227
1212514,17,6,1996,9,female,524,4452,454,328,548,236,264,92,284
1128708,17,16,1996,9,female,278,1915,839,346,4788,195,3351,151,1437
1965680,19,15,1994,4,female,1653,3453,627,345,9071,88,7262,257,1809
1421193,43,23,1970,6,female,766,2032,1253,344,529,101,116,243,413
1207426,89,31,1924,12,male,1944,4581,1090,334,2185,166,1562,168,623
1558389,108,16,1905,3,female,1329,4274,820,346,123,331,90,15,33
1781473,15,2,1998,3,female,449,2113,442,328,720,319,459,9,261
1283801,16,7,1997,1,female,688,2243,559,332,2931,287,1861,45,1070
1008166,16,28,1997,10,female,433,3617,927,338,9852,307,4830,31,5022
1879965,15,31,1998,12,female,575,4173,294,336,1845,336,1205,0,640
1547768,92,1,1921,6,female,1624,2022,619,350,114,8,35,342,79
1155656,19,17,1994,8,male,647,2114,1915,368,409,11,238,357,171
2176117,15,1,1998,4,male,513,2228,660,356,1323,56,1003,300,320
1680037,19,31,1994,7,male,655,2066,1734,350,1233,1,589,349,644
1029702,108,6,1905,8,male,1900,3889,1977,356,835,0,338,356,497
1743496,103,30,1910,12,female,1427,4676,243,359,135,178,55,181,80
1007750,113,20,1900,6,male,1895,2417,1397,360,140,114,98,246,42
1931683,18,11,1995,8,female,351,2144,178,351,501,337,187,14,314
1458216,15,15,1998,1,female,882,3407,627,364,1213,285,686,79,527
1565349,19,18,1994,2,female,466,3070,1365,348,2011,344,1449,4,562
1208130,103,11,1910,3,male,2094,4501,583,365,743,335,329,30,414
1959285,15,11,1998,6,female,655,3742,2009,347,3477,347,2723,0,754
1728221,15,10,1998,8,female,534,3190,936,369,5770,369,4833,0,937
1148141,16,17,1997,7,female,682,3647,1168,355,539,355,419,0,120
1550901,80,10,1933,8,male,1285,1952,1201,374,47,10,35,364,12
1093992,108,18,1905,12,male,1111,4089,510,372,398,9,102,363,296
1122747,108,23,1905,3,female,1101,4063,399,388,1161,16,502,372,659
1568707,15,18,1998,6,female,776,2228,369,391,747,222,418,169,329
1245957,15,21,1998,9,female,476,2430,2177,390,1613,194,1163,196,450
2039360,16,10,1997,6,female,623,4524,1999,370,2459,152,2035,218,424
1601598,23,19,1990,8,female,1567,2082,644,377,1512,102,1033,275,479
1404979,16,2,1997,8,female,655,2758,1153,386,3592,358,1956,28,1636
1421401,19,16,1994,8,male,1186,2358,1514,385,1023,318,606,67,417
1597854,17,6,1996,7,female,279,2536,178,377,2158,377,1913,0,245
1207962,17,26,1996,4,female,606,4759,1507,420,1190,4,866,416,324
1823425,18,29,1995,4,female,1189,1912,918,418,1087,0,426,418,661
1222311,19,4,1994,4,female,580,3559,2273,412,1417,70,795,342,622
1739975,108,17,1905,11,male,933,3325,477,395,1738,57,1303,338,435
1141988,18,8,1995,11,female,700,4420,1890,417,601,168,386,249,215
1585761,68,3,1945,12,male,655,2766,1915,411,560,143,371,268,189
1569542,17,14,1996,11,female,646,2164,718,418,1688,273,1501,145,187
2087369,18,18,1995,6,female,1071,4544,1721,421,1158,129,618,292,540
1219750,19,1,1994,6,female,1449,3275,936,416,2665,179,1302,237,1363
1197454,24,30,1989,11,male,451,4653,512,406,797,125,521,281,276
1839020,19,4,1994,4,female,403,3949,1383,403,1501,375,630,28,871
1915130,29,7,1984,8,female,475,3441,2074,408,1638,338,1037,70,601
2142501,17,12,1996,7,female,862,2420,1916,405,1847,404,1399,1,448
1447678,26,28,1987,10,female,998,2136,1108,410,3124,406,2422,4,702
1391158,16,10,1997,4,male,432,2593,165,402,272,402,264,0,8
1623382,18,5,1995,5,female,373,2302,510,398,403,398,324,0,79
1379819,66,27,1947,3,male,733,2691,2376,407,299,407,265,0,34
1967451,14,3,1999,10,female,336,3426,1073,405,762,405,671,0,91
1784983,23,20,1990,4,male,497,2733,2044,412,832,412,503,0,329
1171228,103,24,1910,11,female,816,1978,1158,406,1466,406,1278,0,188
1920304,16,16,1997,2,female,516,2977,2425,443,250,308,166,135,84
1873314,45,16,1968,8,female,1025,3144,1172,431,640,256,285,175,355
1458639,15,13,1998,10,female,634,2990,901,430,3339,178,2067,252,1272
1799620,19,19,1994,4,female,1332,2258,1245,450,1437,142,1063,308,374
1350571,101,11,1912,9,male,2190,2547,1652,425,1729,157,1398,268,331
1843566,17,8,1996,8,female,949,2697,700,435,3165,378,2316,57,849
1746435,19,25,1994,6,female,686,1938,1357,435,424,432,273,3,151
1528635,80,27,1933,11,female,929,4514,286,424,220,424,173,0,47
1850675,18,26,1995,2,female,368,3728,1654,444,574,444,476,0,98
1943044,16,6,1997,8,female,785,2339,802,446,1046,446,830,0,216
1044992,18,4,1995,6,female,897,2564,599,431,684,431,619,0,65
1368252,19,29,1994,10,male,345,3620,1953,432,6373,432,4905,0,1468
1848042,28,17,1985,8,female,508,4562,451,438,4691,438,2850,0,1841
1270799,18,7,1995,7,female,422,2770,1441,462,1495,37,750,425,745
1671000,16,14,1997,1,female,914,2469,1001,468,216,125,110,343,106
1466914,23,1,1990,2,male,1320,2925,1477,466,689,306,397,160,292
1257473,17,24,1996,1,female,258,4230,697,467,1175,239,492,228,683
1894934,17,18,1996,9,male,1575,1932,848,470,4199,116,1619,354,2580
1024869,57,28,1956,5,female,2226,2521,909,467,209,348,109,119,100
1286085,17,29,1996,8,female,704,2449,860,460,639,438,390,22,249
1893449,15,26,1998,8,female,559,3500,1311,465,743,396,390,69,353
1536090,18,10,1995,11,female,398,4147,926,457,2180,440,1074,17,1106
2113247,18,13,1995,12,female,1556,3158,299,467,1702,409,932,58,770
1214485,18,14,1995,3,female,432,1977,471,475,2204,405,1456,70,748
1677625,78,10,1935,4,female,1691,4735,268,475,2677,423,1857,52,820
2010676,16,19,1997,12,male,460,3079,1994,453,254,452,204,1,50
1398154,14,18,1999,8,female,196,3280,836,461,1224,461,973,0,251
2014301,18,10,1995,1,male,804,2710,1149,459,1131,459,838,0,293
1248113,21,26,1992,10,female,718,4698,811,475,871,475,759,0,112
1317175,50,26,1963,12,male,620,3681,1900,463,3801,463,3438,0,363
1483216,18,29,1995,8,male,616,4431,188,509,6103,40,2362,469,3741
1899239,19,24,1994,4,male,1296,3639,1616,514,962,20,228,494,734
1850094,18,5,1995,5,male,532,2318,1754,515,527,318,478,197,49
1114537,17,29,1996,8,male,1088,4524,2610,505,1111,168,383,337,728
1166881,18,18,1995,1,female,695,4535,1916,492,983,322,511,170,472
1436583,18,11,1995,4,female,540,2078,762,515,2924,111,1442,404,1482
1141239,24,14,1989,4,female,217,2376,1442,487,1681,170,970,317,711
1034591,16,11,1997,2,female,826,2825,1002,514,502,462,429,52,73
1930748,16,2,1997,4,female,658,4705,282,518,699,385,363,133,336
1849008,14,10,1999,2,female,952,2858,305,514,2133,451,1589,63,544
1284401,22,18,1991,6,male,65,2685,1832,507,3508,494,2994,13,514
1362239,68,29,1945,1,female,743,4724,1149,496,1630,424,1321,72,309
1408526,17,20,1996,5,male,517,2458,1710,484,716,481,660,3,56
1796383,108,6,1905,10,male,1107,2653,410,499,378,497,335,2,43
1654139,18,8,1995,5,female,793,1944,1193,488,291,488,193,0,98
1297341,17,12,1996,7,male,711,2756,2338,511,627,511,504,0,123
2070428,18,16,1995,2,female,1000,2493,888,511,1804,511,1635,0,169
1601244,18,9,1995,7,female,483,3330,781,513,4187,513,3958,0,229
1526298,71,10,1942,3,female,1059,4714,527,519,1588,519,1426,0,162
2126936,24,28,1989,5,female,1329,4390,1214,526,978,62,519,464,459
1280332,24,16,1989,8,male,1594,4306,2323,561,1353,6,1006,555,347
1120488,17,14,1996,4,female,428,2179,721,533,703,155,390,378,313
1240333,19,9,1994,10,female,1583,2224,940,538,698,321,250,217,448
1493724,16,22,1997,10,female,718,3412,583,530,1649,248,635,282,1014
1742814,15,29,1998,8,female,625,2825,1281,528,3535,451,3060,77,475
2010243,103,1,1910,12,female,436,2483,621,543,1921,543,1638,0,283
1359188,16,14,1997,4,female,757,1938,1306,591,575,76,149,515,426
1227765,17,18,1996,10,female,911,1999,1135,599,393,72,230,527,163
1210384,17,10,1996,6,male,503,2012,528,568,1581,104,360,464,1221
1562482,19,18,1994,4,male,854,2001,540,567,5133,167,4436,400,697
1057867,19,23,1994,4,female,362,2051,658,571,2863,403,1770,168,1093
1082314,19,20,1994,9,male,605,2111,1462,569,1637,227,776,342,861
1932226,21,29,1992,7,female,975,2861,1106,563,973,362,493,201,480
1734793,23,16,1990,8,female,1432,4505,416,570,1019,340,866,230,153
1007614,50,1,1963,8,male,1943,2697,1024,598,296,465,126,133,170
1591060,18,3,1995,10,female,247,2624,1770,580,528,435,443,145,85
1364326,17,6,1996,6,female,732,2712,522,588,1896,469,764,119,1132
1619348,21,12,1992,2,female,1311,4211,1212,569,1277,422,304,147,973
1205425,60,17,1953,6,female,1562,4794,3538,586,1318,560,960,26,358
1551348,17,27,1996,2,female,447,2083,311,599,1372,598,1048,1,324
1861684,23,25,1990,1,female,486,1987,748,607,515,607,361,0,154
2140658,18,2,1995,6,female,321,2998,865,577,3391,577,2635,0,756
1352830,16,29,1997,5,male,990,3556,1677,644,1381,37,830,607,551
1229700,16,14,1997,5,male,742,2264,1669,663,1362,78,717,585,645
1022725,19,13,1994,9,male,432,2764,2018,637,352,375,299,262,53
2073911,16,5,1997,12,female,498,1929,207,645,866,399,706,246,160
2022668,16,25,1997,2,male,804,2072,1498,626,565,269,429,357,136
1239034,16,25,1997,9,female,494,2928,320,652,842,407,290,245,552
1973377,18,10,1995,4,female,585,3898,2147,662,1185,264,791,398,394
1144249,19,1,1994,7,female,327,3036,1141,644,1394,430,463,214,931
1504420,20,6,1993,6,female,543,3437,786,663,3794,219,2480,444,1314
1681169,34,2,1979,7,male,644,2441,577,626,7297,228,3618,398,3679
2186091,41,9,1972,7,female,1137,2020,123,655,276,576,170,79,106
1292451,20,16,1993,9,female,640,2502,1429,658,791,593,507,65,284
1056622,74,3,1939,10,female,1849,2123,422,662,583,642,520,20,63
1349381,85,21,1928,5,male,1082,1954,1185,610,663,580,580,30,83
2115905,14,24,1999,10,female,185,2007,861,648,2192,570,1304,78,888
2174049,20,31,1993,12,male,1716,2858,825,640,2552,465,1727,175,825
1101955,19,2,1994,3,female,598,4557,1355,618,4986,617,3835,1,1151
1567592,18,14,1995,1,female,425,2966,448,662,65,662,61,0,4
1947208,24,1,1989,2,male,906,3118,2220,625,1541,625,1344,0,197
2004909,58,16,1955,6,female,579,2119,994,699,345,0,62,699,283
1641850,112,1,1901,1,male,1165,4310,543,664,227,0,52,664,175
1019379,22,2,1991,8,female,1489,2185,674,704,641,117,385,587,256
2030365,23,19,1990,2,male,1675,4705,2291,687,2291,84,1365,603,926
1137495,17,20,1996,10,male,338,2393,499,687,583,459,418,228,165
1887875,19,8,1994,1,female,583,2175,1025,707,703,271,410,436,293
2070446,21,28,1992,11,female,1474,1984,189,685,530,353,280,332,250
1891491,102,3,1911,3,male,1459,2356,1480,702,711,489,226,213,485
1292549,16,16,1997,4,female,674,1938,371,690,1694,336,1206,354,488
2030777,16,26,1997,7,female,831,2074,546,674,5097,223,4192,451,905
1742615,17,24,1996,2,male,312,2354,1582,679,1805,257,1391,422,414
1033851,19,28,1994,6,female,581,3118,1782,724,3589,484,2126,240,1463
2149030,20,31,1993,10,female,758,2885,850,665,1480,207,639,458,841
1844996,21,8,1992,5,female,817,2218,492,669,1286,246,711,423,575
1400821,97,20,1916,10,male,1461,1936,953,724,1337,459,506,265,831
1176259,68,9,1945,12,male,761,2440,1735,666,500,648,380,18,120
1480607,17,26,1996,6,female,786,2253,1355,670,1743,502,759,168,984
2074014,19,25,1994,12,female,610,1933,982,683,1271,563,763,120,508
1590957,23,8,1990,8,female,1231,2604,543,679,3020,529,2635,150,385
1320525,85,23,1928,4,female,863,3932,2499,721,2326,686,1747,35,579
2187614,15,2,1998,5,female,614,2907,866,667,528,666,256,1,272
1116472,23,23,1990,4,male,1142,2964,2396,706,2074,703,1650,3,424
1006742,103,25,1910,2,male,1487,1979,977,673,164,673,156,0,8
1550870,16,21,1997,11,female,511,3567,810,695,1842,695,1596,0,246
1681666,68,20,1945,11,female,647,1955,368,793,426,2,237,791,189
2163907,15,11,1998,1,female,313,3707,530,740,781,68,222,672,559
1601426,17,24,1996,12,female,1426,3384,1100,756,646,111,462,645,184
1804329,17,28,1996,9,male,334,3767,2168,766,1036,25,433,741,603
1771131,103,22,1910,8,female,2029,3931,1302,794,2298,94,1357,700,941
1086822,18,28,1995,1,female,645,2245,462,765,1069,390,517,375,552
1299454,16,14,1997,7,female,776,2993,1681,768,3659,248,2211,520,1448
1337853,19,11,1994,4,male,626,2115,508,776,1897,472,1521,304,376
1105790,20,29,1993,3,female,1519,2669,940,769,1354,211,1003,558,351
1794098,94,1,1919,4,female,813,3929,2195,795,2409,574,1685,221,724
1771828,18,5,1995,6,female,344,2204,498,774,805,739,477,35,328
2125985,16,25,1997,1,female,1464,4604,730,793,1370,664,588,129,782
1192042,20,27,1993,12,female,1356,4767,2061,791,6077,746,3769,45,2308
1990873,20,22,1993,12,female,837,3079,280,768,2140,638,1413,130,727
1825400,23,19,1990,1,male,846,4260,1176,764,2050,629,712,135,1338
2107637,38,24,1975,11,female,1292,3044,1712,730,2735,707,2531,23,204
1432744,60,23,1953,11,female,1583,2849,1191,750,1467,649,547,101,920
1894505,24,18,1989,10,female,673,2361,368,757,3418,753,1851,4,1567
1275846,39,2,1974,2,male,526,4297,1279,787,2855,786,1302,1,1553
1340926,108,15,1905,3,male,1384,2511,1459,759,875,759,668,0,207
2055573,18,30,1995,6,female,416,3386,735,733,1557,733,808,0,749
1444529,68,6,1945,2,female,484,2046,851,790,3798,790,3117,0,681
1405803,25,11,1988,8,male,667,3820,2836,835,377,107,106,728,271
1344234,98,5,1915,9,male,697,2668,644,814,299,109,272,705,27
1356284,17,5,1996,5,female,254,3735,486,852,929,163,412,689,517
2188467,18,5,1995,5,male,1010,2958,2195,806,764,75,458,731,306
2146524,20,14,1993,12,male,688,2596,1127,804,1259,52,721,752,538
1800318,19,11,1994,2,female,1051,3951,568,862,3032,66,1386,796,1646
2068044,23,14,1990,3,female,1641,2520,2157,869,2377,115,1415,754,962
1129904,15,6,1998,1,female,680,2310,365,816,323,567,284,249,39
1408420,15,30,1998,5,female,1457,2989,607,842,1254,196,782,646,472
1842822,17,28,1996,2,female,414,2275,1626,821,607,319,405,502,202
1042543,19,12,1994,4,female,521,2186,143,823,3934,380,1148,443,2786
1760041,19,19,1994,6,female,484,3463,1024,875,2000,373,674,502,1326
1708950,20,18,1993,4,female,850,2387,566,874,2374,283,1101,591,1273
1508742,45,16,1968,11,female,1627,2380,985,849,2766,408,1000,441,1766
1144745,46,19,1967,1,male,1423,4615,702,840,1896,347,772,493,1124
2095963,14,10,1999,5,male,662,1911,1475,804,1205,784,844,20,361
1568432,17,26,1996,7,female,766,3163,2160,817,1127,763,1057,54,70
1310982,17,24,1996,7,female,629,3505,1224,861,846,836,748,25,98
1303068,18,1,1995,3,female,1678,1977,769,832,690,693,527,139,163
1918548,89,20,1924,7,female,1536,2025,946,854,676,845,476,9,200
1604095,15,21,1998,12,female,371,4826,97,815,4801,737,3843,78,958
1073794,19,5,1994,12,female,373,4589,1720,841,10253,663,2982,178,7271
1645807,20,10,1993,12,female,459,4710,894,879,4830,671,3180,208,1650
2047058,19,5,1994,9,female,432,1956,221,819,16393,654,11043,165,5350
1845678,20,7,1993,2,female,1669,3765,950,816,1382,619,1035,197,347
1812241,103,10,1910,2,female,1981,2505,1125,818,857,818,775,0,82
2150204,18,24,1995,12,female,583,3013,972,864,2973,864,2609,0,364
1460631,16,17,1997,8,male,313,2580,1729,887,405,41,209,846,196
1785570,17,8,1996,1,female,510,3197,1147,899,337,38,110,861,227
1127854,17,23,1996,6,female,570,2081,710,952,3297,124,1182,828,2115
1871174,20,30,1993,3,female,968,3071,1827,936,3038,110,1741,826,1297
1029505,50,10,1963,8,male,1182,3482,1695,954,2906,17,1344,937,1562
1131419,49,18,1964,5,male,1320,2036,1588,940,503,215,251,725,252
1537257,15,20,1998,10,female,619,4468,751,959,970,642,854,317,116
1822186,14,27,1999,4,female,334,2091,474,899,2297,287,1919,612,378
1902732,16,19,1997,11,female,696,2524,751,935,1490,189,467,746,1023
1256914,15,27,1998,10,female,1189,3438,2559,951,1543,398,626,553,917
1375543,18,10,1995,12,male,728,1941,416,955,4753,308,2844,647,1909
1239973,17,26,1996,4,female,936,4417,1781,910,1851,548,610,362,1241
1949247,19,9,1994,11,female,434,4189,3594,927,2859,528,1290,399,1569
1727588,19,23,1994,7,female,739,2182,1045,981,1835,201,1040,780,795
1589495,19,25,1994,7,male,409,2053,314,891,2745,514,2296,377,449
1744078,22,23,1991,3,female,84,4508,195,905,4844,538,1001,367,3843
2110563,23,9,1990,1,female,709,2015,707,890,1470,214,321,676,1149
1122346,23,10,1990,10,female,1690,2177,353,927,1483,572,230,355,1253
1959804,18,7,1995,1,female,644,2778,1131,962,856,878,612,84,244
1862167,19,25,1994,1,female,704,1935,542,928,1043,916,900,12,143
1801945,19,31,1994,10,female,1528,4320,737,903,1136,743,283,160,853
1312899,16,19,1997,8,female,459,2080,611,888,2166,752,959,136,1207
1934087,19,19,1994,5,male,575,4516,3078,954,3075,834,2464,120,611
1015907,74,27,1939,11,male,832,4630,831,966,39536,941,10199,25,29337
2006222,15,19,1998,6,female,586,2026,870,917,1815,910,1067,7,748
1321655,19,9,1994,6,female,268,3035,281,932,1904,932,1446,0,458
2111567,103,22,1910,5,female,3128,4658,972,929,2756,929,1193,0,1563
1006170,64,4,1949,2,female,1340,2052,1408,1076,501,1,75,1075,426
1932325,68,23,1945,5,female,669,1911,412,1038,262,57,190,981,72
1183666,14,20,1999,10,female,232,2697,479,1021,1869,90,1293,931,576
2022737,16,29,1997,6,male,438,2052,1046,1043,588,241,208,802,380
1188002,17,2,1996,4,female,53,2312,1121,1005,497,207,301,798,196
1799059,15,4,1998,10,female,1095,4233,1329,1042,1491,735,616,307,875
1868869,14,2,1999,8,female,445,1970,1397,1128,8581,331,1989,797,6592
2144524,17,6,1996,11,female,151,3125,471,1071,5530,652,3990,419,1540
1071836,16,2,1997,6,female,377,4105,306,1005,1805,391,354,614,1451
1605870,20,14,1993,9,female,25,4576,1710,1006,2293,299,1453,707,840
1129526,92,7,1921,7,female,1235,4153,2271,1048,1986,404,1244,644,742
1869228,14,8,1999,2,female,191,2199,1410,1083,1579,856,858,227,721
1116336,16,23,1997,11,male,506,3561,260,1066,1136,876,625,190,511
2057051,18,6,1995,2,female,391,2259,1415,1083,15731,1061,5860,22,9871
1190613,20,19,1993,3,female,746,4483,863,998,3379,905,1887,93,1492
1591857,24,22,1989,12,female,797,2351,838,1054,1870,1000,1339,54,531
1086856,100,23,1913,8,male,1189,4632,2548,1064,1908,783,1074,281,834
1075116,49,30,1964,3,female,571,2081,277,993,214,991,131,2,83
1878691,17,13,1996,6,female,666,2204,1431,1114,1221,1114,909,0,312
2025395,18,12,1995,10,female,247,2839,1420,1042,1300,1042,801,0,499
1336111,63,11,1950,10,male,612,2630,1655,1031,753,1031,638,0,115
1974177,18,24,1995,1,male,623,2255,1815,1050,2136,1050,1851,0,285
1913961,21,16,1992,9,female,412,4546,422,1064,2794,1064,2477,0,317
1384977,17,14,1996,4,female,980,3470,1540,1202,1321,230,768,972,553
1971818,14,9,1999,3,female,171,2173,1365,1265,7702,118,5921,1147,1781
1756627,17,1,1996,7,male,225,1956,710,1181,3671,203,2430,978,1241
1160771,26,15,1987,3,female,1013,4604,726,1171,2050,10,653,1161,1397
1906328,17,19,1996,9,male,840,2091,1368,1188,871,755,586,433,285
2136449,19,6,1994,5,female,589,2576,766,1197,1616,595,1418,602,198
1760783,15,18,1998,3,female,282,1989,439,1247,2820,698,858,549,1962
1309290,15,9,1998,4,female,43,2112,222,1267,6336,598,1839,669,4497
1540687,15,5,1998,9,female,417,4191,382,1253,3937,413,2032,840,1905
1334136,17,26,1996,12,female,562,3032,330,1166,1862,389,539,777,1323
1431951,19,4,1994,3,female,389,3003,398,1176,2256,632,1709,544,547
1579327,19,24,1994,5,female,421,4295,897,1183,2123,444,1031,739,1092
1807563,22,6,1991,8,male,1547,3746,2373,1280,9503,329,5318,951,4185
1395581,23,23,1990,1,male,679,2027,601,1280,9570,314,3811,966,5759
2092631,23,11,1990,10,male,285,4478,275,1154,4371,426,3563,728,808
1676607,52,13,1961,8,female,1957,3970,1245,1201,2696,625,1215,576,1481
1030958,17,23,1996,3,female,600,2540,2142,1185,1193,1039,1035,146,158
1906275,50,1,1963,6,male,750,4281,873,1137,906,1107,662,30,244
1166872,108,5,1905,3,female,1231,1982,806,1285,1237,1069,755,216,482
1778029,15,26,1998,12,female,241,3532,269,1202,3676,1149,3348,53,328
1148962,14,21,1999,1,female,202,2998,1505,1205,5407,1184,2146,21,3261
1255972,14,5,1999,5,female,183,2375,553,1178,2165,1093,764,85,1401
1695259,14,12,1999,6,female,566,4615,1848,1257,4680,978,2034,279,2646
1182164,17,12,1996,4,female,434,3813,1936,1281,3005,1255,1390,26,1615
1172044,18,12,1995,10,female,239,2227,1144,1201,10905,1110,6620,91,4285
2118039,20,20,1993,9,female,788,4540,2145,1169,482,1169,375,0,107
1785442,37,26,1976,5,female,270,3676,124,1222,11443,1222,4787,0,6656
1333327,103,29,1910,8,male,1024,2236,1632,1296,220,0,70,1296,150
1992431,24,17,1989,6,female,1486,1986,1245,1464,1962,83,420,1381,1542
1025999,47,25,1966,9,female,768,3117,1799,1500,942,299,224,1201,718
1139873,14,19,1999,9,female,1061,4418,1128,1338,2758,144,1179,1194,1579
1479575,20,15,1993,11,female,835,3170,1768,1485,4604,264,2064,1221,2540
2083603,49,2,1964,12,female,1827,2360,950,1426,3433,94,1283,1332,2150
2175539,19,3,1994,1,female,584,2249,657,1289,419,797,150,492,269
1925828,16,5,1997,7,female,491,3357,1842,1414,1529,727,1037,687,492
1500599,17,23,1996,3,male,561,2347,1411,1353,1636,885,749,468,887
1833990,24,30,1989,4,female,1663,2039,1100,1390,1546,932,1296,458,250
2020433,27,12,1986,12,female,1487,2907,983,1488,1245,602,518,886,727
1653640,68,1,1945,11,male,593,3628,837,1386,921,797,676,589,245
1477284,15,2,1998,5,female,1188,1937,624,1513,6434,477,4362,1036,2072
1226940,15,24,1998,5,female,665,2935,1660,1353,5977,733,4459,620,1518
1484176,17,10,1996,12,female,756,4458,1492,1485,6365,776,4355,709,2010
1273199,16,14,1997,2,female,589,2972,1717,1319,2864,355,971,964,1893
1925562,16,17,1997,8,female,1177,3995,1367,1409,9705,921,8690,488,1015
1343302,20,5,1993,12,male,1252,2763,1920,1367,3632,814,1698,553,1934
1359370,19,16,1994,2,female,668,3675,764,1337,4036,564,2812,773,1224
1669037,19,5,1994,5,female,962,3499,794,1451,2821,975,1416,476,1405
1983513,21,13,1992,3,female,1501,3353,1561,1346,2034,825,591,521,1443
1762561,28,14,1985,8,male,1193,2416,745,1425,10257,723,4306,702,5951
1284837,45,6,1968,2,male,1919,3826,709,1483,4618,521,964,962,3654
1186184,108,10,1905,6,female,854,3253,669,1329,2088,627,876,702,1212
1078115,19,1,1994,1,male,396,4770,639,1345,1951,1279,1686,66,265
1949519,20,17,1993,3,female,596,4585,1744,1350,1963,1307,1431,43,532
1314118,51,11,1962,4,female,391,3279,1115,1383,1926,1265,637,118,1289
1008629,14,26,1999,7,female,357,4641,755,1403,2786,1282,756,121,2030
1250409,15,5,1998,2,female,341,2159,656,1476,3821,1156,3046,320,775
1557619,18,15,1995,12,female,438,3547,1205,1337,2011,1278,1053,59,958
1327875,17,13,1996,6,female,107,2170,195,1428,3651,1276,2791,152,860
2177920,21,17,1992,9,female,968,3279,2693,1402,2226,1346,1976,56,250
1675135,36,5,1977,5,female,184,4138,122,1315,5558,1104,3173,211,2385
2042824,18,25,1995,1,male,51,4817,32,1346,52964,1342,18925,4,34039
2051909,25,10,1988,6,male,533,1913,1726,1474,207,1474,185,0,22
1996778,108,21,1905,11,male,893,2049,719,1297,902,1297,650,0,252
1807752,16,15,1997,1,female,885,2502,1315,1870,883,40,240,1830,643
1195674,17,12,1996,8,female,376,2298,448,1808,1996,70,1095,1738,901
1839680,18,6,1995,10,female,405,2065,277,1817,2218,7,1250,1810,968
2148846,38,16,1975,2,female,1384,2729,1871,1686,1609,42,662,1644,947
2132467,88,3,1925,8,male,1416,3313,1692,1763,1853,3,523,1760,1330
2061020,18,2,1995,8,female,1035,4566,646,1726,4258,19,1746,1707,2512
1078916,20,13,1993,1,male,959,4499,2501,1720,5895,232,4226,1488,1669
1164641,36,15,1977,8,male,449,2856,1674,1532,3658,16,732,1516,2926
2051262,14,11,1999,5,male,873,3463,2110,1659,1385,442,784,1217,601
1376321,15,7,1998,4,female,10,2080,422,1617,2217,705,1746,912,471
1173053,17,8,1996,10,female,532,3894,366,1848,1444,1332,1248,516,196
1513598,18,25,1995,4,male,735,1998,703,1760,1584,584,736,1176,848
1424581,19,20,1994,9,female,1177,2507,1610,1746,2458,726,1922,1020,536
1546204,31,20,1982,6,female,937,2298,1045,1870,2241,704,1502,1166,739
2041292,50,24,1963,4,female,814,2179,1551,1864,1777,667,552,1197,1225
1668308,68,4,1945,3,female,377,2772,454,1740,1718,637,564,1103,1154
1535642,15,3,1998,4,female,520,2263,426,1751,4833,739,2414,1012,2419
1476056,17,15,1996,3,female,1150,2581,587,1549,4415,502,1249,1047,3166
1936854,17,15,1996,8,female,378,2200,492,1820,3543,1161,2074,659,1469
1867413,18,1,1995,8,female,1801,3237,411,1603,2694,530,1687,1073,1007
1350156,20,24,1993,3,male,508,4249,862,1758,5294,645,1894,1113,3400
1685573,38,20,1975,2,male,1930,4845,942,1768,4886,1208,1619,560,3267
1500166,70,15,1943,6,male,785,2664,1468,1621,3067,589,1854,1032,1213
1248835,14,30,1999,11,female,460,2611,656,1551,1781,1355,1131,196,650
1905394,14,7,1999,8,female,309,3303,1284,1819,2384,1781,725,38,1659
1452582,18,30,1995,7,female,717,2123,713,1767,2623,1743,2197,24,426
1284567,18,24,1995,8,female,48,2068,1137,1645,1178,1508,941,137,237
1136908,20,19,1993,9,male,435,2939,984,1856,2704,1523,2397,333,307
1519813,21,7,1992,4,female,2314,3135,1441,1725,2441,1563,1193,162,1248
1526069,16,29,1997,3,female,938,4697,924,1823,2791,1600,2460,223,331
2192435,17,23,1996,4,female,664,2517,508,1542,3212,1302,544,240,2668
1001431,18,28,1995,6,female,1249,2843,828,1679,5765,1359,4106,320,1659
1197783,53,30,1960,4,female,2220,1990,623,1700,6043,1262,2919,438,3124
1842048,18,1,1995,1,female,495,3740,1922,1696,2470,1690,1781,6,689
1628666,103,12,1910,4,male,825,3167,1271,1854,814,1854,744,0,70
1842946,18,6,1995,1,male,458,2159,1249,1525,1108,1525,906,0,202
1903656,17,10,1996,9,female,357,4654,141,1608,9592,1608,7068,0,2524
1844239,19,27,1994,11,female,553,4103,753,1690,5221,1690,4586,0,635
1861730,21,19,1992,4,female,1177,3442,1037,1571,7340,1571,4816,0,2524
1661104,15,1,1998,6,female,500,3478,902,2318,1703,244,710,2074,993
1584317,17,3,1996,1,female,707,2178,526,2252,2848,64,1751,2188,1097
1817366,18,20,1995,1,female,1297,2447,1036,2164,2945,108,1360,2056,1585
1593513,16,21,1997,6,female,426,3282,426,1872,5435,353,2595,1519,2840
1924964,19,1,1994,7,male,487,3285,1256,2094,5122,16,2619,2078,2503
1693605,19,27,1994,8,female,600,3719,1761,1918,3896,77,1499,1841,2397
1518354,22,23,1991,2,female,301,2553,699,2148,6220,124,1342,2024,4878
1715925,23,4,1990,9,female,705,4077,793,1877,152014,80,89911,1797,62103
1219473,18,13,1995,6,female,1103,4021,1325,2067,1028,883,540,1184,488
1069526,18,10,1995,10,female,621,3216,1626,2017,1995,822,983,1195,1012
1872383,21,7,1992,4,female,1176,2207,965,2213,2138,550,684,1663,1454
1639565,59,11,1954,6,female,499,2834,1375,2134,2763,984,1819,1150,944
1182272,17,16,1996,12,female,1082,4464,1716,2049,17159,681,9657,1367,7502
1535797,16,27,1997,7,female,1251,2768,1042,2053,20303,540,11881,1513,8422
1640120,17,13,1996,9,female,1084,2011,1040,2104,3277,1021,1209,1083,2068
1509407,18,23,1995,1,female,451,1970,197,2321,10192,1233,7750,1088,2442
1063988,22,24,1991,12,male,330,4754,506,1950,3369,424,1977,1526,1392
1746334,22,6,1991,10,female,1344,4306,983,1970,7907,652,3868,1318,4039
1257921,61,16,1952,8,male,1695,2845,505,2074,6138,1120,495,954,5643
1539007,103,8,1910,8,female,812,4673,381,1955,3268,1245,2095,710,1173
1075221,22,23,1991,5,male,907,4693,3024,2028,948,1990,517,38,431
2165022,15,7,1998,4,female,469,2397,510,2065,1489,2027,1109,38,380
1113528,15,1,1998,5,female,458,2225,641,2124,1486,1852,1261,272,225
1892160,17,21,1996,2,female,1063,3891,623,2122,2061,2054,708,68,1353
1086672,17,16,1996,7,female,668,1921,368,2147,1402,1893,1083,254,319
1076918,18,12,1995,6,female,601,2855,1521,1911,1767,1452,1369,459,398
1866809,20,12,1993,12,female,763,1931,1021,2108,2481,2001,1105,107,1376
1052695,22,23,1991,9,female,874,4297,3654,1968,2006,1825,1632,143,374
1005926,24,30,1989,11,female,556,2044,847,1963,1809,1681,1176,282,633
1638678,25,16,1988,12,male,1329,3276,1050,2269,3060,2051,1221,218,1839
1976445,43,1,1970,6,female,995,2564,1408,1963,2345,1920,1180,43,1165
1865407,65,25,1948,8,male,1541,2860,1503,2046,1702,1832,1081,214,621
1737135,15,14,1998,4,female,387,2434,1025,2158,17066,1606,11772,552,5294
1967496,15,2,1998,4,female,109,3584,132,1966,7444,1870,5679,96,1765
1772227,16,18,1997,5,female,282,3792,581,2259,4788,1994,3587,265,1201
1244332,16,31,1997,7,female,419,4663,542,2119,4404,1678,3027,441,1377
1939424,18,28,1995,7,female,454,2520,1672,1914,5195,1804,2046,110,3149
1249387,18,26,1995,9,male,1278,2133,702,2075,8095,1936,7173,139,922
1571217,19,25,1994,9,male,225,2321,884,2105,3341,1616,2228,489,1113
1128034,23,29,1990,10,female,795,3993,198,2112,4548,1946,2375,166,2173
1603868,24,8,1989,6,female,601,3769,479,2128,6362,1899,2289,229,4073
2082096,33,29,1980,10,female,2373,2870,2265,2097,4442,1989,2208,108,2234
1731299,17,2,1996,2,female,829,2838,2137,2320,1366,2312,1275,8,91
1314660,18,9,1995,9,female,535,2597,1052,1927,3924,1911,3148,16,776
1878887,16,12,1997,5,female,350,3704,528,2274,1163,2274,970,0,193
1430725,38,5,1975,5,male,446,4413,315,1962,650,1962,571,0,79
1761089,16,10,1997,3,female,587,2121,984,2308,3359,2308,3175,0,184
1015766,19,21,1994,8,female,547,2027,1316,2133,1357,2133,1175,0,182
1213463,52,29,1961,10,female,679,2159,857,2219,2983,2219,2635,0,348
1280902,17,28,1996,1,female,440,2770,700,2041,4932,2041,4230,0,702
2047056,19,22,1994,9,female,553,3014,584,1949,6011,1949,1897,0,4114
1077619,26,10,1987,10,female,950,2832,145,1954,4671,1954,4162,0,509
1480563,18,23,1995,4,male,486,2191,1509,3150,2344,59,1595,3091,749
1110149,18,15,1995,5,female,430,2435,1614,2840,3135,536,1061,2304,2074
1763081,20,13,1993,10,male,302,2373,437,2399,1652,324,1083,2075,569
1900164,23,20,1990,6,male,1026,2352,790,3228,4077,0,1657,3228,2420
2113222,58,16,1955,3,female,184,3120,957,3194,3318,79,1870,3115,1448
1243228,102,16,1911,2,female,390,2842,1735,3273,2176,37,403,3236,1773
1657039,15,24,1998,3,female,1071,2111,860,3025,5183,533,2480,2492,2703
1959232,17,20,1996,5,female,1151,2184,1584,3156,9863,610,3244,2546,6619
1264500,18,11,1995,6,male,516,2129,1678,2803,4724,62,2647,2741,2077
1522003,21,18,1992,2,female,1251,3494,1369,2430,4857,278,1340,2152,3517
1967555,24,15,1989,11,female,219,4587,583,2776,6652,171,4245,2605,2407
1053087,23,6,1990,6,male,596,4320,836,2996,82623,179,43410,2817,39213
1839000,23,11,1990,4,male,883,2211,1684,3294,546,1447,496,1847,50
1954646,22,7,1991,10,male,274,4078,773,3228,1956,1957,1436,1271,520
2159412,15,22,1998,11,female,1041,4452,662,2596,3212,1422,1863,1174,1349
1239018,15,29,1998,9,female,596,4080,793,3306,3069,1898,741,1408,2328
1100631,20,16,1993,10,male,642,2033,613,2708,3969,1448,1710,1260,2259
1033997,22,29,1991,9,female,742,4199,944,3070,4431,799,1154,2271,3277
1472076,69,23,1944,7,male,893,2125,470,3395,2486,952,1261,2443,1225
1487565,108,15,1905,4,male,800,2555,1042,2416,3468,1196,1632,1220,1836
1090279,17,17,1996,6,female,1110,4564,2565,2711,5451,709,3044,2002,2407
2186319,18,27,1995,9,female,1544,2242,1756,3090,6645,1511,3586,1579,3059
1556932,22,8,1991,1,female,172,3055,715,2636,6993,719,1887,1917,5106
1100364,102,19,1911,12,male,754,4420,1284,3244,6855,1234,4520,2010,2335
1972989,15,29,1998,1,female,499,4731,930,2408,479,1835,244,573,235
1401489,18,22,1995,3,female,404,3769,2550,3162,1258,2941,630,221,628
1307672,65,21,1948,5,female,858,2490,996,3477,641,3247,472,230,169
1110109,100,6,1913,11,male,751,1947,1154,3447,2087,3368,1387,79,700
2008877,108,23,1905,4,male,1587,2460,1158,2753,593,2694,327,59,266
1789467,16,9,1997,7,female,584,4638,1033,2402,2947,2064,2582,338,365
1430616,16,9,1997,8,female,717,2733,724,2671,1923,2334,1405,337,518
2010847,18,10,1995,2,female,1084,4509,3233,2672,2053,2009,1074,663,979
1266118,20,11,1993,7,female,926,2843,1042,3547,2317,3276,1262,271,1055
2075815,20,16,1993,7,female,464,3411,529,3158,2061,2604,838,554,1223
1077282,21,24,1992,3,male,1766,2352,180,2897,2317,2751,2111,146,206
1670458,78,29,1935,9,female,859,3727,862,2559,3723,2022,2230,537,1493
2085281,96,28,1917,6,male,999,3738,1705,2952,3857,2223,2709,729,1148
1585181,15,20,1998,5,male,336,1993,267,2964,5546,2865,4202,99,1344
1038391,19,19,1994,8,male,415,2054,1060,2403,8753,1957,5739,446,3014
1617578,20,11,1993,7,female,526,4665,687,3360,7446,2911,7013,449,433
1532834,22,23,1991,11,female,152,4696,231,2724,6012,2150,3207,574,2805
1722067,54,1,1959,5,female,1568,2417,698,3227,3110,3207,1511,20,1599
1981996,16,6,1997,8,female,682,3358,2239,2665,5721,2664,4735,1,986
1198514,20,13,1993,12,female,228,2052,968,3393,1790,3393,1483,0,307
1360039,68,24,1945,1,female,847,2683,423,3008,1442,3008,589,0,853
1248163,15,29,1998,5,female,484,4530,2097,2394,6536,2394,5044,0,1492
1998811,17,7,1996,1,female,189,3521,704,2583,4389,2583,3840,0,549
1218476,21,7,1992,1,female,407,2553,1767,2415,5345,2415,4461,0,884
2051379,44,4,1969,6,female,1385,2066,41,2951,14625,2951,7869,0,6756
1597192,17,4,1996,11,male,54,2842,2276,3701,1908,482,392,3219,1516
1770193,17,20,1996,2,female,752,2040,608,3674,1529,68,432,3606,1097
1620281,17,18,1996,8,female,1613,2268,1342,8432,3214,553,1468,7879,1746
1983951,20,23,1993,12,female,792,2624,517,7460,2513,958,1670,6502,843
1711518,19,10,1994,8,female,622,2560,925,3585,773,31,596,3554,177
1565995,20,9,1993,6,female,659,2007,1095,3817,644,201,314,3616,330
1085984,21,14,1992,10,male,993,2245,1397,6040,2568,18,771,6022,1797
1761484,103,18,1910,3,female,560,3018,547,5595,1926,586,810,5009,1116
1180095,13,23,2000,2,female,188,2028,925,4142,3095,232,454,3910,2641
1808820,16,10,1997,10,female,151,2051,941,3631,3750,720,1710,2911,2040
1417328,19,10,1994,11,female,836,4568,1738,3946,3794,2,2412,3944,1382
1766297,18,8,1995,7,female,1174,2209,1184,5006,5190,374,3187,4632,2003
1841932,18,6,1995,8,female,953,2569,1275,3810,3571,43,1244,3767,2327
1429178,18,22,1995,9,female,888,4733,519,16583,16743,1718,10104,14865,6639
1712413,20,7,1993,11,female,508,2583,646,5025,5969,134,2471,4891,3498
1350506,19,20,1994,8,female,397,3055,2199,8305,6801,1287,4027,7018,2774
1717724,20,14,1993,9,female,242,2355,1773,3981,3391,405,2447,3576,944
1538511,46,17,1967,7,female,447,1989,1710,8275,11436,0,1199,8275,10237
2115451,108,18,1905,5,female,954,3982,1190,6016,4012,1180,2816,4836,1196
2041648,15,29,1998,8,female,893,3893,715,4236,10510,718,2926,3518,7584
1781243,17,1,1996,5,female,976,3683,755,10478,42449,246,27353,10232,15096
1559908,20,4,1993,12,female,1334,4622,1819,4280,45633,472,30754,3808,14879
1298331,19,7,1994,9,female,1059,3776,1068,6912,27029,1197,12019,5715,15010
1914977,20,15,1993,1,female,712,3131,935,11142,37450,887,14806,10255,22644
2050257,20,9,1993,8,male,940,2291,655,3834,8861,2,1339,3832,7522
1771772,23,4,1990,2,female,1179,3840,1830,9734,23008,1373,11651,8361,11357
2144652,16,25,1997,11,female,342,2944,1530,8257,3950,3061,2762,5196,1188
1448930,17,11,1996,10,female,1316,4357,1810,10433,3066,7427,2119,3006,947
1090396,19,31,1994,12,female,247,2653,702,10386,5354,4451,2140,5935,3214
1783264,20,1,1993,3,male,267,2536,610,14355,5151,8591,3461,5764,1690
1269167,31,30,1982,4,male,513,3696,2579,6448,3687,2768,3210,3680,477
1856665,34,22,1979,11,male,392,2634,2201,4202,2458,1736,1684,2466,774
1981043,54,5,1959,8,male,801,3469,1557,5744,1978,2001,1301,3743,677
1103175,15,24,1998,8,female,487,3661,3086,6815,6177,1500,3990,5315,2187
1697605,16,16,1997,3,female,542,2824,1122,11506,9269,3177,5639,8329,3630
1287555,16,31,1997,5,female,558,2219,1712,9633,8874,5744,3841,3889,5033
1852952,17,19,1996,1,male,243,1960,1569,11439,10850,7065,5514,4374,5336
1131001,17,3,1996,3,female,1153,4630,1797,4590,3295,1709,1379,2881,1916
1159082,17,31,1996,5,female,728,2015,607,3922,5664,1938,3791,1984,1873
1415543,19,1,1994,7,female,511,2954,1069,4217,3696,2828,2242,1389,1454
1240778,20,27,1993,1,male,483,2803,2306,4645,3668,2487,2165,2158,1503
2000261,21,19,1992,3,female,1269,2047,640,5155,4077,1770,2522,3385,1555
1070396,37,29,1976,2,female,878,2738,2021,6294,6258,2416,3845,3878,2413
1292537,16,19,1997,1,female,631,3763,498,6369,19397,2386,12342,3983,7055
1745067,17,1,1996,1,female,947,4290,3238,3780,8185,1233,5380,2547,2805
1818104,17,7,1996,3,female,519,2238,1689,5591,15623,2753,11819,2838,3804
1710440,18,1,1995,1,female,404,2014,1324,5455,15089,2191,3799,3264,11290
1441066,18,12,1995,9,male,969,3494,2309,8210,13971,2399,7645,5811,6326
1330487,19,1,1994,1,male,594,3564,781,4007,6578,2796,3520,1211,3058
1982264,19,5,1994,10,male,856,2225,1622,8256,16150,4097,11523,4159,4627
1947946,20,11,1993,2,female,528,2016,803,5407,15036,1094,9022,4313,6014
1344342,20,18,1993,6,female,476,3599,2198,7594,15413,5373,6189,2221,9224
2185422,20,18,1993,8,female,1486,4132,1780,3781,22633,2514,12404,1267,10229
1569422,20,5,1993,8,female,1015,2565,1071,10020,16336,6631,9790,3389,6546
1007328,23,5,1990,11,female,1042,4620,1806,4756,9787,2574,6345,2182,3442
1926313,22,26,1991,3,female,1505,4336,1221,4539,9920,2303,7063,2236,2857
2079095,23,16,1990,9,male,417,3464,1296,8244,12435,3168,7342,5076,5093
1836366,26,3,1987,8,female,1669,4240,857,4794,28778,1153,20770,3641,8008
1686646,43,1,1970,1,male,793,3797,1034,5926,12642,3975,8460,1951,4182
1749991,107,29,1906,12,male,328,3748,396,6203,19674,3667,17624,2536,2050
1963699,18,17,1995,10,female,445,1921,858,8719,584,8142,251,577,333
1390362,17,5,1996,8,female,716,3738,2060,4790,2475,4269,1716,521,759
1638976,18,15,1995,1,female,401,2281,1790,7176,3256,6993,2397,183,859
1991657,15,13,1998,5,female,594,4631,1947,12234,14095,12083,10056,151,4039
1184126,15,20,1998,9,female,636,2769,453,6135,5444,5515,4021,620,1423
1277820,17,27,1996,11,female,1005,4351,2210,5045,4498,4742,3909,303,588
1364616,18,23,1995,12,female,508,3917,1872,3664,3058,3228,2349,436,709
1757787,18,26,1995,3,female,592,2426,585,8667,9534,7539,6731,1128,2803
1674381,18,25,1995,5,female,853,4417,1062,5765,6533,4215,5200,1550,1333
1299870,18,16,1995,8,male,894,3440,1138,3835,3833,3269,2221,566,1612
1043082,18,24,1995,10,female,356,1958,957,3981,5968,3215,2636,766,3332
1364887,20,29,1993,7,female,1089,2392,1408,5339,4964,4119,2366,1220,2598
1729341,21,20,1992,10,male,587,2784,809,5177,5423,4759,3278,418,2145
1008872,25,5,1988,9,female,273,2332,1849,6135,4952,6029,4547,106,405
1902600,58,11,1955,3,male,399,2083,553,6236,7784,4953,4795,1283,2989
1099760,15,29,1998,12,female,546,3712,482,6285,9515,5575,7780,710,1735
1422393,19,27,1994,11,female,456,3850,1311,4151,17117,3981,9370,170,7747
1654565,19,15,1994,8,male,394,4538,4144,4501,15088,4435,5961,66,9127
2063006,20,4,1993,1,female,402,1988,332,7351,106025,7248,73333,103,32692
1132164,20,9,1993,10,female,699,3611,973,4507,7768,4414,6909,93,859
1668695,24,25,1989,4,female,182,2938,1272,6018,17765,5843,11708,175,6057
1458985,28,14,1985,12,female,290,2218,1618,4626,10268,4290,4250,336,6018
1268299,68,4,1945,4,female,541,2118,341,3996,18089,3505,11887,491,6202
1256153,18,12,1995,3,female,21,1968,1720,4401,13412,4399,10592,2,2820
1195943,15,10,1998,5,female,111,2002,1524,11959,12554,11959,11462,0,1092
1468023,23,11,1990,4,female,416,2560,185,4506,6516,4506,5760,0,756
1397896,39,15,1974,5,female,397,2049,768,9410,12443,9410,9530,0,2913
